gIDN,used,notused,food,pets,allspecies,food_percent,pets_percent
6688_terrestrial,144,67,103,85,211,71.52777777777779,59.02777777777778
6689_terrestrial,142,67,101,85,209,71.12676056338029,59.859154929577464
6793_terrestrial,79,45,53,38,124,67.08860759493672,48.10126582278481
6794_terrestrial,77,44,51,38,121,66.23376623376623,49.35064935064935
7042_terrestrial,184,77,130,113,261,70.65217391304348,61.41304347826087
7043_terrestrial,194,86,137,121,280,70.61855670103093,62.371134020618555
7044_terrestrial,192,81,135,120,273,70.3125,62.5
7045_terrestrial,199,82,140,126,281,70.35175879396985,63.31658291457286
7046_terrestrial,200,82,143,127,282,71.5,63.5
7047_terrestrial,204,82,142,128,286,69.6078431372549,62.745098039215684
7048_terrestrial,196,78,137,122,274,69.89795918367348,62.244897959183675
7049_terrestrial,197,83,137,123,280,69.54314720812182,62.43654822335025
7050_terrestrial,188,83,134,116,271,71.27659574468085,61.702127659574465
7051_terrestrial,157,73,112,96,230,71.3375796178344,61.146496815286625
7146_terrestrial,101,46,60,58,147,59.4059405940594,57.42574257425742
7147_terrestrial,107,46,65,60,153,60.747663551401864,56.074766355140184
7148_terrestrial,112,45,70,63,157,62.5,56.25
7149_terrestrial,114,43,72,63,157,63.1578947368421,55.26315789473685
7150_terrestrial,106,43,66,59,149,62.264150943396224,55.660377358490564
7151_terrestrial,104,48,67,56,152,64.42307692307693,53.84615384615385
7152_terrestrial,104,51,67,56,155,64.42307692307693,53.84615384615385
7153_terrestrial,100,45,64,53,145,64,53
7154_terrestrial,97,43,64,54,140,65.97938144329896,55.670103092783506
7398_terrestrial,206,92,139,131,298,67.47572815533981,63.59223300970874
7399_terrestrial,219,91,151,138,310,68.94977168949772,63.013698630136986
7400_terrestrial,219,93,153,137,312,69.86301369863014,62.55707762557078
7401_terrestrial,222,93,154,132,315,69.36936936936937,59.45945945945946
7402_terrestrial,214,89,149,128,303,69.62616822429906,59.813084112149525
7403_terrestrial,209,81,142,126,290,67.94258373205741,60.28708133971292
7404_terrestrial,205,78,137,123,283,66.82926829268293,60
7405_terrestrial,156,47,96,106,203,61.53846153846154,67.94871794871796
7406_terrestrial,161,50,102,110,211,63.35403726708074,68.32298136645963
7407_terrestrial,157,51,102,109,208,64.96815286624204,69.42675159235668
7408_terrestrial,150,51,96,106,201,64,70.66666666666667
7409_terrestrial,173,56,115,122,229,66.47398843930635,70.52023121387283
7410_terrestrial,218,83,150,139,301,68.80733944954129,63.76146788990825
7411_terrestrial,199,80,137,127,279,68.84422110552764,63.81909547738693
7412_terrestrial,181,71,124,110,252,68.50828729281768,60.773480662983424
7413_terrestrial,164,71,111,103,235,67.6829268292683,62.80487804878049
7414_terrestrial,153,71,103,95,224,67.3202614379085,62.091503267973856
7415_terrestrial,145,68,96,90,213,66.20689655172414,62.06896551724138
7416_terrestrial,140,64,93,86,204,66.42857142857143,61.42857142857143
7417_terrestrial,138,64,93,84,202,67.3913043478261,60.86956521739131
7505_terrestrial,110,44,62,67,154,56.36363636363636,60.909090909090914
7506_terrestrial,115,44,68,66,159,59.130434782608695,57.391304347826086
7507_terrestrial,119,47,72,67,166,60.50420168067227,56.30252100840336
7508_terrestrial,119,41,73,67,160,61.34453781512605,56.30252100840336
7509_terrestrial,118,34,74,65,152,62.71186440677966,55.08474576271186
7510_terrestrial,124,32,77,70,156,62.096774193548384,56.451612903225815
7511_terrestrial,119,34,74,69,153,62.18487394957983,57.98319327731093
7512_terrestrial,122,44,75,72,166,61.47540983606557,59.01639344262295
7513_terrestrial,126,47,76,72,173,60.317460317460316,57.14285714285714
7514_terrestrial,124,52,75,71,176,60.483870967741936,57.25806451612904
7515_terrestrial,127,48,77,74,175,60.629921259842526,58.26771653543307
7756_terrestrial,220,102,157,133,322,71.36363636363636,60.45454545454545
7757_terrestrial,229,102,161,137,331,70.3056768558952,59.82532751091703
7758_terrestrial,227,97,156,138,324,68.72246696035242,60.792951541850215
7759_terrestrial,170,59,108,119,229,63.52941176470588,70
7760_terrestrial,165,59,108,113,224,65.45454545454545,68.48484848484848
7761_terrestrial,162,54,107,111,216,66.0493827160494,68.51851851851852
7762_terrestrial,156,53,100,109,209,64.1025641025641,69.87179487179486
7763_terrestrial,160,54,100,111,214,62.5,69.375
7764_terrestrial,165,61,104,117,226,63.030303030303024,70.9090909090909
7765_terrestrial,168,61,105,119,229,62.5,70.83333333333334
7766_terrestrial,165,63,102,117,228,61.81818181818181,70.9090909090909
7767_terrestrial,166,61,103,117,227,62.048192771084345,70.48192771084338
7768_terrestrial,165,63,100,120,228,60.60606060606061,72.72727272727273
7769_terrestrial,173,66,109,122,239,63.005780346820806,70.52023121387283
7770_terrestrial,175,65,109,126,240,62.28571428571429,72
7771_terrestrial,163,61,98,120,224,60.122699386503065,73.61963190184049
7772_terrestrial,166,57,101,117,223,60.8433734939759,70.48192771084338
7773_terrestrial,167,51,104,118,218,62.27544910179641,70.65868263473054
7774_terrestrial,165,54,102,116,219,61.81818181818181,70.3030303030303
7775_terrestrial,146,50,90,105,196,61.64383561643836,71.91780821917808
7776_terrestrial,137,45,85,99,182,62.04379562043796,72.26277372262774
7777_terrestrial,162,68,104,105,230,64.19753086419753,64.81481481481481
7778_terrestrial,146,65,97,90,211,66.43835616438356,61.64383561643836
7791_terrestrial,108,57,68,55,165,62.96296296296296,50.92592592592593
7792_terrestrial,110,58,69,57,168,62.727272727272734,51.81818181818182
7793_terrestrial,115,61,70,60,176,60.86956521739131,52.17391304347826
7794_terrestrial,115,59,71,62,174,61.73913043478261,53.91304347826087
7795_terrestrial,114,59,71,61,173,62.28070175438597,53.50877192982456
7796_terrestrial,111,57,70,59,168,63.06306306306306,53.153153153153156
7797_terrestrial,110,54,70,57,164,63.63636363636363,51.81818181818182
7798_terrestrial,108,55,68,55,163,62.96296296296296,50.92592592592593
7799_terrestrial,111,57,71,56,168,63.96396396396396,50.45045045045045
7827_terrestrial,117,53,65,73,170,55.55555555555556,62.39316239316239
7828_terrestrial,118,52,63,75,170,53.38983050847458,63.559322033898304
7864_terrestrial,113,43,63,73,156,55.75221238938053,64.60176991150442
7865_terrestrial,113,43,62,73,156,54.86725663716814,64.60176991150442
7866_terrestrial,120,43,68,72,163,56.666666666666664,60
7867_terrestrial,123,41,68,75,164,55.28455284552846,60.97560975609756
7868_terrestrial,122,39,67,74,161,54.91803278688525,60.65573770491803
7869_terrestrial,122,37,67,74,159,54.91803278688525,60.65573770491803
7870_terrestrial,122,35,69,76,157,56.557377049180324,62.295081967213115
7871_terrestrial,122,37,70,75,159,57.377049180327866,61.47540983606557
7872_terrestrial,124,43,70,78,167,56.451612903225815,62.903225806451616
7873_terrestrial,124,47,71,78,171,57.25806451612904,62.903225806451616
7874_terrestrial,125,48,71,79,173,56.8,63.2
7875_terrestrial,126,51,72,76,177,57.14285714285714,60.317460317460316
7876_terrestrial,125,49,72,75,174,57.599999999999994,60
7877_terrestrial,127,42,72,77,169,56.69291338582677,60.629921259842526
7878_terrestrial,124,39,72,76,163,58.06451612903226,61.29032258064516
7879_terrestrial,124,35,71,78,159,57.25806451612904,62.903225806451616
7880_terrestrial,119,38,69,77,157,57.98319327731093,64.70588235294117
7881_terrestrial,121,38,70,79,159,57.85123966942148,65.28925619834712
7882_terrestrial,122,39,69,79,161,56.557377049180324,64.75409836065575
7883_terrestrial,121,47,68,77,168,56.19834710743802,63.63636363636363
7884_terrestrial,119,47,66,75,166,55.46218487394958,63.02521008403361
7885_terrestrial,118,46,66,75,164,55.932203389830505,63.559322033898304
7886_terrestrial,118,46,66,75,164,55.932203389830505,63.559322033898304
8114_terrestrial,218,87,152,134,305,69.72477064220183,61.46788990825688
8115_terrestrial,236,94,165,148,330,69.91525423728814,62.71186440677966
8116_terrestrial,243,99,170,152,342,69.95884773662551,62.55144032921811
8117_terrestrial,240,96,165,144,336,68.75,60
8118_terrestrial,153,57,96,106,210,62.745098039215684,69.28104575163398
8119_terrestrial,156,56,102,108,212,65.38461538461539,69.23076923076923
8120_terrestrial,159,55,103,112,214,64.77987421383648,70.44025157232704
8121_terrestrial,174,61,113,117,235,64.9425287356322,67.24137931034483
8122_terrestrial,168,59,111,119,227,66.07142857142857,70.83333333333334
8123_terrestrial,163,59,107,119,222,65.6441717791411,73.00613496932516
8124_terrestrial,172,64,108,125,236,62.7906976744186,72.67441860465115
8125_terrestrial,173,62,107,128,235,61.849710982658955,73.98843930635837
8126_terrestrial,163,60,101,120,223,61.963190184049076,73.61963190184049
8127_terrestrial,165,64,100,124,229,60.60606060606061,75.15151515151514
8128_terrestrial,168,64,104,125,232,61.904761904761905,74.40476190476191
8129_terrestrial,173,64,109,128,237,63.005780346820806,73.98843930635837
8130_terrestrial,179,68,113,129,247,63.128491620111724,72.06703910614524
8131_terrestrial,173,69,107,125,242,61.849710982658955,72.25433526011561
8132_terrestrial,207,82,136,137,289,65.70048309178745,66.18357487922705
8133_terrestrial,212,82,143,139,294,67.45283018867924,65.56603773584906
8134_terrestrial,168,59,104,117,227,61.904761904761905,69.64285714285714
8135_terrestrial,162,58,97,114,220,59.876543209876544,70.37037037037037
8136_terrestrial,159,54,97,113,213,61.0062893081761,71.0691823899371
8137_terrestrial,149,48,87,110,197,58.38926174496645,73.8255033557047
8148_terrestrial,117,59,74,64,176,63.24786324786324,54.700854700854705
8149_terrestrial,124,60,79,69,184,63.70967741935484,55.64516129032258
8150_terrestrial,134,64,86,76,198,64.17910447761194,56.71641791044776
8151_terrestrial,111,48,64,71,159,57.65765765765766,63.96396396396396
8152_terrestrial,113,51,64,74,164,56.63716814159292,65.48672566371681
8153_terrestrial,123,50,69,79,173,56.09756097560976,64.22764227642277
8154_terrestrial,145,66,89,87,211,61.37931034482759,60
8155_terrestrial,148,67,90,89,215,60.810810810810814,60.13513513513513
8156_terrestrial,127,49,75,82,176,59.055118110236215,64.56692913385827
8157_terrestrial,119,47,69,80,166,57.98319327731093,67.22689075630252
8158_terrestrial,113,47,64,77,160,56.63716814159292,68.14159292035397
8159_terrestrial,119,50,70,74,169,58.82352941176471,62.18487394957983
8160_terrestrial,118,49,71,73,167,60.16949152542372,61.86440677966102
8161_terrestrial,118,46,73,73,164,61.86440677966102,61.86440677966102
8162_terrestrial,116,50,71,75,166,61.206896551724135,64.65517241379311
8163_terrestrial,114,50,68,74,164,59.64912280701754,64.91228070175438
8164_terrestrial,119,51,73,79,170,61.34453781512605,66.38655462184873
8165_terrestrial,116,51,71,76,167,61.206896551724135,65.51724137931035
8166_terrestrial,123,61,80,74,184,65.04065040650406,60.16260162601627
8167_terrestrial,126,60,82,74,186,65.07936507936508,58.730158730158735
8168_terrestrial,106,54,66,62,160,62.264150943396224,58.490566037735846
8169_terrestrial,104,56,65,62,160,62.5,59.61538461538461
8170_terrestrial,103,57,64,61,160,62.13592233009708,59.22330097087378
8171_terrestrial,96,52,58,55,148,60.416666666666664,57.291666666666664
8172_terrestrial,100,57,61,55,157,61,55.00000000000001
8183_terrestrial,109,48,62,72,157,56.88073394495413,66.05504587155964
8184_terrestrial,113,48,63,76,161,55.75221238938053,67.2566371681416
8185_terrestrial,116,51,65,79,167,56.03448275862068,68.10344827586206
8186_terrestrial,125,55,70,83,180,56.00000000000001,66.4
8187_terrestrial,128,54,70,86,182,54.6875,67.1875
8188_terrestrial,129,53,70,87,182,54.263565891472865,67.44186046511628
8224_terrestrial,125,48,66,86,173,52.800000000000004,68.8
8225_terrestrial,126,49,67,87,175,53.17460317460318,69.04761904761905
8226_terrestrial,130,47,69,86,177,53.07692307692308,66.15384615384615
8227_terrestrial,130,47,71,84,177,54.61538461538461,64.61538461538461
8228_terrestrial,131,41,74,83,172,56.48854961832062,63.358778625954194
8229_terrestrial,131,39,73,83,170,55.72519083969466,63.358778625954194
8230_terrestrial,132,35,73,85,167,55.3030303030303,64.39393939393939
8231_terrestrial,132,45,73,85,177,55.3030303030303,64.39393939393939
8232_terrestrial,127,49,68,85,176,53.54330708661418,66.92913385826772
8233_terrestrial,128,49,69,86,177,53.90625,67.1875
8234_terrestrial,127,49,68,85,176,53.54330708661418,66.92913385826772
8235_terrestrial,130,51,70,85,181,53.84615384615385,65.38461538461539
8236_terrestrial,131,49,71,84,180,54.19847328244275,64.12213740458014
8237_terrestrial,130,46,70,84,176,53.84615384615385,64.61538461538461
8238_terrestrial,132,45,72,85,177,54.54545454545454,64.39393939393939
8239_terrestrial,132,38,71,87,170,53.78787878787878,65.9090909090909
8240_terrestrial,133,38,72,87,171,54.13533834586466,65.41353383458647
8241_terrestrial,133,38,75,87,171,56.390977443609025,65.41353383458647
8242_terrestrial,132,42,74,89,174,56.060606060606055,67.42424242424242
8243_terrestrial,131,46,74,88,177,56.48854961832062,67.17557251908397
8244_terrestrial,130,48,74,88,178,56.92307692307692,67.6923076923077
8245_terrestrial,129,49,73,87,178,56.58914728682171,67.44186046511628
8246_terrestrial,129,49,73,87,178,56.58914728682171,67.44186046511628
8247_terrestrial,128,48,73,86,176,57.03125,67.1875
8248_terrestrial,132,44,77,86,176,58.333333333333336,65.15151515151516
8249_terrestrial,130,40,76,84,170,58.46153846153847,64.61538461538461
8250_terrestrial,129,42,76,86,171,58.91472868217055,66.66666666666666
8251_terrestrial,126,44,73,85,170,57.936507936507944,67.46031746031747
8252_terrestrial,130,46,76,88,176,58.46153846153847,67.6923076923077
8253_terrestrial,128,45,75,86,173,58.59375,67.1875
8254_terrestrial,129,47,76,86,176,58.91472868217055,66.66666666666666
8255_terrestrial,131,45,78,87,176,59.541984732824424,66.41221374045801
8256_terrestrial,134,44,78,86,178,58.2089552238806,64.17910447761194
8473_terrestrial,230,88,162,135,318,70.43478260869566,58.69565217391305
8474_terrestrial,252,93,179,155,345,71.03174603174604,61.50793650793651
8475_terrestrial,254,103,179,159,357,70.47244094488188,62.59842519685039
8476_terrestrial,177,62,112,127,239,63.2768361581921,71.75141242937853
8477_terrestrial,173,56,110,123,229,63.58381502890174,71.09826589595376
8478_terrestrial,165,56,105,118,221,63.63636363636363,71.51515151515152
8479_terrestrial,177,56,114,124,233,64.40677966101694,70.05649717514125
8480_terrestrial,165,57,109,116,222,66.06060606060606,70.3030303030303
8481_terrestrial,171,61,111,119,232,64.91228070175438,69.5906432748538
8482_terrestrial,190,64,121,136,254,63.68421052631579,71.57894736842105
8483_terrestrial,193,65,123,138,258,63.730569948186535,71.50259067357513
8484_terrestrial,195,71,125,141,266,64.1025641025641,72.3076923076923
8485_terrestrial,196,70,126,141,266,64.28571428571429,71.93877551020408
8486_terrestrial,187,70,118,135,257,63.101604278074866,72.19251336898395
8487_terrestrial,184,68,115,131,252,62.5,71.19565217391305
8488_terrestrial,183,69,115,129,252,62.841530054644814,70.49180327868852
8489_terrestrial,180,75,109,130,255,60.55555555555555,72.22222222222221
8490_terrestrial,190,73,118,137,263,62.10526315789474,72.10526315789474
8491_terrestrial,185,68,114,132,253,61.62162162162163,71.35135135135135
8492_terrestrial,183,68,114,128,251,62.295081967213115,69.94535519125684
8493_terrestrial,213,82,139,140,295,65.25821596244131,65.72769953051643
8494_terrestrial,213,82,138,137,295,64.7887323943662,64.31924882629107
8495_terrestrial,215,81,138,137,296,64.18604651162791,63.72093023255814
8505_terrestrial,192,65,121,125,257,63.020833333333336,65.10416666666666
8506_terrestrial,180,72,113,111,252,62.77777777777778,61.66666666666667
8507_terrestrial,178,75,112,109,253,62.92134831460674,61.23595505617978
8508_terrestrial,177,73,110,111,250,62.14689265536724,62.71186440677966
8509_terrestrial,158,59,92,106,217,58.22784810126582,67.08860759493672
8510_terrestrial,150,51,84,105,201,56.00000000000001,70
8511_terrestrial,154,54,87,106,208,56.493506493506494,68.83116883116884
8512_terrestrial,157,57,92,103,214,58.59872611464968,65.60509554140127
8513_terrestrial,156,60,91,104,216,58.333333333333336,66.66666666666666
8514_terrestrial,154,62,92,104,216,59.74025974025974,67.53246753246754
8515_terrestrial,151,61,90,105,212,59.60264900662252,69.5364238410596
8516_terrestrial,151,61,90,106,212,59.60264900662252,70.19867549668875
8517_terrestrial,149,60,89,106,209,59.73154362416108,71.14093959731544
8518_terrestrial,153,58,92,109,211,60.130718954248366,71.24183006535948
8519_terrestrial,154,58,93,111,212,60.3896103896104,72.07792207792207
8520_terrestrial,151,59,92,108,210,60.9271523178808,71.52317880794702
8521_terrestrial,148,57,90,104,205,60.810810810810814,70.27027027027027
8522_terrestrial,148,59,89,103,207,60.13513513513513,69.5945945945946
8523_terrestrial,155,63,93,106,218,60,68.38709677419355
8524_terrestrial,156,64,92,104,220,58.97435897435898,66.66666666666666
8525_terrestrial,159,72,96,105,231,60.37735849056604,66.0377358490566
8526_terrestrial,160,73,97,107,233,60.62499999999999,66.875
8527_terrestrial,148,68,90,103,216,60.810810810810814,69.5945945945946
8528_terrestrial,145,64,90,99,209,62.06896551724138,68.27586206896552
8529_terrestrial,148,70,96,97,218,64.86486486486487,65.54054054054053
8530_terrestrial,143,70,93,92,213,65.03496503496503,64.33566433566433
8531_terrestrial,136,70,88,85,206,64.70588235294117,62.5
8532_terrestrial,133,68,87,85,201,65.41353383458647,63.90977443609023
8533_terrestrial,125,64,80,78,189,64,62.4
8534_terrestrial,115,60,70,68,175,60.86956521739131,59.130434782608695
8535_terrestrial,106,56,60,69,162,56.60377358490566,65.09433962264151
8536_terrestrial,104,54,58,67,158,55.769230769230774,64.42307692307693
8537_terrestrial,109,53,62,73,162,56.88073394495413,66.97247706422019
8538_terrestrial,116,55,64,78,171,55.172413793103445,67.24137931034483
8539_terrestrial,119,58,65,82,177,54.621848739495796,68.90756302521008
8540_terrestrial,122,60,68,84,182,55.73770491803278,68.85245901639344
8541_terrestrial,124,59,68,86,183,54.83870967741935,69.35483870967742
8542_terrestrial,129,55,72,89,184,55.81395348837209,68.9922480620155
8543_terrestrial,131,53,72,90,184,54.961832061068705,68.70229007633588
8544_terrestrial,128,51,70,88,179,54.6875,68.75
8545_terrestrial,128,53,69,90,181,53.90625,70.3125
8546_terrestrial,133,54,73,92,187,54.88721804511278,69.17293233082707
8547_terrestrial,136,57,75,95,193,55.14705882352941,69.85294117647058
8548_terrestrial,136,57,75,96,193,55.14705882352941,70.58823529411765
8549_terrestrial,137,58,74,97,195,54.01459854014598,70.8029197080292
8574_terrestrial,128,37,70,94,165,54.6875,73.4375
8575_terrestrial,127,37,69,93,164,54.330708661417326,73.22834645669292
8576_terrestrial,129,37,71,95,166,55.03875968992248,73.64341085271317
8577_terrestrial,126,38,69,91,164,54.761904761904766,72.22222222222221
8578_terrestrial,127,38,70,92,165,55.118110236220474,72.44094488188976
8579_terrestrial,127,38,69,92,165,54.330708661417326,72.44094488188976
8580_terrestrial,130,41,71,94,171,54.61538461538461,72.3076923076923
8581_terrestrial,129,43,70,93,172,54.263565891472865,72.09302325581395
8582_terrestrial,129,45,70,93,174,54.263565891472865,72.09302325581395
8583_terrestrial,128,49,70,92,177,54.6875,71.875
8584_terrestrial,126,51,68,90,177,53.96825396825397,71.42857142857143
8585_terrestrial,124,49,68,89,173,54.83870967741935,71.7741935483871
8586_terrestrial,129,49,72,89,178,55.81395348837209,68.9922480620155
8587_terrestrial,127,47,71,87,174,55.90551181102362,68.50393700787401
8588_terrestrial,132,38,75,88,170,56.81818181818182,66.66666666666666
8589_terrestrial,132,38,75,88,170,56.81818181818182,66.66666666666666
8590_terrestrial,133,34,76,90,167,57.14285714285714,67.66917293233082
8591_terrestrial,132,42,74,90,174,56.060606060606055,68.18181818181817
8592_terrestrial,132,48,74,90,180,56.060606060606055,68.18181818181817
8593_terrestrial,132,48,74,90,180,56.060606060606055,68.18181818181817
8594_terrestrial,132,44,75,90,176,56.81818181818182,68.18181818181817
8595_terrestrial,134,44,76,91,178,56.71641791044776,67.91044776119402
8596_terrestrial,132,44,75,90,176,56.81818181818182,68.18181818181817
8597_terrestrial,132,44,75,90,176,56.81818181818182,68.18181818181817
8598_terrestrial,135,45,78,90,180,57.77777777777777,66.66666666666666
8599_terrestrial,135,40,78,90,175,57.77777777777777,66.66666666666666
8600_terrestrial,135,40,78,89,175,57.77777777777777,65.92592592592592
8601_terrestrial,134,40,77,89,174,57.46268656716418,66.4179104477612
8602_terrestrial,133,40,76,89,173,57.14285714285714,66.9172932330827
8603_terrestrial,129,40,74,89,169,57.36434108527132,68.9922480620155
8604_terrestrial,130,43,76,88,173,58.46153846153847,67.6923076923077
8605_terrestrial,125,41,72,85,166,57.599999999999994,68
8606_terrestrial,124,47,71,84,171,57.25806451612904,67.74193548387096
8607_terrestrial,126,47,73,83,173,57.936507936507944,65.87301587301587
8608_terrestrial,128,47,74,87,175,57.8125,67.96875
8609_terrestrial,128,45,74,88,173,57.8125,68.75
8610_terrestrial,127,43,75,86,170,59.055118110236215,67.71653543307087
8611_terrestrial,129,45,76,88,174,58.91472868217055,68.21705426356588
8612_terrestrial,128,47,74,89,175,57.8125,69.53125
8613_terrestrial,128,49,74,89,177,57.8125,69.53125
8614_terrestrial,128,48,74,89,176,57.8125,69.53125
8615_terrestrial,128,46,74,89,174,57.8125,69.53125
8832_terrestrial,240,91,169,140,331,70.41666666666667,58.333333333333336
8833_terrestrial,272,99,191,167,371,70.22058823529412,61.39705882352941
8834_terrestrial,267,103,186,162,370,69.66292134831461,60.67415730337079
8835_terrestrial,177,62,112,126,239,63.2768361581921,71.1864406779661
8836_terrestrial,168,55,107,120,223,63.69047619047619,71.42857142857143
8837_terrestrial,173,54,109,122,227,63.005780346820806,70.52023121387283
8838_terrestrial,177,52,113,124,229,63.84180790960452,70.05649717514125
8839_terrestrial,172,55,110,120,227,63.95348837209303,69.76744186046511
8840_terrestrial,177,61,113,124,238,63.84180790960452,70.05649717514125
8841_terrestrial,193,62,123,141,255,63.730569948186535,73.05699481865285
8842_terrestrial,221,77,146,154,298,66.06334841628959,69.68325791855203
8843_terrestrial,204,74,135,141,278,66.17647058823529,69.11764705882352
8844_terrestrial,200,77,134,136,277,67,68
8845_terrestrial,228,88,147,159,316,64.47368421052632,69.73684210526315
8846_terrestrial,239,87,152,170,326,63.59832635983263,71.1297071129707
8847_terrestrial,204,74,128,147,278,62.745098039215684,72.05882352941177
8848_terrestrial,189,73,117,133,262,61.904761904761905,70.37037037037037
8849_terrestrial,191,74,115,135,265,60.20942408376963,70.68062827225131
8850_terrestrial,195,76,120,136,271,61.53846153846154,69.74358974358974
8851_terrestrial,193,69,118,134,262,61.13989637305699,69.43005181347151
8852_terrestrial,184,67,112,128,251,60.86956521739131,69.56521739130434
8853_terrestrial,183,67,111,127,250,60.65573770491803,69.39890710382514
8854_terrestrial,182,67,111,128,249,60.98901098901099,70.32967032967034
8855_terrestrial,210,79,134,140,289,63.8095238095238,66.66666666666666
8862_terrestrial,169,61,99,119,230,58.57988165680473,70.41420118343196
8863_terrestrial,171,60,99,119,231,57.89473684210527,69.5906432748538
8864_terrestrial,175,60,101,124,235,57.714285714285715,70.85714285714285
8865_terrestrial,211,79,130,138,290,61.61137440758294,65.40284360189574
8866_terrestrial,179,63,103,126,242,57.54189944134078,70.39106145251397
8867_terrestrial,180,64,105,125,244,58.333333333333336,69.44444444444444
8868_terrestrial,181,67,106,126,248,58.5635359116022,69.61325966850829
8869_terrestrial,178,65,105,124,243,58.98876404494382,69.66292134831461
8870_terrestrial,177,64,106,125,241,59.887005649717516,70.62146892655367
8871_terrestrial,173,68,102,123,241,58.95953757225434,71.09826589595376
8872_terrestrial,172,65,101,123,237,58.720930232558146,71.51162790697676
8873_terrestrial,174,67,104,123,241,59.77011494252874,70.6896551724138
8874_terrestrial,173,67,104,121,240,60.115606936416185,69.94219653179191
8875_terrestrial,171,67,103,119,238,60.23391812865497,69.5906432748538
8876_terrestrial,168,64,101,117,232,60.11904761904761,69.64285714285714
8877_terrestrial,166,62,98,119,228,59.036144578313255,71.6867469879518
8878_terrestrial,167,64,101,119,231,60.47904191616767,71.25748502994011
8879_terrestrial,167,69,102,120,236,61.07784431137725,71.8562874251497
8880_terrestrial,167,66,101,121,233,60.47904191616767,72.45508982035929
8881_terrestrial,167,63,101,120,230,60.47904191616767,71.8562874251497
8882_terrestrial,168,59,99,119,227,58.92857142857143,70.83333333333334
8883_terrestrial,169,58,99,120,227,58.57988165680473,71.00591715976331
8884_terrestrial,168,67,99,122,235,58.92857142857143,72.61904761904762
8885_terrestrial,168,66,100,121,234,59.523809523809526,72.02380952380952
8886_terrestrial,171,66,102,124,237,59.64912280701754,72.51461988304094
8887_terrestrial,167,66,98,119,233,58.68263473053892,71.25748502994011
8888_terrestrial,165,65,98,118,230,59.3939393939394,71.51515151515152
8889_terrestrial,161,61,95,115,222,59.006211180124225,71.42857142857143
8890_terrestrial,156,67,94,111,223,60.256410256410255,71.15384615384616
8891_terrestrial,155,66,92,109,221,59.354838709677416,70.3225806451613
8892_terrestrial,153,67,92,107,220,60.130718954248366,69.93464052287581
8893_terrestrial,151,66,90,105,217,59.60264900662252,69.5364238410596
8894_terrestrial,150,64,90,104,214,60,69.33333333333334
8895_terrestrial,149,62,91,103,211,61.07382550335571,69.12751677852349
8896_terrestrial,146,62,88,103,208,60.273972602739725,70.54794520547945
8897_terrestrial,143,57,84,105,200,58.74125874125874,73.42657342657343
8898_terrestrial,142,60,81,105,202,57.04225352112676,73.94366197183099
8899_terrestrial,145,59,84,106,204,57.931034482758626,73.10344827586206
8900_terrestrial,142,59,81,104,201,57.04225352112676,73.23943661971832
8901_terrestrial,145,57,82,106,202,56.55172413793104,73.10344827586206
8902_terrestrial,143,60,81,105,203,56.64335664335665,73.42657342657343
8903_terrestrial,146,60,82,108,206,56.16438356164384,73.97260273972603
8904_terrestrial,148,60,84,110,208,56.75675675675676,74.32432432432432
8905_terrestrial,144,60,82,107,204,56.94444444444444,74.30555555555556
8906_terrestrial,143,62,81,105,205,56.64335664335665,73.42657342657343
8907_terrestrial,143,60,81,105,203,56.64335664335665,73.42657342657343
8908_terrestrial,144,62,82,106,206,56.94444444444444,73.61111111111111
8909_terrestrial,146,62,83,108,208,56.849315068493155,73.97260273972603
8910_terrestrial,143,53,82,108,196,57.34265734265735,75.52447552447552
8928_terrestrial,143,47,81,106,190,56.64335664335665,74.12587412587412
8929_terrestrial,142,46,79,105,188,55.633802816901415,73.94366197183099
8930_terrestrial,140,46,78,103,186,55.714285714285715,73.57142857142858
8931_terrestrial,141,44,78,104,185,55.319148936170215,73.75886524822694
8932_terrestrial,141,42,77,106,183,54.60992907801418,75.177304964539
8933_terrestrial,143,42,78,108,185,54.54545454545454,75.52447552447552
8934_terrestrial,144,44,78,109,188,54.166666666666664,75.69444444444444
8935_terrestrial,144,45,79,109,189,54.861111111111114,75.69444444444444
8936_terrestrial,142,45,78,107,187,54.929577464788736,75.35211267605634
8937_terrestrial,141,48,78,106,189,55.319148936170215,75.177304964539
8938_terrestrial,139,49,78,103,188,56.11510791366906,74.10071942446042
8939_terrestrial,141,49,80,105,190,56.73758865248227,74.46808510638297
8940_terrestrial,142,49,81,106,191,57.04225352112676,74.64788732394366
8941_terrestrial,140,49,80,104,189,57.14285714285714,74.28571428571429
8942_terrestrial,139,49,79,103,188,56.83453237410072,74.10071942446042
8943_terrestrial,139,49,79,103,188,56.83453237410072,74.10071942446042
8944_terrestrial,140,53,80,104,193,57.14285714285714,74.28571428571429
8945_terrestrial,139,53,80,103,192,57.55395683453237,74.10071942446042
8946_terrestrial,141,54,81,101,195,57.446808510638306,71.63120567375887
8947_terrestrial,140,52,81,100,192,57.85714285714286,71.42857142857143
8948_terrestrial,142,46,84,98,188,59.154929577464785,69.01408450704226
8949_terrestrial,142,42,83,97,184,58.45070422535211,68.30985915492957
8950_terrestrial,140,41,81,95,181,57.85714285714286,67.85714285714286
8951_terrestrial,140,47,82,95,187,58.57142857142858,67.85714285714286
8952_terrestrial,139,47,81,94,186,58.27338129496403,67.62589928057554
8953_terrestrial,137,45,79,93,182,57.66423357664233,67.88321167883211
8954_terrestrial,136,47,78,92,183,57.35294117647059,67.64705882352942
8955_terrestrial,134,49,76,92,183,56.71641791044776,68.65671641791045
8956_terrestrial,134,47,76,91,181,56.71641791044776,67.91044776119402
8957_terrestrial,137,47,79,92,184,57.66423357664233,67.15328467153284
8958_terrestrial,137,45,79,92,182,57.66423357664233,67.15328467153284
8959_terrestrial,136,41,79,91,177,58.08823529411765,66.91176470588235
8960_terrestrial,136,40,79,91,176,58.08823529411765,66.91176470588235
8961_terrestrial,135,40,78,91,175,57.77777777777777,67.4074074074074
8962_terrestrial,135,40,78,92,175,57.77777777777777,68.14814814814815
8963_terrestrial,135,39,78,92,174,57.77777777777777,68.14814814814815
8964_terrestrial,135,40,80,92,175,59.25925925925925,68.14814814814815
8965_terrestrial,137,42,82,92,179,59.854014598540154,67.15328467153284
8966_terrestrial,137,41,81,94,178,59.12408759124088,68.61313868613139
8967_terrestrial,135,46,80,92,181,59.25925925925925,68.14814814814815
8968_terrestrial,135,46,80,91,181,59.25925925925925,67.4074074074074
8969_terrestrial,134,48,79,92,182,58.95522388059702,68.65671641791045
8970_terrestrial,135,48,80,92,183,59.25925925925925,68.14814814814815
8971_terrestrial,129,48,74,89,177,57.36434108527132,68.9922480620155
8972_terrestrial,125,51,71,87,176,56.8,69.6
8973_terrestrial,123,52,69,85,175,56.09756097560976,69.10569105691057
8974_terrestrial,124,52,70,84,176,56.451612903225815,67.74193548387096
9191_terrestrial,267,106,184,162,373,68.91385767790263,60.67415730337079
9192_terrestrial,283,113,200,172,396,70.6713780918728,60.7773851590106
9193_terrestrial,284,107,195,171,391,68.66197183098592,60.2112676056338
9194_terrestrial,186,60,115,138,246,61.82795698924731,74.19354838709677
9195_terrestrial,174,59,105,125,233,60.3448275862069,71.83908045977012
9196_terrestrial,173,53,105,127,226,60.69364161849711,73.41040462427746
9197_terrestrial,174,54,111,122,228,63.793103448275865,70.11494252873564
9198_terrestrial,178,56,116,124,234,65.1685393258427,69.66292134831461
9199_terrestrial,181,62,114,129,243,62.98342541436463,71.27071823204419
9200_terrestrial,189,64,120,135,253,63.49206349206349,71.42857142857143
9201_terrestrial,220,75,144,156,295,65.45454545454545,70.9090909090909
9202_terrestrial,206,75,136,145,281,66.01941747572816,70.3883495145631
9204_terrestrial,222,86,143,152,308,64.41441441441441,68.46846846846847
9205_terrestrial,240,87,151,167,327,62.916666666666664,69.58333333333333
9206_terrestrial,243,89,155,168,332,63.78600823045267,69.1358024691358
9207_terrestrial,214,78,137,149,292,64.01869158878505,69.62616822429906
9208_terrestrial,198,78,125,136,276,63.13131313131313,68.68686868686868
9209_terrestrial,200,78,121,140,278,60.5,70
9210_terrestrial,205,81,125,141,286,60.97560975609756,68.78048780487805
9211_terrestrial,205,79,127,137,284,61.951219512195124,66.82926829268293
9212_terrestrial,198,76,119,136,274,60.1010101010101,68.68686868686868
9213_terrestrial,198,70,116,139,268,58.58585858585859,70.2020202020202
9214_terrestrial,199,71,119,138,270,59.798994974874375,69.34673366834171
9215_terrestrial,228,89,143,150,317,62.71929824561403,65.78947368421053
9216_terrestrial,218,84,137,145,302,62.84403669724771,66.5137614678899
9217_terrestrial,213,80,136,141,293,63.84976525821596,66.19718309859155
9218_terrestrial,199,75,126,132,274,63.31658291457286,66.33165829145729
9219_terrestrial,217,79,139,142,296,64.0552995391705,65.43778801843318
9220_terrestrial,237,84,146,155,321,61.60337552742617,65.40084388185655
9221_terrestrial,243,89,152,159,332,62.55144032921811,65.4320987654321
9222_terrestrial,211,75,127,146,286,60.18957345971564,69.19431279620854
9223_terrestrial,200,71,121,141,271,60.5,70.5
9224_terrestrial,195,69,117,137,264,60,70.25641025641025
9225_terrestrial,190,69,114,136,259,60,71.57894736842105
9226_terrestrial,191,70,115,137,261,60.20942408376963,71.72774869109948
9227_terrestrial,190,70,113,137,260,59.473684210526315,72.10526315789474
9228_terrestrial,190,68,113,133,258,59.473684210526315,70
9229_terrestrial,189,68,113,132,257,59.78835978835979,69.84126984126983
9230_terrestrial,186,65,111,130,251,59.67741935483871,69.89247311827957
9231_terrestrial,184,64,110,128,248,59.78260869565217,69.56521739130434
9232_terrestrial,177,64,107,124,241,60.451977401129945,70.05649717514125
9233_terrestrial,180,65,109,128,245,60.55555555555555,71.11111111111111
9234_terrestrial,174,66,106,124,240,60.91954022988506,71.26436781609196
9235_terrestrial,175,68,105,123,243,60,70.28571428571428
9236_terrestrial,174,67,104,122,241,59.77011494252874,70.11494252873564
9237_terrestrial,178,69,107,126,247,60.1123595505618,70.78651685393258
9238_terrestrial,174,67,103,124,241,59.195402298850574,71.26436781609196
9239_terrestrial,179,71,106,128,250,59.217877094972074,71.50837988826815
9240_terrestrial,177,72,103,125,249,58.19209039548022,70.62146892655367
9241_terrestrial,174,66,101,124,240,58.04597701149425,71.26436781609196
9242_terrestrial,165,59,96,122,224,58.18181818181818,73.93939393939394
9243_terrestrial,166,56,97,123,222,58.43373493975904,74.09638554216868
9244_terrestrial,169,66,101,124,235,59.76331360946746,73.37278106508876
9245_terrestrial,171,67,101,126,238,59.06432748538012,73.68421052631578
9246_terrestrial,173,65,104,126,238,60.115606936416185,72.83236994219652
9247_terrestrial,173,63,104,127,236,60.115606936416185,73.41040462427746
9248_terrestrial,172,63,102,126,235,59.30232558139535,73.25581395348837
9249_terrestrial,165,59,99,123,224,60,74.54545454545455
9250_terrestrial,164,59,99,122,223,60.36585365853659,74.39024390243902
9251_terrestrial,168,61,99,125,229,58.92857142857143,74.40476190476191
9252_terrestrial,165,61,98,123,226,59.3939393939394,74.54545454545455
9253_terrestrial,163,64,95,120,227,58.282208588957054,73.61963190184049
9254_terrestrial,160,62,92,119,222,57.49999999999999,74.375
9255_terrestrial,157,62,91,118,219,57.961783439490446,75.15923566878982
9256_terrestrial,157,62,91,118,219,57.961783439490446,75.15923566878982
9257_terrestrial,155,58,91,117,213,58.70967741935483,75.48387096774194
9258_terrestrial,155,57,90,116,212,58.06451612903226,74.83870967741936
9259_terrestrial,152,60,86,114,212,56.57894736842105,75
9260_terrestrial,149,59,84,112,208,56.375838926174495,75.16778523489933
9261_terrestrial,148,59,83,111,207,56.08108108108109,75
9262_terrestrial,144,60,81,107,204,56.25,74.30555555555556
9263_terrestrial,144,60,81,107,204,56.25,74.30555555555556
9264_terrestrial,146,60,85,110,206,58.21917808219178,75.34246575342466
9265_terrestrial,146,59,85,109,205,58.21917808219178,74.65753424657534
9266_terrestrial,149,59,88,111,208,59.06040268456376,74.49664429530202
9267_terrestrial,150,63,89,112,213,59.333333333333336,74.66666666666667
9268_terrestrial,147,62,86,109,209,58.50340136054422,74.14965986394559
9269_terrestrial,148,62,85,110,210,57.432432432432435,74.32432432432432
9270_terrestrial,148,56,85,110,204,57.432432432432435,74.32432432432432
9271_terrestrial,148,55,85,111,203,57.432432432432435,75
9288_terrestrial,152,49,87,115,201,57.23684210526315,75.6578947368421
9289_terrestrial,153,49,88,116,202,57.51633986928104,75.81699346405229
9290_terrestrial,152,50,87,115,202,57.23684210526315,75.6578947368421
9291_terrestrial,152,50,87,115,202,57.23684210526315,75.6578947368421
9292_terrestrial,151,51,87,114,202,57.615894039735096,75.49668874172185
9293_terrestrial,150,51,86,115,201,57.333333333333336,76.66666666666667
9294_terrestrial,153,49,87,117,202,56.86274509803921,76.47058823529412
9295_terrestrial,152,51,86,116,203,56.57894736842105,76.31578947368422
9296_terrestrial,152,52,87,116,204,57.23684210526315,76.31578947368422
9297_terrestrial,153,55,88,117,208,57.51633986928104,76.47058823529412
9298_terrestrial,157,55,89,119,212,56.68789808917197,75.79617834394905
9299_terrestrial,154,58,89,116,212,57.7922077922078,75.32467532467533
9300_terrestrial,154,56,89,115,210,57.7922077922078,74.67532467532467
9301_terrestrial,156,54,92,117,210,58.97435897435898,75
9302_terrestrial,156,56,94,119,212,60.256410256410255,76.28205128205127
9303_terrestrial,155,58,94,118,213,60.64516129032258,76.12903225806451
9304_terrestrial,157,58,96,120,215,61.146496815286625,76.43312101910828
9305_terrestrial,157,60,96,119,217,61.146496815286625,75.79617834394905
9306_terrestrial,160,60,100,121,220,62.5,75.625
9307_terrestrial,161,61,99,120,222,61.49068322981367,74.53416149068323
9308_terrestrial,160,59,98,117,219,61.25000000000001,73.125
9309_terrestrial,163,58,101,117,221,61.963190184049076,71.77914110429448
9310_terrestrial,165,56,101,119,221,61.212121212121204,72.12121212121212
9311_terrestrial,164,56,101,118,220,61.58536585365854,71.95121951219512
9312_terrestrial,161,58,99,116,219,61.49068322981367,72.04968944099379
9313_terrestrial,158,58,96,113,216,60.75949367088608,71.51898734177216
9314_terrestrial,157,56,96,112,213,61.146496815286625,71.3375796178344
9315_terrestrial,153,54,93,108,207,60.78431372549019,70.58823529411765
9316_terrestrial,149,56,89,106,205,59.73154362416108,71.14093959731544
9317_terrestrial,146,54,86,104,200,58.9041095890411,71.23287671232876
9318_terrestrial,145,48,85,103,193,58.620689655172406,71.03448275862068
9319_terrestrial,144,46,84,102,190,58.333333333333336,70.83333333333334
9320_terrestrial,144,44,84,102,188,58.333333333333336,70.83333333333334
9321_terrestrial,141,43,82,101,184,58.156028368794324,71.63120567375887
9322_terrestrial,142,42,83,101,184,58.45070422535211,71.12676056338029
9323_terrestrial,141,41,81,100,182,57.446808510638306,70.92198581560284
9324_terrestrial,142,41,82,99,183,57.74647887323944,69.71830985915493
9325_terrestrial,140,42,81,100,182,57.85714285714286,71.42857142857143
9326_terrestrial,141,42,82,100,183,58.156028368794324,70.92198581560284
9327_terrestrial,139,46,80,98,185,57.55395683453237,70.50359712230215
9328_terrestrial,135,44,76,95,179,56.2962962962963,70.37037037037037
9329_terrestrial,131,48,74,91,179,56.48854961832062,69.46564885496184
9330_terrestrial,132,50,75,90,182,56.81818181818182,68.18181818181817
9331_terrestrial,130,52,73,90,182,56.15384615384615,69.23076923076923
9332_terrestrial,127,53,71,88,180,55.90551181102362,69.29133858267717
9333_terrestrial,125,51,68,86,176,54.400000000000006,68.8
9334_terrestrial,125,53,68,84,178,54.400000000000006,67.2
9394_terrestrial,145,84,57,110,229,39.310344827586206,75.86206896551724
9395_terrestrial,144,84,56,109,228,38.88888888888889,75.69444444444444
9396_terrestrial,147,83,57,110,230,38.775510204081634,74.82993197278913
9397_terrestrial,148,83,59,111,231,39.86486486486486,75
9548_terrestrial,261,112,184,149,373,70.49808429118774,57.08812260536399
9549_terrestrial,282,116,199,165,398,70.56737588652481,58.51063829787234
9550_terrestrial,299,117,208,182,416,69.56521739130434,60.86956521739131
9551_terrestrial,308,117,214,189,425,69.48051948051948,61.36363636363637
9552_terrestrial,296,114,203,180,410,68.58108108108108,60.810810810810814
9553_terrestrial,192,68,113,143,260,58.854166666666664,74.47916666666666
9554_terrestrial,171,61,100,124,232,58.47953216374269,72.51461988304094
9555_terrestrial,188,56,118,136,244,62.76595744680851,72.3404255319149
9556_terrestrial,170,54,107,123,224,62.94117647058823,72.35294117647058
9557_terrestrial,182,60,116,133,242,63.73626373626373,73.07692307692307
9558_terrestrial,223,82,139,158,305,62.33183856502242,70.85201793721974
9559_terrestrial,221,83,142,155,304,64.25339366515837,70.13574660633483
9560_terrestrial,210,81,139,146,291,66.19047619047619,69.52380952380952
9561_terrestrial,212,75,141,147,287,66.50943396226415,69.33962264150944
9562_terrestrial,235,94,149,163,329,63.40425531914894,69.36170212765957
9563_terrestrial,240,98,153,166,338,63.74999999999999,69.16666666666667
9564_terrestrial,251,94,158,170,345,62.94820717131474,67.729083665338635
9565_terrestrial,220,80,136,151,300,61.81818181818181,68.63636363636364
9566_terrestrial,206,81,128,140,287,62.13592233009708,67.96116504854369
9567_terrestrial,208,85,129,142,293,62.019230769230774,68.26923076923077
9568_terrestrial,220,82,133,153,302,60.45454545454545,69.54545454545455
9569_terrestrial,222,84,136,157,306,61.261261261261254,70.72072072072072
9570_terrestrial,229,89,141,161,318,61.572052401746724,70.3056768558952
9571_terrestrial,230,89,139,160,319,60.43478260869565,69.56521739130434
9572_terrestrial,228,86,137,159,314,60.08771929824561,69.73684210526315
9573_terrestrial,213,78,127,148,291,59.624413145539904,69.48356807511738
9574_terrestrial,221,77,128,152,298,57.9185520361991,68.77828054298642
9575_terrestrial,222,80,131,149,302,59.009009009009006,67.11711711711712
9576_terrestrial,207,76,124,145,283,59.90338164251207,70.04830917874396
9577_terrestrial,233,90,146,155,323,62.66094420600859,66.52360515021459
9578_terrestrial,236,85,149,155,321,63.13559322033898,65.67796610169492
9579_terrestrial,236,88,151,153,324,63.983050847457626,64.83050847457628
9580_terrestrial,203,75,124,139,278,61.083743842364534,68.4729064039409
9581_terrestrial,203,75,119,144,278,58.620689655172406,70.93596059113301
9582_terrestrial,201,75,120,141,276,59.70149253731343,70.1492537313433
9583_terrestrial,207,75,126,143,282,60.86956521739131,69.08212560386472
9584_terrestrial,205,74,125,143,279,60.97560975609756,69.7560975609756
9585_terrestrial,203,72,121,144,275,59.60591133004927,70.93596059113301
9586_terrestrial,199,74,119,144,273,59.798994974874375,72.36180904522614
9587_terrestrial,199,78,120,144,277,60.30150753768844,72.36180904522614
9588_terrestrial,194,74,116,140,268,59.79381443298969,72.16494845360825
9589_terrestrial,191,74,116,136,265,60.73298429319372,71.20418848167539
9590_terrestrial,191,74,116,135,265,60.73298429319372,70.68062827225131
9591_terrestrial,193,72,116,137,265,60.10362694300518,70.98445595854922
9592_terrestrial,189,74,114,136,263,60.317460317460316,71.95767195767195
9593_terrestrial,186,72,112,132,258,60.215053763440864,70.96774193548387
9594_terrestrial,187,68,114,133,255,60.962566844919785,71.12299465240642
9595_terrestrial,187,70,113,134,257,60.42780748663101,71.65775401069519
9596_terrestrial,182,72,110,131,254,60.43956043956044,71.97802197802197
9597_terrestrial,185,70,115,135,255,62.16216216216216,72.97297297297297
9598_terrestrial,180,74,111,133,254,61.66666666666667,73.88888888888889
9599_terrestrial,180,73,110,133,253,61.111111111111114,73.88888888888889
9600_terrestrial,183,79,110,134,262,60.10928961748634,73.224043715847
9601_terrestrial,173,65,101,131,238,58.38150289017341,75.72254335260115
9602_terrestrial,175,67,105,133,242,60,76
9603_terrestrial,179,68,108,135,247,60.33519553072626,75.41899441340783
9604_terrestrial,180,70,110,136,250,61.111111111111114,75.55555555555556
9605_terrestrial,177,71,107,134,248,60.451977401129945,75.70621468926554
9606_terrestrial,180,67,110,137,247,61.111111111111114,76.11111111111111
9607_terrestrial,179,64,108,136,243,60.33519553072626,75.97765363128491
9608_terrestrial,175,60,104,132,235,59.42857142857143,75.42857142857143
9609_terrestrial,171,64,101,127,235,59.06432748538012,74.26900584795322
9610_terrestrial,170,62,102,124,232,60,72.94117647058823
9611_terrestrial,166,62,100,122,228,60.24096385542169,73.49397590361446
9612_terrestrial,165,58,99,122,223,60,73.93939393939394
9613_terrestrial,158,62,93,118,220,58.86075949367089,74.68354430379746
9614_terrestrial,155,63,92,115,218,59.354838709677416,74.19354838709677
9615_terrestrial,152,62,91,114,214,59.86842105263158,75
9616_terrestrial,152,60,91,114,212,59.86842105263158,75
9617_terrestrial,151,60,89,113,211,58.94039735099338,74.83443708609272
9618_terrestrial,151,60,88,111,211,58.27814569536424,73.50993377483444
9619_terrestrial,152,60,90,112,212,59.210526315789465,73.68421052631578
9620_terrestrial,153,60,91,113,213,59.47712418300654,73.8562091503268
9621_terrestrial,154,60,91,113,214,59.09090909090909,73.37662337662337
9622_terrestrial,154,62,92,115,216,59.74025974025974,74.67532467532467
9623_terrestrial,154,61,91,114,215,59.09090909090909,74.02597402597402
9624_terrestrial,155,61,91,115,216,58.70967741935483,74.19354838709677
9625_terrestrial,154,60,90,114,214,58.44155844155844,74.02597402597402
9626_terrestrial,156,60,92,115,216,58.97435897435898,73.71794871794873
9627_terrestrial,157,62,93,118,219,59.23566878980891,75.15923566878982
9628_terrestrial,158,62,93,118,220,58.86075949367089,74.68354430379746
9629_terrestrial,157,63,92,117,220,58.59872611464968,74.52229299363057
9630_terrestrial,156,59,91,116,215,58.333333333333336,74.35897435897436
9631_terrestrial,153,60,88,115,213,57.51633986928104,75.16339869281046
9632_terrestrial,151,58,87,113,209,57.615894039735096,74.83443708609272
9647_terrestrial,159,50,94,119,209,59.11949685534591,74.84276729559748
9648_terrestrial,161,50,95,121,211,59.006211180124225,75.15527950310559
9649_terrestrial,161,52,95,121,213,59.006211180124225,75.15527950310559
9650_terrestrial,161,53,95,121,214,59.006211180124225,75.15527950310559
9651_terrestrial,162,53,94,121,215,58.0246913580247,74.69135802469135
9652_terrestrial,160,55,94,121,215,58.75,75.625
9653_terrestrial,158,57,92,121,215,58.22784810126582,76.58227848101265
9654_terrestrial,160,57,93,123,217,58.12500000000001,76.875
9655_terrestrial,157,59,90,122,216,57.324840764331206,77.70700636942675
9656_terrestrial,158,59,91,123,217,57.59493670886076,77.84810126582279
9657_terrestrial,158,61,92,123,219,58.22784810126582,77.84810126582279
9658_terrestrial,159,61,91,122,220,57.23270440251572,76.72955974842768
9659_terrestrial,158,63,91,120,221,57.59493670886076,75.9493670886076
9660_terrestrial,159,65,94,120,224,59.11949685534591,75.47169811320755
9661_terrestrial,161,66,96,121,227,59.62732919254658,75.15527950310559
9662_terrestrial,162,66,98,122,228,60.49382716049383,75.30864197530865
9663_terrestrial,162,66,98,122,228,60.49382716049383,75.30864197530865
9664_terrestrial,165,66,101,125,231,61.212121212121204,75.75757575757575
9665_terrestrial,165,66,101,125,231,61.212121212121204,75.75757575757575
9666_terrestrial,164,65,101,124,229,61.58536585365854,75.60975609756098
9667_terrestrial,165,65,102,125,230,61.81818181818181,75.75757575757575
9668_terrestrial,168,67,103,125,235,61.30952380952381,74.40476190476191
9669_terrestrial,166,66,102,123,232,61.44578313253012,74.09638554216868
9670_terrestrial,169,69,103,123,238,60.946745562130175,72.7810650887574
9671_terrestrial,164,69,102,121,233,62.19512195121951,73.78048780487805
9672_terrestrial,165,71,102,122,236,61.81818181818181,73.93939393939394
9673_terrestrial,169,73,106,124,242,62.721893491124256,73.37278106508876
9674_terrestrial,170,70,106,123,240,62.35294117647059,72.35294117647058
9675_terrestrial,163,67,100,119,230,61.34969325153374,73.00613496932516
9676_terrestrial,162,63,99,118,225,61.111111111111114,72.8395061728395
9677_terrestrial,159,58,97,115,217,61.0062893081761,72.32704402515722
9678_terrestrial,155,58,92,110,213,59.354838709677416,70.96774193548387
9679_terrestrial,148,54,87,105,202,58.78378378378378,70.94594594594594
9680_terrestrial,147,48,85,105,195,57.82312925170068,71.42857142857143
9681_terrestrial,146,46,84,105,192,57.534246575342465,71.91780821917808
9682_terrestrial,144,46,83,103,190,57.638888888888886,71.52777777777779
9683_terrestrial,143,46,82,100,189,57.34265734265735,69.93006993006993
9684_terrestrial,142,45,81,100,187,57.04225352112676,70.4225352112676
9685_terrestrial,141,45,79,100,186,56.02836879432624,70.92198581560284
9686_terrestrial,138,47,78,99,185,56.52173913043478,71.73913043478261
9687_terrestrial,135,51,75,96,186,55.55555555555556,71.11111111111111
9688_terrestrial,134,53,74,96,187,55.223880597014926,71.64179104477611
9689_terrestrial,138,53,77,97,191,55.79710144927537,70.28985507246377
9690_terrestrial,135,53,75,95,188,55.55555555555556,70.37037037037037
9691_terrestrial,134,57,74,94,191,55.223880597014926,70.1492537313433
9692_terrestrial,132,57,73,92,189,55.3030303030303,69.6969696969697
9693_terrestrial,130,55,71,92,185,54.61538461538461,70.76923076923077
9754_terrestrial,148,86,59,115,234,39.86486486486486,77.7027027027027
9755_terrestrial,146,86,56,113,232,38.35616438356164,77.3972602739726
9756_terrestrial,152,84,59,115,236,38.81578947368421,75.6578947368421
9757_terrestrial,147,84,56,112,231,38.095238095238095,76.19047619047619
9758_terrestrial,147,84,57,112,231,38.775510204081634,76.19047619047619
9759_terrestrial,147,84,56,110,231,38.095238095238095,74.82993197278913
9906_terrestrial,285,117,202,167,402,70.87719298245614,58.59649122807018
9907_terrestrial,292,116,207,173,408,70.8904109589041,59.24657534246576
9908_terrestrial,311,122,222,186,433,71.38263665594855,59.80707395498393
9909_terrestrial,315,125,224,188,440,71.11111111111111,59.682539682539684
9910_terrestrial,213,75,139,158,288,65.25821596244131,74.17840375586854
9911_terrestrial,193,65,120,143,258,62.17616580310881,74.09326424870466
9912_terrestrial,189,64,118,132,253,62.43386243386243,69.84126984126983
9913_terrestrial,179,66,112,124,245,62.56983240223464,69.27374301675978
9914_terrestrial,174,61,108,121,235,62.06896551724138,69.54022988505747
9915_terrestrial,179,57,114,127,236,63.687150837988824,70.94972067039106
9916_terrestrial,186,62,118,132,248,63.44086021505376,70.96774193548387
9917_terrestrial,204,73,128,145,277,62.745098039215684,71.07843137254902
9918_terrestrial,220,85,141,155,305,64.0909090909091,70.45454545454545
9919_terrestrial,200,79,130,137,279,65,68.5
9922_terrestrial,248,99,157,171,347,63.306451612903224,68.95161290322581
9923_terrestrial,227,92,141,156,319,62.11453744493392,68.72246696035242
9924_terrestrial,229,90,144,151,319,62.882096069869,65.93886462882097
9925_terrestrial,225,90,141,152,315,62.66666666666667,67.55555555555556
9926_terrestrial,217,91,136,149,308,62.67281105990783,68.66359447004609
9927_terrestrial,220,91,137,154,311,62.272727272727266,70
9928_terrestrial,226,92,140,158,318,61.94690265486725,69.91150442477876
9929_terrestrial,228,96,141,159,324,61.8421052631579,69.73684210526315
9930_terrestrial,233,98,143,162,331,61.37339055793991,69.52789699570815
9931_terrestrial,253,98,154,173,351,60.86956521739131,68.37944664031622
9932_terrestrial,246,94,152,170,340,61.78861788617886,69.10569105691057
9933_terrestrial,232,89,141,161,321,60.775862068965516,69.39655172413794
9934_terrestrial,228,80,139,157,308,60.96491228070175,68.85964912280701
9935_terrestrial,227,78,138,157,305,60.792951541850215,69.16299559471366
9936_terrestrial,225,78,141,152,303,62.66666666666667,67.55555555555556
9937_terrestrial,223,77,138,152,300,61.88340807174888,68.16143497757847
9938_terrestrial,222,77,136,153,299,61.261261261261254,68.91891891891892
9939_terrestrial,213,75,128,151,288,60.093896713615024,70.89201877934272
9940_terrestrial,211,76,127,149,287,60.18957345971564,70.61611374407583
9941_terrestrial,205,78,126,146,283,61.46341463414634,71.21951219512195
9942_terrestrial,206,79,127,145,285,61.6504854368932,70.3883495145631
9943_terrestrial,206,81,125,145,287,60.679611650485434,70.3883495145631
9944_terrestrial,205,83,124,144,288,60.48780487804878,70.24390243902438
9945_terrestrial,206,81,124,144,287,60.19417475728155,69.90291262135922
9946_terrestrial,207,82,125,145,289,60.38647342995169,70.04830917874396
9947_terrestrial,206,83,124,146,289,60.19417475728155,70.87378640776699
9948_terrestrial,205,82,122,147,287,59.512195121951216,71.70731707317073
9949_terrestrial,203,82,124,148,285,61.083743842364534,72.9064039408867
9950_terrestrial,206,82,125,151,288,60.679611650485434,73.30097087378641
9951_terrestrial,204,80,125,149,284,61.274509803921575,73.0392156862745
9952_terrestrial,201,77,123,147,278,61.19402985074627,73.13432835820896
9953_terrestrial,201,77,123,145,278,61.19402985074627,72.13930348258707
9954_terrestrial,201,79,124,144,280,61.69154228855721,71.64179104477611
9955_terrestrial,200,81,123,143,281,61.5,71.5
9956_terrestrial,197,85,123,140,282,62.43654822335025,71.06598984771574
9957_terrestrial,197,79,120,143,276,60.913705583756354,72.58883248730965
9958_terrestrial,200,80,122,148,280,61,74
9959_terrestrial,198,82,122,148,280,61.61616161616161,74.74747474747475
9960_terrestrial,198,79,122,148,277,61.61616161616161,74.74747474747475
9961_terrestrial,182,65,110,140,247,60.43956043956044,76.92307692307693
9962_terrestrial,185,66,113,143,251,61.08108108108108,77.29729729729729
9963_terrestrial,185,70,112,142,255,60.54054054054055,76.75675675675676
9964_terrestrial,183,72,111,140,255,60.65573770491803,76.50273224043715
9965_terrestrial,184,78,112,140,262,60.86956521739131,76.08695652173914
9966_terrestrial,182,78,111,138,260,60.98901098901099,75.82417582417582
9967_terrestrial,184,75,113,140,259,61.41304347826087,76.08695652173914
9968_terrestrial,180,70,108,136,250,60,75.55555555555556
9969_terrestrial,178,70,106,133,248,59.55056179775281,74.71910112359551
9970_terrestrial,179,66,106,133,245,59.217877094972074,74.30167597765363
9971_terrestrial,177,65,105,131,242,59.32203389830508,74.01129943502825
9972_terrestrial,176,60,104,130,236,59.09090909090909,73.86363636363636
9973_terrestrial,173,61,104,129,234,60.115606936416185,74.56647398843931
9974_terrestrial,169,60,100,126,229,59.171597633136095,74.55621301775149
9975_terrestrial,167,61,98,125,228,58.68263473053892,74.8502994011976
9976_terrestrial,164,61,96,122,225,58.536585365853654,74.39024390243902
9977_terrestrial,164,60,97,121,224,59.14634146341463,73.78048780487805
9978_terrestrial,163,60,97,120,223,59.50920245398773,73.61963190184049
9979_terrestrial,161,58,96,118,219,59.62732919254658,73.29192546583852
9980_terrestrial,161,58,96,119,219,59.62732919254658,73.91304347826086
9981_terrestrial,161,58,95,118,219,59.006211180124225,73.29192546583852
9982_terrestrial,160,59,96,117,219,60,73.125
9983_terrestrial,157,60,94,114,217,59.87261146496815,72.61146496815286
9984_terrestrial,157,60,95,114,217,60.509554140127385,72.61146496815286
9985_terrestrial,158,63,96,117,221,60.75949367088608,74.0506329113924
9986_terrestrial,158,65,96,117,223,60.75949367088608,74.0506329113924
9987_terrestrial,160,68,98,119,228,61.25000000000001,74.375
9988_terrestrial,161,69,97,121,230,60.24844720496895,75.15527950310559
9989_terrestrial,161,71,97,121,232,60.24844720496895,75.15527950310559
9990_terrestrial,161,68,95,121,229,59.006211180124225,75.15527950310559
9991_terrestrial,159,64,92,121,223,57.861635220125784,76.10062893081762
9992_terrestrial,159,63,92,121,222,57.861635220125784,76.10062893081762
9993_terrestrial,160,61,91,121,221,56.875,75.625
10006_terrestrial,165,53,98,125,218,59.3939393939394,75.75757575757575
10007_terrestrial,165,57,98,125,222,59.3939393939394,75.75757575757575
10008_terrestrial,164,57,98,124,221,59.756097560975604,75.60975609756098
10009_terrestrial,167,58,100,127,225,59.88023952095808,76.04790419161677
10010_terrestrial,168,57,100,127,225,59.523809523809526,75.59523809523809
10011_terrestrial,168,57,100,127,225,59.523809523809526,75.59523809523809
10012_terrestrial,168,59,100,127,227,59.523809523809526,75.59523809523809
10013_terrestrial,167,63,98,128,230,58.68263473053892,76.64670658682635
10014_terrestrial,166,65,95,126,231,57.22891566265061,75.90361445783132
10015_terrestrial,167,71,98,129,238,58.68263473053892,77.24550898203593
10016_terrestrial,167,71,98,129,238,58.68263473053892,77.24550898203593
10017_terrestrial,168,71,99,130,239,58.92857142857143,77.38095238095238
10018_terrestrial,169,71,100,130,240,59.171597633136095,76.92307692307693
10019_terrestrial,171,71,103,132,242,60.23391812865497,77.19298245614034
10020_terrestrial,172,71,104,133,243,60.46511627906976,77.32558139534885
10021_terrestrial,171,71,105,130,242,61.40350877192983,76.0233918128655
10022_terrestrial,170,71,105,129,241,61.76470588235294,75.88235294117646
10023_terrestrial,170,69,105,129,239,61.76470588235294,75.88235294117646
10024_terrestrial,169,69,105,128,238,62.1301775147929,75.7396449704142
10025_terrestrial,169,69,105,128,238,62.1301775147929,75.7396449704142
10026_terrestrial,171,69,106,128,240,61.98830409356725,74.85380116959064
10027_terrestrial,168,71,103,126,239,61.30952380952381,75
10028_terrestrial,169,71,103,127,240,60.946745562130175,75.14792899408283
10029_terrestrial,169,75,102,127,244,60.35502958579882,75.14792899408283
10030_terrestrial,172,75,105,128,247,61.04651162790697,74.4186046511628
10031_terrestrial,168,73,104,128,241,61.904761904761905,76.19047619047619
10032_terrestrial,166,71,102,129,237,61.44578313253012,77.71084337349397
10033_terrestrial,165,68,101,128,233,61.212121212121204,77.57575757575758
10034_terrestrial,162,68,99,124,230,61.111111111111114,76.5432098765432
10035_terrestrial,161,67,97,123,228,60.24844720496895,76.3975155279503
10036_terrestrial,163,64,99,123,227,60.73619631901841,75.4601226993865
10037_terrestrial,162,68,97,120,230,59.876543209876544,74.07407407407408
10038_terrestrial,162,60,97,118,222,59.876543209876544,72.8395061728395
10039_terrestrial,157,56,92,113,213,58.59872611464968,71.97452229299363
10040_terrestrial,150,52,86,106,202,57.333333333333336,70.66666666666667
10041_terrestrial,148,54,84,103,202,56.75675675675676,69.5945945945946
10042_terrestrial,146,50,83,100,196,56.849315068493155,68.4931506849315
10043_terrestrial,147,50,83,101,197,56.4625850340136,68.70748299319727
10044_terrestrial,144,53,79,102,197,54.861111111111114,70.83333333333334
10045_terrestrial,142,50,77,101,192,54.22535211267606,71.12676056338029
10046_terrestrial,141,51,77,101,192,54.60992907801418,71.63120567375887
10047_terrestrial,137,54,76,101,191,55.47445255474452,73.72262773722628
10048_terrestrial,140,54,79,100,194,56.42857142857143,71.42857142857143
10049_terrestrial,141,54,81,99,195,57.446808510638306,70.2127659574468
10050_terrestrial,142,56,82,99,198,57.74647887323944,69.71830985915493
10051_terrestrial,144,56,83,101,200,57.638888888888886,70.13888888888889
10052_terrestrial,136,56,78,96,192,57.35294117647059,70.58823529411765
10053_terrestrial,133,56,77,94,189,57.89473684210527,70.67669172932331
10110_terrestrial,222,136,107,139,358,48.1981981981982,62.612612612612615
10111_terrestrial,227,136,110,138,363,48.458149779735685,60.792951541850215
10112_terrestrial,236,149,117,146,385,49.57627118644068,61.86440677966102
10113_terrestrial,248,148,126,152,396,50.806451612903224,61.29032258064516
10114_terrestrial,247,145,123,151,392,49.797570850202426,61.1336032388664
10115_terrestrial,170,94,63,131,264,37.05882352941177,77.05882352941177
10116_terrestrial,152,90,56,117,242,36.84210526315789,76.97368421052632
10117_terrestrial,159,86,59,117,245,37.10691823899371,73.58490566037736
10118_terrestrial,160,85,62,118,245,38.75,73.75
10119_terrestrial,163,83,63,121,246,38.65030674846626,74.23312883435584
10120_terrestrial,161,85,60,117,246,37.267080745341616,72.67080745341616
10126_terrestrial,147,95,59,107,242,40.136054421768705,72.78911564625851
10127_terrestrial,149,93,59,107,242,39.59731543624161,71.81208053691275
10128_terrestrial,144,93,55,105,237,38.19444444444444,72.91666666666666
10147_terrestrial,162,89,59,124,251,36.41975308641975,76.5432098765432
10148_terrestrial,157,83,59,120,240,37.57961783439491,76.43312101910828
10265_terrestrial,275,118,195,149,393,70.9090909090909,54.18181818181819
10266_terrestrial,310,133,222,177,443,71.61290322580646,57.096774193548384
10267_terrestrial,294,131,212,160,425,72.10884353741497,54.421768707483
10268_terrestrial,304,127,219,166,431,72.03947368421053,54.60526315789473
10269_terrestrial,197,67,129,139,264,65.48223350253807,70.55837563451777
10270_terrestrial,205,75,132,152,280,64.39024390243902,74.14634146341463
10271_terrestrial,221,79,138,167,300,62.44343891402715,75.56561085972851
10272_terrestrial,216,82,139,158,298,64.35185185185185,73.14814814814815
10273_terrestrial,198,74,130,143,272,65.65656565656566,72.22222222222221
10274_terrestrial,185,69,120,132,254,64.86486486486487,71.35135135135135
10275_terrestrial,194,72,128,138,266,65.97938144329896,71.1340206185567
10276_terrestrial,198,77,131,141,275,66.16161616161617,71.21212121212122
10277_terrestrial,214,79,136,152,293,63.55140186915887,71.02803738317756
10278_terrestrial,219,91,145,148,310,66.21004566210046,67.57990867579909
10282_terrestrial,260,107,166,177,367,63.84615384615384,68.07692307692308
10283_terrestrial,236,93,150,163,329,63.559322033898304,69.0677966101695
10284_terrestrial,238,94,151,160,332,63.4453781512605,67.22689075630252
10285_terrestrial,231,92,142,159,323,61.471861471861466,68.83116883116884
10286_terrestrial,224,91,138,154,315,61.60714285714286,68.75
10287_terrestrial,224,89,137,152,313,61.16071428571429,67.85714285714286
10288_terrestrial,235,100,144,156,335,61.27659574468085,66.38297872340425
10289_terrestrial,257,103,157,174,360,61.08949416342413,67.70428015564202
10290_terrestrial,258,102,161,175,360,62.4031007751938,67.82945736434108
10291_terrestrial,259,100,160,175,359,61.77606177606177,67.56756756756756
10292_terrestrial,248,98,154,168,346,62.096774193548384,67.74193548387096
10293_terrestrial,245,97,152,165,342,62.04081632653061,67.3469387755102
10294_terrestrial,240,93,147,164,333,61.25000000000001,68.33333333333333
10295_terrestrial,236,86,146,161,322,61.86440677966102,68.22033898305084
10296_terrestrial,233,84,143,159,317,61.37339055793991,68.24034334763948
10297_terrestrial,230,85,142,158,315,61.73913043478261,68.69565217391305
10298_terrestrial,231,87,144,159,318,62.33766233766234,68.83116883116884
10299_terrestrial,222,84,135,156,306,60.810810810810814,70.27027027027027
10300_terrestrial,213,82,130,152,295,61.03286384976526,71.36150234741784
10301_terrestrial,207,83,125,146,290,60.38647342995169,70.53140096618358
10302_terrestrial,210,83,127,146,293,60.476190476190474,69.52380952380952
10303_terrestrial,209,83,128,147,292,61.24401913875598,70.33492822966507
10304_terrestrial,206,85,126,144,291,61.165048543689316,69.90291262135922
10305_terrestrial,206,87,126,144,293,61.165048543689316,69.90291262135922
10306_terrestrial,206,87,126,144,293,61.165048543689316,69.90291262135922
10307_terrestrial,205,88,126,144,293,61.46341463414634,70.24390243902438
10308_terrestrial,207,84,126,146,291,60.86956521739131,70.53140096618358
10309_terrestrial,208,82,126,147,290,60.57692307692307,70.67307692307693
10310_terrestrial,211,81,126,148,292,59.71563981042654,70.14218009478674
10311_terrestrial,210,82,125,149,292,59.523809523809526,70.95238095238095
10312_terrestrial,208,80,124,149,288,59.61538461538461,71.63461538461539
10313_terrestrial,211,83,130,145,294,61.61137440758294,68.72037914691943
10314_terrestrial,213,83,131,147,296,61.502347417840376,69.01408450704226
10315_terrestrial,211,83,130,148,294,61.61137440758294,70.14218009478674
10316_terrestrial,215,92,135,152,307,62.7906976744186,70.69767441860465
10317_terrestrial,213,92,131,151,305,61.502347417840376,70.89201877934272
10318_terrestrial,205,92,123,149,297,60,72.6829268292683
10319_terrestrial,203,97,123,149,300,60.591133004926114,73.39901477832512
10320_terrestrial,202,98,122,148,300,60.396039603960396,73.26732673267327
10321_terrestrial,179,77,105,136,256,58.659217877094974,75.97765363128491
10322_terrestrial,181,79,107,138,260,59.11602209944752,76.24309392265194
10323_terrestrial,184,80,107,139,264,58.152173913043484,75.54347826086956
10324_terrestrial,183,80,107,139,263,58.46994535519126,75.95628415300546
10325_terrestrial,186,85,111,139,271,59.67741935483871,74.73118279569893
10326_terrestrial,186,85,111,139,271,59.67741935483871,74.73118279569893
10327_terrestrial,184,84,111,139,268,60.32608695652174,75.54347826086956
10328_terrestrial,186,85,112,141,271,60.215053763440864,75.80645161290323
10329_terrestrial,185,86,112,139,271,60.54054054054055,75.13513513513513
10330_terrestrial,188,84,115,141,272,61.170212765957444,75
10331_terrestrial,185,83,112,138,268,60.54054054054055,74.5945945945946
10332_terrestrial,182,80,110,137,262,60.43956043956044,75.27472527472527
10333_terrestrial,180,78,108,136,258,60,75.55555555555556
10334_terrestrial,178,77,107,134,255,60.1123595505618,75.28089887640449
10335_terrestrial,180,76,109,134,256,60.55555555555555,74.44444444444444
10336_terrestrial,184,73,110,136,257,59.78260869565217,73.91304347826086
10337_terrestrial,180,72,107,133,252,59.44444444444444,73.88888888888889
10338_terrestrial,179,68,105,132,247,58.659217877094974,73.74301675977654
10339_terrestrial,180,67,106,132,247,58.88888888888889,73.33333333333333
10340_terrestrial,175,66,104,129,241,59.42857142857143,73.71428571428571
10341_terrestrial,173,66,102,126,239,58.95953757225434,72.83236994219652
10342_terrestrial,170,68,101,126,238,59.411764705882355,74.11764705882354
10343_terrestrial,168,66,100,124,234,59.523809523809526,73.80952380952381
10344_terrestrial,168,66,100,124,234,59.523809523809526,73.80952380952381
10345_terrestrial,166,65,100,122,231,60.24096385542169,73.49397590361446
10346_terrestrial,166,67,100,122,233,60.24096385542169,73.49397590361446
10347_terrestrial,167,67,101,123,234,60.47904191616767,73.65269461077844
10348_terrestrial,167,67,99,125,234,59.281437125748504,74.8502994011976
10349_terrestrial,168,71,101,126,239,60.11904761904761,75
10350_terrestrial,164,76,98,124,240,59.756097560975604,75.60975609756098
10351_terrestrial,167,72,100,127,239,59.88023952095808,76.04790419161677
10352_terrestrial,163,69,96,124,232,58.895705521472394,76.07361963190185
10353_terrestrial,164,66,95,124,230,57.92682926829268,75.60975609756098
10354_terrestrial,165,64,94,126,229,56.96969696969697,76.36363636363637
10365_terrestrial,172,61,103,130,233,59.883720930232556,75.5813953488372
10366_terrestrial,172,63,103,130,235,59.883720930232556,75.5813953488372
10367_terrestrial,174,62,103,133,236,59.195402298850574,76.4367816091954
10368_terrestrial,174,64,103,133,238,59.195402298850574,76.4367816091954
10369_terrestrial,171,66,102,131,237,59.64912280701754,76.60818713450293
10370_terrestrial,173,65,104,133,238,60.115606936416185,76.878612716763
10371_terrestrial,174,71,103,132,245,59.195402298850574,75.86206896551724
10372_terrestrial,175,70,103,132,245,58.857142857142854,75.42857142857143
10373_terrestrial,175,72,102,133,247,58.285714285714285,76
10374_terrestrial,176,70,103,134,246,58.52272727272727,76.13636363636364
10375_terrestrial,175,73,100,133,248,57.14285714285714,76
10376_terrestrial,177,71,102,135,248,57.6271186440678,76.27118644067797
10377_terrestrial,175,71,103,134,246,58.857142857142854,76.57142857142857
10378_terrestrial,170,70,103,133,240,60.588235294117645,78.23529411764706
10379_terrestrial,169,70,102,132,239,60.35502958579882,78.10650887573965
10380_terrestrial,166,70,101,129,236,60.8433734939759,77.71084337349397
10381_terrestrial,168,71,101,129,239,60.11904761904761,76.78571428571429
10382_terrestrial,167,71,100,128,238,59.88023952095808,76.64670658682635
10383_terrestrial,167,71,101,128,238,60.47904191616767,76.64670658682635
10384_terrestrial,166,71,101,127,237,60.8433734939759,76.50602409638554
10385_terrestrial,165,71,100,126,236,60.60606060606061,76.36363636363637
10386_terrestrial,166,75,99,125,241,59.63855421686747,75.30120481927712
10387_terrestrial,168,75,101,127,243,60.11904761904761,75.59523809523809
10388_terrestrial,168,77,101,126,245,60.11904761904761,75
10389_terrestrial,168,77,100,126,245,59.523809523809526,75
10390_terrestrial,169,77,101,125,246,59.76331360946746,73.96449704142012
10391_terrestrial,163,74,99,124,237,60.73619631901841,76.07361963190185
10392_terrestrial,162,69,98,125,231,60.49382716049383,77.1604938271605
10393_terrestrial,162,69,98,125,231,60.49382716049383,77.1604938271605
10394_terrestrial,160,65,97,123,225,60.62499999999999,76.875
10395_terrestrial,160,65,97,122,225,60.62499999999999,76.25
10396_terrestrial,162,67,98,122,229,60.49382716049383,75.30864197530865
10397_terrestrial,161,64,97,120,225,60.24844720496895,74.53416149068323
10398_terrestrial,159,62,96,116,221,60.37735849056604,72.95597484276729
10399_terrestrial,159,63,95,117,222,59.74842767295597,73.58490566037736
10400_terrestrial,154,57,90,109,211,58.44155844155844,70.77922077922078
10401_terrestrial,151,57,86,106,208,56.95364238410596,70.19867549668875
10402_terrestrial,148,57,84,103,205,56.75675675675676,69.5945945945946
10403_terrestrial,144,56,80,102,200,55.55555555555556,70.83333333333334
10404_terrestrial,144,59,79,104,203,54.861111111111114,72.22222222222221
10405_terrestrial,147,58,84,103,205,57.14285714285714,70.06802721088435
10406_terrestrial,142,59,80,101,201,56.33802816901409,71.12676056338029
10407_terrestrial,137,59,78,98,196,56.934306569343065,71.53284671532847
10408_terrestrial,138,58,79,99,196,57.2463768115942,71.73913043478261
10409_terrestrial,141,60,82,98,201,58.156028368794324,69.50354609929079
10410_terrestrial,142,60,83,99,202,58.45070422535211,69.71830985915493
10411_terrestrial,140,60,81,98,200,57.85714285714286,70
10412_terrestrial,136,58,77,94,194,56.61764705882353,69.11764705882352
10413_terrestrial,135,57,76,94,192,56.2962962962963,69.62962962962963
10414_terrestrial,134,56,75,93,190,55.970149253731336,69.40298507462687
10471_terrestrial,237,139,119,139,376,50.210970464135016,58.64978902953587
10472_terrestrial,238,143,122,144,381,51.26050420168067,60.50420168067227
10473_terrestrial,225,131,122,134,356,54.22222222222223,59.55555555555555
10474_terrestrial,224,135,118,133,359,52.67857142857143,59.375
10475_terrestrial,224,137,110,134,361,49.107142857142854,59.82142857142857
10476_terrestrial,228,140,113,136,368,49.56140350877193,59.64912280701754
10477_terrestrial,223,137,113,133,360,50.672645739910315,59.64125560538116
10478_terrestrial,234,138,120,138,372,51.28205128205128,58.97435897435898
10479_terrestrial,243,144,124,146,387,51.028806584362144,60.08230452674898
10480_terrestrial,176,96,65,130,272,36.93181818181818,73.86363636363636
10481_terrestrial,240,146,121,142,386,50.416666666666664,59.166666666666664
10486_terrestrial,166,109,67,120,275,40.36144578313253,72.28915662650603
10487_terrestrial,163,106,63,118,269,38.65030674846626,72.39263803680981
10488_terrestrial,163,103,60,117,266,36.809815950920246,71.77914110429448
10493_terrestrial,166,96,64,122,262,38.55421686746988,73.49397590361446
10494_terrestrial,171,97,63,121,268,36.84210526315789,70.76023391812866
10495_terrestrial,164,99,57,119,263,34.756097560975604,72.5609756097561
10496_terrestrial,169,100,58,123,269,34.319526627218934,72.7810650887574
10507_terrestrial,173,103,60,137,276,34.68208092485549,79.1907514450867
10508_terrestrial,166,99,58,130,265,34.93975903614458,78.3132530120482
10509_terrestrial,165,95,59,130,260,35.75757575757576,78.78787878787878
10510_terrestrial,160,90,56,125,250,35,78.125
10626_terrestrial,301,129,216,167,430,71.76079734219269,55.48172757475083
10627_terrestrial,299,136,219,157,435,73.24414715719062,52.508361204013376
10628_terrestrial,303,126,221,160,429,72.93729372937293,52.8052805280528
10629_terrestrial,197,73,131,137,270,66.49746192893402,69.54314720812182
10630_terrestrial,235,87,153,172,322,65.1063829787234,73.19148936170212
10631_terrestrial,261,87,169,197,348,64.75095785440614,75.47892720306514
10632_terrestrial,248,88,165,189,336,66.53225806451613,76.20967741935483
10633_terrestrial,224,84,148,163,308,66.07142857142857,72.76785714285714
10634_terrestrial,201,84,133,142,285,66.16915422885572,70.64676616915423
10635_terrestrial,210,83,140,147,293,66.66666666666666,70
10636_terrestrial,220,89,150,150,309,68.18181818181817,68.18181818181817
10637_terrestrial,236,92,153,166,328,64.83050847457628,70.33898305084746
10638_terrestrial,263,103,175,178,366,66.53992395437263,67.68060836501901
10639_terrestrial,255,95,172,171,350,67.45098039215686,67.05882352941175
10640_terrestrial,192,63,129,150,255,67.1875,78.125
10641_terrestrial,193,63,131,149,256,67.87564766839378,77.2020725388601
10642_terrestrial,274,109,177,183,383,64.59854014598541,66.78832116788321
10643_terrestrial,277,112,181,183,389,65.34296028880865,66.06498194945848
10644_terrestrial,278,117,180,184,395,64.74820143884892,66.18705035971223
10645_terrestrial,274,118,178,182,392,64.96350364963503,66.42335766423358
10646_terrestrial,265,118,172,176,383,64.90566037735849,66.41509433962264
10647_terrestrial,263,117,166,174,380,63.11787072243346,66.15969581749049
10648_terrestrial,282,119,176,189,401,62.4113475177305,67.02127659574468
10649_terrestrial,285,123,178,190,408,62.4561403508772,66.66666666666666
10650_terrestrial,280,120,177,186,400,63.21428571428571,66.42857142857143
10651_terrestrial,289,117,185,187,406,64.01384083044984,64.70588235294117
10652_terrestrial,256,94,162,171,350,63.28125,66.796875
10653_terrestrial,255,98,161,172,353,63.13725490196078,67.45098039215686
10654_terrestrial,244,100,152,169,344,62.295081967213115,69.26229508196722
10655_terrestrial,246,100,157,169,346,63.82113821138211,68.69918699186992
10656_terrestrial,241,98,153,166,339,63.48547717842323,68.87966804979253
10657_terrestrial,236,97,149,163,333,63.13559322033898,69.0677966101695
10658_terrestrial,233,98,144,163,331,61.80257510729614,69.95708154506438
10659_terrestrial,227,96,139,160,323,61.23348017621145,70.48458149779736
10660_terrestrial,223,96,136,159,319,60.98654708520179,71.30044843049326
10661_terrestrial,222,91,133,161,313,59.909909909909906,72.52252252252252
10662_terrestrial,221,91,133,159,312,60.18099547511312,71.94570135746606
10663_terrestrial,222,87,133,160,309,59.909909909909906,72.07207207207207
10664_terrestrial,222,85,133,160,307,59.909909909909906,72.07207207207207
10665_terrestrial,223,87,134,159,310,60.0896860986547,71.30044843049326
10666_terrestrial,217,86,130,155,303,59.907834101382484,71.42857142857143
10667_terrestrial,219,89,132,154,308,60.273972602739725,70.31963470319634
10668_terrestrial,218,85,132,153,303,60.550458715596335,70.18348623853211
10669_terrestrial,217,86,131,152,303,60.36866359447005,70.04608294930875
10670_terrestrial,217,88,131,152,305,60.36866359447005,70.04608294930875
10671_terrestrial,222,92,136,152,314,61.261261261261254,68.46846846846847
10672_terrestrial,224,94,138,155,318,61.60714285714286,69.19642857142857
10673_terrestrial,221,94,137,156,315,61.990950226244344,70.58823529411765
10674_terrestrial,223,94,136,156,317,60.98654708520179,69.95515695067265
10675_terrestrial,221,94,136,155,315,61.53846153846154,70.13574660633483
10676_terrestrial,220,94,135,158,314,61.36363636363637,71.81818181818181
10677_terrestrial,222,93,138,155,315,62.16216216216216,69.81981981981981
10678_terrestrial,214,93,130,154,307,60.747663551401864,71.96261682242991
10679_terrestrial,216,96,130,160,312,60.18518518518518,74.07407407407408
10680_terrestrial,211,98,125,157,309,59.241706161137444,74.40758293838863
10681_terrestrial,195,84,114,150,279,58.46153846153847,76.92307692307693
10682_terrestrial,196,86,115,151,282,58.673469387755105,77.04081632653062
10683_terrestrial,197,85,116,150,282,58.88324873096447,76.14213197969542
10684_terrestrial,197,84,117,149,281,59.390862944162436,75.63451776649747
10685_terrestrial,191,83,114,145,274,59.68586387434554,75.91623036649214
10686_terrestrial,191,83,115,145,274,60.20942408376963,75.91623036649214
10687_terrestrial,192,93,116,145,285,60.416666666666664,75.52083333333334
10688_terrestrial,195,93,118,147,288,60.51282051282051,75.38461538461539
10689_terrestrial,195,93,116,145,288,59.48717948717949,74.35897435897436
10690_terrestrial,195,89,117,145,284,60,74.35897435897436
10691_terrestrial,192,87,115,142,279,59.895833333333336,73.95833333333334
10692_terrestrial,193,86,116,141,279,60.10362694300518,73.05699481865285
10693_terrestrial,191,84,116,141,275,60.73298429319372,73.82198952879581
10694_terrestrial,190,84,116,139,274,61.05263157894737,73.15789473684211
10695_terrestrial,188,83,115,138,271,61.170212765957444,73.40425531914893
10696_terrestrial,186,81,113,138,267,60.752688172043015,74.19354838709677
10697_terrestrial,185,80,113,135,265,61.08108108108108,72.97297297297297
10698_terrestrial,185,80,114,135,265,61.62162162162163,72.97297297297297
10699_terrestrial,184,80,113,133,264,61.41304347826087,72.28260869565217
10700_terrestrial,182,79,111,133,261,60.98901098901099,73.07692307692307
10701_terrestrial,181,74,109,132,255,60.22099447513812,72.92817679558011
10702_terrestrial,178,75,106,130,253,59.55056179775281,73.03370786516854
10703_terrestrial,178,75,107,130,253,60.1123595505618,73.03370786516854
10704_terrestrial,176,77,107,130,253,60.79545454545454,73.86363636363636
10705_terrestrial,177,74,108,132,251,61.016949152542374,74.57627118644068
10706_terrestrial,176,72,106,132,248,60.22727272727273,75
10707_terrestrial,174,74,105,130,248,60.3448275862069,74.71264367816092
10708_terrestrial,174,74,104,131,248,59.77011494252874,75.28735632183908
10709_terrestrial,178,78,108,134,256,60.67415730337079,75.28089887640449
10710_terrestrial,177,81,107,133,258,60.451977401129945,75.14124293785311
10711_terrestrial,171,81,102,131,252,59.64912280701754,76.60818713450293
10712_terrestrial,168,79,98,127,247,58.333333333333336,75.59523809523809
10713_terrestrial,170,78,98,128,248,57.647058823529406,75.29411764705883
10714_terrestrial,171,78,97,129,249,56.72514619883041,75.43859649122807
10715_terrestrial,169,78,97,128,247,57.396449704142015,75.7396449704142
10725_terrestrial,174,71,103,133,245,59.195402298850574,76.4367816091954
10726_terrestrial,176,72,104,135,248,59.09090909090909,76.70454545454545
10727_terrestrial,177,73,105,136,250,59.32203389830508,76.8361581920904
10728_terrestrial,180,72,106,138,252,58.88888888888889,76.66666666666667
10729_terrestrial,177,73,104,135,250,58.75706214689266,76.27118644067797
10730_terrestrial,178,74,104,136,252,58.42696629213483,76.40449438202246
10731_terrestrial,178,74,104,136,252,58.42696629213483,76.40449438202246
10732_terrestrial,181,74,105,137,255,58.011049723756905,75.69060773480662
10733_terrestrial,181,76,105,137,257,58.011049723756905,75.69060773480662
10734_terrestrial,183,79,106,139,262,57.92349726775956,75.95628415300546
10735_terrestrial,180,77,103,137,257,57.22222222222222,76.11111111111111
10736_terrestrial,181,79,103,137,260,56.9060773480663,75.69060773480662
10737_terrestrial,181,80,103,137,261,56.9060773480663,75.69060773480662
10738_terrestrial,178,77,103,137,255,57.865168539325836,76.96629213483146
10739_terrestrial,178,75,103,137,253,57.865168539325836,76.96629213483146
10740_terrestrial,178,75,104,137,253,58.42696629213483,76.96629213483146
10741_terrestrial,178,75,105,137,253,58.98876404494382,76.96629213483146
10742_terrestrial,176,77,105,135,253,59.65909090909091,76.70454545454545
10743_terrestrial,176,77,104,133,253,59.09090909090909,75.56818181818183
10744_terrestrial,172,75,102,131,247,59.30232558139535,76.16279069767442
10745_terrestrial,167,75,99,129,242,59.281437125748504,77.24550898203593
10746_terrestrial,167,77,99,129,244,59.281437125748504,77.24550898203593
10747_terrestrial,165,77,99,129,242,60,78.18181818181819
10748_terrestrial,164,75,98,128,239,59.756097560975604,78.04878048780488
10749_terrestrial,163,75,97,127,238,59.50920245398773,77.91411042944786
10750_terrestrial,162,74,96,126,236,59.25925925925925,77.77777777777779
10751_terrestrial,164,69,98,127,233,59.756097560975604,77.4390243902439
10752_terrestrial,163,71,97,126,234,59.50920245398773,77.30061349693251
10753_terrestrial,164,66,99,126,230,60.36585365853659,76.82926829268293
10754_terrestrial,164,64,100,124,228,60.97560975609756,75.60975609756098
10755_terrestrial,166,66,100,124,232,60.24096385542169,74.69879518072288
10756_terrestrial,168,67,103,125,235,61.30952380952381,74.40476190476191
10757_terrestrial,165,69,100,122,234,60.60606060606061,73.93939393939394
10758_terrestrial,170,64,103,122,234,60.588235294117645,71.76470588235294
10759_terrestrial,164,59,98,119,223,59.756097560975604,72.5609756097561
10760_terrestrial,161,57,93,116,218,57.7639751552795,72.04968944099379
10761_terrestrial,156,61,88,113,217,56.41025641025641,72.43589743589743
10762_terrestrial,153,63,85,110,216,55.55555555555556,71.89542483660131
10763_terrestrial,151,62,83,109,213,54.966887417218544,72.18543046357617
10764_terrestrial,146,64,80,106,210,54.794520547945204,72.6027397260274
10765_terrestrial,149,64,83,106,213,55.70469798657718,71.14093959731544
10766_terrestrial,146,65,81,104,211,55.47945205479452,71.23287671232876
10767_terrestrial,146,63,81,103,209,55.47945205479452,70.54794520547945
10768_terrestrial,145,67,82,103,212,56.55172413793104,71.03448275862068
10769_terrestrial,146,73,83,102,219,56.849315068493155,69.86301369863014
10770_terrestrial,148,73,84,103,221,56.75675675675676,69.5945945945946
10771_terrestrial,148,70,85,103,218,57.432432432432435,69.5945945945946
10772_terrestrial,143,71,80,102,214,55.94405594405595,71.32867132867133
10773_terrestrial,144,69,81,102,213,56.25,70.83333333333334
10774_terrestrial,141,71,78,99,212,55.319148936170215,70.2127659574468
10839_terrestrial,209,120,111,118,329,53.110047846889955,56.45933014354066
10840_terrestrial,215,130,113,124,345,52.55813953488372,57.674418604651166
10841_terrestrial,231,136,124,138,367,53.67965367965368,59.74025974025974
10842_terrestrial,237,144,124,141,381,52.320675105485236,59.49367088607595
10843_terrestrial,254,157,129,154,411,50.78740157480315,60.629921259842526
10844_terrestrial,265,172,135,165,437,50.943396226415096,62.264150943396224
10845_terrestrial,274,182,136,173,456,49.63503649635037,63.138686131386855
10846_terrestrial,262,176,127,167,438,48.473282442748086,63.74045801526718
10847_terrestrial,176,116,69,132,292,39.20454545454545,75
10848_terrestrial,161,107,63,118,268,39.130434782608695,73.29192546583852
10849_terrestrial,157,104,60,114,261,38.21656050955414,72.61146496815286
10853_terrestrial,167,95,63,120,262,37.72455089820359,71.8562874251497
10854_terrestrial,168,97,63,121,265,37.5,72.02380952380952
10855_terrestrial,173,100,64,125,273,36.99421965317919,72.25433526011561
10856_terrestrial,175,104,63,127,279,36,72.57142857142857
10857_terrestrial,172,99,61,128,271,35.46511627906977,74.4186046511628
10868_terrestrial,178,102,62,140,280,34.831460674157306,78.65168539325843
10869_terrestrial,180,104,61,140,284,33.88888888888889,77.77777777777779
10874_terrestrial,153,79,54,119,232,35.294117647058826,77.77777777777779
10977_terrestrial,245,94,198,110,339,80.81632653061224,44.89795918367347
10978_terrestrial,245,95,198,111,340,80.81632653061224,45.30612244897959
10986_terrestrial,331,138,243,189,469,73.41389728096676,57.09969788519638
10987_terrestrial,318,136,235,173,454,73.89937106918238,54.40251572327044
10988_terrestrial,196,68,129,140,264,65.81632653061224,71.42857142857143
10989_terrestrial,215,74,143,156,289,66.51162790697674,72.55813953488372
10990_terrestrial,366,140,271,208,506,74.04371584699454,56.830601092896174
10991_terrestrial,380,148,278,212,528,73.15789473684211,55.78947368421052
10992_terrestrial,362,136,266,211,498,73.48066298342542,58.28729281767956
10993_terrestrial,233,86,150,167,319,64.37768240343348,71.67381974248927
10994_terrestrial,236,89,153,167,325,64.83050847457628,70.76271186440678
10995_terrestrial,244,87,160,173,331,65.57377049180327,70.90163934426229
10996_terrestrial,238,89,156,168,327,65.54621848739495,70.58823529411765
10997_terrestrial,240,89,160,167,329,66.66666666666666,69.58333333333333
10998_terrestrial,280,106,193,185,386,68.92857142857143,66.07142857142857
10999_terrestrial,272,106,190,178,378,69.85294117647058,65.44117647058823
11003_terrestrial,291,116,189,198,407,64.94845360824742,68.04123711340206
11004_terrestrial,316,133,204,215,449,64.55696202531645,68.0379746835443
11005_terrestrial,294,125,191,203,419,64.96598639455783,69.04761904761905
11006_terrestrial,297,126,193,203,423,64.98316498316498,68.35016835016835
11007_terrestrial,295,126,193,199,421,65.42372881355932,67.45762711864407
11008_terrestrial,304,125,195,200,429,64.14473684210526,65.78947368421053
11009_terrestrial,303,121,194,199,424,64.02640264026402,65.67656765676567
11010_terrestrial,293,119,186,195,412,63.48122866894198,66.55290102389078
11011_terrestrial,304,121,197,199,425,64.80263157894737,65.46052631578947
11012_terrestrial,272,108,171,185,380,62.86764705882353,68.01470588235294
11013_terrestrial,261,109,161,179,370,61.68582375478927,68.5823754789272
11014_terrestrial,253,112,157,176,365,62.055335968379445,69.56521739130434
11015_terrestrial,253,111,157,176,364,62.055335968379445,69.56521739130434
11016_terrestrial,243,112,151,171,355,62.139917695473244,70.37037037037037
11017_terrestrial,239,114,146,169,353,61.08786610878661,70.7112970711297
11018_terrestrial,238,114,146,171,352,61.34453781512605,71.84873949579831
11019_terrestrial,237,117,148,167,354,62.447257383966246,70.46413502109705
11020_terrestrial,235,114,147,165,349,62.5531914893617,70.2127659574468
11021_terrestrial,233,105,144,166,338,61.80257510729614,71.24463519313305
11022_terrestrial,231,99,143,165,330,61.904761904761905,71.42857142857143
11023_terrestrial,232,100,144,166,332,62.06896551724138,71.55172413793103
11024_terrestrial,234,94,145,167,328,61.965811965811966,71.36752136752136
11025_terrestrial,233,93,144,166,326,61.80257510729614,71.24463519313305
11026_terrestrial,233,97,144,166,330,61.80257510729614,71.24463519313305
11027_terrestrial,230,102,142,165,332,61.73913043478261,71.73913043478261
11028_terrestrial,231,102,143,164,333,61.904761904761905,70.995670995671
11029_terrestrial,229,102,141,162,331,61.572052401746724,70.74235807860262
11030_terrestrial,225,99,139,157,324,61.77777777777778,69.77777777777779
11031_terrestrial,226,97,139,156,323,61.504424778761056,69.02654867256636
11032_terrestrial,227,97,138,155,324,60.792951541850215,68.28193832599119
11033_terrestrial,229,97,140,156,326,61.135371179039296,68.12227074235808
11034_terrestrial,222,92,136,154,314,61.261261261261254,69.36936936936937
11035_terrestrial,226,91,140,156,317,61.94690265486725,69.02654867256636
11036_terrestrial,225,91,139,156,316,61.77777777777778,69.33333333333334
11037_terrestrial,226,95,138,157,321,61.06194690265486,69.46902654867256
11038_terrestrial,226,95,138,160,321,61.06194690265486,70.79646017699115
11039_terrestrial,221,100,133,162,321,60.18099547511312,73.303167420814475
11040_terrestrial,223,102,136,166,325,60.98654708520179,74.43946188340807
11041_terrestrial,209,95,125,163,304,59.80861244019139,77.99043062200957
11042_terrestrial,203,92,123,157,295,60.591133004926114,77.33990147783251
11043_terrestrial,202,89,121,155,291,59.900990099009896,76.73267326732673
11044_terrestrial,202,88,123,153,290,60.89108910891089,75.74257425742574
11045_terrestrial,203,89,124,153,292,61.083743842364534,75.36945812807882
11046_terrestrial,204,94,125,152,298,61.274509803921575,74.50980392156863
11047_terrestrial,203,95,124,152,298,61.083743842364534,74.8768472906404
11048_terrestrial,202,94,124,151,296,61.386138613861384,74.75247524752476
11049_terrestrial,207,94,127,154,301,61.35265700483091,74.39613526570048
11050_terrestrial,201,94,123,149,295,61.19402985074627,74.12935323383084
11051_terrestrial,203,90,125,149,293,61.57635467980296,73.39901477832512
11052_terrestrial,199,90,123,147,289,61.80904522613066,73.86934673366834
11053_terrestrial,198,87,123,146,285,62.121212121212125,73.73737373737373
11054_terrestrial,195,84,119,146,279,61.02564102564103,74.87179487179488
11055_terrestrial,194,84,120,143,278,61.855670103092784,73.71134020618557
11056_terrestrial,195,85,121,144,280,62.05128205128205,73.84615384615385
11057_terrestrial,193,89,119,143,282,61.6580310880829,74.09326424870466
11058_terrestrial,194,90,120,144,284,61.855670103092784,74.22680412371135
11059_terrestrial,194,90,120,143,284,61.855670103092784,73.71134020618557
11060_terrestrial,193,90,119,143,283,61.6580310880829,74.09326424870466
11061_terrestrial,191,89,117,143,280,61.25654450261781,74.86910994764398
11062_terrestrial,191,84,115,143,275,60.20942408376963,74.86910994764398
11063_terrestrial,191,84,115,143,275,60.20942408376963,74.86910994764398
11064_terrestrial,187,79,113,141,266,60.42780748663101,75.40106951871658
11065_terrestrial,188,85,114,142,273,60.63829787234043,75.53191489361703
11066_terrestrial,189,82,115,144,271,60.84656084656085,76.19047619047619
11067_terrestrial,190,83,116,144,273,61.05263157894737,75.78947368421053
11068_terrestrial,190,83,114,145,273,60,76.31578947368422
11069_terrestrial,191,82,115,146,273,60.20942408376963,76.43979057591623
11070_terrestrial,189,87,113,145,276,59.78835978835979,76.71957671957672
11071_terrestrial,187,85,112,143,272,59.893048128342244,76.47058823529412
11072_terrestrial,187,87,112,145,274,59.893048128342244,77.54010695187165
11073_terrestrial,188,84,107,144,272,56.91489361702128,76.59574468085107
11074_terrestrial,181,86,103,137,267,56.9060773480663,75.69060773480662
11075_terrestrial,180,84,100,138,264,55.55555555555556,76.66666666666667
11076_terrestrial,179,84,100,137,263,55.865921787709496,76.53631284916202
11084_terrestrial,180,76,105,137,256,58.333333333333336,76.11111111111111
11085_terrestrial,181,75,106,139,256,58.5635359116022,76.79558011049724
11086_terrestrial,181,78,106,139,259,58.5635359116022,76.79558011049724
11087_terrestrial,181,77,106,139,258,58.5635359116022,76.79558011049724
11088_terrestrial,184,77,108,141,261,58.69565217391305,76.63043478260869
11089_terrestrial,184,78,108,141,262,58.69565217391305,76.63043478260869
11090_terrestrial,187,78,111,144,265,59.35828877005348,77.00534759358288
11091_terrestrial,184,83,107,141,267,58.152173913043484,76.63043478260869
11092_terrestrial,186,82,106,142,268,56.98924731182796,76.34408602150538
11093_terrestrial,188,83,108,144,271,57.446808510638306,76.59574468085107
11094_terrestrial,190,82,109,146,272,57.36842105263158,76.84210526315789
11095_terrestrial,190,76,109,145,266,57.36842105263158,76.31578947368422
11096_terrestrial,187,71,109,144,258,58.288770053475936,77.00534759358288
11097_terrestrial,189,75,113,145,264,59.78835978835979,76.71957671957672
11098_terrestrial,185,76,112,142,261,60.54054054054055,76.75675675675676
11099_terrestrial,183,76,110,142,259,60.10928961748634,77.59562841530054
11100_terrestrial,183,76,108,140,259,59.01639344262295,76.50273224043715
11101_terrestrial,183,72,108,139,255,59.01639344262295,75.95628415300546
11102_terrestrial,177,70,104,135,247,58.75706214689266,76.27118644067797
11103_terrestrial,178,70,107,135,248,60.1123595505618,75.84269662921348
11104_terrestrial,178,70,108,135,248,60.67415730337079,75.84269662921348
11105_terrestrial,172,69,106,133,241,61.627906976744185,77.32558139534885
11106_terrestrial,172,69,106,131,241,61.627906976744185,76.16279069767442
11107_terrestrial,172,67,106,131,239,61.627906976744185,76.16279069767442
11108_terrestrial,170,66,104,129,236,61.1764705882353,75.88235294117646
11109_terrestrial,168,64,102,129,232,60.71428571428571,76.78571428571429
11110_terrestrial,167,64,102,128,231,61.07784431137725,76.64670658682635
11111_terrestrial,170,65,105,128,235,61.76470588235294,75.29411764705883
11112_terrestrial,169,67,104,128,236,61.53846153846154,75.7396449704142
11113_terrestrial,169,70,105,125,239,62.1301775147929,73.96449704142012
11114_terrestrial,171,70,105,125,241,61.40350877192983,73.09941520467837
11115_terrestrial,174,70,107,125,244,61.49425287356321,71.83908045977012
11116_terrestrial,174,67,107,127,241,61.49425287356321,72.98850574712644
11117_terrestrial,171,65,104,123,236,60.81871345029239,71.9298245614035
11118_terrestrial,169,65,101,121,234,59.76331360946746,71.59763313609467
11119_terrestrial,169,64,101,122,233,59.76331360946746,72.18934911242604
11120_terrestrial,166,62,98,118,228,59.036144578313255,71.08433734939759
11121_terrestrial,161,68,93,116,229,57.7639751552795,72.04968944099379
11122_terrestrial,156,64,88,115,220,56.41025641025641,73.71794871794873
11123_terrestrial,184,86,113,118,270,61.41304347826087,64.13043478260869
11124_terrestrial,183,89,112,117,272,61.20218579234973,63.934426229508205
11125_terrestrial,178,89,107,116,267,60.1123595505618,65.1685393258427
11126_terrestrial,176,88,107,110,264,60.79545454545454,62.5
11127_terrestrial,177,90,110,110,267,62.14689265536724,62.14689265536724
11128_terrestrial,177,92,112,111,269,63.2768361581921,62.71186440677966
11129_terrestrial,181,94,116,112,275,64.08839779005525,61.87845303867403
11130_terrestrial,178,94,113,112,272,63.48314606741573,62.92134831460674
11131_terrestrial,184,98,119,120,282,64.67391304347827,65.21739130434783
11132_terrestrial,175,98,112,111,273,64,63.42857142857142
11133_terrestrial,175,97,112,111,272,64,63.42857142857142
11134_terrestrial,166,92,104,106,258,62.65060240963856,63.85542168674698
11135_terrestrial,170,98,108,108,268,63.52941176470588,63.52941176470588
11202_terrestrial,201,122,104,119,323,51.741293532338304,59.20398009950249
11203_terrestrial,233,138,123,134,371,52.78969957081545,57.5107296137339
11204_terrestrial,250,149,131,145,399,52.400000000000006,57.99999999999999
11205_terrestrial,253,155,128,150,408,50.59288537549407,59.28853754940712
11206_terrestrial,273,170,140,163,443,51.28205128205128,59.70695970695971
11207_terrestrial,277,178,139,169,455,50.18050541516246,61.01083032490975
11208_terrestrial,180,123,72,137,303,40,76.11111111111111
11209_terrestrial,158,113,60,115,271,37.9746835443038,72.78481012658227
11210_terrestrial,156,108,60,113,264,38.46153846153847,72.43589743589743
11214_terrestrial,165,98,60,118,263,36.36363636363637,71.51515151515152
11215_terrestrial,166,97,60,119,263,36.144578313253014,71.6867469879518
11216_terrestrial,171,102,62,124,273,36.25730994152047,72.51461988304094
11217_terrestrial,171,93,61,126,264,35.67251461988304,73.68421052631578
11218_terrestrial,176,94,61,128,270,34.659090909090914,72.72727272727273
11219_terrestrial,174,96,61,130,270,35.05747126436782,74.71264367816092
11335_terrestrial,303,129,231,144,432,76.23762376237624,47.524752475247524
11336_terrestrial,346,132,260,185,478,75.14450867052022,53.46820809248555
11337_terrestrial,360,139,275,197,499,76.38888888888889,54.72222222222223
11338_terrestrial,248,95,201,111,343,81.04838709677419,44.75806451612903
11346_terrestrial,334,134,247,188,468,73.95209580838323,56.287425149700596
11347_terrestrial,384,151,280,220,535,72.91666666666666,57.291666666666664
11348_terrestrial,377,138,274,213,515,72.67904509283821,56.49867374005305
11349_terrestrial,346,130,251,192,476,72.54335260115607,55.49132947976878
11350_terrestrial,331,137,239,186,468,72.20543806646525,56.19335347432024
11351_terrestrial,190,77,118,143,267,62.10526315789474,75.26315789473685
11352_terrestrial,357,142,258,202,499,72.26890756302521,56.582633053221286
11353_terrestrial,258,97,171,184,355,66.27906976744185,71.31782945736434
11354_terrestrial,248,93,165,170,341,66.53225806451613,68.54838709677419
11355_terrestrial,242,88,160,172,330,66.11570247933885,71.07438016528926
11356_terrestrial,241,90,159,170,331,65.97510373443983,70.53941908713693
11357_terrestrial,269,106,186,176,375,69.14498141263941,65.4275092936803
11358_terrestrial,253,103,177,163,356,69.96047430830039,64.42687747035573
11362_terrestrial,251,78,173,185,329,68.92430278884463,73.70517928286853
11363_terrestrial,262,80,179,190,342,68.32061068702289,72.51908396946564
11364_terrestrial,310,132,200,208,442,64.51612903225806,67.0967741935484
11365_terrestrial,305,137,197,206,442,64.59016393442623,67.54098360655738
11366_terrestrial,267,117,166,185,384,62.172284644194754,69.28838951310861
11367_terrestrial,265,111,162,185,376,61.13207547169811,69.81132075471697
11368_terrestrial,277,117,170,190,394,61.371841155234655,68.59205776173285
11369_terrestrial,259,110,158,180,369,61.003861003861005,69.4980694980695
11370_terrestrial,257,110,157,179,367,61.08949416342413,69.64980544747081
11371_terrestrial,256,115,160,176,371,62.5,68.75
11372_terrestrial,257,115,159,176,372,61.86770428015564,68.48249027237354
11373_terrestrial,252,112,156,176,364,61.904761904761905,69.84126984126983
11374_terrestrial,253,114,157,179,367,62.055335968379445,70.7509881422925
11375_terrestrial,247,114,152,176,361,61.53846153846154,71.25506072874494
11376_terrestrial,248,115,149,177,363,60.08064516129033,71.37096774193549
11377_terrestrial,247,118,149,175,365,60.32388663967612,70.8502024291498
11378_terrestrial,249,118,152,176,367,61.044176706827315,70.68273092369478
11379_terrestrial,251,114,154,176,365,61.354581673306775,70.1195219123506
11380_terrestrial,251,114,155,173,365,61.75298804780876,68.92430278884463
11381_terrestrial,250,116,157,171,366,62.8,68.4
11382_terrestrial,250,113,153,172,363,61.199999999999996,68.8
11383_terrestrial,250,113,151,172,363,60.4,68.8
11384_terrestrial,245,107,149,169,352,60.816326530612244,68.9795918367347
11385_terrestrial,246,107,148,170,353,60.16260162601627,69.10569105691057
11386_terrestrial,241,103,144,170,344,59.75103734439834,70.53941908713693
11387_terrestrial,240,105,143,170,345,59.583333333333336,70.83333333333334
11388_terrestrial,238,107,142,168,345,59.66386554621849,70.58823529411765
11389_terrestrial,239,99,144,169,338,60.25104602510461,70.7112970711297
11390_terrestrial,238,98,143,166,336,60.08403361344538,69.74789915966386
11391_terrestrial,239,98,142,166,337,59.41422594142259,69.4560669456067
11392_terrestrial,236,94,140,163,330,59.32203389830508,69.0677966101695
11393_terrestrial,234,94,139,163,328,59.401709401709404,69.65811965811966
11394_terrestrial,231,95,137,162,326,59.307359307359306,70.12987012987013
11395_terrestrial,237,95,140,162,332,59.07172995780591,68.35443037974683
11396_terrestrial,234,95,139,160,329,59.401709401709404,68.37606837606837
11397_terrestrial,233,99,137,161,332,58.798283261802574,69.09871244635193
11398_terrestrial,237,104,140,169,341,59.07172995780591,71.30801687763713
11399_terrestrial,225,104,135,164,329,60,72.88888888888889
11400_terrestrial,226,107,137,167,333,60.61946902654868,73.89380530973452
11401_terrestrial,217,100,128,168,317,58.986175115207374,77.41935483870968
11402_terrestrial,210,100,124,160,310,59.04761904761905,76.19047619047619
11403_terrestrial,214,100,127,160,314,59.345794392523366,74.76635514018692
11404_terrestrial,213,98,129,158,311,60.56338028169014,74.17840375586854
11405_terrestrial,216,99,132,160,315,61.111111111111114,74.07407407407408
11406_terrestrial,220,102,133,160,322,60.45454545454545,72.72727272727273
11407_terrestrial,218,102,132,159,320,60.550458715596335,72.93577981651376
11408_terrestrial,221,101,135,160,322,61.085972850678736,72.39819004524887
11409_terrestrial,217,102,132,154,319,60.82949308755761,70.96774193548387
11410_terrestrial,214,102,129,151,316,60.280373831775705,70.56074766355141
11411_terrestrial,209,98,126,152,307,60.28708133971292,72.72727272727273
11412_terrestrial,210,96,129,155,306,61.42857142857143,73.80952380952381
11413_terrestrial,206,94,126,154,300,61.165048543689316,74.75728155339806
11414_terrestrial,208,93,127,155,301,61.057692307692314,74.51923076923077
11415_terrestrial,208,93,126,156,301,60.57692307692307,75
11416_terrestrial,206,93,126,156,299,61.165048543689316,75.72815533980582
11417_terrestrial,203,91,124,154,294,61.083743842364534,75.86206896551724
11418_terrestrial,202,91,124,152,293,61.386138613861384,75.24752475247524
11419_terrestrial,199,92,121,151,291,60.80402010050251,75.87939698492463
11420_terrestrial,199,91,123,150,290,61.80904522613066,75.37688442211056
11421_terrestrial,198,91,122,149,289,61.61616161616161,75.25252525252525
11422_terrestrial,197,96,121,148,293,61.42131979695431,75.1269035532995
11423_terrestrial,195,94,117,149,289,60,76.41025641025641
11424_terrestrial,198,95,119,152,293,60.1010101010101,76.76767676767676
11425_terrestrial,198,92,119,152,290,60.1010101010101,76.76767676767676
11426_terrestrial,196,91,118,150,287,60.204081632653065,76.53061224489795
11427_terrestrial,193,88,116,147,281,60.10362694300518,76.16580310880829
11428_terrestrial,194,90,117,149,284,60.30927835051546,76.80412371134021
11429_terrestrial,195,92,117,151,287,60,77.435897435897445
11430_terrestrial,196,96,118,152,292,60.204081632653065,77.55102040816327
11431_terrestrial,197,94,116,153,291,58.88324873096447,77.66497461928934
11432_terrestrial,198,101,116,154,299,58.58585858585859,77.77777777777779
11433_terrestrial,200,101,116,155,301,57.99999999999999,77.5
11434_terrestrial,198,101,114,153,299,57.57575757575758,77.27272727272727
11435_terrestrial,194,96,111,149,290,57.21649484536082,76.80412371134021
11436_terrestrial,191,94,108,146,285,56.54450261780105,76.43979057591623
11437_terrestrial,191,90,107,148,281,56.02094240837696,77.4869109947644
11438_terrestrial,190,94,107,149,284,56.315789473684205,78.42105263157895
11439_terrestrial,188,92,106,148,280,56.38297872340425,78.72340425531915
11440_terrestrial,188,93,106,148,281,56.38297872340425,78.72340425531915
11441_terrestrial,187,94,105,147,281,56.14973262032086,78.6096256684492
11442_terrestrial,189,94,108,148,283,57.14285714285714,78.3068783068783
11443_terrestrial,191,91,109,148,282,57.06806282722513,77.4869109947644
11444_terrestrial,191,89,111,148,280,58.1151832460733,77.4869109947644
11445_terrestrial,188,87,109,147,275,57.97872340425532,78.19148936170212
11446_terrestrial,186,85,110,145,271,59.13978494623656,77.95698924731182
11447_terrestrial,187,84,110,145,271,58.82352941176471,77.54010695187165
11448_terrestrial,192,87,113,150,279,58.854166666666664,78.125
11449_terrestrial,193,89,114,148,282,59.067357512953365,76.68393782383419
11450_terrestrial,194,88,114,149,282,58.76288659793815,76.80412371134021
11451_terrestrial,196,90,115,152,286,58.673469387755105,77.55102040816327
11452_terrestrial,194,86,113,150,280,58.24742268041238,77.31958762886599
11453_terrestrial,194,80,115,151,274,59.27835051546392,77.83505154639175
11454_terrestrial,192,79,114,148,271,59.375,77.08333333333334
11455_terrestrial,192,77,114,148,269,59.375,77.08333333333334
11456_terrestrial,190,75,114,148,265,60,77.89473684210526
11457_terrestrial,193,78,116,149,271,60.10362694300518,77.2020725388601
11458_terrestrial,192,79,115,147,271,59.895833333333336,76.5625
11459_terrestrial,191,80,115,147,271,60.20942408376963,76.96335078534031
11460_terrestrial,188,76,113,144,264,60.1063829787234,76.59574468085107
11461_terrestrial,190,74,114,146,264,60,76.84210526315789
11462_terrestrial,190,74,113,144,264,59.473684210526315,75.78947368421053
11463_terrestrial,185,73,110,142,258,59.45945945945946,76.75675675675676
11464_terrestrial,182,70,110,140,252,60.43956043956044,76.92307692307693
11465_terrestrial,178,71,109,138,249,61.23595505617978,77.52808988764045
11466_terrestrial,176,71,106,136,247,60.22727272727273,77.27272727272727
11467_terrestrial,174,67,106,134,241,60.91954022988506,77.01149425287356
11468_terrestrial,172,69,105,132,241,61.04651162790697,76.74418604651163
11469_terrestrial,174,74,107,132,248,61.49425287356321,75.86206896551724
11470_terrestrial,174,74,106,130,248,60.91954022988506,74.71264367816092
11471_terrestrial,175,73,107,130,248,61.142857142857146,74.28571428571429
11472_terrestrial,177,75,109,129,252,61.5819209039548,72.88135593220339
11473_terrestrial,175,75,108,127,250,61.71428571428571,72.57142857142857
11474_terrestrial,174,73,106,128,247,60.91954022988506,73.5632183908046
11475_terrestrial,177,74,108,129,251,61.016949152542374,72.88135593220339
11476_terrestrial,172,69,104,124,241,60.46511627906976,72.09302325581395
11477_terrestrial,170,69,103,123,239,60.588235294117645,72.35294117647058
11478_terrestrial,167,70,100,122,237,59.88023952095808,73.05389221556887
11479_terrestrial,168,68,99,122,236,58.92857142857143,72.61904761904762
11480_terrestrial,166,70,98,119,236,59.036144578313255,71.6867469879518
11481_terrestrial,192,92,121,123,284,63.020833333333336,64.0625
11482_terrestrial,184,87,114,120,271,61.95652173913043,65.21739130434783
11483_terrestrial,173,82,105,111,255,60.69364161849711,64.16184971098265
11492_terrestrial,164,89,104,104,253,63.41463414634146,63.41463414634146
11493_terrestrial,167,87,104,107,254,62.27544910179641,64.07185628742515
11567_terrestrial,247,154,125,144,401,50.607287449392715,58.2995951417004
11568_terrestrial,266,172,134,160,438,50.37593984962406,60.150375939849624
11569_terrestrial,179,116,69,138,295,38.547486033519554,77.09497206703911
11570_terrestrial,170,113,65,127,283,38.23529411764706,74.70588235294117
11574_terrestrial,168,104,61,121,272,36.30952380952381,72.02380952380952
11575_terrestrial,170,105,61,123,275,35.88235294117647,72.35294117647058
11576_terrestrial,174,102,60,127,276,34.48275862068966,72.98850574712644
11577_terrestrial,174,101,58,128,275,33.33333333333333,73.5632183908046
11578_terrestrial,179,100,60,133,279,33.5195530726257,74.30167597765363
11579_terrestrial,177,99,61,135,276,34.463276836158194,76.27118644067797
11580_terrestrial,180,100,61,139,280,33.88888888888889,77.22222222222223
11694_terrestrial,293,113,230,145,406,78.49829351535837,49.48805460750853
11695_terrestrial,356,143,266,191,499,74.71910112359551,53.65168539325843
11696_terrestrial,375,146,278,218,521,74.13333333333333,58.13333333333334
11697_terrestrial,382,137,283,222,519,74.08376963350786,58.1151832460733
11698_terrestrial,380,136,285,218,516,75,57.36842105263158
11699_terrestrial,315,132,242,163,447,76.82539682539684,51.746031746031754
11709_terrestrial,324,131,239,172,455,73.76543209876543,53.086419753086425
11710_terrestrial,355,149,258,198,504,72.67605633802818,55.774647887323944
11711_terrestrial,342,145,250,190,487,73.09941520467837,55.55555555555556
11712_terrestrial,344,131,248,198,475,72.09302325581395,57.55813953488372
11713_terrestrial,346,136,251,203,482,72.54335260115607,58.67052023121387
11714_terrestrial,240,91,161,168,331,67.08333333333333,70
11715_terrestrial,231,89,154,159,320,66.66666666666666,68.83116883116884
11716_terrestrial,222,92,146,151,314,65.76576576576578,68.01801801801803
11717_terrestrial,289,125,198,190,414,68.5121107266436,65.7439446366782
11718_terrestrial,209,84,147,146,293,70.33492822966507,69.85645933014354
11719_terrestrial,211,75,151,142,286,71.56398104265402,67.29857819905213
11720_terrestrial,199,74,143,134,273,71.85929648241206,67.33668341708542
11722_terrestrial,329,132,215,221,461,65.34954407294833,67.17325227963525
11723_terrestrial,328,136,214,222,464,65.2439024390244,67.6829268292683
11724_terrestrial,293,135,189,197,428,64.50511945392492,67.23549488054607
11725_terrestrial,324,140,209,219,464,64.50617283950618,67.5925925925926
11726_terrestrial,271,118,168,189,389,61.99261992619927,69.74169741697416
11727_terrestrial,275,121,170,190,396,61.81818181818181,69.0909090909091
11728_terrestrial,278,115,170,193,393,61.15107913669065,69.42446043165468
11729_terrestrial,256,110,154,179,366,60.15625,69.921875
11730_terrestrial,251,110,151,176,361,60.1593625498008,70.1195219123506
11731_terrestrial,249,111,151,174,360,60.6425702811245,69.87951807228916
11732_terrestrial,248,114,153,173,362,61.693548387096776,69.75806451612904
11733_terrestrial,247,119,153,172,366,61.943319838056674,69.63562753036437
11734_terrestrial,244,116,150,171,360,61.47540983606557,70.08196721311475
11735_terrestrial,245,116,150,172,361,61.224489795918366,70.20408163265306
11736_terrestrial,252,117,155,177,369,61.50793650793651,70.23809523809523
11737_terrestrial,252,122,154,178,374,61.111111111111114,70.63492063492063
11738_terrestrial,262,124,156,181,386,59.541984732824424,69.08396946564885
11739_terrestrial,263,123,156,180,386,59.31558935361216,68.44106463878326
11740_terrestrial,263,124,156,180,387,59.31558935361216,68.44106463878326
11741_terrestrial,262,117,158,177,379,60.30534351145038,67.55725190839695
11742_terrestrial,260,118,157,177,378,60.38461538461538,68.07692307692308
11743_terrestrial,262,120,158,178,382,60.30534351145038,67.93893129770993
11744_terrestrial,263,122,159,179,385,60.45627376425855,68.06083650190115
11745_terrestrial,262,120,159,179,382,60.68702290076335,68.32061068702289
11746_terrestrial,254,102,153,176,356,60.23622047244095,69.29133858267717
11747_terrestrial,260,114,157,177,374,60.38461538461538,68.07692307692308
11748_terrestrial,258,118,155,176,376,60.07751937984496,68.21705426356588
11749_terrestrial,259,116,156,176,375,60.231660231660236,67.95366795366795
11750_terrestrial,250,101,147,174,351,58.8,69.6
11751_terrestrial,246,103,146,170,349,59.34959349593496,69.10569105691057
11752_terrestrial,242,103,143,168,345,59.09090909090909,69.42148760330579
11753_terrestrial,243,96,142,168,339,58.43621399176955,69.1358024691358
11754_terrestrial,247,98,146,169,345,59.10931174089069,68.42105263157895
11755_terrestrial,244,96,146,169,340,59.83606557377049,69.26229508196722
11756_terrestrial,243,100,143,172,343,58.8477366255144,70.78189300411523
11757_terrestrial,251,103,145,175,354,57.76892430278885,69.7211155378486
11758_terrestrial,240,106,139,176,346,57.91666666666667,73.33333333333333
11759_terrestrial,237,110,139,177,347,58.64978902953587,74.68354430379746
11760_terrestrial,241,107,141,180,348,58.50622406639005,74.68879668049793
11761_terrestrial,243,109,143,184,352,58.8477366255144,75.7201646090535
11762_terrestrial,233,102,136,181,335,58.36909871244635,77.6824034334764
11763_terrestrial,236,101,138,181,337,58.47457627118644,76.69491525423729
11764_terrestrial,230,104,137,172,334,59.56521739130435,74.78260869565217
11765_terrestrial,231,102,139,176,333,60.17316017316018,76.19047619047619
11766_terrestrial,230,104,139,174,334,60.43478260869565,75.65217391304347
11767_terrestrial,233,103,143,173,336,61.37339055793991,74.2489270386266
11768_terrestrial,232,103,144,171,335,62.06896551724138,73.70689655172413
11769_terrestrial,230,100,140,167,330,60.86956521739131,72.60869565217392
11770_terrestrial,230,100,141,167,330,61.30434782608696,72.60869565217392
11771_terrestrial,230,99,140,168,329,60.86956521739131,73.04347826086956
11772_terrestrial,230,99,141,168,329,61.30434782608696,73.04347826086956
11773_terrestrial,229,99,140,166,328,61.135371179039296,72.48908296943232
11774_terrestrial,227,99,140,165,326,61.67400881057269,72.68722466960352
11775_terrestrial,223,95,138,162,318,61.88340807174888,72.6457399103139
11776_terrestrial,222,95,137,163,317,61.711711711711715,73.42342342342343
11777_terrestrial,218,95,134,162,313,61.46788990825688,74.31192660550458
11778_terrestrial,215,92,131,159,307,60.93023255813953,73.95348837209302
11779_terrestrial,215,90,131,160,305,60.93023255813953,74.4186046511628
11780_terrestrial,213,93,130,158,306,61.03286384976526,74.17840375586854
11781_terrestrial,214,98,130,158,312,60.747663551401864,73.83177570093457
11782_terrestrial,211,101,130,158,312,61.61137440758294,74.88151658767772
11783_terrestrial,214,99,131,160,313,61.21495327102804,74.76635514018692
11784_terrestrial,212,98,132,158,310,62.264150943396224,74.52830188679245
11785_terrestrial,213,96,131,159,309,61.502347417840376,74.64788732394366
11786_terrestrial,206,97,126,159,303,61.165048543689316,77.18446601941747
11787_terrestrial,204,94,123,158,298,60.29411764705882,77.45098039215686
11788_terrestrial,205,93,126,157,298,61.46341463414634,76.58536585365854
11789_terrestrial,202,94,122,158,296,60.396039603960396,78.21782178217822
11790_terrestrial,201,95,121,157,296,60.19900497512438,78.1094527363184
11791_terrestrial,204,99,123,157,303,60.29411764705882,76.9607843137255
11792_terrestrial,206,103,124,160,309,60.19417475728155,77.66990291262135
11793_terrestrial,205,103,123,160,308,60,78.04878048780488
11794_terrestrial,201,106,119,159,307,59.20398009950249,79.1044776119403
11795_terrestrial,204,109,119,159,313,58.333333333333336,77.94117647058823
11796_terrestrial,200,107,116,155,307,57.99999999999999,77.5
11797_terrestrial,199,104,114,154,303,57.286432160804026,77.38693467336684
11798_terrestrial,199,99,113,156,298,56.78391959798995,78.39195979899498
11799_terrestrial,197,100,112,154,297,56.852791878172596,78.1725888324873
11800_terrestrial,196,98,113,155,294,57.6530612244898,79.08163265306123
11801_terrestrial,197,101,115,155,298,58.37563451776649,78.68020304568529
11802_terrestrial,194,99,112,153,293,57.73195876288659,78.8659793814433
11803_terrestrial,193,102,110,152,295,56.994818652849744,78.75647668393782
11804_terrestrial,196,98,112,155,294,57.14285714285714,79.08163265306123
11805_terrestrial,195,98,113,153,293,57.948717948717956,78.46153846153847
11806_terrestrial,196,100,114,154,296,58.16326530612245,78.57142857142857
11807_terrestrial,199,99,114,154,298,57.286432160804026,77.38693467336684
11808_terrestrial,201,95,117,156,296,58.2089552238806,77.61194029850746
11809_terrestrial,201,94,118,156,295,58.70646766169154,77.61194029850746
11810_terrestrial,199,96,119,157,295,59.798994974874375,78.89447236180904
11811_terrestrial,203,93,123,159,296,60.591133004926114,78.32512315270937
11812_terrestrial,202,90,122,158,292,60.396039603960396,78.21782178217822
11813_terrestrial,198,87,120,154,285,60.60606060606061,77.77777777777779
11814_terrestrial,197,80,120,155,277,60.913705583756354,78.68020304568529
11815_terrestrial,197,80,120,154,277,60.913705583756354,78.1725888324873
11816_terrestrial,192,82,116,149,274,60.416666666666664,77.60416666666666
11817_terrestrial,195,80,119,152,275,61.02564102564103,77.94871794871796
11818_terrestrial,197,74,119,152,271,60.40609137055838,77.15736040609137
11819_terrestrial,195,75,117,153,270,60,78.46153846153847
11820_terrestrial,196,73,119,153,269,60.71428571428571,78.06122448979592
11821_terrestrial,196,73,119,152,269,60.71428571428571,77.55102040816327
11822_terrestrial,199,72,122,153,271,61.30653266331658,76.88442211055276
11823_terrestrial,196,70,122,150,266,62.244897959183675,76.53061224489795
11824_terrestrial,190,72,119,145,262,62.63157894736842,76.31578947368422
11825_terrestrial,190,72,119,143,262,62.63157894736842,75.26315789473685
11826_terrestrial,186,73,117,140,259,62.903225806451616,75.26881720430107
11827_terrestrial,184,71,114,140,255,61.95652173913043,76.08695652173914
11828_terrestrial,184,74,111,140,258,60.32608695652174,76.08695652173914
11829_terrestrial,184,72,112,139,256,60.86956521739131,75.54347826086956
11830_terrestrial,180,72,109,136,252,60.55555555555555,75.55555555555556
11831_terrestrial,182,72,110,136,254,60.43956043956044,74.72527472527473
11832_terrestrial,179,72,109,133,251,60.893854748603346,74.30167597765363
11833_terrestrial,178,71,108,132,249,60.67415730337079,74.15730337078652
11834_terrestrial,179,70,108,132,249,60.33519553072626,73.74301675977654
11835_terrestrial,173,72,103,129,245,59.53757225433526,74.56647398843931
11836_terrestrial,175,71,104,129,246,59.42857142857143,73.71428571428571
11837_terrestrial,171,71,102,126,242,59.64912280701754,73.68421052631578
11838_terrestrial,172,73,102,126,245,59.30232558139535,73.25581395348837
11839_terrestrial,198,95,127,131,293,64.14141414141415,66.16161616161617
11840_terrestrial,198,90,127,130,288,64.14141414141415,65.65656565656566
11841_terrestrial,191,87,121,124,278,63.35078534031413,64.92146596858639
11928_terrestrial,260,154,128,143,414,49.23076923076923,55.00000000000001
11929_terrestrial,250,167,131,153,417,52.400000000000006,61.199999999999996
11930_terrestrial,183,132,70,146,315,38.25136612021858,79.78142076502732
11933_terrestrial,166,111,60,121,277,36.144578313253014,72.89156626506023
11934_terrestrial,169,108,59,124,277,34.9112426035503,73.37278106508876
11935_terrestrial,175,109,60,128,284,34.285714285714285,73.14285714285714
11936_terrestrial,177,107,59,132,284,33.33333333333333,74.57627118644068
11937_terrestrial,179,113,60,132,292,33.5195530726257,73.74301675977654
11938_terrestrial,183,116,60,136,299,32.78688524590164,74.31693989071039
11939_terrestrial,184,113,62,141,297,33.69565217391305,76.63043478260869
11940_terrestrial,190,112,62,149,302,32.631578947368425,78.42105263157895
11941_terrestrial,185,110,58,144,295,31.351351351351354,77.83783783783784
11942_terrestrial,193,108,61,150,301,31.606217616580313,77.720207253886
11973_terrestrial,127,79,47,88,206,37.00787401574803,69.29133858267717
12054_terrestrial,310,138,236,151,448,76.12903225806451,48.70967741935484
12055_terrestrial,369,147,274,204,516,74.25474254742548,55.28455284552846
12056_terrestrial,386,146,294,214,532,76.16580310880829,55.44041450777202
12057_terrestrial,407,142,305,240,549,74.93857493857494,58.96805896805897
12058_terrestrial,403,148,304,237,551,75.43424317617865,58.80893300248139
12069_terrestrial,378,145,275,214,523,72.75132275132276,56.613756613756614
12070_terrestrial,269,97,179,197,366,66.54275092936803,73.23420074349443
12071_terrestrial,334,138,239,195,472,71.55688622754491,58.38323353293413
12072_terrestrial,249,105,179,147,354,71.8875502008032,59.036144578313255
12073_terrestrial,369,156,261,226,525,70.73170731707317,61.24661246612466
12074_terrestrial,272,105,182,195,377,66.91176470588235,71.69117647058823
12075_terrestrial,301,124,208,198,425,69.10299003322258,65.78073089700996
12076_terrestrial,289,118,195,189,407,67.47404844290658,65.39792387543253
12077_terrestrial,292,127,200,191,419,68.4931506849315,65.41095890410958
12079_terrestrial,199,71,143,133,270,71.85929648241206,66.83417085427136
12082_terrestrial,318,137,209,209,455,65.72327044025157,65.72327044025157
12083_terrestrial,282,124,174,200,406,61.702127659574465,70.92198581560284
12084_terrestrial,314,147,201,212,461,64.01273885350318,67.51592356687898
12085_terrestrial,284,127,177,200,411,62.323943661971825,70.4225352112676
12086_terrestrial,285,123,176,199,408,61.75438596491228,69.82456140350877
12087_terrestrial,276,117,173,191,393,62.68115942028986,69.20289855072464
12088_terrestrial,285,116,176,199,401,61.75438596491228,69.82456140350877
12089_terrestrial,278,113,172,195,391,61.87050359712231,70.14388489208633
12090_terrestrial,260,110,160,182,370,61.53846153846154,70
12091_terrestrial,253,112,156,179,365,61.6600790513834,70.7509881422925
12092_terrestrial,253,115,156,176,368,61.6600790513834,69.56521739130434
12093_terrestrial,251,120,155,174,371,61.75298804780876,69.32270916334662
12094_terrestrial,249,123,153,173,372,61.44578313253012,69.47791164658635
12095_terrestrial,252,118,154,175,370,61.111111111111114,69.44444444444444
12096_terrestrial,258,118,153,181,376,59.30232558139535,70.15503875968993
12097_terrestrial,263,124,156,185,387,59.31558935361216,70.34220532319392
12098_terrestrial,262,123,155,182,385,59.16030534351145,69.46564885496184
12099_terrestrial,262,122,155,182,384,59.16030534351145,69.46564885496184
12100_terrestrial,264,117,156,182,381,59.09090909090909,68.93939393939394
12101_terrestrial,260,111,152,182,371,58.46153846153847,70
12102_terrestrial,263,116,156,180,379,59.31558935361216,68.44106463878326
12103_terrestrial,265,121,159,180,386,60,67.9245283018868
12104_terrestrial,265,124,157,178,389,59.24528301886792,67.16981132075472
12105_terrestrial,268,120,157,182,388,58.582089552238806,67.91044776119402
12106_terrestrial,270,123,159,181,393,58.88888888888889,67.03703703703704
12107_terrestrial,268,123,159,180,391,59.32835820895522,67.16417910447761
12108_terrestrial,271,125,160,182,396,59.040590405904055,67.15867158671587
12109_terrestrial,269,125,160,182,394,59.479553903345725,67.65799256505576
12110_terrestrial,268,121,158,183,389,58.95522388059702,68.28358208955224
12111_terrestrial,269,124,159,184,393,59.10780669144982,68.40148698884758
12112_terrestrial,263,122,156,182,385,59.31558935361216,69.20152091254754
12113_terrestrial,260,119,154,180,379,59.23076923076923,69.23076923076923
12114_terrestrial,259,109,152,181,368,58.68725868725869,69.88416988416989
12115_terrestrial,254,107,147,181,361,57.874015748031496,71.25984251968504
12116_terrestrial,250,103,146,177,353,58.4,70.8
12117_terrestrial,251,105,145,179,356,57.76892430278885,71.31474103585657
12118_terrestrial,237,104,140,178,341,59.07172995780591,75.10548523206751
12119_terrestrial,236,101,138,180,337,58.47457627118644,76.27118644067797
12120_terrestrial,239,104,141,181,343,58.995815899581594,75.73221757322176
12121_terrestrial,248,110,147,187,358,59.2741935483871,75.40322580645162
12122_terrestrial,243,102,142,187,345,58.43621399176955,76.95473251028807
12123_terrestrial,236,107,138,179,343,58.47457627118644,75.84745762711864
12124_terrestrial,236,109,138,180,345,58.47457627118644,76.27118644067797
12125_terrestrial,238,107,144,179,345,60.50420168067227,75.21008403361344
12126_terrestrial,238,105,145,179,343,60.924369747899156,75.21008403361344
12127_terrestrial,241,105,147,181,346,60.99585062240664,75.10373443983403
12128_terrestrial,236,108,145,174,344,61.440677966101696,73.72881355932203
12129_terrestrial,234,109,143,172,343,61.111111111111114,73.50427350427351
12130_terrestrial,233,107,144,169,340,61.80257510729614,72.53218884120172
12131_terrestrial,233,103,144,169,336,61.80257510729614,72.53218884120172
12132_terrestrial,233,102,145,169,335,62.231759656652365,72.53218884120172
12133_terrestrial,232,100,145,169,332,62.5,72.84482758620689
12134_terrestrial,236,101,145,173,337,61.440677966101696,73.30508474576271
12135_terrestrial,233,108,144,171,341,61.80257510729614,73.39055793991416
12136_terrestrial,228,105,141,169,333,61.8421052631579,74.12280701754386
12137_terrestrial,227,103,138,167,330,60.792951541850215,73.568281938326
12138_terrestrial,228,100,137,167,328,60.08771929824561,73.24561403508771
12139_terrestrial,225,98,136,166,323,60.44444444444444,73.77777777777777
12140_terrestrial,224,101,135,165,325,60.26785714285714,73.66071428571429
12141_terrestrial,226,101,136,165,327,60.17699115044248,73.00884955752213
12142_terrestrial,233,101,140,172,334,60.08583690987125,73.8197424892704
12143_terrestrial,232,101,139,171,333,59.91379310344828,73.70689655172413
12144_terrestrial,238,101,144,171,339,60.50420168067227,71.84873949579831
12145_terrestrial,239,101,144,174,340,60.25104602510461,72.80334728033473
12146_terrestrial,230,101,141,173,331,61.30434782608696,75.21739130434783
12147_terrestrial,223,98,137,171,321,61.43497757847533,76.68161434977578
12148_terrestrial,219,98,136,169,317,62.10045662100456,77.1689497716895
12149_terrestrial,218,99,133,167,317,61.00917431192661,76.60550458715596
12150_terrestrial,219,101,133,169,320,60.73059360730594,77.1689497716895
12151_terrestrial,225,107,138,173,332,61.33333333333333,76.88888888888889
12152_terrestrial,226,110,137,176,336,60.61946902654868,77.87610619469027
12153_terrestrial,228,115,136,175,343,59.64912280701754,76.75438596491229
12154_terrestrial,222,115,132,174,337,59.45945945945946,78.37837837837837
12155_terrestrial,218,116,126,169,334,57.798165137614674,77.52293577981652
12156_terrestrial,211,113,121,163,324,57.345971563981045,77.25118483412322
12157_terrestrial,212,108,119,164,320,56.132075471698116,77.35849056603774
12158_terrestrial,209,100,117,161,309,55.980861244019145,77.03349282296651
12159_terrestrial,209,104,118,161,313,56.45933014354066,77.03349282296651
12160_terrestrial,210,104,118,162,314,56.19047619047619,77.14285714285715
12161_terrestrial,207,104,115,161,311,55.55555555555556,77.77777777777779
12162_terrestrial,202,103,116,158,305,57.42574257425742,78.21782178217822
12163_terrestrial,206,105,119,161,311,57.76699029126213,78.15533980582524
12164_terrestrial,206,105,118,161,311,57.28155339805825,78.15533980582524
12165_terrestrial,207,103,120,162,310,57.971014492753625,78.26086956521739
12166_terrestrial,209,101,120,163,310,57.41626794258373,77.99043062200957
12167_terrestrial,211,101,120,166,312,56.872037914691944,78.67298578199052
12168_terrestrial,212,100,123,169,312,58.01886792452831,79.71698113207547
12169_terrestrial,219,103,130,172,322,59.3607305936073,78.53881278538812
12170_terrestrial,215,100,128,169,315,59.53488372093023,78.6046511627907
12171_terrestrial,216,99,131,170,315,60.64814814814815,78.70370370370371
12172_terrestrial,209,96,125,164,305,59.80861244019139,78.4688995215311
12173_terrestrial,210,96,126,163,306,60,77.61904761904762
12174_terrestrial,209,88,126,162,297,60.28708133971292,77.51196172248804
12175_terrestrial,207,87,125,160,294,60.38647342995169,77.29468599033817
12176_terrestrial,207,87,125,160,294,60.38647342995169,77.29468599033817
12177_terrestrial,208,85,127,160,293,61.057692307692314,76.92307692307693
12178_terrestrial,210,80,128,161,290,60.952380952380956,76.66666666666667
12179_terrestrial,211,78,129,161,289,61.137440758293835,76.30331753554502
12180_terrestrial,210,76,129,160,286,61.42857142857143,76.19047619047619
12181_terrestrial,209,73,127,160,282,60.76555023923444,76.55502392344498
12182_terrestrial,209,74,126,161,283,60.28708133971292,77.03349282296651
12183_terrestrial,210,70,127,162,280,60.476190476190474,77.14285714285715
12184_terrestrial,206,71,125,159,277,60.679611650485434,77.18446601941747
12185_terrestrial,201,75,125,154,276,62.189054726368155,76.61691542288557
12186_terrestrial,199,72,123,152,271,61.80904522613066,76.38190954773869
12187_terrestrial,195,73,120,147,268,61.53846153846154,75.38461538461539
12188_terrestrial,190,73,116,144,263,61.05263157894737,75.78947368421053
12189_terrestrial,185,73,114,141,258,61.62162162162163,76.21621621621621
12190_terrestrial,183,73,112,138,256,61.20218579234973,75.40983606557377
12191_terrestrial,185,75,112,139,260,60.54054054054055,75.13513513513513
12192_terrestrial,182,75,110,136,257,60.43956043956044,74.72527472527473
12193_terrestrial,184,73,112,138,257,60.86956521739131,75
12194_terrestrial,183,75,111,137,258,60.65573770491803,74.86338797814209
12195_terrestrial,180,75,107,134,255,59.44444444444444,74.44444444444444
12196_terrestrial,183,67,106,135,250,57.92349726775956,73.77049180327869
12197_terrestrial,179,74,105,132,253,58.659217877094974,73.74301675977654
12198_terrestrial,208,99,134,137,307,64.42307692307693,65.86538461538461
12199_terrestrial,199,97,128,131,296,64.321608040201,65.82914572864321
12288_terrestrial,232,137,128,128,369,55.172413793103445,55.172413793103445
12289_terrestrial,240,153,133,143,393,55.41666666666667,59.583333333333336
12290_terrestrial,256,172,133,159,428,51.953125,62.109375
12291_terrestrial,278,189,144,178,467,51.798561151079134,64.02877697841727
12292_terrestrial,183,131,66,140,314,36.0655737704918,76.50273224043715
12293_terrestrial,174,118,60,131,292,34.48275862068966,75.28735632183908
12294_terrestrial,169,114,57,127,283,33.72781065088758,75.14792899408283
12295_terrestrial,174,111,54,130,285,31.03448275862069,74.71264367816092
12296_terrestrial,177,113,56,132,290,31.63841807909605,74.57627118644068
12297_terrestrial,183,120,60,136,303,32.78688524590164,74.31693989071039
12298_terrestrial,187,127,62,142,314,33.155080213903744,75.93582887700535
12299_terrestrial,186,128,60,140,314,32.25806451612903,75.26881720430107
12300_terrestrial,189,128,61,146,317,32.27513227513227,77.24867724867724
12301_terrestrial,185,121,58,144,306,31.351351351351354,77.83783783783784
12302_terrestrial,198,115,65,153,313,32.82828282828283,77.27272727272727
12303_terrestrial,198,111,63,153,309,31.818181818181817,77.27272727272727
12304_terrestrial,198,112,64,153,310,32.323232323232325,77.27272727272727
12305_terrestrial,205,109,67,162,314,32.6829268292683,79.02439024390245
12330_terrestrial,139,80,49,99,219,35.25179856115108,71.22302158273382
12331_terrestrial,139,80,48,100,219,34.53237410071942,71.94244604316546
12332_terrestrial,144,80,52,102,224,36.11111111111111,70.83333333333334
12333_terrestrial,142,88,54,100,230,38.028169014084504,70.4225352112676
12334_terrestrial,131,85,49,92,216,37.404580152671755,70.22900763358778
12335_terrestrial,129,82,48,90,211,37.2093023255814,69.76744186046511
12336_terrestrial,126,80,45,88,206,35.714285714285715,69.84126984126983
12337_terrestrial,122,77,46,87,199,37.704918032786885,71.31147540983606
12338_terrestrial,119,76,46,84,195,38.655462184873954,70.58823529411765
12412_terrestrial,301,123,235,142,424,78.07308970099668,47.176079734219265
12413_terrestrial,327,126,255,163,453,77.98165137614679,49.84709480122324
12414_terrestrial,360,134,274,190,494,76.11111111111111,52.77777777777778
12415_terrestrial,382,160,282,197,542,73.82198952879581,51.57068062827225
12416_terrestrial,390,153,299,218,543,76.66666666666667,55.8974358974359
12417_terrestrial,408,158,310,231,566,75.98039215686273,56.61764705882353
12418_terrestrial,408,147,308,237,555,75.49019607843137,58.08823529411765
12419_terrestrial,388,145,294,216,533,75.77319587628865,55.670103092783506
12429_terrestrial,397,158,295,225,555,74.3073047858942,56.67506297229219
12430_terrestrial,357,148,257,216,505,71.98879551820728,60.50420168067227
12431_terrestrial,332,148,237,196,480,71.3855421686747,59.036144578313255
12432_terrestrial,306,113,221,193,419,72.22222222222221,63.0718954248366
12433_terrestrial,360,156,258,220,516,71.66666666666667,61.111111111111114
12434_terrestrial,308,135,215,197,443,69.8051948051948,63.961038961038966
12435_terrestrial,311,148,205,198,459,65.91639871382637,63.665594855305464
12436_terrestrial,206,88,137,133,294,66.50485436893204,64.56310679611651
12441_terrestrial,290,131,198,187,421,68.27586206896552,64.48275862068965
12442_terrestrial,327,144,216,213,471,66.05504587155964,65.13761467889908
12443_terrestrial,270,116,166,189,386,61.48148148148148,70
12444_terrestrial,272,118,166,189,390,61.029411764705884,69.48529411764706
12445_terrestrial,277,118,171,193,395,61.73285198555957,69.67509025270758
12446_terrestrial,278,119,172,197,397,61.87050359712231,70.86330935251799
12447_terrestrial,290,121,178,205,411,61.37931034482759,70.6896551724138
12448_terrestrial,289,124,179,201,413,61.93771626297578,69.55017301038062
12449_terrestrial,278,125,171,192,403,61.51079136690647,69.06474820143885
12450_terrestrial,272,123,169,187,395,62.13235294117647,68.75
12451_terrestrial,266,131,167,185,397,62.78195488721805,69.54887218045113
12452_terrestrial,264,130,164,185,394,62.121212121212125,70.07575757575758
12453_terrestrial,260,129,158,180,389,60.76923076923077,69.23076923076923
12454_terrestrial,263,127,160,178,390,60.836501901140686,67.68060836501901
12455_terrestrial,265,126,158,179,391,59.62264150943396,67.54716981132076
12456_terrestrial,262,122,154,180,384,58.778625954198475,68.70229007633588
12457_terrestrial,265,124,158,182,389,59.62264150943396,68.67924528301886
12458_terrestrial,264,120,158,179,384,59.84848484848485,67.8030303030303
12459_terrestrial,263,122,157,178,385,59.6958174904943,67.68060836501901
12460_terrestrial,261,124,157,178,385,60.15325670498084,68.19923371647509
12461_terrestrial,262,120,158,178,382,60.30534351145038,67.93893129770993
12462_terrestrial,267,127,159,181,394,59.55056179775281,67.79026217228464
12463_terrestrial,265,127,160,180,392,60.37735849056604,67.9245283018868
12464_terrestrial,260,129,155,176,389,59.61538461538461,67.6923076923077
12465_terrestrial,263,131,156,176,394,59.31558935361216,66.92015209125475
12466_terrestrial,267,131,159,180,398,59.55056179775281,67.41573033707866
12467_terrestrial,270,133,159,182,403,58.88888888888889,67.4074074074074
12468_terrestrial,272,131,160,182,403,58.82352941176471,66.91176470588235
12469_terrestrial,272,137,160,182,409,58.82352941176471,66.91176470588235
12470_terrestrial,272,135,159,184,407,58.45588235294118,67.64705882352942
12471_terrestrial,269,133,156,181,402,57.99256505576208,67.28624535315984
12472_terrestrial,267,134,157,182,401,58.80149812734082,68.16479400749064
12473_terrestrial,265,132,158,182,397,59.62264150943396,68.67924528301886
12474_terrestrial,255,123,148,179,378,58.03921568627452,70.19607843137254
12475_terrestrial,257,118,149,180,375,57.97665369649806,70.03891050583657
12476_terrestrial,254,117,145,180,371,57.08661417322835,70.86614173228347
12477_terrestrial,245,117,141,179,362,57.55102040816327,73.06122448979592
12478_terrestrial,242,107,141,181,349,58.26446280991735,74.79338842975206
12479_terrestrial,238,102,141,177,340,59.2436974789916,74.36974789915966
12480_terrestrial,250,112,147,188,362,58.8,75.2
12481_terrestrial,257,120,151,190,377,58.754863813229576,73.92996108949417
12482_terrestrial,240,108,143,179,348,59.583333333333336,74.58333333333333
12483_terrestrial,243,114,147,181,357,60.49382716049383,74.48559670781893
12484_terrestrial,239,114,143,181,353,59.83263598326359,75.73221757322176
12485_terrestrial,240,121,145,181,361,60.416666666666664,75.41666666666667
12486_terrestrial,238,116,146,178,354,61.34453781512605,74.78991596638656
12487_terrestrial,235,116,144,174,351,61.27659574468085,74.04255319148936
12488_terrestrial,234,114,145,173,348,61.965811965811966,73.93162393162393
12489_terrestrial,239,112,148,176,351,61.92468619246861,73.64016736401673
12490_terrestrial,239,108,148,177,347,61.92468619246861,74.05857740585773
12491_terrestrial,240,106,149,178,346,62.083333333333336,74.16666666666667
12492_terrestrial,244,111,151,176,355,61.885245901639344,72.1311475409836
12493_terrestrial,243,111,150,176,354,61.72839506172839,72.42798353909465
12494_terrestrial,240,112,147,175,352,61.25000000000001,72.91666666666666
12495_terrestrial,240,110,147,175,350,61.25000000000001,72.91666666666666
12496_terrestrial,239,113,147,176,352,61.50627615062761,73.64016736401673
12497_terrestrial,239,111,146,178,350,61.08786610878661,74.47698744769873
12498_terrestrial,236,109,144,175,345,61.016949152542374,74.15254237288136
12499_terrestrial,231,107,143,171,338,61.904761904761905,74.02597402597402
12500_terrestrial,228,108,141,170,336,61.8421052631579,74.56140350877193
12501_terrestrial,228,111,139,172,339,60.96491228070175,75.43859649122807
12502_terrestrial,238,110,145,178,348,60.924369747899156,74.78991596638656
12503_terrestrial,245,113,150,179,358,61.224489795918366,73.06122448979592
12504_terrestrial,243,115,146,176,358,60.08230452674898,72.42798353909465
12505_terrestrial,242,110,148,176,352,61.15702479338842,72.72727272727273
12506_terrestrial,237,107,143,177,344,60.337552742616026,74.68354430379746
12507_terrestrial,234,104,141,178,338,60.256410256410255,76.06837606837607
12508_terrestrial,225,105,137,175,330,60.88888888888889,77.77777777777779
12509_terrestrial,228,112,138,176,340,60.526315789473685,77.19298245614034
12510_terrestrial,228,116,137,178,344,60.08771929824561,78.0701754385965
12511_terrestrial,229,120,137,176,349,59.82532751091703,76.85589519650655
12512_terrestrial,234,119,138,184,353,58.97435897435898,78.63247863247864
12513_terrestrial,228,114,134,179,342,58.77192982456141,78.50877192982456
12514_terrestrial,222,118,129,175,340,58.108108108108105,78.82882882882883
12515_terrestrial,224,114,130,175,338,58.03571428571429,78.125
12516_terrestrial,222,111,129,175,333,58.108108108108105,78.82882882882883
12517_terrestrial,224,105,129,178,329,57.58928571428571,79.46428571428571
12518_terrestrial,225,108,127,179,333,56.44444444444444,79.55555555555556
12519_terrestrial,221,105,125,175,326,56.56108597285068,79.18552036199095
12520_terrestrial,214,106,118,166,320,55.140186915887845,77.57009345794393
12521_terrestrial,208,106,114,162,314,54.807692307692314,77.88461538461539
12522_terrestrial,207,110,114,161,317,55.072463768115945,77.77777777777779
12524_terrestrial,209,110,118,162,319,56.45933014354066,77.51196172248804
12525_terrestrial,210,105,118,163,315,56.19047619047619,77.61904761904762
12526_terrestrial,216,106,121,165,322,56.018518518518526,76.38888888888889
12527_terrestrial,223,102,126,172,325,56.502242152466366,77.13004484304933
12528_terrestrial,226,102,132,175,328,58.4070796460177,77.43362831858407
12529_terrestrial,227,104,135,173,331,59.471365638766514,76.2114537444934
12530_terrestrial,230,102,137,176,332,59.56521739130435,76.52173913043478
12531_terrestrial,224,104,133,174,328,59.375,77.67857142857143
12532_terrestrial,216,102,130,168,318,60.18518518518518,77.77777777777779
12533_terrestrial,214,100,130,166,314,60.747663551401864,77.57009345794393
12534_terrestrial,213,100,130,165,313,61.03286384976526,77.46478873239437
12535_terrestrial,211,90,129,164,301,61.137440758293835,77.72511848341233
12536_terrestrial,213,89,132,165,302,61.97183098591549,77.46478873239437
12537_terrestrial,215,82,134,167,297,62.32558139534884,77.67441860465117
12538_terrestrial,215,80,134,166,295,62.32558139534884,77.20930232558139
12539_terrestrial,217,80,134,167,297,61.75115207373272,76.95852534562212
12540_terrestrial,213,78,129,168,291,60.56338028169014,78.87323943661971
12541_terrestrial,216,80,131,168,296,60.64814814814815,77.77777777777779
12542_terrestrial,218,80,134,169,298,61.46788990825688,77.52293577981652
12543_terrestrial,218,80,134,167,298,61.46788990825688,76.60550458715596
12544_terrestrial,221,80,139,166,301,62.89592760180995,75.1131221719457
12545_terrestrial,216,74,136,163,290,62.96296296296296,75.46296296296296
12546_terrestrial,212,75,132,160,287,62.264150943396224,75.47169811320755
12547_terrestrial,212,72,133,158,284,62.735849056603776,74.52830188679245
12548_terrestrial,210,78,132,158,288,62.857142857142854,75.23809523809524
12549_terrestrial,209,77,131,156,286,62.67942583732058,74.64114832535886
12550_terrestrial,204,81,126,150,285,61.76470588235294,73.52941176470588
12551_terrestrial,196,81,121,145,277,61.73469387755102,73.9795918367347
12552_terrestrial,196,84,119,145,280,60.71428571428571,73.9795918367347
12553_terrestrial,195,82,119,145,277,61.02564102564103,74.35897435897436
12554_terrestrial,193,77,114,146,270,59.067357512953365,75.64766839378238
12555_terrestrial,194,80,115,147,274,59.27835051546392,75.77319587628865
12556_terrestrial,193,79,115,145,272,59.58549222797927,75.12953367875647
12557_terrestrial,229,105,151,157,334,65.93886462882097,68.5589519650655
12558_terrestrial,231,104,150,160,335,64.93506493506493,69.26406926406926
12559_terrestrial,166,59,115,129,225,69.27710843373494,77.71084337349397
12647_terrestrial,211,103,128,127,314,60.66350710900474,60.18957345971564
12648_terrestrial,218,106,128,131,324,58.71559633027523,60.09174311926605
12649_terrestrial,212,104,129,132,316,60.84905660377359,62.264150943396224
12650_terrestrial,244,175,135,144,419,55.32786885245902,59.01639344262295
12651_terrestrial,260,179,138,158,439,53.07692307692308,60.76923076923077
12652_terrestrial,279,180,151,170,459,54.121863799283155,60.93189964157706
12653_terrestrial,192,138,68,149,330,35.41666666666667,77.60416666666666
12654_terrestrial,183,123,58,140,306,31.693989071038253,76.50273224043715
12655_terrestrial,177,121,56,134,298,31.63841807909605,75.70621468926554
12656_terrestrial,181,124,57,137,305,31.491712707182316,75.69060773480662
12657_terrestrial,186,126,61,141,312,32.795698924731184,75.80645161290323
12658_terrestrial,199,136,64,152,335,32.1608040201005,76.38190954773869
12659_terrestrial,205,138,64,155,343,31.21951219512195,75.60975609756098
12660_terrestrial,201,143,64,151,344,31.8407960199005,75.12437810945273
12661_terrestrial,203,141,67,155,344,33.004926108374384,76.35467980295566
12662_terrestrial,197,135,67,154,332,34.01015228426396,78.1725888324873
12663_terrestrial,201,124,66,160,325,32.83582089552239,79.60199004975125
12664_terrestrial,201,117,63,160,318,31.343283582089555,79.60199004975125
12665_terrestrial,206,119,65,166,325,31.55339805825243,80.58252427184466
12671_terrestrial,205,120,64,164,325,31.21951219512195,80
12672_terrestrial,203,115,61,162,318,30.049261083743843,79.80295566502463
12673_terrestrial,201,118,59,160,319,29.35323383084577,79.60199004975125
12677_terrestrial,193,114,61,153,307,31.606217616580313,79.27461139896373
12678_terrestrial,185,111,57,147,296,30.810810810810814,79.45945945945945
12679_terrestrial,181,111,56,144,292,30.939226519337016,79.55801104972376
12680_terrestrial,189,108,58,152,297,30.687830687830687,80.42328042328042
12681_terrestrial,188,109,57,150,297,30.319148936170215,79.7872340425532
12682_terrestrial,181,108,54,143,289,29.83425414364641,79.00552486187846
12688_terrestrial,146,81,45,107,227,30.82191780821918,73.28767123287672
12689_terrestrial,145,81,46,106,226,31.724137931034484,73.10344827586206
12690_terrestrial,144,82,46,106,226,31.944444444444443,73.61111111111111
12691_terrestrial,147,79,47,109,226,31.97278911564626,74.14965986394559
12692_terrestrial,151,81,50,111,232,33.11258278145696,73.50993377483444
12693_terrestrial,145,81,53,103,226,36.55172413793103,71.03448275862068
12694_terrestrial,142,81,50,103,223,35.2112676056338,72.53521126760563
12695_terrestrial,145,78,54,105,223,37.24137931034483,72.41379310344827
12696_terrestrial,138,77,47,101,215,34.05797101449276,73.18840579710145
12697_terrestrial,135,76,49,101,211,36.2962962962963,74.81481481481481
12698_terrestrial,130,84,49,94,214,37.69230769230769,72.3076923076923
12721_terrestrial,152,80,85,82,232,55.92105263157895,53.94736842105263
12722_terrestrial,158,86,88,86,244,55.69620253164557,54.43037974683544
12723_terrestrial,163,92,92,91,255,56.44171779141104,55.828220858895705
12770_terrestrial,305,118,237,131,423,77.70491803278688,42.950819672131146
12771_terrestrial,336,120,261,160,456,77.67857142857143,47.61904761904761
12772_terrestrial,357,131,279,181,488,78.15126050420169,50.700280112044815
12773_terrestrial,350,125,274,186,475,78.28571428571428,53.142857142857146
12774_terrestrial,349,123,275,187,472,78.79656160458453,53.581661891117484
12775_terrestrial,379,160,288,200,539,75.98944591029023,52.770448548812666
12776_terrestrial,371,149,281,207,520,75.74123989218329,55.79514824797843
12777_terrestrial,396,157,301,221,553,76.01010101010101,55.80808080808081
12778_terrestrial,414,155,321,237,569,77.53623188405797,57.2463768115942
12779_terrestrial,401,150,308,233,551,76.80798004987531,58.104738154613464
12780_terrestrial,380,148,294,212,528,77.36842105263158,55.78947368421052
12789_terrestrial,396,156,291,216,552,73.48484848484848,54.54545454545454
12790_terrestrial,419,182,306,239,601,73.0310262529833,57.04057279236277
12791_terrestrial,359,154,262,216,513,72.98050139275766,60.16713091922006
12792_terrestrial,363,169,260,231,532,71.62534435261708,63.63636363636363
12793_terrestrial,358,163,253,234,521,70.6703910614525,65.36312849162012
12794_terrestrial,330,146,226,216,476,68.48484848484848,65.45454545454545
12795_terrestrial,315,154,213,202,469,67.61904761904762,64.12698412698413
12796_terrestrial,297,149,198,191,446,66.66666666666666,64.3097643097643
12797_terrestrial,297,147,200,191,444,67.34006734006735,64.3097643097643
12798_terrestrial,310,146,209,200,456,67.41935483870968,64.51612903225806
12799_terrestrial,318,152,216,205,470,67.9245283018868,64.46540880503144
12800_terrestrial,338,152,228,225,490,67.45562130177515,66.5680473372781
12801_terrestrial,330,147,221,213,477,66.96969696969697,64.54545454545455
12802_terrestrial,327,146,215,209,473,65.74923547400611,63.91437308868502
12803_terrestrial,287,124,177,199,411,61.672473867595826,69.33797909407666
12804_terrestrial,286,120,174,199,406,60.83916083916085,69.58041958041959
12805_terrestrial,284,120,170,199,404,59.859154929577464,70.07042253521126
12806_terrestrial,283,119,170,198,402,60.07067137809188,69.96466431095406
12807_terrestrial,277,121,169,196,398,61.01083032490975,70.7581227436823
12808_terrestrial,275,129,169,191,404,61.45454545454545,69.45454545454545
12809_terrestrial,272,132,166,189,404,61.029411764705884,69.48529411764706
12810_terrestrial,271,127,168,190,398,61.99261992619927,70.11070110701108
12811_terrestrial,269,127,170,186,396,63.19702602230484,69.14498141263941
12812_terrestrial,272,127,169,185,399,62.13235294117647,68.01470588235294
12813_terrestrial,266,126,161,180,392,60.526315789473685,67.66917293233082
12814_terrestrial,265,127,158,179,392,59.62264150943396,67.54716981132076
12815_terrestrial,262,126,157,178,388,59.92366412213741,67.93893129770993
12816_terrestrial,258,128,154,177,386,59.68992248062015,68.6046511627907
12817_terrestrial,259,125,157,177,384,60.61776061776062,68.33976833976834
12818_terrestrial,259,124,154,179,383,59.45945945945946,69.1119691119691
12819_terrestrial,272,133,165,182,405,60.66176470588235,66.91176470588235
12820_terrestrial,265,127,158,182,392,59.62264150943396,68.67924528301886
12821_terrestrial,266,127,160,180,393,60.150375939849624,67.66917293233082
12822_terrestrial,265,135,159,179,400,60,67.54716981132076
12823_terrestrial,263,136,159,177,399,60.45627376425855,67.30038022813687
12824_terrestrial,258,130,154,177,388,59.68992248062015,68.6046511627907
12825_terrestrial,256,130,153,176,386,59.765625,68.75
12826_terrestrial,256,128,154,176,384,60.15625,68.75
12827_terrestrial,261,130,155,179,391,59.38697318007663,68.5823754789272
12828_terrestrial,268,135,159,179,403,59.32835820895522,66.7910447761194
12829_terrestrial,270,139,162,180,409,60,66.66666666666666
12830_terrestrial,265,139,161,178,404,60.75471698113207,67.16981132075472
12831_terrestrial,261,139,160,177,400,61.30268199233716,67.81609195402298
12832_terrestrial,248,129,147,174,377,59.2741935483871,70.16129032258065
12833_terrestrial,244,130,144,175,374,59.01639344262295,71.72131147540983
12834_terrestrial,246,126,143,177,372,58.13008130081301,71.95121951219512
12835_terrestrial,246,121,143,175,367,58.13008130081301,71.13821138211382
12836_terrestrial,252,126,147,178,378,58.333333333333336,70.63492063492063
12837_terrestrial,253,126,147,181,379,58.10276679841897,71.54150197628458
12838_terrestrial,252,121,149,184,373,59.12698412698413,73.01587301587301
12839_terrestrial,250,118,149,184,368,59.599999999999994,73.6
12840_terrestrial,263,124,158,194,387,60.07604562737643,73.76425855513308
12841_terrestrial,240,121,141,181,361,58.75,75.41666666666667
12842_terrestrial,240,118,145,180,358,60.416666666666664,75
12843_terrestrial,236,116,143,177,352,60.59322033898306,75
12844_terrestrial,237,118,140,178,355,59.07172995780591,75.10548523206751
12845_terrestrial,226,114,136,168,340,60.17699115044248,74.33628318584071
12846_terrestrial,227,111,136,170,338,59.91189427312775,74.8898678414097
12847_terrestrial,218,106,136,161,324,62.38532110091744,73.85321100917432
12848_terrestrial,222,106,138,165,328,62.16216216216216,74.32432432432432
12849_terrestrial,216,101,134,163,317,62.03703703703704,75.46296296296296
12850_terrestrial,214,99,135,159,313,63.084112149532714,74.29906542056075
12851_terrestrial,213,99,132,158,312,61.97183098591549,74.17840375586854
12852_terrestrial,219,101,136,163,320,62.10045662100456,74.42922374429224
12853_terrestrial,221,100,139,167,321,62.89592760180995,75.56561085972851
12854_terrestrial,223,104,139,165,327,62.33183856502242,73.99103139013454
12855_terrestrial,223,110,140,164,333,62.78026905829597,73.54260089686099
12856_terrestrial,226,112,142,165,338,62.83185840707964,73.00884955752213
12857_terrestrial,231,113,145,170,344,62.77056277056276,73.59307359307358
12858_terrestrial,231,115,144,171,346,62.33766233766234,74.02597402597402
12859_terrestrial,237,112,147,175,349,62.0253164556962,73.83966244725738
12860_terrestrial,234,113,144,172,347,61.53846153846154,73.50427350427351
12861_terrestrial,237,113,148,173,350,62.447257383966246,72.9957805907173
12862_terrestrial,249,111,153,184,360,61.44578313253012,73.89558232931726
12863_terrestrial,251,114,153,185,365,60.95617529880478,73.70517928286853
12864_terrestrial,248,115,151,183,363,60.88709677419355,73.79032258064517
12865_terrestrial,243,109,147,179,352,60.49382716049383,73.66255144032921
12866_terrestrial,239,109,144,179,348,60.25104602510461,74.89539748953975
12867_terrestrial,241,112,146,183,353,60.58091286307054,75.93360995850622
12868_terrestrial,241,111,147,182,352,60.99585062240664,75.51867219917013
12869_terrestrial,228,118,138,178,346,60.526315789473685,78.0701754385965
12870_terrestrial,232,123,140,182,355,60.3448275862069,78.44827586206897
12871_terrestrial,235,127,140,185,362,59.57446808510638,78.72340425531915
12872_terrestrial,241,128,140,194,369,58.09128630705395,80.49792531120332
12873_terrestrial,239,124,139,192,363,58.15899581589959,80.3347280334728
12874_terrestrial,232,117,134,184,349,57.758620689655174,79.3103448275862
12875_terrestrial,233,113,137,184,346,58.798283261802574,78.96995708154506
12876_terrestrial,234,114,135,185,348,57.692307692307686,79.05982905982906
12877_terrestrial,235,115,134,187,350,57.02127659574469,79.57446808510639
12878_terrestrial,238,117,136,187,355,57.14285714285714,78.57142857142857
12879_terrestrial,237,112,135,186,349,56.9620253164557,78.48101265822784
12880_terrestrial,230,110,131,180,340,56.95652173913044,78.26086956521739
12881_terrestrial,225,108,128,176,333,56.888888888888886,78.22222222222223
12882_terrestrial,213,108,119,166,321,55.86854460093896,77.93427230046949
12883_terrestrial,216,111,122,168,327,56.481481481481474,77.77777777777779
12884_terrestrial,217,113,123,166,330,56.68202764976959,76.49769585253456
12885_terrestrial,220,110,124,170,330,56.36363636363636,77.27272727272727
12886_terrestrial,223,107,126,171,330,56.502242152466366,76.68161434977578
12887_terrestrial,227,106,132,174,333,58.14977973568281,76.65198237885463
12888_terrestrial,230,106,134,173,336,58.26086956521739,75.21739130434783
12889_terrestrial,231,108,135,173,339,58.44155844155844,74.89177489177489
12890_terrestrial,234,106,139,179,340,59.401709401709404,76.49572649572649
12891_terrestrial,230,112,136,178,342,59.130434782608695,77.39130434782608
12892_terrestrial,228,112,137,174,340,60.08771929824561,76.31578947368422
12893_terrestrial,222,104,133,169,326,59.909909909909906,76.12612612612612
12894_terrestrial,219,101,132,169,320,60.273972602739725,77.1689497716895
12895_terrestrial,220,96,132,171,316,60,77.72727272727272
12896_terrestrial,219,94,132,173,313,60.273972602739725,78.99543378995433
12897_terrestrial,225,90,138,173,315,61.33333333333333,76.88888888888889
12898_terrestrial,227,88,139,175,315,61.23348017621145,77.09251101321586
12899_terrestrial,225,87,137,175,312,60.88888888888889,77.77777777777779
12900_terrestrial,227,82,142,172,309,62.55506607929515,75.77092511013215
12901_terrestrial,233,88,145,176,321,62.231759656652365,75.53648068669528
12902_terrestrial,231,87,144,174,318,62.33766233766234,75.32467532467533
12903_terrestrial,233,88,147,176,321,63.0901287553648,75.53648068669528
12904_terrestrial,229,92,144,173,321,62.882096069869,75.54585152838428
12905_terrestrial,228,95,144,176,323,63.1578947368421,77.19298245614034
12906_terrestrial,226,94,142,172,320,62.83185840707964,76.10619469026548
12907_terrestrial,219,87,137,168,306,62.55707762557078,76.71232876712328
12908_terrestrial,215,86,134,163,301,62.32558139534884,75.81395348837209
12909_terrestrial,212,83,131,160,295,61.79245283018868,75.47169811320755
12910_terrestrial,213,82,131,159,295,61.502347417840376,74.64788732394366
12911_terrestrial,210,83,130,158,293,61.904761904761905,75.23809523809524
12912_terrestrial,203,85,127,154,288,62.5615763546798,75.86206896551724
12913_terrestrial,202,83,126,154,285,62.37623762376238,76.23762376237624
12914_terrestrial,197,85,120,153,282,60.913705583756354,77.66497461928934
12915_terrestrial,201,90,122,156,291,60.69651741293532,77.61194029850746
12916_terrestrial,230,110,150,160,340,65.21739130434783,69.56521739130434
12917_terrestrial,225,107,147,158,332,65.33333333333333,70.22222222222221
12918_terrestrial,227,107,147,159,334,64.75770925110133,70.04405286343612
12919_terrestrial,236,113,154,164,349,65.2542372881356,69.49152542372882
12920_terrestrial,230,113,152,157,343,66.08695652173913,68.26086956521739
12921_terrestrial,224,113,147,150,337,65.625,66.96428571428571
12923_terrestrial,217,109,139,151,326,64.0552995391705,69.5852534562212
13007_terrestrial,171,87,103,95,258,60.23391812865497,55.55555555555556
13008_terrestrial,183,95,109,99,278,59.56284153005464,54.09836065573771
13009_terrestrial,182,91,107,100,273,58.791208791208796,54.94505494505495
13010_terrestrial,237,156,136,136,393,57.383966244725734,57.383966244725734
13011_terrestrial,245,166,140,138,411,57.14285714285714,56.326530612244895
13012_terrestrial,255,179,144,151,434,56.470588235294116,59.21568627450981
13013_terrestrial,288,181,152,175,469,52.77777777777778,60.763888888888886
13014_terrestrial,197,136,70,152,333,35.53299492385787,77.15736040609137
13015_terrestrial,186,126,59,139,312,31.72043010752688,74.73118279569893
13016_terrestrial,184,124,61,141,308,33.15217391304348,76.63043478260869
13017_terrestrial,193,130,62,148,323,32.12435233160622,76.68393782383419
13018_terrestrial,199,142,62,156,341,31.155778894472363,78.39195979899498
13019_terrestrial,210,143,67,162,353,31.9047619047619,77.14285714285715
13020_terrestrial,206,151,64,157,357,31.06796116504854,76.2135922330097
13021_terrestrial,205,144,63,155,349,30.73170731707317,75.60975609756098
13022_terrestrial,206,145,66,158,351,32.038834951456316,76.69902912621359
13023_terrestrial,213,146,72,167,359,33.80281690140845,78.40375586854461
13024_terrestrial,210,131,67,169,341,31.9047619047619,80.47619047619048
13025_terrestrial,223,134,70,181,357,31.390134529147986,81.16591928251121
13029_terrestrial,222,128,66,181,350,29.72972972972973,81.53153153153153
13030_terrestrial,220,127,66,179,347,30,81.36363636363636
13031_terrestrial,220,129,64,177,349,29.09090909090909,80.45454545454545
13032_terrestrial,217,125,64,172,342,29.493087557603687,79.26267281105991
13033_terrestrial,213,130,64,168,343,30.046948356807512,78.87323943661971
13034_terrestrial,216,133,66,170,349,30.555555555555557,78.70370370370371
13035_terrestrial,214,136,64,168,350,29.906542056074763,78.50467289719626
13036_terrestrial,214,135,66,170,349,30.8411214953271,79.43925233644859
13037_terrestrial,209,134,64,167,343,30.62200956937799,79.90430622009569
13038_terrestrial,209,133,63,169,342,30.14354066985646,80.86124401913875
13039_terrestrial,205,129,62,165,334,30.24390243902439,80.48780487804879
13040_terrestrial,206,132,60,166,338,29.126213592233007,80.58252427184466
13041_terrestrial,202,135,60,163,337,29.7029702970297,80.6930693069307
13042_terrestrial,193,136,61,155,329,31.606217616580313,80.31088082901555
13043_terrestrial,179,128,56,143,307,31.28491620111732,79.88826815642457
13044_terrestrial,172,109,56,136,281,32.55813953488372,79.06976744186046
13045_terrestrial,166,109,52,130,275,31.32530120481928,78.3132530120482
13046_terrestrial,160,107,49,126,267,30.625000000000004,78.75
13047_terrestrial,158,104,46,122,262,29.11392405063291,77.21518987341773
13048_terrestrial,154,99,44,118,253,28.57142857142857,76.62337662337663
13049_terrestrial,146,98,43,110,244,29.45205479452055,75.34246575342466
13050_terrestrial,143,91,43,107,234,30.069930069930066,74.82517482517483
13051_terrestrial,140,88,41,102,228,29.28571428571429,72.85714285714285
13052_terrestrial,143,81,44,103,224,30.76923076923077,72.02797202797203
13053_terrestrial,147,79,48,105,226,32.6530612244898,71.42857142857143
13054_terrestrial,141,78,47,103,219,33.33333333333333,73.04964539007092
13055_terrestrial,138,74,47,102,212,34.05797101449276,73.91304347826086
13056_terrestrial,138,73,46,102,211,33.33333333333333,73.91304347826086
13057_terrestrial,151,76,54,114,227,35.76158940397351,75.49668874172185
13058_terrestrial,147,91,53,107,238,36.054421768707485,72.78911564625851
13062_terrestrial,118,82,48,81,200,40.67796610169492,68.64406779661016
13080_terrestrial,164,87,89,88,251,54.268292682926834,53.65853658536586
13081_terrestrial,162,88,89,87,250,54.93827160493827,53.70370370370371
13082_terrestrial,161,87,87,88,248,54.037267080745345,54.6583850931677
13083_terrestrial,162,91,91,86,253,56.17283950617284,53.086419753086425
13130_terrestrial,317,121,247,140,438,77.91798107255521,44.164037854889585
13131_terrestrial,366,125,286,181,491,78.14207650273224,49.45355191256831
13132_terrestrial,359,123,282,181,482,78.55153203342618,50.41782729805014
13133_terrestrial,175,43,132,138,218,75.42857142857143,78.85714285714286
13134_terrestrial,343,130,269,179,473,78.4256559766764,52.1865889212828
13136_terrestrial,378,159,289,196,537,76.45502645502646,51.85185185185185
13137_terrestrial,406,169,310,228,575,76.35467980295566,56.15763546798029
13138_terrestrial,412,166,317,233,578,76.94174757281553,56.55339805825243
13139_terrestrial,255,86,184,193,341,72.15686274509804,75.68627450980392
13140_terrestrial,384,155,302,217,539,78.64583333333334,56.510416666666664
13141_terrestrial,351,151,275,187,502,78.34757834757835,53.27635327635327
13145_terrestrial,309,109,242,157,418,78.31715210355988,50.80906148867314
13146_terrestrial,402,164,300,216,566,74.6268656716418,53.73134328358209
13147_terrestrial,416,170,308,228,586,74.03846153846155,54.807692307692314
13148_terrestrial,397,173,289,219,570,72.79596977329975,55.16372795969773
13149_terrestrial,423,183,306,236,606,72.3404255319149,55.7919621749409
13150_terrestrial,413,185,302,229,598,73.12348668280872,55.44794188861986
13151_terrestrial,358,164,252,225,522,70.39106145251397,62.849162011173185
13152_terrestrial,351,164,243,224,515,69.23076923076923,63.817663817663814
13153_terrestrial,287,127,189,206,414,65.85365853658537,71.77700348432056
13154_terrestrial,336,154,230,221,490,68.45238095238095,65.77380952380952
13155_terrestrial,340,163,230,221,503,67.64705882352942,65
13156_terrestrial,279,136,180,192,415,64.51612903225806,68.81720430107528
13157_terrestrial,273,132,177,187,405,64.83516483516483,68.4981684981685
13158_terrestrial,269,133,178,185,402,66.17100371747212,68.77323420074349
13159_terrestrial,285,131,186,195,416,65.26315789473685,68.42105263157895
13160_terrestrial,278,128,183,188,406,65.82733812949641,67.62589928057554
13161_terrestrial,266,126,172,179,392,64.66165413533834,67.29323308270678
13162_terrestrial,276,127,174,191,403,63.04347826086957,69.20289855072464
13163_terrestrial,287,129,179,197,416,62.36933797909408,68.6411149825784
13164_terrestrial,293,133,178,203,426,60.75085324232082,69.28327645051195
13165_terrestrial,280,130,165,192,410,58.92857142857143,68.57142857142857
13166_terrestrial,279,125,166,190,404,59.49820788530465,68.10035842293907
13167_terrestrial,274,128,163,190,402,59.48905109489051,69.34306569343066
13168_terrestrial,269,127,164,188,396,60.966542750929364,69.88847583643123
13169_terrestrial,267,131,165,186,398,61.79775280898876,69.66292134831461
13170_terrestrial,266,125,164,187,391,61.65413533834586,70.30075187969925
13171_terrestrial,264,122,162,184,386,61.36363636363637,69.6969696969697
13172_terrestrial,264,126,161,184,390,60.984848484848484,69.6969696969697
13173_terrestrial,267,123,163,184,390,61.04868913857678,68.91385767790263
13174_terrestrial,260,127,157,180,387,60.38461538461538,69.23076923076923
13175_terrestrial,261,133,159,177,394,60.91954022988506,67.81609195402298
13176_terrestrial,259,135,158,176,394,61.003861003861005,67.95366795366795
13177_terrestrial,254,129,152,174,383,59.84251968503938,68.50393700787401
13178_terrestrial,259,131,155,178,390,59.84555984555985,68.72586872586872
13179_terrestrial,261,131,155,180,392,59.38697318007663,68.96551724137932
13180_terrestrial,263,137,156,182,400,59.31558935361216,69.20152091254754
13181_terrestrial,271,143,162,181,414,59.77859778597786,66.78966789667896
13182_terrestrial,271,145,161,179,416,59.40959409594095,66.05166051660517
13183_terrestrial,255,139,154,172,394,60.3921568627451,67.45098039215686
13184_terrestrial,251,136,152,170,387,60.55776892430279,67.729083665338635
13185_terrestrial,244,134,147,163,378,60.245901639344254,66.80327868852459
13186_terrestrial,250,130,152,170,380,60.8,68
13187_terrestrial,253,136,153,175,389,60.47430830039525,69.1699604743083
13188_terrestrial,260,146,157,176,406,60.38461538461538,67.6923076923077
13189_terrestrial,258,145,156,174,403,60.46511627906976,67.44186046511628
13190_terrestrial,258,141,157,175,399,60.85271317829457,67.82945736434108
13191_terrestrial,255,140,156,173,395,61.1764705882353,67.84313725490196
13192_terrestrial,245,123,141,172,368,57.55102040816327,70.20408163265306
13193_terrestrial,242,125,140,171,367,57.85123966942148,70.66115702479338
13194_terrestrial,244,125,140,173,369,57.377049180327866,70.90163934426229
13195_terrestrial,246,124,143,177,370,58.13008130081301,71.95121951219512
13196_terrestrial,251,125,147,180,376,58.56573705179283,71.71314741035857
13197_terrestrial,254,130,151,187,384,59.4488188976378,73.62204724409449
13198_terrestrial,257,127,151,190,384,58.754863813229576,73.92996108949417
13199_terrestrial,259,131,154,189,390,59.45945945945946,72.97297297297297
13200_terrestrial,256,126,157,188,382,61.328125,73.4375
13201_terrestrial,237,125,146,170,362,61.60337552742617,71.72995780590718
13202_terrestrial,218,118,133,163,336,61.00917431192661,74.77064220183486
13203_terrestrial,211,110,132,158,321,62.55924170616114,74.88151658767772
13204_terrestrial,215,110,130,160,325,60.46511627906976,74.4186046511628
13205_terrestrial,220,110,133,166,330,60.45454545454545,75.45454545454545
13206_terrestrial,216,102,133,164,318,61.57407407407407,75.92592592592592
13207_terrestrial,218,104,135,165,322,61.92660550458715,75.68807339449542
13208_terrestrial,217,100,135,162,317,62.21198156682027,74.65437788018433
13209_terrestrial,218,101,135,165,319,61.92660550458715,75.68807339449542
13210_terrestrial,222,101,134,165,323,60.36036036036037,74.32432432432432
13211_terrestrial,221,103,131,163,324,59.276018099547514,73.7556561085973
13212_terrestrial,212,99,128,158,311,60.37735849056604,74.52830188679245
13213_terrestrial,212,99,132,157,311,62.264150943396224,74.05660377358491
13214_terrestrial,213,102,132,159,315,61.97183098591549,74.64788732394366
13215_terrestrial,218,101,134,162,319,61.46788990825688,74.31192660550458
13216_terrestrial,220,101,137,162,321,62.272727272727266,73.63636363636363
13217_terrestrial,220,101,137,162,321,62.272727272727266,73.63636363636363
13218_terrestrial,223,105,137,163,328,61.43497757847533,73.09417040358744
13219_terrestrial,236,106,145,171,342,61.440677966101696,72.45762711864407
13220_terrestrial,237,115,145,173,352,61.18143459915611,72.9957805907173
13221_terrestrial,244,113,150,178,357,61.47540983606557,72.95081967213115
13222_terrestrial,253,117,152,185,370,60.079051383399204,73.12252964426878
13223_terrestrial,259,123,157,187,382,60.61776061776062,72.2007722007722
13224_terrestrial,260,123,158,190,383,60.76923076923077,73.07692307692307
13225_terrestrial,256,113,156,189,369,60.9375,73.828125
13226_terrestrial,252,112,156,191,364,61.904761904761905,75.79365079365078
13227_terrestrial,251,121,156,191,372,62.15139442231076,76.09561752988047
13228_terrestrial,245,122,150,187,367,61.224489795918366,76.32653061224491
13229_terrestrial,236,126,141,184,362,59.7457627118644,77.96610169491525
13230_terrestrial,239,127,140,191,366,58.57740585774059,79.9163179916318
13231_terrestrial,250,125,145,197,375,57.99999999999999,78.8
13232_terrestrial,249,129,146,197,378,58.63453815261044,79.11646586345381
13233_terrestrial,250,128,147,198,378,58.8,79.2
13234_terrestrial,250,124,144,198,374,57.599999999999994,79.2
13235_terrestrial,246,116,142,194,362,57.72357723577236,78.86178861788618
13236_terrestrial,247,112,143,193,359,57.89473684210527,78.13765182186235
13237_terrestrial,245,119,141,192,364,57.55102040816327,78.36734693877551
13238_terrestrial,246,123,141,194,369,57.3170731707317,78.86178861788618
13239_terrestrial,243,123,136,193,366,55.96707818930041,79.42386831275721
13240_terrestrial,244,120,137,193,364,56.14754098360656,79.09836065573771
13241_terrestrial,242,119,136,190,361,56.19834710743802,78.51239669421489
13242_terrestrial,240,117,136,186,357,56.666666666666664,77.5
13243_terrestrial,237,116,135,180,353,56.9620253164557,75.9493670886076
13244_terrestrial,230,119,130,175,349,56.52173913043478,76.08695652173914
13245_terrestrial,231,116,131,177,347,56.709956709956714,76.62337662337663
13246_terrestrial,229,119,132,174,348,57.64192139737992,75.9825327510917
13247_terrestrial,236,123,137,176,359,58.05084745762712,74.57627118644068
13248_terrestrial,232,116,135,176,348,58.189655172413794,75.86206896551724
13249_terrestrial,239,112,139,180,351,58.15899581589959,75.31380753138075
13250_terrestrial,245,111,145,185,356,59.183673469387756,75.51020408163265
13251_terrestrial,241,115,143,182,356,59.33609958506224,75.51867219917013
13252_terrestrial,232,112,137,175,344,59.05172413793104,75.43103448275862
13253_terrestrial,233,108,140,174,341,60.08583690987125,74.67811158798283
13254_terrestrial,235,104,141,176,339,60,74.8936170212766
13255_terrestrial,234,103,140,174,337,59.82905982905983,74.35897435897436
13256_terrestrial,235,102,142,176,337,60.42553191489362,74.8936170212766
13257_terrestrial,233,101,140,176,334,60.08583690987125,75.53648068669528
13258_terrestrial,237,99,143,180,336,60.337552742616026,75.9493670886076
13259_terrestrial,242,99,147,184,341,60.74380165289256,76.03305785123968
13260_terrestrial,242,99,150,184,341,61.98347107438017,76.03305785123968
13261_terrestrial,254,109,157,192,363,61.811023622047244,75.59055118110236
13262_terrestrial,253,114,159,192,367,62.845849802371546,75.8893280632411
13263_terrestrial,252,114,157,189,366,62.301587301587304,75
13264_terrestrial,256,115,162,189,371,63.28125,73.828125
13265_terrestrial,257,112,163,190,369,63.42412451361867,73.92996108949417
13266_terrestrial,246,112,157,183,358,63.82113821138211,74.39024390243902
13267_terrestrial,226,100,139,174,326,61.504424778761056,76.99115044247787
13268_terrestrial,223,100,137,170,323,61.43497757847533,76.23318385650224
13269_terrestrial,222,98,135,168,320,60.810810810810814,75.67567567567568
13270_terrestrial,219,96,134,166,315,61.18721461187214,75.79908675799086
13271_terrestrial,212,93,130,161,305,61.32075471698113,75.94339622641509
13272_terrestrial,209,89,127,159,298,60.76555023923444,76.07655502392345
13273_terrestrial,204,86,128,157,290,62.745098039215684,76.9607843137255
13274_terrestrial,201,86,125,156,287,62.189054726368155,77.61194029850746
13275_terrestrial,202,89,127,155,291,62.87128712871287,76.73267326732673
13276_terrestrial,203,91,127,154,294,62.5615763546798,75.86206896551724
13277_terrestrial,236,114,156,161,350,66.10169491525424,68.22033898305084
13278_terrestrial,236,118,157,160,354,66.52542372881356,67.79661016949152
13279_terrestrial,238,113,158,161,351,66.38655462184873,67.64705882352942
13280_terrestrial,203,91,125,154,294,61.57635467980296,75.86206896551724
13281_terrestrial,251,119,165,165,370,65.73705179282868,65.73705179282868
13282_terrestrial,280,143,179,183,423,63.92857142857142,65.35714285714286
13283_terrestrial,219,112,140,150,331,63.926940639269404,68.4931506849315
13284_terrestrial,218,113,140,150,331,64.22018348623854,68.80733944954129
13299_terrestrial,192,119,118,115,311,61.458333333333336,59.895833333333336
13372_terrestrial,243,163,139,141,406,57.20164609053497,58.0246913580247
13373_terrestrial,266,178,145,156,444,54.51127819548872,58.64661654135338
13374_terrestrial,293,187,154,176,480,52.55972696245734,60.068259385665534
13375_terrestrial,207,135,72,158,342,34.78260869565217,76.32850241545893
13376_terrestrial,195,127,64,148,322,32.82051282051282,75.8974358974359
13377_terrestrial,190,129,64,145,319,33.68421052631579,76.31578947368422
13378_terrestrial,201,142,67,154,343,33.33333333333333,76.61691542288557
13379_terrestrial,204,148,65,157,352,31.862745098039213,76.9607843137255
13380_terrestrial,207,148,66,161,355,31.88405797101449,77.77777777777779
13381_terrestrial,209,155,64,161,364,30.62200956937799,77.03349282296651
13382_terrestrial,210,159,64,160,369,30.476190476190478,76.19047619047619
13383_terrestrial,210,155,66,162,365,31.428571428571427,77.14285714285715
13384_terrestrial,217,149,64,172,366,29.493087557603687,79.26267281105991
13385_terrestrial,229,153,68,188,382,29.694323144104807,82.09606986899564
13388_terrestrial,212,133,65,179,345,30.660377358490564,84.43396226415094
13389_terrestrial,213,132,66,180,345,30.985915492957744,84.50704225352112
13390_terrestrial,215,128,67,179,343,31.16279069767442,83.25581395348837
13391_terrestrial,219,126,66,184,345,30.136986301369863,84.01826484018264
13392_terrestrial,215,135,66,178,350,30.697674418604652,82.7906976744186
13393_terrestrial,216,135,65,175,351,30.09259259259259,81.01851851851852
13394_terrestrial,213,138,66,171,351,30.985915492957744,80.28169014084507
13395_terrestrial,215,139,67,173,354,31.16279069767442,80.46511627906978
13396_terrestrial,220,139,65,178,359,29.545454545454547,80.9090909090909
13397_terrestrial,222,137,63,176,359,28.37837837837838,79.27927927927928
13398_terrestrial,217,133,63,173,350,29.03225806451613,79.72350230414746
13399_terrestrial,213,131,64,171,344,30.046948356807512,80.28169014084507
13400_terrestrial,212,140,60,172,352,28.30188679245283,81.13207547169812
13401_terrestrial,214,140,64,174,354,29.906542056074763,81.30841121495327
13402_terrestrial,211,140,63,172,351,29.85781990521327,81.51658767772511
13403_terrestrial,202,145,65,161,347,32.17821782178218,79.70297029702971
13404_terrestrial,186,129,56,147,315,30.107526881720432,79.03225806451613
13405_terrestrial,178,120,57,139,298,32.02247191011236,78.08988764044943
13406_terrestrial,170,115,53,134,285,31.176470588235293,78.82352941176471
13407_terrestrial,164,105,48,130,269,29.268292682926827,79.26829268292683
13408_terrestrial,163,106,48,129,269,29.447852760736197,79.14110429447852
13409_terrestrial,159,104,46,125,263,28.930817610062892,78.61635220125787
13410_terrestrial,155,101,45,121,256,29.03225806451613,78.06451612903226
13411_terrestrial,146,96,44,112,242,30.136986301369863,76.71232876712328
13412_terrestrial,146,94,44,112,240,30.136986301369863,76.71232876712328
13413_terrestrial,145,93,44,110,238,30.344827586206897,75.86206896551724
13414_terrestrial,147,92,46,110,239,31.292517006802722,74.82993197278913
13415_terrestrial,143,88,46,105,231,32.16783216783217,73.42657342657343
13416_terrestrial,138,83,43,102,221,31.15942028985507,73.91304347826086
13417_terrestrial,148,81,49,111,229,33.108108108108105,75
13418_terrestrial,156,96,53,116,252,33.97435897435898,74.35897435897436
13419_terrestrial,149,102,52,110,251,34.899328859060404,73.8255033557047
13422_terrestrial,131,88,52,94,219,39.69465648854962,71.7557251908397
13423_terrestrial,116,76,41,83,192,35.3448275862069,71.55172413793103
13424_terrestrial,107,72,37,74,179,34.57943925233645,69.1588785046729
13425_terrestrial,104,71,37,73,175,35.57692307692308,70.1923076923077
13440_terrestrial,116,67,42,79,183,36.206896551724135,68.10344827586206
13490_terrestrial,318,130,254,134,448,79.87421383647799,42.138364779874216
13491_terrestrial,368,139,294,173,507,79.8913043478261,47.01086956521739
13492_terrestrial,355,131,286,178,486,80.56338028169014,50.140845070422536
13493_terrestrial,359,131,291,174,490,81.05849582172702,48.467966573816156
13494_terrestrial,359,136,286,177,495,79.66573816155989,49.30362116991643
13495_terrestrial,165,82,116,114,247,70.3030303030303,69.0909090909091
13496_terrestrial,387,165,300,200,552,77.51937984496125,51.67958656330749
13497_terrestrial,393,167,306,212,560,77.86259541984732,53.9440203562341
13498_terrestrial,253,94,185,187,347,73.12252964426878,73.91304347826086
13499_terrestrial,237,93,177,175,330,74.68354430379746,73.83966244725738
13500_terrestrial,257,104,190,190,361,73.92996108949417,73.92996108949417
13501_terrestrial,408,157,315,234,565,77.20588235294117,57.35294117647059
13502_terrestrial,400,160,310,217,560,77.5,54.25
13505_terrestrial,422,170,313,231,592,74.17061611374407,54.739336492891
13506_terrestrial,437,174,323,247,611,73.91304347826086,56.52173913043478
13507_terrestrial,306,131,213,218,437,69.6078431372549,71.24183006535948
13508_terrestrial,290,127,198,200,417,68.27586206896552,68.96551724137932
13509_terrestrial,284,130,185,201,414,65.14084507042254,70.77464788732394
13510_terrestrial,269,131,173,194,400,64.31226765799256,72.11895910780669
13511_terrestrial,285,135,180,201,420,63.1578947368421,70.52631578947368
13512_terrestrial,282,136,181,200,418,64.18439716312056,70.92198581560284
13513_terrestrial,274,136,177,195,410,64.59854014598541,71.16788321167883
13514_terrestrial,279,135,181,201,414,64.87455197132617,72.04301075268818
13515_terrestrial,288,136,186,205,424,64.58333333333334,71.18055555555556
13516_terrestrial,275,135,177,193,410,64.36363636363637,70.18181818181817
13517_terrestrial,265,135,170,183,400,64.15094339622641,69.0566037735849
13518_terrestrial,266,131,172,185,397,64.66165413533834,69.54887218045113
13519_terrestrial,277,133,183,191,410,66.06498194945848,68.95306859205776
13520_terrestrial,271,131,176,186,402,64.94464944649447,68.63468634686348
13521_terrestrial,270,132,172,185,402,63.70370370370371,68.51851851851852
13522_terrestrial,274,135,176,190,409,64.23357664233576,69.34306569343066
13523_terrestrial,275,139,173,190,414,62.909090909090914,69.0909090909091
13524_terrestrial,285,141,172,196,426,60.35087719298245,68.77192982456141
13525_terrestrial,284,141,167,193,425,58.80281690140845,67.95774647887323
13526_terrestrial,274,127,162,188,401,59.12408759124088,68.61313868613139
13527_terrestrial,273,128,159,191,401,58.24175824175825,69.96336996336996
13528_terrestrial,270,126,161,190,396,59.62962962962963,70.37037037037037
13529_terrestrial,267,133,161,188,400,60.2996254681648,70.4119850187266
13530_terrestrial,266,136,160,189,402,60.150375939849624,71.05263157894737
13531_terrestrial,272,136,163,193,408,59.92647058823529,70.95588235294117
13532_terrestrial,279,134,167,198,413,59.85663082437276,70.96774193548387
13533_terrestrial,269,129,161,190,398,59.85130111524164,70.63197026022306
13534_terrestrial,275,136,165,194,411,60,70.54545454545455
13535_terrestrial,275,139,165,193,414,60,70.18181818181817
13536_terrestrial,266,136,160,187,402,60.150375939849624,70.30075187969925
13537_terrestrial,264,138,163,185,402,61.74242424242424,70.07575757575758
13538_terrestrial,260,133,158,184,393,60.76923076923077,70.76923076923077
13539_terrestrial,260,139,158,183,399,60.76923076923077,70.38461538461539
13540_terrestrial,262,139,158,183,401,60.30534351145038,69.8473282442748
13541_terrestrial,262,139,157,181,401,59.92366412213741,69.08396946564885
13542_terrestrial,260,141,154,177,401,59.23076923076923,68.07692307692308
13543_terrestrial,257,138,153,174,395,59.53307392996109,67.70428015564202
13544_terrestrial,252,134,151,172,386,59.92063492063492,68.25396825396825
13545_terrestrial,250,134,149,170,384,59.599999999999994,68
13546_terrestrial,261,152,159,174,413,60.91954022988506,66.66666666666666
13547_terrestrial,265,151,161,175,416,60.75471698113207,66.0377358490566
13548_terrestrial,266,151,157,178,417,59.02255639097744,66.9172932330827
13549_terrestrial,263,146,157,173,409,59.6958174904943,65.77946768060836
13550_terrestrial,251,134,156,166,385,62.15139442231076,66.13545816733067
13551_terrestrial,254,134,157,170,388,61.811023622047244,66.92913385826772
13552_terrestrial,247,128,149,174,375,60.32388663967612,70.44534412955466
13553_terrestrial,259,133,161,184,392,62.16216216216216,71.04247104247105
13554_terrestrial,262,135,161,187,397,61.45038167938931,71.37404580152672
13555_terrestrial,261,135,162,190,396,62.06896551724138,72.79693486590038
13556_terrestrial,266,128,165,192,394,62.03007518796993,72.18045112781954
13557_terrestrial,264,127,161,194,391,60.984848484848484,73.48484848484848
13558_terrestrial,255,125,157,187,380,61.568627450980394,73.33333333333333
13559_terrestrial,244,123,152,177,367,62.295081967213115,72.54098360655738
13560_terrestrial,237,122,151,173,359,63.71308016877637,72.9957805907173
13561_terrestrial,221,115,139,160,336,62.89592760180995,72.39819004524887
13562_terrestrial,211,103,130,159,314,61.61137440758294,75.35545023696683
13563_terrestrial,211,100,131,157,311,62.08530805687204,74.40758293838863
13564_terrestrial,215,102,133,161,317,61.86046511627907,74.88372093023256
13565_terrestrial,215,106,132,159,321,61.395348837209305,73.95348837209302
13566_terrestrial,216,107,134,158,323,62.03703703703704,73.14814814814815
13567_terrestrial,219,104,135,162,323,61.64383561643836,73.97260273972603
13568_terrestrial,220,106,138,165,326,62.727272727272734,75
13569_terrestrial,221,104,138,164,325,62.44343891402715,74.2081447963801
13570_terrestrial,219,104,135,161,323,61.64383561643836,73.51598173515981
13571_terrestrial,215,102,131,159,317,60.93023255813953,73.95348837209302
13572_terrestrial,212,100,127,156,312,59.905660377358494,73.58490566037736
13573_terrestrial,211,104,127,155,315,60.18957345971564,73.45971563981043
13574_terrestrial,211,105,128,154,316,60.66350710900474,72.98578199052133
13575_terrestrial,220,101,135,161,321,61.36363636363637,73.18181818181819
13576_terrestrial,223,103,138,163,326,61.88340807174888,73.09417040358744
13577_terrestrial,222,105,139,164,327,62.612612612612615,73.87387387387388
13578_terrestrial,226,107,140,165,333,61.94690265486725,73.00884955752213
13579_terrestrial,225,106,137,166,331,60.88888888888889,73.77777777777777
13580_terrestrial,234,111,141,170,345,60.256410256410255,72.64957264957265
13581_terrestrial,241,117,147,178,358,60.99585062240664,73.85892116182573
13582_terrestrial,248,119,151,182,367,60.88709677419355,73.38709677419355
13583_terrestrial,253,122,154,187,375,60.86956521739131,73.91304347826086
13584_terrestrial,266,127,163,196,393,61.278195488721806,73.68421052631578
13585_terrestrial,267,124,163,197,391,61.04868913857678,73.78277153558052
13586_terrestrial,267,129,164,197,396,61.42322097378277,73.78277153558052
13587_terrestrial,269,133,165,201,402,61.33828996282528,74.72118959107806
13588_terrestrial,259,135,156,201,394,60.231660231660236,77.60617760617761
13589_terrestrial,261,130,155,203,391,59.38697318007663,77.77777777777779
13590_terrestrial,258,136,152,203,394,58.91472868217055,78.68217054263566
13591_terrestrial,265,142,155,208,407,58.490566037735846,78.49056603773586
13592_terrestrial,266,144,155,208,410,58.27067669172933,78.19548872180451
13593_terrestrial,268,147,155,210,415,57.83582089552238,78.35820895522389
13594_terrestrial,258,145,154,200,403,59.68992248062015,77.51937984496125
13595_terrestrial,258,141,153,198,399,59.30232558139535,76.74418604651163
13596_terrestrial,252,138,149,195,390,59.12698412698413,77.38095238095238
13597_terrestrial,249,136,147,194,385,59.036144578313255,77.91164658634538
13598_terrestrial,251,127,146,198,378,58.16733067729084,78.88446215139442
13599_terrestrial,254,123,146,202,377,57.48031496062992,79.52755905511812
13600_terrestrial,258,123,150,200,381,58.139534883720934,77.51937984496125
13601_terrestrial,256,118,145,200,374,56.640625,78.125
13602_terrestrial,258,120,145,201,378,56.201550387596896,77.90697674418605
13603_terrestrial,258,128,145,203,386,56.201550387596896,78.68217054263566
13604_terrestrial,249,126,144,193,375,57.831325301204814,77.51004016064257
13605_terrestrial,243,124,141,184,367,58.0246913580247,75.7201646090535
13606_terrestrial,247,123,144,188,370,58.2995951417004,76.11336032388664
13607_terrestrial,255,137,151,194,392,59.21568627450981,76.07843137254902
13608_terrestrial,248,119,151,190,367,60.88709677419355,76.61290322580645
13609_terrestrial,254,117,156,189,371,61.417322834645674,74.40944881889764
13610_terrestrial,252,117,156,188,369,61.904761904761905,74.60317460317461
13611_terrestrial,247,117,151,184,364,61.1336032388664,74.49392712550608
13612_terrestrial,246,114,148,184,360,60.16260162601627,74.79674796747967
13613_terrestrial,244,117,148,182,361,60.65573770491803,74.59016393442623
13614_terrestrial,239,119,144,180,358,60.25104602510461,75.31380753138075
13615_terrestrial,237,116,143,180,353,60.337552742616026,75.9493670886076
13616_terrestrial,247,117,151,188,364,61.1336032388664,76.11336032388664
13617_terrestrial,250,112,154,194,362,61.6,77.60000000000001
13618_terrestrial,251,111,155,195,362,61.75298804780876,77.68924302788844
13619_terrestrial,250,106,155,193,356,62,77.2
13620_terrestrial,252,105,156,192,357,61.904761904761905,76.19047619047619
13621_terrestrial,258,116,160,194,374,62.01550387596899,75.1937984496124
13622_terrestrial,245,111,153,182,356,62.44897959183674,74.28571428571429
13623_terrestrial,248,110,155,184,358,62.5,74.19354838709677
13624_terrestrial,248,110,154,185,358,62.096774193548384,74.59677419354838
13625_terrestrial,249,116,157,187,365,63.05220883534136,75.1004016064257
13626_terrestrial,254,124,162,190,378,63.77952755905512,74.80314960629921
13627_terrestrial,246,125,157,184,371,63.82113821138211,74.79674796747967
13628_terrestrial,229,107,142,176,336,62.00873362445415,76.85589519650655
13629_terrestrial,224,101,137,171,325,61.16071428571429,76.33928571428571
13630_terrestrial,224,99,137,170,323,61.16071428571429,75.89285714285714
13631_terrestrial,223,99,136,169,322,60.98654708520179,75.7847533632287
13632_terrestrial,214,94,131,164,308,61.21495327102804,76.63551401869158
13633_terrestrial,209,89,129,161,298,61.72248803827751,77.03349282296651
13634_terrestrial,211,92,130,163,303,61.61137440758294,77.25118483412322
13635_terrestrial,209,97,129,160,306,61.72248803827751,76.55502392344498
13636_terrestrial,206,99,126,158,305,61.165048543689316,76.69902912621359
13637_terrestrial,207,104,128,157,311,61.83574879227053,75.84541062801932
13638_terrestrial,212,97,135,160,309,63.67924528301887,75.47169811320755
13639_terrestrial,209,93,132,156,302,63.1578947368421,74.64114832535886
13640_terrestrial,209,94,130,154,303,62.20095693779905,73.68421052631578
13641_terrestrial,256,120,168,166,376,65.625,64.84375
13642_terrestrial,289,145,184,188,434,63.667820069204154,65.05190311418684
13643_terrestrial,167,92,97,135,259,58.08383233532935,80.83832335329342
13644_terrestrial,225,119,146,154,344,64.88888888888889,68.44444444444444
13733_terrestrial,256,169,139,146,425,54.296875,57.03125
13734_terrestrial,267,182,145,157,449,54.30711610486891,58.80149812734082
13735_terrestrial,285,189,141,175,474,49.473684210526315,61.40350877192983
13736_terrestrial,294,182,139,184,476,47.27891156462585,62.585034013605444
13737_terrestrial,215,137,73,163,352,33.95348837209302,75.81395348837209
13738_terrestrial,218,146,68,169,364,31.19266055045872,77.52293577981652
13739_terrestrial,221,161,71,172,382,32.126696832579185,77.82805429864254
13740_terrestrial,214,161,70,169,375,32.71028037383177,78.97196261682244
13741_terrestrial,216,168,70,170,384,32.407407407407405,78.70370370370371
13742_terrestrial,219,168,69,173,387,31.506849315068493,78.99543378995433
13743_terrestrial,218,162,67,170,380,30.73394495412844,77.98165137614679
13744_terrestrial,215,158,63,169,373,29.30232558139535,78.6046511627907
13745_terrestrial,233,155,67,189,388,28.75536480686695,81.11587982832617
13746_terrestrial,245,164,78,205,409,31.83673469387755,83.6734693877551
13747_terrestrial,216,144,69,179,360,31.944444444444443,82.87037037037037
13748_terrestrial,209,134,68,174,343,32.535885167464116,83.25358851674642
13749_terrestrial,203,124,65,170,327,32.01970443349754,83.74384236453201
13750_terrestrial,200,130,64,167,330,32,83.5
13751_terrestrial,205,134,66,172,339,32.19512195121951,83.90243902439025
13752_terrestrial,207,139,68,173,346,32.850241545893724,83.57487922705315
13753_terrestrial,218,145,70,180,363,32.11009174311927,82.56880733944955
13754_terrestrial,225,149,69,185,374,30.666666666666664,82.22222222222221
13755_terrestrial,223,146,72,184,369,32.28699551569507,82.51121076233184
13756_terrestrial,226,144,71,186,370,31.41592920353982,82.30088495575221
13757_terrestrial,231,148,70,191,379,30.303030303030305,82.68398268398268
13758_terrestrial,231,157,68,189,388,29.43722943722944,81.81818181818183
13759_terrestrial,228,155,67,186,383,29.385964912280706,81.57894736842105
13760_terrestrial,230,158,67,188,388,29.130434782608695,81.73913043478261
13761_terrestrial,216,152,66,178,368,30.555555555555557,82.4074074074074
13762_terrestrial,218,163,63,179,381,28.899082568807337,82.11009174311926
13763_terrestrial,218,151,64,181,369,29.357798165137616,83.02752293577981
13764_terrestrial,220,154,66,179,374,30,81.36363636363636
13765_terrestrial,201,140,61,160,341,30.34825870646766,79.60199004975125
13766_terrestrial,183,129,53,145,312,28.96174863387978,79.23497267759562
13767_terrestrial,172,119,49,135,291,28.488372093023255,78.48837209302324
13768_terrestrial,163,117,49,128,280,30.061349693251532,78.52760736196319
13769_terrestrial,163,112,48,128,275,29.447852760736197,78.52760736196319
13770_terrestrial,161,110,48,126,271,29.81366459627329,78.26086956521739
13771_terrestrial,160,105,47,125,265,29.375,78.125
13772_terrestrial,156,106,47,121,262,30.128205128205128,77.56410256410257
13773_terrestrial,155,104,47,119,259,30.32258064516129,76.77419354838709
13774_terrestrial,150,102,47,117,252,31.333333333333336,78
13775_terrestrial,152,100,49,116,252,32.23684210526316,76.31578947368422
13776_terrestrial,156,100,49,118,256,31.41025641025641,75.64102564102564
13777_terrestrial,154,96,48,116,250,31.16883116883117,75.32467532467533
13778_terrestrial,164,101,53,125,265,32.31707317073171,76.21951219512195
13779_terrestrial,165,102,54,128,267,32.72727272727273,77.57575757575758
13780_terrestrial,167,116,56,128,283,33.532934131736525,76.64670658682635
13781_terrestrial,166,110,59,126,276,35.54216867469879,75.90361445783132
13782_terrestrial,159,109,54,118,268,33.9622641509434,74.21383647798741
13783_terrestrial,140,86,43,104,226,30.714285714285715,74.28571428571429
13784_terrestrial,129,85,41,96,214,31.782945736434108,74.4186046511628
13785_terrestrial,125,89,39,91,214,31.2,72.8
13786_terrestrial,116,88,34,85,204,29.310344827586203,73.27586206896551
13787_terrestrial,113,91,34,82,204,30.08849557522124,72.56637168141593
13788_terrestrial,112,87,34,81,199,30.357142857142854,72.32142857142857
13789_terrestrial,112,83,34,83,195,30.357142857142854,74.10714285714286
13790_terrestrial,111,82,35,81,193,31.53153153153153,72.97297297297297
13850_terrestrial,325,134,260,135,459,80,41.53846153846154
13851_terrestrial,362,138,289,162,500,79.8342541436464,44.751381215469614
13852_terrestrial,353,133,285,162,486,80.73654390934844,45.892351274787536
13853_terrestrial,323,129,260,142,452,80.4953560371517,43.962848297213625
13855_terrestrial,332,160,262,148,492,78.91566265060241,44.57831325301205
13856_terrestrial,400,175,315,203,575,78.75,50.74999999999999
13857_terrestrial,415,178,323,215,593,77.83132530120483,51.80722891566265
13858_terrestrial,411,182,323,214,593,78.58880778588808,52.06812652068127
13859_terrestrial,252,103,186,183,355,73.80952380952381,72.61904761904762
13860_terrestrial,260,101,190,189,361,73.07692307692307,72.6923076923077
13861_terrestrial,429,169,337,224,598,78.55477855477857,52.21445221445221
13862_terrestrial,421,174,331,217,595,78.62232779097387,51.543942992874115
13863_terrestrial,407,194,299,220,601,73.46437346437347,54.054054054054056
13864_terrestrial,430,185,312,240,615,72.55813953488372,55.81395348837209
13865_terrestrial,462,192,340,259,654,73.59307359307358,56.060606060606055
13866_terrestrial,318,139,219,221,457,68.86792452830188,69.49685534591194
13867_terrestrial,316,142,207,217,458,65.50632911392405,68.67088607594937
13868_terrestrial,274,137,177,198,411,64.59854014598541,72.26277372262774
13869_terrestrial,264,135,167,188,399,63.25757575757576,71.21212121212122
13870_terrestrial,265,137,166,184,402,62.64150943396226,69.43396226415094
13871_terrestrial,279,144,174,198,423,62.365591397849464,70.96774193548387
13872_terrestrial,284,142,178,203,426,62.676056338028175,71.47887323943662
13873_terrestrial,284,141,184,203,425,64.7887323943662,71.47887323943662
13874_terrestrial,282,143,178,201,425,63.12056737588653,71.27659574468085
13875_terrestrial,290,147,186,206,437,64.13793103448275,71.03448275862068
13876_terrestrial,289,140,182,206,429,62.9757785467128,71.280276816609
13877_terrestrial,273,137,173,192,410,63.369963369963365,70.32967032967034
13878_terrestrial,277,134,179,197,411,64.62093862815884,71.11913357400722
13879_terrestrial,270,132,174,194,402,64.44444444444444,71.85185185185186
13880_terrestrial,261,135,167,180,396,63.984674329501914,68.96551724137932
13881_terrestrial,265,138,172,182,403,64.90566037735849,68.67924528301886
13882_terrestrial,266,140,172,184,406,64.66165413533834,69.17293233082707
13883_terrestrial,271,144,170,187,415,62.73062730627307,69.00369003690037
13884_terrestrial,289,142,175,197,431,60.553633217993074,68.16608996539793
13885_terrestrial,288,143,172,200,431,59.72222222222222,69.44444444444444
13886_terrestrial,284,136,171,202,420,60.2112676056338,71.12676056338029
13887_terrestrial,281,133,165,198,414,58.718861209964416,70.46263345195729
13888_terrestrial,282,137,165,198,419,58.51063829787234,70.2127659574468
13889_terrestrial,275,137,164,195,412,59.63636363636363,70.9090909090909
13890_terrestrial,280,145,171,199,425,61.07142857142858,71.07142857142857
13891_terrestrial,286,147,174,205,433,60.83916083916085,71.67832167832168
13892_terrestrial,288,142,172,203,430,59.72222222222222,70.48611111111111
13893_terrestrial,279,141,167,199,420,59.85663082437276,71.32616487455196
13894_terrestrial,283,137,171,200,420,60.42402826855123,70.6713780918728
13895_terrestrial,276,136,164,195,412,59.42028985507246,70.65217391304348
13896_terrestrial,267,136,155,193,403,58.052434456928836,72.28464419475655
13897_terrestrial,261,145,156,188,406,59.77011494252874,72.03065134099617
13898_terrestrial,255,138,154,182,393,60.3921568627451,71.37254901960785
13899_terrestrial,251,143,151,179,394,60.1593625498008,71.31474103585657
13900_terrestrial,263,144,160,189,407,60.836501901140686,71.86311787072243
13901_terrestrial,262,143,157,187,405,59.92366412213741,71.37404580152672
13902_terrestrial,255,141,152,179,396,59.6078431372549,70.19607843137254
13903_terrestrial,248,139,142,173,387,57.25806451612904,69.75806451612904
13904_terrestrial,241,136,140,169,377,58.09128630705395,70.12448132780082
13905_terrestrial,240,136,141,166,376,58.75,69.16666666666667
13906_terrestrial,250,154,151,165,404,60.4,66
13907_terrestrial,249,150,150,165,399,60.24096385542169,66.26506024096386
13908_terrestrial,249,146,154,167,395,61.84738955823293,67.06827309236948
13909_terrestrial,242,136,152,164,378,62.8099173553719,67.76859504132231
13910_terrestrial,239,127,155,164,366,64.85355648535564,68.6192468619247
13911_terrestrial,251,125,163,174,376,64.9402390438247,69.32270916334662
13912_terrestrial,254,132,167,176,386,65.74803149606299,69.29133858267717
13913_terrestrial,256,131,166,175,387,64.84375,68.359375
13914_terrestrial,251,137,162,174,388,64.5418326693227,69.32270916334662
13915_terrestrial,261,134,167,182,395,63.984674329501914,69.73180076628353
13916_terrestrial,251,124,159,181,375,63.34661354581673,72.11155378486056
13917_terrestrial,243,128,156,176,371,64.19753086419753,72.42798353909465
13918_terrestrial,234,126,152,169,360,64.95726495726495,72.22222222222221
13919_terrestrial,234,124,151,171,358,64.52991452991454,73.07692307692307
13920_terrestrial,215,115,136,153,330,63.25581395348837,71.16279069767441
13921_terrestrial,216,111,139,154,327,64.35185185185185,71.29629629629629
13922_terrestrial,205,98,131,152,303,63.90243902439025,74.14634146341463
13923_terrestrial,206,97,133,153,303,64.56310679611651,74.27184466019418
13924_terrestrial,201,100,127,152,301,63.18407960199005,75.62189054726367
13925_terrestrial,206,102,128,157,308,62.13592233009708,76.2135922330097
13926_terrestrial,208,97,129,156,305,62.019230769230774,75
13927_terrestrial,206,94,128,150,300,62.13592233009708,72.81553398058253
13928_terrestrial,203,97,127,151,300,62.5615763546798,74.38423645320196
13929_terrestrial,203,98,126,151,301,62.06896551724138,74.38423645320196
13930_terrestrial,204,99,127,153,303,62.254901960784316,75
13931_terrestrial,208,100,129,155,308,62.019230769230774,74.51923076923077
13932_terrestrial,208,100,127,155,308,61.057692307692314,74.51923076923077
13933_terrestrial,210,104,129,154,314,61.42857142857143,73.33333333333333
13934_terrestrial,212,102,132,152,314,62.264150943396224,71.69811320754717
13935_terrestrial,215,106,135,157,321,62.7906976744186,73.0232558139535
13936_terrestrial,216,101,134,158,317,62.03703703703704,73.14814814814815
13937_terrestrial,224,103,139,165,327,62.05357142857143,73.66071428571429
13938_terrestrial,223,108,139,165,331,62.33183856502242,73.99103139013454
13939_terrestrial,226,112,138,167,338,61.06194690265486,73.89380530973452
13940_terrestrial,232,113,144,169,345,62.06896551724138,72.84482758620689
13941_terrestrial,230,117,142,169,347,61.73913043478261,73.47826086956522
13942_terrestrial,244,126,149,181,370,61.065573770491795,74.18032786885246
13943_terrestrial,263,124,162,195,387,61.59695817490495,74.1444866920152
13944_terrestrial,275,132,165,206,407,60,74.90909090909092
13945_terrestrial,282,137,166,215,419,58.86524822695035,76.24113475177306
13946_terrestrial,281,142,168,213,423,59.7864768683274,75.80071174377224
13947_terrestrial,277,144,166,212,421,59.92779783393502,76.53429602888086
13948_terrestrial,270,143,161,210,413,59.62962962962963,77.77777777777779
13949_terrestrial,265,145,156,206,410,58.867924528301884,77.73584905660378
13950_terrestrial,270,141,161,209,411,59.62962962962963,77.4074074074074
13951_terrestrial,274,146,165,215,420,60.21897810218978,78.46715328467153
13952_terrestrial,275,154,165,217,429,60,78.9090909090909
13953_terrestrial,275,157,163,217,432,59.27272727272728,78.9090909090909
13954_terrestrial,268,159,161,209,427,60.07462686567165,77.98507462686567
13955_terrestrial,268,160,161,206,428,60.07462686567165,76.86567164179104
13956_terrestrial,266,149,161,204,415,60.526315789473685,76.69172932330827
13957_terrestrial,256,141,152,202,397,59.375,78.90625
13958_terrestrial,259,133,155,204,392,59.84555984555985,78.76447876447877
13959_terrestrial,265,129,159,208,394,60,78.49056603773586
13960_terrestrial,262,126,155,201,388,59.16030534351145,76.7175572519084
13961_terrestrial,261,127,154,200,388,59.00383141762452,76.62835249042146
13962_terrestrial,268,127,158,209,395,58.95522388059702,77.98507462686567
13963_terrestrial,275,124,163,213,399,59.27272727272728,77.45454545454545
13964_terrestrial,275,134,165,210,409,60,76.36363636363637
13965_terrestrial,269,133,161,205,402,59.85130111524164,76.2081784386617
13966_terrestrial,274,137,166,203,411,60.58394160583942,74.08759124087592
13967_terrestrial,273,133,166,202,406,60.8058608058608,73.992673992674
13968_terrestrial,266,126,163,199,392,61.278195488721806,74.81203007518798
13969_terrestrial,258,122,160,196,380,62.01550387596899,75.96899224806202
13970_terrestrial,249,121,153,191,370,61.44578313253012,76.70682730923694
13971_terrestrial,249,119,153,192,368,61.44578313253012,77.10843373493977
13972_terrestrial,249,116,154,190,365,61.84738955823293,76.30522088353415
13973_terrestrial,247,125,151,186,372,61.1336032388664,75.30364372469636
13974_terrestrial,247,126,154,184,373,62.34817813765182,74.49392712550608
13975_terrestrial,254,128,160,191,382,62.99212598425197,75.19685039370079
13976_terrestrial,256,124,160,194,380,62.5,75.78125
13977_terrestrial,258,121,160,195,379,62.01550387596899,75.5813953488372
13978_terrestrial,257,120,159,195,377,61.86770428015564,75.87548638132296
13979_terrestrial,251,116,155,192,367,61.75298804780876,76.49402390438247
13980_terrestrial,254,123,161,189,377,63.38582677165354,74.40944881889764
13981_terrestrial,260,120,166,190,380,63.84615384615384,73.07692307692307
13982_terrestrial,243,112,156,179,355,64.19753086419753,73.66255144032921
13983_terrestrial,248,113,158,181,361,63.70967741935484,72.98387096774194
13984_terrestrial,248,115,156,183,363,62.903225806451616,73.79032258064517
13985_terrestrial,248,119,158,184,367,63.70967741935484,74.19354838709677
13986_terrestrial,241,125,154,180,366,63.90041493775933,74.68879668049793
13987_terrestrial,252,135,159,193,387,63.095238095238095,76.5873015873016
13988_terrestrial,252,125,160,191,377,63.49206349206349,75.79365079365078
13989_terrestrial,238,116,149,184,354,62.60504201680672,77.31092436974791
13990_terrestrial,235,105,149,181,340,63.40425531914894,77.02127659574468
13991_terrestrial,230,102,145,175,332,63.04347826086957,76.08695652173914
13992_terrestrial,224,103,143,171,327,63.83928571428571,76.33928571428571
13993_terrestrial,217,101,139,166,318,64.0552995391705,76.49769585253456
13994_terrestrial,218,100,138,167,318,63.30275229357798,76.60550458715596
13995_terrestrial,216,94,136,164,310,62.96296296296296,75.92592592592592
13996_terrestrial,222,100,140,167,322,63.06306306306306,75.22522522522522
13997_terrestrial,224,101,143,170,325,63.83928571428571,75.89285714285714
13998_terrestrial,230,105,149,170,335,64.78260869565217,73.91304347826086
13999_terrestrial,227,102,147,167,329,64.75770925110133,73.568281938326
14000_terrestrial,221,103,142,163,324,64.25339366515837,73.7556561085973
14001_terrestrial,277,130,185,176,407,66.78700361010831,63.537906137184116
14002_terrestrial,299,150,192,190,449,64.21404682274247,63.54515050167224
14003_terrestrial,238,127,154,164,365,64.70588235294117,68.90756302521008
14004_terrestrial,233,125,152,162,358,65.23605150214593,69.52789699570815
14092_terrestrial,221,134,125,127,355,56.56108597285068,57.466063348416284
14093_terrestrial,272,194,145,155,466,53.30882352941176,56.98529411764706
14094_terrestrial,277,204,145,157,481,52.34657039711191,56.678700361010826
14095_terrestrial,294,210,150,174,504,51.02040816326531,59.183673469387756
14096_terrestrial,315,204,156,200,519,49.523809523809526,63.49206349206349
14097_terrestrial,330,221,165,214,551,50,64.84848484848484
14098_terrestrial,263,170,98,206,433,37.26235741444867,78.32699619771863
14099_terrestrial,257,173,89,198,430,34.63035019455253,77.04280155642024
14100_terrestrial,239,178,72,187,417,30.125523012552303,78.24267782426779
14101_terrestrial,237,185,73,187,422,30.801687763713083,78.90295358649789
14102_terrestrial,228,188,71,184,416,31.140350877192986,80.7017543859649
14103_terrestrial,229,164,72,181,393,31.4410480349345,79.03930131004367
14104_terrestrial,216,156,69,173,372,31.944444444444443,80.0925925925926
14105_terrestrial,229,164,68,183,393,29.694323144104807,79.91266375545851
14106_terrestrial,250,171,80,206,421,32,82.39999999999999
14107_terrestrial,238,162,74,194,400,31.092436974789916,81.5126050420168
14108_terrestrial,207,135,66,172,342,31.88405797101449,83.09178743961353
14109_terrestrial,205,138,66,171,343,32.19512195121951,83.41463414634146
14110_terrestrial,205,147,69,170,352,33.65853658536586,82.92682926829268
14111_terrestrial,205,148,68,168,353,33.170731707317074,81.95121951219512
14112_terrestrial,206,140,69,168,346,33.49514563106796,81.55339805825243
14113_terrestrial,205,142,70,167,347,34.146341463414636,81.46341463414633
14114_terrestrial,208,146,68,170,354,32.69230769230769,81.73076923076923
14115_terrestrial,215,147,69,177,362,32.093023255813954,82.32558139534883
14116_terrestrial,222,151,73,177,373,32.88288288288289,79.72972972972973
14117_terrestrial,231,169,72,188,400,31.16883116883117,81.38528138528139
14118_terrestrial,235,161,70,193,396,29.78723404255319,82.12765957446808
14119_terrestrial,240,171,70,196,411,29.166666666666668,81.66666666666667
14120_terrestrial,239,177,71,199,416,29.707112970711297,83.26359832635984
14121_terrestrial,244,171,74,204,415,30.327868852459016,83.60655737704919
14122_terrestrial,248,179,75,207,427,30.241935483870968,83.46774193548387
14123_terrestrial,240,177,70,197,417,29.166666666666668,82.08333333333333
14124_terrestrial,243,185,73,200,428,30.04115226337449,82.3045267489712
14125_terrestrial,224,166,66,183,390,29.464285714285715,81.69642857142857
14126_terrestrial,208,153,56,169,361,26.923076923076923,81.25
14127_terrestrial,195,136,54,158,331,27.692307692307693,81.02564102564102
14128_terrestrial,182,135,51,145,317,28.021978021978022,79.67032967032966
14129_terrestrial,177,128,49,140,305,27.683615819209038,79.09604519774011
14130_terrestrial,168,125,47,131,293,27.976190476190478,77.97619047619048
14131_terrestrial,167,124,46,132,291,27.54491017964072,79.04191616766467
14132_terrestrial,171,133,49,135,304,28.654970760233915,78.94736842105263
14133_terrestrial,165,129,47,129,294,28.484848484848484,78.18181818181819
14134_terrestrial,165,122,47,129,287,28.484848484848484,78.18181818181819
14135_terrestrial,158,114,46,124,272,29.11392405063291,78.48101265822784
14136_terrestrial,161,111,50,124,272,31.05590062111801,77.01863354037268
14137_terrestrial,158,111,47,121,269,29.746835443037973,76.58227848101265
14138_terrestrial,163,107,48,126,270,29.447852760736197,77.30061349693251
14139_terrestrial,166,113,49,127,279,29.518072289156628,76.50602409638554
14140_terrestrial,172,113,53,133,285,30.813953488372093,77.32558139534885
14141_terrestrial,168,112,54,129,280,32.142857142857146,76.78571428571429
14142_terrestrial,160,109,49,122,269,30.625000000000004,76.25
14143_terrestrial,147,108,45,112,255,30.612244897959183,76.19047619047619
14144_terrestrial,143,102,43,108,245,30.069930069930066,75.52447552447552
14145_terrestrial,139,101,42,104,240,30.215827338129497,74.82014388489209
14146_terrestrial,137,102,38,105,239,27.73722627737226,76.64233576642336
14147_terrestrial,136,104,37,105,240,27.205882352941174,77.20588235294117
14148_terrestrial,132,98,36,101,230,27.27272727272727,76.51515151515152
14149_terrestrial,131,95,36,100,226,27.480916030534353,76.33587786259542
14150_terrestrial,134,98,38,102,232,28.35820895522388,76.11940298507463
14151_terrestrial,136,101,41,104,237,30.14705882352941,76.47058823529412
14152_terrestrial,146,108,44,116,254,30.136986301369863,79.45205479452055
14153_terrestrial,158,113,49,128,271,31.0126582278481,81.0126582278481
14154_terrestrial,199,142,87,135,341,43.71859296482412,67.8391959798995
14155_terrestrial,151,113,52,116,264,34.437086092715234,76.82119205298014
14156_terrestrial,209,138,107,127,347,51.196172248803826,60.76555023923444
14157_terrestrial,197,134,101,117,331,51.26903553299492,59.390862944162436
14158_terrestrial,195,126,104,113,321,53.333333333333336,57.948717948717956
14159_terrestrial,196,123,106,113,319,54.08163265306123,57.6530612244898
14215_terrestrial,351,181,281,154,532,80.05698005698005,43.87464387464387
14216_terrestrial,401,183,317,191,584,79.05236907730672,47.63092269326683
14217_terrestrial,413,183,326,206,596,78.93462469733656,49.87893462469734
14218_terrestrial,423,186,337,213,609,79.66903073286052,50.35460992907801
14219_terrestrial,421,194,334,213,615,79.33491686460808,50.5938242280285
14220_terrestrial,403,173,317,203,576,78.66004962779157,50.37220843672456
14221_terrestrial,397,163,317,196,560,79.84886649874056,49.37027707808564
14222_terrestrial,464,207,349,246,671,75.21551724137932,53.01724137931034
14223_terrestrial,442,199,324,250,641,73.303167420814475,56.56108597285068
14224_terrestrial,311,143,211,227,454,67.84565916398714,72.9903536977492
14225_terrestrial,294,139,193,216,433,65.64625850340136,73.46938775510205
14226_terrestrial,287,141,187,205,428,65.1567944250871,71.42857142857143
14227_terrestrial,280,144,177,194,424,63.21428571428571,69.28571428571428
14228_terrestrial,281,143,182,202,424,64.76868327402136,71.88612099644128
14229_terrestrial,274,143,175,192,417,63.868613138686136,70.07299270072993
14230_terrestrial,254,145,159,174,399,62.59842519685039,68.50393700787401
14231_terrestrial,263,151,166,185,414,63.11787072243346,70.34220532319392
14232_terrestrial,275,151,176,195,426,64,70.9090909090909
14233_terrestrial,280,149,175,200,429,62.5,71.42857142857143
14234_terrestrial,291,145,180,205,436,61.855670103092784,70.44673539518901
14235_terrestrial,297,146,183,207,443,61.61616161616161,69.6969696969697
14236_terrestrial,296,148,185,206,444,62.5,69.5945945945946
14237_terrestrial,285,159,175,195,444,61.40350877192983,68.42105263157895
14238_terrestrial,293,159,180,209,452,61.43344709897611,71.33105802047781
14239_terrestrial,276,144,172,198,420,62.31884057971014,71.73913043478261
14240_terrestrial,272,150,169,190,422,62.13235294117647,69.85294117647058
14241_terrestrial,273,147,171,188,420,62.637362637362635,68.86446886446886
14242_terrestrial,281,145,175,192,426,62.27758007117438,68.32740213523132
14243_terrestrial,274,146,171,186,420,62.40875912408759,67.88321167883211
14244_terrestrial,296,145,185,210,441,62.5,70.94594594594594
14245_terrestrial,303,147,187,220,450,61.71617161716172,72.60726072607261
14246_terrestrial,295,142,180,213,437,61.016949152542374,72.20338983050848
14247_terrestrial,283,133,170,202,416,60.07067137809188,71.37809187279152
14248_terrestrial,283,128,168,200,411,59.36395759717315,70.6713780918728
14249_terrestrial,279,132,168,197,411,60.215053763440864,70.60931899641577
14250_terrestrial,284,151,172,198,435,60.56338028169014,69.71830985915493
14251_terrestrial,292,163,178,205,455,60.95890410958904,70.2054794520548
14252_terrestrial,286,160,174,202,446,60.83916083916085,70.62937062937063
14253_terrestrial,274,154,166,195,428,60.58394160583942,71.16788321167883
14254_terrestrial,265,138,157,189,403,59.24528301886792,71.32075471698113
14255_terrestrial,269,138,158,194,407,58.7360594795539,72.11895910780669
14256_terrestrial,264,139,157,193,403,59.46969696969697,73.10606060606061
14257_terrestrial,255,138,155,185,393,60.78431372549019,72.54901960784314
14258_terrestrial,254,133,154,181,387,60.629921259842526,71.25984251968504
14259_terrestrial,257,135,154,179,392,59.92217898832685,69.64980544747081
14260_terrestrial,260,140,158,179,400,60.76923076923077,68.84615384615384
14261_terrestrial,261,138,158,183,399,60.53639846743295,70.11494252873564
14262_terrestrial,249,135,152,174,384,61.044176706827315,69.87951807228916
14263_terrestrial,246,138,151,172,384,61.382113821138205,69.91869918699187
14264_terrestrial,252,142,154,173,394,61.111111111111114,68.65079365079364
14265_terrestrial,228,145,138,160,373,60.526315789473685,70.17543859649122
14266_terrestrial,241,164,154,166,405,63.90041493775933,68.87966804979253
14267_terrestrial,238,144,152,165,382,63.86554621848739,69.32773109243698
14268_terrestrial,236,135,154,164,371,65.2542372881356,69.49152542372882
14269_terrestrial,217,114,139,155,331,64.0552995391705,71.42857142857143
14270_terrestrial,211,107,137,151,318,64.92890995260665,71.56398104265402
14271_terrestrial,232,123,152,163,355,65.51724137931035,70.25862068965517
14272_terrestrial,233,134,153,162,367,65.66523605150213,69.52789699570815
14273_terrestrial,221,134,144,146,355,65.15837104072398,66.06334841628959
14274_terrestrial,200,132,128,137,332,64,68.5
14275_terrestrial,210,125,131,147,335,62.38095238095238,70
14276_terrestrial,200,126,130,142,326,65,71
14277_terrestrial,204,123,131,143,327,64.2156862745098,70.09803921568627
14278_terrestrial,201,117,129,140,318,64.17910447761194,69.65174129353234
14279_terrestrial,199,110,126,143,309,63.31658291457286,71.85929648241206
14280_terrestrial,195,103,124,139,298,63.589743589743584,71.28205128205128
14281_terrestrial,197,103,125,142,300,63.45177664974619,72.08121827411168
14282_terrestrial,197,90,124,149,287,62.944162436548226,75.63451776649747
14283_terrestrial,198,93,126,150,291,63.63636363636363,75.75757575757575
14284_terrestrial,194,98,122,148,292,62.88659793814433,76.28865979381443
14285_terrestrial,193,99,122,146,292,63.212435233160626,75.64766839378238
14286_terrestrial,192,95,119,145,287,61.979166666666664,75.52083333333334
14287_terrestrial,200,91,125,150,291,62.5,75
14288_terrestrial,205,97,127,151,302,61.951219512195124,73.65853658536585
14289_terrestrial,204,104,127,149,308,62.254901960784316,73.0392156862745
14290_terrestrial,202,97,121,151,299,59.900990099009896,74.75247524752476
14291_terrestrial,201,100,120,149,301,59.70149253731343,74.12935323383084
14292_terrestrial,198,107,121,146,305,61.111111111111114,73.73737373737373
14293_terrestrial,203,106,125,146,309,61.57635467980296,71.92118226600985
14294_terrestrial,199,102,124,143,301,62.311557788944725,71.85929648241206
14295_terrestrial,206,103,128,152,309,62.13592233009708,73.7864077669903
14296_terrestrial,209,103,133,153,312,63.63636363636363,73.20574162679426
14297_terrestrial,216,101,136,164,317,62.96296296296296,75.92592592592592
14298_terrestrial,218,108,137,164,326,62.84403669724771,75.22935779816514
14299_terrestrial,237,113,145,175,350,61.18143459915611,73.83966244725738
14300_terrestrial,237,121,144,174,358,60.75949367088608,73.41772151898735
14301_terrestrial,239,129,146,178,368,61.08786610878661,74.47698744769873
14302_terrestrial,252,133,153,188,385,60.71428571428571,74.60317460317461
14303_terrestrial,269,143,163,200,412,60.594795539033456,74.34944237918215
14304_terrestrial,287,143,170,215,430,59.23344947735192,74.91289198606272
14305_terrestrial,280,133,165,215,413,58.92857142857143,76.78571428571429
14306_terrestrial,277,138,164,217,415,59.205776173285194,78.33935018050542
14307_terrestrial,275,139,163,211,414,59.27272727272728,76.72727272727272
14308_terrestrial,277,143,164,214,420,59.205776173285194,77.25631768953069
14309_terrestrial,276,145,166,217,421,60.14492753623188,78.62318840579711
14310_terrestrial,282,148,172,218,430,60.99290780141844,77.30496453900709
14311_terrestrial,290,159,178,220,449,61.37931034482759,75.86206896551724
14312_terrestrial,292,165,177,224,457,60.61643835616438,76.71232876712328
14313_terrestrial,285,165,172,220,450,60.35087719298245,77.19298245614034
14314_terrestrial,279,168,170,216,447,60.93189964157706,77.41935483870968
14315_terrestrial,278,167,168,213,445,60.431654676258994,76.61870503597122
14316_terrestrial,275,162,168,212,437,61.09090909090909,77.0909090909091
14317_terrestrial,264,143,161,208,407,60.984848484848484,78.78787878787878
14318_terrestrial,266,132,164,206,398,61.65413533834586,77.44360902255639
14319_terrestrial,271,136,167,205,407,61.62361623616236,75.64575645756457
14322_terrestrial,254,125,148,195,379,58.26771653543307,76.77165354330708
14323_terrestrial,273,131,166,208,404,60.8058608058608,76.19047619047619
14324_terrestrial,273,136,164,209,409,60.07326007326007,76.55677655677655
14325_terrestrial,271,143,164,206,414,60.51660516605166,76.01476014760148
14326_terrestrial,268,136,163,203,404,60.820895522388064,75.74626865671642
14327_terrestrial,258,137,156,198,395,60.46511627906976,76.74418604651163
14328_terrestrial,262,135,161,198,397,61.45038167938931,75.57251908396947
14329_terrestrial,257,133,160,197,390,62.2568093385214,76.65369649805449
14330_terrestrial,253,127,154,192,380,60.86956521739131,75.8893280632411
14331_terrestrial,249,125,153,189,374,61.44578313253012,75.90361445783132
14332_terrestrial,252,126,155,192,378,61.50793650793651,76.19047619047619
14333_terrestrial,255,128,159,190,383,62.35294117647059,74.50980392156863
14334_terrestrial,260,134,161,190,394,61.92307692307693,73.07692307692307
14335_terrestrial,264,130,162,196,394,61.36363636363637,74.24242424242425
14336_terrestrial,254,129,157,190,383,61.811023622047244,74.80314960629921
14337_terrestrial,253,129,161,188,382,63.63636363636363,74.30830039525692
14338_terrestrial,246,133,156,186,379,63.41463414634146,75.60975609756098
14339_terrestrial,245,130,158,185,375,64.48979591836735,75.51020408163265
14340_terrestrial,256,140,163,193,396,63.671875,75.390625
14341_terrestrial,250,122,157,187,372,62.8,74.8
14342_terrestrial,248,121,158,184,369,63.70967741935484,74.19354838709677
14343_terrestrial,254,117,161,188,371,63.38582677165354,74.01574803149606
14344_terrestrial,255,120,160,191,375,62.745098039215684,74.90196078431373
14345_terrestrial,255,124,163,194,379,63.921568627450974,76.07843137254902
14346_terrestrial,253,130,159,191,383,62.845849802371546,75.49407114624506
14347_terrestrial,254,139,162,195,393,63.77952755905512,76.77165354330708
14348_terrestrial,266,140,170,202,406,63.90977443609023,75.93984962406014
14349_terrestrial,245,119,158,191,364,64.48979591836735,77.9591836734694
14350_terrestrial,242,118,154,188,360,63.63636363636363,77.68595041322314
14351_terrestrial,245,112,155,190,357,63.26530612244898,77.55102040816327
14352_terrestrial,240,112,153,184,352,63.74999999999999,76.66666666666667
14353_terrestrial,231,111,148,179,342,64.06926406926407,77.48917748917748
14354_terrestrial,229,106,146,178,335,63.75545851528385,77.72925764192141
14355_terrestrial,231,104,151,176,335,65.36796536796537,76.19047619047619
14356_terrestrial,240,109,155,180,349,64.58333333333334,75
14357_terrestrial,241,116,157,179,357,65.14522821576763,74.27385892116183
14358_terrestrial,241,114,159,176,355,65.97510373443983,73.02904564315352
14359_terrestrial,229,109,148,169,338,64.62882096069869,73.7991266375546
14360_terrestrial,221,98,143,166,319,64.70588235294117,75.1131221719457
14361_terrestrial,274,123,184,177,397,67.15328467153284,64.59854014598541
14363_terrestrial,251,131,161,168,382,64.14342629482071,66.93227091633466
14364_terrestrial,241,127,154,165,368,63.90041493775933,68.46473029045643
14453_terrestrial,217,135,124,122,352,57.14285714285714,56.22119815668203
14454_terrestrial,231,154,134,130,385,58.00865800865801,56.27705627705628
14455_terrestrial,265,169,149,167,434,56.22641509433962,63.0188679245283
14456_terrestrial,346,232,174,215,578,50.28901734104046,62.138728323699425
14457_terrestrial,370,271,184,233,641,49.72972972972973,62.972972972972975
14458_terrestrial,370,290,181,243,660,48.91891891891892,65.67567567567568
14459_terrestrial,357,296,169,233,653,47.33893557422969,65.26610644257703
14460_terrestrial,254,239,86,195,493,33.85826771653544,76.77165354330708
14461_terrestrial,248,213,81,186,461,32.66129032258064,75
14462_terrestrial,248,206,82,185,454,33.064516129032256,74.59677419354838
14463_terrestrial,239,193,75,184,432,31.380753138075313,76.98744769874477
14464_terrestrial,243,182,81,185,425,33.33333333333333,76.13168724279835
14465_terrestrial,236,172,76,181,408,32.20338983050847,76.69491525423729
14466_terrestrial,238,195,74,185,433,31.092436974789916,77.73109243697479
14467_terrestrial,260,194,82,205,454,31.538461538461537,78.84615384615384
14468_terrestrial,223,183,71,185,406,31.838565022421523,82.95964125560538
14469_terrestrial,209,162,67,175,371,32.057416267942585,83.73205741626795
14470_terrestrial,216,160,70,177,376,32.407407407407405,81.94444444444444
14471_terrestrial,211,154,70,172,365,33.175355450236964,81.51658767772511
14472_terrestrial,208,153,71,167,361,34.13461538461539,80.28846153846155
14473_terrestrial,203,154,70,164,357,34.48275862068966,80.78817733990148
14474_terrestrial,201,156,69,165,357,34.32835820895522,82.08955223880598
14475_terrestrial,205,151,70,168,356,34.146341463414636,81.95121951219512
14476_terrestrial,215,165,70,176,380,32.55813953488372,81.86046511627907
14477_terrestrial,223,173,71,184,396,31.838565022421523,82.51121076233184
14478_terrestrial,236,164,71,196,400,30.08474576271186,83.05084745762711
14479_terrestrial,244,178,73,202,422,29.918032786885245,82.78688524590164
14480_terrestrial,241,190,72,197,431,29.87551867219917,81.74273858921161
14481_terrestrial,240,191,72,198,431,30,82.5
14482_terrestrial,258,201,78,213,459,30.23255813953488,82.55813953488372
14483_terrestrial,265,209,79,224,474,29.81132075471698,84.52830188679246
14484_terrestrial,256,220,73,211,476,28.515625,82.421875
14485_terrestrial,248,216,71,201,464,28.62903225806452,81.04838709677419
14486_terrestrial,230,186,63,186,416,27.391304347826086,80.8695652173913
14487_terrestrial,214,185,55,175,399,25.70093457943925,81.77570093457945
14488_terrestrial,200,152,55,163,352,27.500000000000004,81.5
14489_terrestrial,197,147,53,160,344,26.903553299492383,81.21827411167513
14490_terrestrial,194,141,54,155,335,27.835051546391753,79.89690721649485
14491_terrestrial,190,145,55,151,335,28.947368421052634,79.47368421052632
14492_terrestrial,206,188,64,164,394,31.06796116504854,79.6116504854369
14493_terrestrial,185,142,54,149,327,29.18918918918919,80.54054054054053
14494_terrestrial,182,135,53,144,317,29.120879120879124,79.12087912087912
14495_terrestrial,177,132,50,139,309,28.24858757062147,78.53107344632768
14496_terrestrial,171,125,49,135,296,28.654970760233915,78.94736842105263
14497_terrestrial,169,125,50,135,294,29.585798816568047,79.88165680473372
14498_terrestrial,172,125,52,133,297,30.23255813953488,77.32558139534885
14499_terrestrial,172,120,53,135,292,30.813953488372093,78.48837209302324
14500_terrestrial,170,118,52,133,288,30.58823529411765,78.23529411764706
14501_terrestrial,167,120,50,130,287,29.94011976047904,77.84431137724552
14502_terrestrial,165,113,48,129,278,29.09090909090909,78.18181818181819
14503_terrestrial,155,113,46,122,268,29.677419354838708,78.70967741935485
14504_terrestrial,153,111,44,121,264,28.75816993464052,79.08496732026144
14505_terrestrial,145,112,41,115,257,28.27586206896552,79.3103448275862
14506_terrestrial,145,111,40,115,256,27.586206896551722,79.3103448275862
14507_terrestrial,152,101,42,120,253,27.631578947368425,78.94736842105263
14508_terrestrial,149,102,42,118,251,28.187919463087248,79.19463087248322
14509_terrestrial,155,106,46,122,261,29.677419354838708,78.70967741935485
14510_terrestrial,165,113,54,132,278,32.72727272727273,80
14511_terrestrial,178,113,61,145,291,34.26966292134831,81.46067415730337
14512_terrestrial,223,147,96,157,370,43.04932735426009,70.4035874439462
14513_terrestrial,216,148,93,147,364,43.05555555555556,68.05555555555556
14514_terrestrial,233,176,100,161,409,42.91845493562232,69.09871244635193
14515_terrestrial,214,150,93,146,364,43.45794392523364,68.22429906542055
14516_terrestrial,261,165,124,166,426,47.509578544061306,63.601532567049816
14517_terrestrial,184,78,100,123,262,54.347826086956516,66.84782608695652
14518_terrestrial,184,76,102,121,260,55.434782608695656,65.76086956521739
14519_terrestrial,179,72,98,120,251,54.7486033519553,67.0391061452514
14522_terrestrial,197,81,115,118,278,58.37563451776649,59.89847715736041
14523_terrestrial,191,75,112,115,266,58.63874345549738,60.20942408376963
14578_terrestrial,312,131,258,130,443,82.6923076923077,41.66666666666667
14579_terrestrial,430,218,317,210,648,73.72093023255813,48.837209302325576
14580_terrestrial,425,205,314,219,630,73.88235294117646,51.52941176470588
14581_terrestrial,447,209,335,235,656,74.9440715883669,52.57270693512305
14582_terrestrial,451,211,332,239,662,73.61419068736141,52.993348115299334
14583_terrestrial,277,136,188,197,413,67.87003610108303,71.11913357400722
14584_terrestrial,270,136,174,196,406,64.44444444444444,72.5925925925926
14585_terrestrial,287,137,185,209,424,64.45993031358886,72.82229965156795
14586_terrestrial,278,147,179,196,425,64.38848920863309,70.50359712230215
14587_terrestrial,280,149,177,205,429,63.21428571428571,73.21428571428571
14588_terrestrial,289,146,189,208,435,65.39792387543253,71.97231833910035
14589_terrestrial,292,143,190,209,435,65.06849315068493,71.57534246575342
14590_terrestrial,276,142,175,190,418,63.40579710144928,68.84057971014492
14591_terrestrial,273,148,174,190,421,63.73626373626373,69.59706959706959
14592_terrestrial,278,154,179,195,432,64.38848920863309,70.14388489208633
14593_terrestrial,287,155,177,203,442,61.672473867595826,70.73170731707317
14594_terrestrial,291,154,175,201,445,60.13745704467354,69.0721649484536
14595_terrestrial,289,139,178,204,428,61.5916955017301,70.58823529411765
14596_terrestrial,293,149,180,204,442,61.43344709897611,69.6245733788396
14597_terrestrial,311,159,197,218,470,63.344051446945336,70.09646302250803
14598_terrestrial,310,174,189,218,484,60.967741935483865,70.3225806451613
14599_terrestrial,329,180,205,233,509,62.31003039513677,70.82066869300911
14600_terrestrial,326,183,203,226,509,62.26993865030674,69.32515337423312
14601_terrestrial,311,189,188,209,500,60.45016077170418,67.20257234726688
14602_terrestrial,314,180,190,216,494,60.509554140127385,68.78980891719745
14603_terrestrial,333,180,204,231,513,61.261261261261254,69.36936936936937
14604_terrestrial,321,159,192,224,480,59.813084112149525,69.78193146417445
14605_terrestrial,311,155,192,226,466,61.7363344051447,72.66881028938906
14606_terrestrial,297,148,188,213,445,63.2996632996633,71.71717171717171
14607_terrestrial,280,147,172,197,427,61.42857142857143,70.35714285714286
14608_terrestrial,277,149,170,194,426,61.371841155234655,70.03610108303249
14609_terrestrial,269,151,167,192,420,62.0817843866171,71.37546468401487
14610_terrestrial,269,145,166,191,414,61.71003717472119,71.00371747211895
14611_terrestrial,277,156,169,196,433,61.01083032490975,70.7581227436823
14612_terrestrial,288,160,175,206,448,60.763888888888886,71.52777777777779
14613_terrestrial,284,160,173,205,444,60.91549295774647,72.1830985915493
14614_terrestrial,283,154,173,207,437,61.130742049469966,73.14487632508833
14615_terrestrial,274,154,169,202,428,61.67883211678832,73.72262773722628
14616_terrestrial,271,151,164,195,422,60.51660516605166,71.95571955719558
14617_terrestrial,262,146,156,191,408,59.541984732824424,72.90076335877863
14618_terrestrial,260,148,161,189,408,61.92307692307693,72.6923076923077
14619_terrestrial,261,145,159,188,406,60.91954022988506,72.03065134099617
14620_terrestrial,261,148,160,186,409,61.30268199233716,71.26436781609196
14621_terrestrial,261,147,162,190,408,62.06896551724138,72.79693486590038
14622_terrestrial,254,137,157,182,391,61.811023622047244,71.65354330708661
14623_terrestrial,253,147,158,180,400,62.450592885375485,71.14624505928853
14624_terrestrial,247,161,156,177,408,63.1578947368421,71.65991902834008
14625_terrestrial,257,172,169,174,429,65.75875486381322,67.70428015564202
14626_terrestrial,263,162,173,180,425,65.77946768060836,68.44106463878326
14627_terrestrial,240,144,155,171,384,64.58333333333334,71.25
14628_terrestrial,228,129,150,161,357,65.78947368421053,70.6140350877193
14629_terrestrial,210,107,135,154,317,64.28571428571429,73.33333333333333
14630_terrestrial,206,106,136,150,312,66.01941747572816,72.81553398058253
14631_terrestrial,218,121,144,158,339,66.05504587155964,72.47706422018348
14632_terrestrial,231,126,157,158,357,67.96536796536796,68.3982683982684
14633_terrestrial,213,120,142,144,333,66.66666666666666,67.6056338028169
14634_terrestrial,187,109,124,133,296,66.31016042780749,71.12299465240642
14635_terrestrial,180,105,119,130,285,66.11111111111111,72.22222222222221
14636_terrestrial,182,100,120,132,282,65.93406593406593,72.52747252747253
14637_terrestrial,182,107,121,131,289,66.48351648351648,71.97802197802197
14638_terrestrial,183,105,121,132,288,66.12021857923497,72.1311475409836
14639_terrestrial,187,103,121,135,290,64.70588235294117,72.19251336898395
14640_terrestrial,189,99,123,139,288,65.07936507936508,73.54497354497354
14641_terrestrial,181,94,116,139,275,64.08839779005525,76.79558011049724
14642_terrestrial,183,95,116,140,278,63.387978142076506,76.50273224043715
14643_terrestrial,183,99,113,138,282,61.74863387978142,75.40983606557377
14644_terrestrial,178,96,110,135,274,61.79775280898876,75.84269662921348
14645_terrestrial,178,90,110,135,268,61.79775280898876,75.84269662921348
14646_terrestrial,182,91,114,137,273,62.637362637362635,75.27472527472527
14647_terrestrial,183,95,113,138,278,61.74863387978142,75.40983606557377
14648_terrestrial,181,91,112,136,272,61.87845303867403,75.13812154696133
14649_terrestrial,185,90,116,137,275,62.70270270270271,74.05405405405405
14650_terrestrial,185,86,115,135,271,62.16216216216216,72.97297297297297
14651_terrestrial,190,87,119,136,277,62.63157894736842,71.57894736842105
14652_terrestrial,195,98,122,140,293,62.56410256410256,71.7948717948718
14653_terrestrial,190,99,118,140,289,62.10526315789474,73.68421052631578
14654_terrestrial,200,98,125,145,298,62.5,72.5
14655_terrestrial,206,98,128,150,304,62.13592233009708,72.81553398058253
14656_terrestrial,208,95,130,155,303,62.5,74.51923076923077
14661_terrestrial,231,123,147,171,354,63.63636363636363,74.02597402597402
14662_terrestrial,240,128,152,179,368,63.33333333333333,74.58333333333333
14663_terrestrial,273,144,169,203,417,61.904761904761905,74.35897435897436
14664_terrestrial,298,164,178,226,462,59.73154362416108,75.83892617449665
14665_terrestrial,297,164,174,231,461,58.58585858585859,77.77777777777779
14666_terrestrial,294,149,173,229,443,58.843537414965986,77.89115646258503
14667_terrestrial,302,160,179,231,462,59.27152317880795,76.49006622516556
14668_terrestrial,298,157,177,231,455,59.395973154362416,77.51677852348993
14669_terrestrial,283,145,173,220,428,61.130742049469966,77.73851590106007
14670_terrestrial,284,150,172,217,434,60.56338028169014,76.40845070422534
14671_terrestrial,280,145,170,219,425,60.71428571428571,78.21428571428571
14672_terrestrial,261,145,158,204,406,60.53639846743295,78.16091954022988
14676_terrestrial,276,155,171,214,431,61.95652173913043,77.53623188405797
14677_terrestrial,273,139,166,213,412,60.8058608058608,78.02197802197803
14678_terrestrial,273,136,164,202,409,60.07326007326007,73.992673992674
14679_terrestrial,250,130,150,184,380,60,73.6
14680_terrestrial,241,116,143,181,357,59.33609958506224,75.10373443983403
14681_terrestrial,243,120,145,182,363,59.67078189300411,74.8971193415638
14682_terrestrial,240,120,144,180,360,60,75
14683_terrestrial,243,124,147,179,367,60.49382716049383,73.66255144032921
14684_terrestrial,243,125,146,181,368,60.08230452674898,74.48559670781893
14685_terrestrial,241,133,143,179,374,59.33609958506224,74.27385892116183
14686_terrestrial,235,133,140,180,368,59.57446808510638,76.59574468085107
14687_terrestrial,236,134,140,181,370,59.32203389830508,76.69491525423729
14688_terrestrial,258,134,157,193,392,60.85271317829457,74.8062015503876
14689_terrestrial,254,133,155,192,387,61.023622047244096,75.59055118110236
14690_terrestrial,247,132,151,185,379,61.1336032388664,74.89878542510121
14691_terrestrial,247,133,150,184,380,60.72874493927125,74.49392712550608
14692_terrestrial,253,139,155,188,392,61.26482213438735,74.30830039525692
14693_terrestrial,245,139,151,179,384,61.63265306122449,73.06122448979592
14694_terrestrial,242,132,150,181,374,61.98347107438017,74.79338842975206
14695_terrestrial,224,113,140,168,337,62.5,75
14696_terrestrial,238,119,157,180,357,65.96638655462185,75.63025210084034
14697_terrestrial,252,135,163,187,387,64.68253968253968,74.20634920634922
14698_terrestrial,260,141,169,194,401,65,74.61538461538461
14699_terrestrial,252,143,164,191,395,65.07936507936508,75.79365079365078
14700_terrestrial,257,141,162,193,398,63.035019455252915,75.09727626459144
14701_terrestrial,250,130,155,189,380,62,75.6
14702_terrestrial,254,126,158,191,380,62.20472440944882,75.19685039370079
14703_terrestrial,255,119,159,190,374,62.35294117647059,74.50980392156863
14704_terrestrial,256,122,162,198,378,63.28125,77.34375
14705_terrestrial,253,121,160,195,374,63.24110671936759,77.07509881422925
14706_terrestrial,259,129,162,197,388,62.54826254826254,76.06177606177607
14707_terrestrial,250,129,157,192,379,62.8,76.8
14708_terrestrial,268,137,172,204,405,64.17910447761194,76.11940298507463
14709_terrestrial,269,137,174,204,406,64.68401486988847,75.8364312267658
14710_terrestrial,268,138,173,202,406,64.55223880597015,75.3731343283582
14711_terrestrial,264,123,170,197,387,64.39393939393939,74.62121212121212
14712_terrestrial,249,122,161,194,371,64.65863453815261,77.91164658634538
14713_terrestrial,247,117,160,195,364,64.77732793522267,78.94736842105263
14714_terrestrial,250,117,161,198,367,64.4,79.2
14715_terrestrial,248,117,160,191,365,64.51612903225806,77.01612903225806
14716_terrestrial,255,119,168,189,374,65.88235294117646,74.11764705882354
14717_terrestrial,249,118,163,183,367,65.46184738955823,73.49397590361446
14718_terrestrial,244,119,160,178,363,65.57377049180327,72.95081967213115
14719_terrestrial,232,111,153,172,343,65.94827586206897,74.13793103448276
14720_terrestrial,222,103,142,163,325,63.96396396396396,73.42342342342343
14721_terrestrial,266,125,180,171,391,67.66917293233082,64.28571428571429
14723_terrestrial,269,143,176,172,412,65.4275092936803,63.94052044609665
14724_terrestrial,253,135,165,166,388,65.21739130434783,65.61264822134387
14725_terrestrial,240,129,157,159,369,65.41666666666667,66.25
14815_terrestrial,260,155,148,163,415,56.92307692307692,62.69230769230769
14816_terrestrial,349,271,176,210,620,50.429799426934096,60.17191977077364
14817_terrestrial,354,281,178,219,635,50.282485875706215,61.86440677966102
14818_terrestrial,359,295,180,236,654,50.13927576601671,65.73816155988858
14819_terrestrial,273,253,98,210,526,35.8974358974359,76.92307692307693
14820_terrestrial,256,246,84,199,502,32.8125,77.734375
14821_terrestrial,247,231,84,189,478,34.0080971659919,76.51821862348179
14822_terrestrial,248,217,84,190,465,33.87096774193548,76.61290322580645
14823_terrestrial,247,213,80,191,460,32.388663967611336,77.32793522267207
14824_terrestrial,245,191,83,183,436,33.87755102040816,74.6938775510204
14825_terrestrial,242,174,82,183,416,33.88429752066116,75.6198347107438
14826_terrestrial,247,192,79,189,439,31.983805668016196,76.51821862348179
14827_terrestrial,267,217,83,212,484,31.086142322097377,79.40074906367042
14828_terrestrial,264,212,86,209,476,32.57575757575758,79.16666666666666
14829_terrestrial,235,191,76,190,426,32.340425531914896,80.85106382978722
14830_terrestrial,231,185,73,191,416,31.601731601731604,82.68398268398268
14831_terrestrial,225,175,72,183,400,32,81.33333333333333
14832_terrestrial,225,176,74,181,401,32.88888888888889,80.44444444444444
14833_terrestrial,218,161,76,173,379,34.862385321100916,79.35779816513761
14834_terrestrial,224,169,80,176,393,35.714285714285715,78.57142857142857
14835_terrestrial,214,169,74,171,383,34.57943925233645,79.90654205607477
14836_terrestrial,218,178,71,178,396,32.56880733944954,81.65137614678899
14837_terrestrial,228,191,75,188,419,32.89473684210527,82.45614035087719
14838_terrestrial,232,179,74,192,411,31.896551724137932,82.75862068965517
14839_terrestrial,234,182,71,193,416,30.34188034188034,82.47863247863248
14840_terrestrial,228,180,69,188,408,30.263157894736842,82.45614035087719
14841_terrestrial,229,172,70,189,401,30.567685589519648,82.53275109170306
14842_terrestrial,233,191,73,192,424,31.330472103004293,82.40343347639485
14843_terrestrial,250,218,75,207,468,30,82.8
14844_terrestrial,258,217,74,213,475,28.68217054263566,82.55813953488372
14845_terrestrial,257,233,75,209,490,29.18287937743191,81.32295719844358
14846_terrestrial,237,218,67,191,455,28.270042194092827,80.59071729957806
14847_terrestrial,223,206,60,178,429,26.905829596412556,79.82062780269058
14848_terrestrial,216,190,55,173,406,25.462962962962965,80.0925925925926
14849_terrestrial,213,167,53,172,380,24.88262910798122,80.75117370892019
14850_terrestrial,217,181,55,176,398,25.34562211981567,81.10599078341014
14851_terrestrial,232,213,64,189,445,27.586206896551722,81.46551724137932
14852_terrestrial,227,199,65,185,426,28.634361233480178,81.4977973568282
14853_terrestrial,199,182,60,161,381,30.15075376884422,80.90452261306532
14854_terrestrial,208,179,61,166,387,29.326923076923077,79.8076923076923
14855_terrestrial,205,174,61,163,379,29.756097560975608,79.51219512195122
14856_terrestrial,196,139,55,156,335,28.061224489795915,79.59183673469387
14857_terrestrial,184,134,49,146,318,26.6304347826087,79.34782608695652
14858_terrestrial,178,130,52,142,308,29.213483146067414,79.7752808988764
14859_terrestrial,178,123,53,141,301,29.775280898876407,79.21348314606742
14860_terrestrial,179,131,53,144,310,29.608938547486037,80.44692737430168
14861_terrestrial,180,125,54,148,305,30,82.22222222222221
14862_terrestrial,176,124,52,144,300,29.545454545454547,81.81818181818183
14863_terrestrial,172,121,49,140,293,28.488372093023255,81.3953488372093
14864_terrestrial,165,124,46,135,289,27.878787878787882,81.81818181818183
14865_terrestrial,159,125,44,129,284,27.67295597484277,81.13207547169812
14866_terrestrial,156,126,45,126,282,28.846153846153843,80.76923076923077
14867_terrestrial,161,123,45,131,284,27.95031055900621,81.36645962732919
14868_terrestrial,171,123,51,141,294,29.82456140350877,82.45614035087719
14869_terrestrial,176,122,51,143,298,28.97727272727273,81.25
14870_terrestrial,184,130,56,152,314,30.434782608695656,82.6086956521739
14871_terrestrial,248,190,103,176,438,41.53225806451613,70.96774193548387
14872_terrestrial,247,181,96,173,428,38.8663967611336,70.04048582995951
14873_terrestrial,230,159,92,160,389,40,69.56521739130434
14874_terrestrial,252,177,111,163,429,44.047619047619044,64.68253968253968
14875_terrestrial,246,169,114,157,415,46.34146341463415,63.82113821138211
14876_terrestrial,263,179,123,171,442,46.7680608365019,65.0190114068441
14936_terrestrial,450,221,341,210,671,75.77777777777777,46.666666666666664
14937_terrestrial,439,211,328,218,650,74.71526195899773,49.65831435079727
14938_terrestrial,446,214,329,225,660,73.76681614349776,50.44843049327354
14939_terrestrial,467,226,346,243,693,74.08993576017131,52.03426124197003
14940_terrestrial,277,139,183,202,416,66.06498194945848,72.92418772563177
14941_terrestrial,263,141,171,186,404,65.0190114068441,70.72243346007605
14942_terrestrial,273,137,182,196,410,66.66666666666666,71.7948717948718
14943_terrestrial,280,142,185,201,422,66.07142857142857,71.78571428571429
14944_terrestrial,276,140,178,202,416,64.4927536231884,73.18840579710145
14945_terrestrial,283,139,185,204,422,65.37102473498233,72.08480565371025
14946_terrestrial,272,152,176,184,424,64.70588235294117,67.64705882352942
14947_terrestrial,293,152,184,205,445,62.79863481228669,69.96587030716724
14948_terrestrial,316,159,200,225,475,63.29113924050633,71.20253164556962
14949_terrestrial,305,160,199,218,465,65.24590163934427,71.47540983606558
14950_terrestrial,285,150,183,205,435,64.21052631578948,71.9298245614035
14951_terrestrial,287,153,184,201,440,64.11149825783971,70.03484320557492
14952_terrestrial,300,147,193,207,447,64.33333333333333,69
14953_terrestrial,304,146,188,218,450,61.8421052631579,71.71052631578947
14954_terrestrial,316,166,195,225,482,61.70886075949367,71.20253164556962
14955_terrestrial,310,165,185,216,475,59.67741935483871,69.6774193548387
14956_terrestrial,321,171,189,225,492,58.87850467289719,70.09345794392523
14957_terrestrial,342,189,215,244,531,62.86549707602339,71.34502923976608
14958_terrestrial,342,183,207,245,525,60.526315789473685,71.6374269005848
14959_terrestrial,342,178,206,247,520,60.23391812865497,72.22222222222221
14960_terrestrial,322,183,190,232,505,59.006211180124225,72.04968944099379
14961_terrestrial,320,193,187,222,513,58.4375,69.375
14962_terrestrial,335,187,201,241,522,60,71.94029850746269
14963_terrestrial,361,185,223,261,546,61.772853185595565,72.29916897506925
14964_terrestrial,335,172,202,237,507,60.298507462686565,70.74626865671641
14965_terrestrial,322,166,192,228,488,59.62732919254658,70.80745341614907
14966_terrestrial,322,159,194,230,481,60.24844720496895,71.42857142857143
14967_terrestrial,319,163,198,226,482,62.06896551724138,70.84639498432603
14968_terrestrial,311,155,198,220,466,63.665594855305464,70.7395498392283
14969_terrestrial,289,156,180,201,445,62.28373702422145,69.55017301038062
14970_terrestrial,273,155,168,193,428,61.53846153846154,70.6959706959707
14971_terrestrial,273,152,167,193,425,61.172161172161175,70.6959706959707
14972_terrestrial,280,156,174,196,436,62.142857142857146,70
14973_terrestrial,274,154,171,195,428,62.40875912408759,71.16788321167883
14974_terrestrial,273,160,170,201,433,62.27106227106227,73.62637362637363
14975_terrestrial,272,171,173,198,443,63.60294117647059,72.79411764705883
14976_terrestrial,270,161,172,200,431,63.70370370370371,74.07407407407408
14977_terrestrial,254,154,158,185,408,62.20472440944882,72.83464566929135
14978_terrestrial,259,150,164,189,409,63.32046332046332,72.97297297297297
14979_terrestrial,259,138,164,195,397,63.32046332046332,75.2895752895753
14980_terrestrial,277,170,179,201,447,64.62093862815884,72.56317689530685
14981_terrestrial,257,150,165,197,407,64.2023346303502,76.65369649805449
14982_terrestrial,257,146,166,185,403,64.59143968871595,71.98443579766537
14983_terrestrial,242,152,155,175,394,64.0495867768595,72.31404958677686
14984_terrestrial,248,163,166,176,411,66.93548387096774,70.96774193548387
14985_terrestrial,257,172,176,178,429,68.48249027237354,69.26070038910505
14986_terrestrial,250,148,168,172,398,67.2,68.8
14987_terrestrial,242,135,163,166,377,67.35537190082644,68.59504132231406
14988_terrestrial,230,121,156,155,351,67.82608695652173,67.3913043478261
14989_terrestrial,208,105,135,154,313,64.90384615384616,74.03846153846155
14990_terrestrial,210,99,140,156,309,66.66666666666666,74.28571428571429
14991_terrestrial,217,101,147,153,318,67.74193548387096,70.50691244239631
14992_terrestrial,236,115,165,158,351,69.91525423728814,66.94915254237289
14993_terrestrial,220,120,150,145,340,68.18181818181817,65.9090909090909
14994_terrestrial,186,107,123,128,293,66.12903225806451,68.81720430107528
14995_terrestrial,174,97,114,124,271,65.51724137931035,71.26436781609196
14996_terrestrial,177,101,115,127,278,64.97175141242938,71.75141242937853
14997_terrestrial,173,102,113,126,275,65.3179190751445,72.83236994219652
14998_terrestrial,164,101,104,127,265,63.41463414634146,77.4390243902439
14999_terrestrial,174,107,112,130,281,64.36781609195403,74.71264367816092
15000_terrestrial,178,108,113,134,286,63.48314606741573,75.28089887640449
15001_terrestrial,181,109,113,135,290,62.430939226519335,74.58563535911603
15002_terrestrial,186,104,120,142,290,64.51612903225806,76.34408602150538
15012_terrestrial,185,96,115,131,281,62.16216216216216,70.8108108108108
15013_terrestrial,192,99,123,135,291,64.0625,70.3125
15014_terrestrial,193,94,124,140,287,64.24870466321244,72.53886010362694
15015_terrestrial,195,93,123,142,288,63.07692307692307,72.82051282051282
15016_terrestrial,198,94,127,145,292,64.14141414141415,73.23232323232324
15021_terrestrial,225,111,145,165,336,64.44444444444444,73.33333333333333
15022_terrestrial,242,120,155,179,362,64.0495867768595,73.96694214876032
15023_terrestrial,258,147,166,193,405,64.34108527131784,74.8062015503876
15024_terrestrial,272,168,168,205,440,61.76470588235294,75.36764705882352
15025_terrestrial,283,179,170,215,462,60.07067137809188,75.97173144876325
15026_terrestrial,296,201,177,230,497,59.797297297297305,77.7027027027027
15027_terrestrial,298,198,175,230,496,58.7248322147651,77.18120805369128
15028_terrestrial,284,184,167,216,468,58.80281690140845,76.05633802816901
15029_terrestrial,267,177,163,207,444,61.04868913857678,77.52808988764045
15037_terrestrial,246,140,151,185,386,61.382113821138205,75.20325203252033
15038_terrestrial,237,130,145,181,367,61.18143459915611,76.37130801687763
15039_terrestrial,226,129,141,172,355,62.38938053097345,76.10619469026548
15040_terrestrial,221,122,133,168,343,60.18099547511312,76.01809954751131
15041_terrestrial,220,113,133,167,333,60.45454545454545,75.9090909090909
15042_terrestrial,217,110,131,165,327,60.36866359447005,76.036866359447
15043_terrestrial,221,116,137,163,337,61.990950226244344,73.7556561085973
15044_terrestrial,217,119,137,161,336,63.133640552995395,74.19354838709677
15045_terrestrial,208,116,130,154,324,62.5,74.03846153846155
15046_terrestrial,211,121,131,152,332,62.08530805687204,72.03791469194313
15047_terrestrial,214,126,134,157,340,62.616822429906534,73.36448598130842
15048_terrestrial,225,123,141,161,348,62.66666666666667,71.55555555555554
15049_terrestrial,224,128,139,161,352,62.05357142857143,71.875
15050_terrestrial,216,124,135,155,340,62.5,71.75925925925925
15051_terrestrial,211,122,129,153,333,61.137440758293835,72.51184834123224
15052_terrestrial,203,124,123,151,327,60.591133004926114,74.38423645320196
15053_terrestrial,197,116,123,144,313,62.43654822335025,73.09644670050761
15054_terrestrial,189,110,125,142,299,66.13756613756614,75.13227513227513
15055_terrestrial,192,103,128,145,295,66.66666666666666,75.52083333333334
15056_terrestrial,201,109,131,147,310,65.17412935323384,73.13432835820896
15057_terrestrial,212,120,136,153,332,64.15094339622641,72.16981132075472
15058_terrestrial,215,127,137,160,342,63.72093023255814,74.4186046511628
15059_terrestrial,225,124,145,166,349,64.44444444444444,73.77777777777777
15060_terrestrial,234,124,149,177,358,63.67521367521367,75.64102564102564
15061_terrestrial,244,131,154,187,375,63.114754098360656,76.63934426229508
15062_terrestrial,244,127,157,183,371,64.34426229508196,75
15063_terrestrial,253,120,166,192,373,65.61264822134387,75.8893280632411
15064_terrestrial,255,127,168,196,382,65.88235294117646,76.86274509803923
15065_terrestrial,252,125,165,194,377,65.47619047619048,76.98412698412699
15066_terrestrial,250,126,163,190,376,65.2,76
15067_terrestrial,252,128,160,190,380,63.49206349206349,75.39682539682539
15068_terrestrial,258,130,164,197,388,63.565891472868216,76.35658914728683
15069_terrestrial,261,133,169,196,394,64.75095785440614,75.09578544061303
15070_terrestrial,273,137,176,203,410,64.46886446886447,74.35897435897436
15071_terrestrial,278,138,179,207,416,64.38848920863309,74.46043165467626
15072_terrestrial,264,123,173,198,387,65.53030303030303,75
15073_terrestrial,270,133,173,205,403,64.07407407407408,75.92592592592592
15074_terrestrial,278,138,178,208,416,64.02877697841727,74.82014388489209
15075_terrestrial,278,144,179,208,422,64.38848920863309,74.82014388489209
15076_terrestrial,259,131,171,196,390,66.02316602316603,75.67567567567568
15077_terrestrial,257,124,168,191,381,65.36964980544747,74.31906614785993
15078_terrestrial,246,113,161,184,359,65.4471544715447,74.79674796747967
15079_terrestrial,237,107,157,176,344,66.24472573839662,74.26160337552743
15080_terrestrial,287,125,193,183,412,67.24738675958189,63.76306620209059
15081_terrestrial,278,123,188,177,401,67.62589928057554,63.66906474820144
15082_terrestrial,250,118,160,168,368,64,67.2
15083_terrestrial,269,143,176,172,412,65.4275092936803,63.94052044609665
15085_terrestrial,232,119,152,155,351,65.51724137931035,66.8103448275862
15176_terrestrial,313,233,163,188,546,52.07667731629393,60.063897763578275
15177_terrestrial,292,224,142,190,516,48.63013698630137,65.06849315068493
15178_terrestrial,319,271,158,214,590,49.52978056426332,67.0846394984326
15179_terrestrial,264,245,96,208,509,36.36363636363637,78.78787878787878
15180_terrestrial,258,244,91,203,502,35.27131782945737,78.68217054263566
15181_terrestrial,237,206,88,184,443,37.130801687763714,77.63713080168776
15182_terrestrial,237,192,87,187,429,36.708860759493675,78.90295358649789
15183_terrestrial,247,207,86,195,454,34.81781376518219,78.94736842105263
15184_terrestrial,240,204,75,185,444,31.25,77.08333333333334
15185_terrestrial,236,183,79,181,419,33.47457627118644,76.69491525423729
15186_terrestrial,245,174,84,187,419,34.285714285714285,76.32653061224491
15187_terrestrial,256,187,84,196,443,32.8125,76.5625
15188_terrestrial,257,213,84,197,470,32.68482490272373,76.65369649805449
15189_terrestrial,248,200,82,194,448,33.064516129032256,78.2258064516129
15190_terrestrial,241,195,75,194,436,31.12033195020747,80.49792531120332
15191_terrestrial,230,190,71,184,420,30.869565217391305,80
15192_terrestrial,226,183,71,177,409,31.41592920353982,78.31858407079646
15193_terrestrial,211,176,70,164,387,33.175355450236964,77.72511848341233
15194_terrestrial,217,173,76,171,390,35.02304147465438,78.80184331797236
15195_terrestrial,209,176,71,167,385,33.97129186602871,79.90430622009569
15196_terrestrial,219,181,74,176,400,33.789954337899545,80.36529680365297
15197_terrestrial,235,181,75,187,416,31.914893617021278,79.57446808510639
15198_terrestrial,242,180,80,193,422,33.057851239669425,79.75206611570248
15199_terrestrial,243,176,80,199,419,32.92181069958848,81.89300411522635
15200_terrestrial,237,183,77,194,420,32.48945147679325,81.85654008438819
15201_terrestrial,223,170,70,187,393,31.390134529147986,83.85650224215246
15202_terrestrial,226,204,71,187,430,31.41592920353982,82.7433628318584
15203_terrestrial,236,213,76,196,449,32.20338983050847,83.05084745762711
15204_terrestrial,254,225,78,212,479,30.708661417322837,83.46456692913385
15205_terrestrial,263,239,78,219,502,29.65779467680608,83.26996197718631
15206_terrestrial,255,222,73,211,477,28.627450980392155,82.74509803921568
15207_terrestrial,240,215,67,197,455,27.916666666666668,82.08333333333333
15208_terrestrial,235,218,64,190,453,27.23404255319149,80.85106382978722
15209_terrestrial,234,222,65,189,456,27.77777777777778,80.76923076923077
15210_terrestrial,236,205,67,193,441,28.389830508474578,81.77966101694916
15211_terrestrial,235,208,67,188,443,28.510638297872344,80
15212_terrestrial,248,220,79,199,468,31.85483870967742,80.24193548387096
15213_terrestrial,185,118,60,171,303,32.432432432432435,92.43243243243244
15215_terrestrial,219,187,62,179,406,28.31050228310502,81.7351598173516
15216_terrestrial,225,197,71,181,422,31.555555555555554,80.44444444444444
15217_terrestrial,207,167,61,166,374,29.468599033816425,80.19323671497585
15218_terrestrial,208,154,61,167,362,29.326923076923077,80.28846153846155
15219_terrestrial,198,148,55,156,346,27.77777777777778,78.78787878787878
15220_terrestrial,193,147,53,155,340,27.461139896373055,80.31088082901555
15221_terrestrial,194,143,56,156,337,28.865979381443296,80.41237113402062
15222_terrestrial,192,138,56,153,330,29.166666666666668,79.6875
15223_terrestrial,185,137,52,150,322,28.10810810810811,81.08108108108108
15224_terrestrial,181,138,49,146,319,27.071823204419886,80.66298342541437
15225_terrestrial,180,138,49,145,318,27.22222222222222,80.55555555555556
15226_terrestrial,180,137,52,145,317,28.888888888888886,80.55555555555556
15227_terrestrial,181,139,53,149,320,29.2817679558011,82.32044198895028
15228_terrestrial,194,161,62,157,355,31.958762886597935,80.9278350515464
15229_terrestrial,209,168,69,168,377,33.014354066985646,80.38277511961722
15230_terrestrial,261,216,106,182,477,40.61302681992337,69.73180076628353
15231_terrestrial,261,206,103,180,467,39.46360153256705,68.96551724137932
15232_terrestrial,207,151,64,160,358,30.917874396135264,77.29468599033817
15233_terrestrial,203,152,64,157,355,31.527093596059114,77.33990147783251
15234_terrestrial,251,175,110,166,426,43.82470119521912,66.13545816733067
15235_terrestrial,274,183,128,178,457,46.715328467153284,64.96350364963503
15236_terrestrial,286,200,133,187,486,46.50349650349651,65.38461538461539
15237_terrestrial,215,105,114,146,320,53.02325581395348,67.90697674418604
15240_terrestrial,229,111,120,147,340,52.40174672489083,64.19213973799127
15296_terrestrial,437,218,332,201,655,75.97254004576659,45.9954233409611
15297_terrestrial,455,225,346,212,680,76.04395604395604,46.59340659340659
15298_terrestrial,495,238,373,241,733,75.35353535353535,48.68686868686869
15299_terrestrial,504,226,378,247,730,75,49.007936507936506
15300_terrestrial,281,139,184,199,420,65.48042704626334,70.8185053380783
15301_terrestrial,271,140,176,187,411,64.94464944649447,69.00369003690037
15302_terrestrial,275,144,177,193,419,64.36363636363637,70.18181818181817
15303_terrestrial,284,143,184,201,427,64.7887323943662,70.77464788732394
15304_terrestrial,272,142,173,195,414,63.60294117647059,71.69117647058823
15305_terrestrial,276,142,179,195,418,64.85507246376811,70.65217391304348
15306_terrestrial,283,155,178,197,438,62.89752650176679,69.6113074204947
15307_terrestrial,327,169,205,227,496,62.69113149847095,69.41896024464832
15308_terrestrial,339,174,217,240,513,64.0117994100295,70.79646017699115
15309_terrestrial,341,178,221,242,519,64.80938416422288,70.96774193548387
15310_terrestrial,338,180,220,238,518,65.08875739644971,70.41420118343196
15311_terrestrial,306,180,195,216,486,63.725490196078425,70.58823529411765
15312_terrestrial,320,180,201,218,500,62.81250000000001,68.125
15313_terrestrial,305,176,189,214,481,61.967213114754095,70.16393442622952
15314_terrestrial,282,167,172,193,449,60.99290780141844,68.43971631205675
15315_terrestrial,272,173,160,183,445,58.82352941176471,67.27941176470588
15316_terrestrial,290,174,161,201,464,55.51724137931034,69.3103448275862
15317_terrestrial,339,191,208,243,530,61.35693215339233,71.68141592920354
15318_terrestrial,323,177,202,229,500,62.538699690402474,70.89783281733746
15319_terrestrial,328,183,204,234,511,62.19512195121951,71.34146341463415
15320_terrestrial,315,185,192,222,500,60.952380952380956,70.47619047619048
15321_terrestrial,323,172,203,229,495,62.848297213622295,70.89783281733746
15322_terrestrial,320,170,202,225,490,63.125,70.3125
15323_terrestrial,338,175,206,242,513,60.946745562130175,71.59763313609467
15324_terrestrial,324,170,187,227,494,57.71604938271605,70.06172839506173
15325_terrestrial,323,172,185,224,495,57.27554179566563,69.3498452012384
15326_terrestrial,326,170,188,225,496,57.668711656441715,69.01840490797547
15327_terrestrial,325,160,190,230,485,58.46153846153847,70.76923076923077
15328_terrestrial,315,170,198,217,485,62.857142857142854,68.88888888888889
15329_terrestrial,306,160,194,210,466,63.39869281045751,68.62745098039215
15330_terrestrial,320,172,205,214,492,64.0625,66.875
15331_terrestrial,310,173,200,204,483,64.51612903225806,65.80645161290323
15332_terrestrial,310,156,204,212,466,65.80645161290323,68.38709677419355
15333_terrestrial,301,161,201,204,462,66.77740863787376,67.77408637873754
15334_terrestrial,293,167,199,202,460,67.91808873720136,68.94197952218431
15335_terrestrial,293,167,198,204,460,67.57679180887372,69.6245733788396
15336_terrestrial,281,160,193,200,441,68.68327402135232,71.17437722419929
15337_terrestrial,266,146,183,191,412,68.796992481203,71.80451127819549
15338_terrestrial,301,171,216,197,472,71.76079734219269,65.4485049833887
15339_terrestrial,307,178,222,193,485,72.31270358306189,62.866449511400646
15340_terrestrial,333,200,231,213,533,69.36936936936937,63.96396396396396
15341_terrestrial,289,162,194,201,451,67.1280276816609,69.55017301038062
15342_terrestrial,274,151,183,197,425,66.78832116788321,71.8978102189781
15343_terrestrial,263,150,180,191,413,68.44106463878326,72.6235741444867
15344_terrestrial,241,144,162,177,385,67.21991701244814,73.44398340248964
15345_terrestrial,249,141,175,167,390,70.28112449799197,67.06827309236948
15346_terrestrial,237,126,164,161,363,69.19831223628692,67.9324894514768
15347_terrestrial,248,123,170,165,371,68.54838709677419,66.53225806451613
15348_terrestrial,243,126,166,160,369,68.3127572016461,65.84362139917695
15349_terrestrial,244,140,169,155,384,69.26229508196722,63.52459016393443
15350_terrestrial,246,116,170,161,362,69.10569105691057,65.4471544715447
15351_terrestrial,239,111,164,153,350,68.6192468619247,64.01673640167364
15352_terrestrial,246,129,175,155,375,71.13821138211382,63.00813008130082
15353_terrestrial,237,122,168,147,359,70.88607594936708,62.0253164556962
15354_terrestrial,212,115,146,135,327,68.86792452830188,63.67924528301887
15355_terrestrial,168,105,111,123,273,66.07142857142857,73.21428571428571
15356_terrestrial,157,104,104,114,261,66.2420382165605,72.61146496815286
15357_terrestrial,154,102,101,114,256,65.5844155844156,74.02597402597402
15358_terrestrial,158,96,102,120,254,64.55696202531645,75.9493670886076
15359_terrestrial,168,103,107,121,271,63.69047619047619,72.02380952380952
15381_terrestrial,233,132,145,177,365,62.231759656652365,75.9656652360515
15382_terrestrial,248,139,156,185,387,62.903225806451616,74.59677419354838
15383_terrestrial,257,149,165,193,406,64.2023346303502,75.09727626459144
15384_terrestrial,268,166,168,203,434,62.68656716417911,75.74626865671642
15385_terrestrial,268,183,167,205,451,62.31343283582089,76.49253731343283
15386_terrestrial,275,182,173,213,457,62.909090909090914,77.45454545454545
15397_terrestrial,210,132,127,161,342,60.476190476190474,76.66666666666667
15398_terrestrial,214,128,130,164,342,60.747663551401864,76.63551401869158
15399_terrestrial,208,118,127,154,326,61.057692307692314,74.03846153846155
15400_terrestrial,200,115,119,147,315,59.5,73.5
15401_terrestrial,198,119,120,144,317,60.60606060606061,72.72727272727273
15402_terrestrial,200,120,122,148,320,61,74
15403_terrestrial,194,122,119,144,316,61.34020618556701,74.22680412371135
15404_terrestrial,187,116,112,137,303,59.893048128342244,73.2620320855615
15405_terrestrial,186,113,114,136,299,61.29032258064516,73.11827956989248
15406_terrestrial,190,115,117,135,305,61.578947368421055,71.05263157894737
15407_terrestrial,197,125,122,141,322,61.92893401015228,71.57360406091371
15408_terrestrial,193,127,119,135,320,61.6580310880829,69.94818652849742
15409_terrestrial,193,125,117,133,318,60.62176165803109,68.9119170984456
15410_terrestrial,190,119,116,127,309,61.05263157894737,66.84210526315789
15411_terrestrial,184,110,114,126,294,61.95652173913043,68.47826086956522
15412_terrestrial,175,104,113,124,279,64.57142857142857,70.85714285714285
15413_terrestrial,170,97,113,122,267,66.47058823529412,71.76470588235294
15414_terrestrial,163,94,107,117,257,65.6441717791411,71.77914110429448
15415_terrestrial,161,93,110,119,254,68.32298136645963,73.91304347826086
15416_terrestrial,180,99,117,130,279,65,72.22222222222221
15417_terrestrial,190,99,120,136,289,63.1578947368421,71.57894736842105
15418_terrestrial,197,106,123,144,303,62.43654822335025,73.09644670050761
15419_terrestrial,214,118,135,158,332,63.084112149532714,73.83177570093457
15420_terrestrial,229,125,142,174,354,62.00873362445415,75.9825327510917
15421_terrestrial,242,124,151,183,366,62.396694214876035,75.6198347107438
15422_terrestrial,245,126,156,187,371,63.6734693877551,76.32653061224491
15423_terrestrial,248,125,159,190,373,64.11290322580645,76.61290322580645
15424_terrestrial,250,129,163,191,379,65.2,76.4
15425_terrestrial,246,122,162,189,368,65.85365853658537,76.82926829268293
15426_terrestrial,245,119,162,188,364,66.12244897959184,76.73469387755102
15427_terrestrial,252,123,165,197,375,65.47619047619048,78.17460317460318
15428_terrestrial,259,130,167,203,389,64.47876447876449,78.37837837837837
15429_terrestrial,269,131,173,202,400,64.31226765799256,75.09293680297398
15430_terrestrial,273,137,177,206,410,64.83516483516483,75.45787545787546
15431_terrestrial,285,146,185,217,431,64.91228070175438,76.14035087719299
15432_terrestrial,280,142,182,212,422,65,75.71428571428571
15433_terrestrial,284,137,184,213,421,64.7887323943662,75
15434_terrestrial,272,145,175,202,417,64.33823529411765,74.26470588235294
15435_terrestrial,281,148,185,210,429,65.83629893238434,74.73309608540926
15436_terrestrial,264,133,173,201,397,65.53030303030303,76.13636363636364
15437_terrestrial,249,128,160,189,377,64.2570281124498,75.90361445783132
15438_terrestrial,247,114,157,185,361,63.56275303643725,74.89878542510121
15439_terrestrial,295,138,198,190,433,67.11864406779661,64.40677966101694
15440_terrestrial,278,128,188,181,406,67.62589928057554,65.10791366906474
15442_terrestrial,260,128,171,170,388,65.76923076923077,65.38461538461539
15443_terrestrial,269,139,179,175,408,66.54275092936803,65.05576208178438
15444_terrestrial,244,123,161,164,367,65.98360655737704,67.21311475409836
15536_terrestrial,305,227,162,188,532,53.11475409836065,61.63934426229508
15537_terrestrial,346,280,177,225,626,51.15606936416185,65.02890173410405
15538_terrestrial,243,247,88,200,490,36.21399176954733,82.3045267489712
15539_terrestrial,242,256,79,192,498,32.64462809917356,79.33884297520662
15540_terrestrial,249,237,88,195,486,35.34136546184739,78.3132530120482
15541_terrestrial,223,203,86,178,426,38.56502242152467,79.82062780269058
15542_terrestrial,241,212,84,186,453,34.85477178423236,77.17842323651453
15543_terrestrial,256,217,87,197,473,33.984375,76.953125
15544_terrestrial,245,207,74,186,452,30.20408163265306,75.91836734693878
15545_terrestrial,222,180,66,171,402,29.72972972972973,77.02702702702703
15546_terrestrial,236,183,78,179,419,33.05084745762712,75.84745762711864
15547_terrestrial,255,177,83,191,432,32.549019607843135,74.90196078431373
15548_terrestrial,245,195,82,185,440,33.46938775510204,75.51020408163265
15549_terrestrial,252,186,83,194,438,32.93650793650794,76.98412698412699
15550_terrestrial,247,193,78,194,440,31.57894736842105,78.54251012145748
15551_terrestrial,243,191,73,193,434,30.04115226337449,79.42386831275721
15552_terrestrial,234,178,77,182,412,32.9059829059829,77.77777777777779
15553_terrestrial,218,172,71,170,390,32.56880733944954,77.98165137614679
15554_terrestrial,208,163,70,166,371,33.65384615384615,79.8076923076923
15555_terrestrial,211,182,69,164,393,32.70142180094787,77.72511848341233
15556_terrestrial,222,175,71,172,397,31.98198198198198,77.47747747747748
15557_terrestrial,228,165,69,180,393,30.263157894736842,78.94736842105263
15558_terrestrial,232,165,72,186,397,31.03448275862069,80.17241379310344
15559_terrestrial,237,169,79,195,406,33.33333333333333,82.27848101265823
15560_terrestrial,244,171,81,200,415,33.19672131147541,81.9672131147541
15561_terrestrial,234,178,74,193,412,31.62393162393162,82.47863247863248
15562_terrestrial,225,201,68,188,426,30.22222222222222,83.55555555555556
15563_terrestrial,242,206,74,203,448,30.57851239669421,83.88429752066115
15564_terrestrial,247,225,75,207,472,30.364372469635626,83.80566801619433
15565_terrestrial,258,225,77,217,483,29.844961240310074,84.10852713178295
15566_terrestrial,267,216,74,225,483,27.715355805243448,84.26966292134831
15567_terrestrial,269,230,77,224,499,28.624535315985128,83.27137546468401
15568_terrestrial,272,281,84,221,553,30.88235294117647,81.25
15569_terrestrial,257,274,78,207,531,30.35019455252918,80.54474708171206
15570_terrestrial,244,257,76,199,501,31.147540983606557,81.55737704918032
15571_terrestrial,240,238,75,195,478,31.25,81.25
15572_terrestrial,253,252,80,205,505,31.620553359683797,81.02766798418972
15573_terrestrial,247,232,77,201,479,31.17408906882591,81.37651821862349
15574_terrestrial,248,226,78,202,474,31.451612903225808,81.45161290322581
15575_terrestrial,241,231,77,195,472,31.950207468879665,80.91286307053942
15576_terrestrial,266,288,83,215,554,31.203007518796994,80.82706766917293
15577_terrestrial,260,252,80,212,512,30.76923076923077,81.53846153846153
15578_terrestrial,243,196,71,202,439,29.218106995884774,83.1275720164609
15579_terrestrial,248,199,74,207,447,29.838709677419356,83.46774193548387
15580_terrestrial,228,182,67,188,410,29.385964912280706,82.45614035087719
15581_terrestrial,217,175,64,177,392,29.493087557603687,81.5668202764977
15582_terrestrial,218,169,61,178,387,27.981651376146786,81.65137614678899
15583_terrestrial,222,166,66,180,388,29.72972972972973,81.08108108108108
15584_terrestrial,215,168,64,174,383,29.767441860465116,80.93023255813954
15585_terrestrial,207,179,61,166,386,29.468599033816425,80.19323671497585
15586_terrestrial,215,193,66,169,408,30.697674418604652,78.6046511627907
15587_terrestrial,262,234,91,195,496,34.73282442748092,74.42748091603053
15588_terrestrial,267,234,93,200,501,34.831460674157306,74.90636704119851
15589_terrestrial,270,228,98,199,498,36.2962962962963,73.70370370370371
15590_terrestrial,268,244,100,191,512,37.3134328358209,71.26865671641791
15591_terrestrial,209,169,63,161,378,30.14354066985646,77.03349282296651
15592_terrestrial,199,166,59,154,365,29.64824120603015,77.38693467336684
15593_terrestrial,202,158,58,155,360,28.71287128712871,76.73267326732673
15594_terrestrial,208,153,65,164,361,31.25,78.84615384615384
15595_terrestrial,271,190,122,181,461,45.018450184501845,66.78966789667896
15596_terrestrial,302,226,143,192,528,47.35099337748344,63.576158940397356
15597_terrestrial,287,203,140,181,490,48.78048780487805,63.06620209059234
15598_terrestrial,235,113,128,153,348,54.46808510638298,65.1063829787234
15599_terrestrial,241,120,128,153,361,53.11203319502075,63.48547717842323
15600_terrestrial,249,124,134,156,373,53.81526104417671,62.65060240963856
15601_terrestrial,234,120,122,157,354,52.13675213675214,67.09401709401709
15658_terrestrial,443,223,337,198,666,76.07223476297969,44.69525959367946
15659_terrestrial,502,244,385,235,746,76.69322709163346,46.81274900398406
15660_terrestrial,313,145,219,213,458,69.96805111821087,68.05111821086261
15661_terrestrial,271,143,179,187,414,66.05166051660517,69.00369003690037
15662_terrestrial,275,147,178,193,422,64.72727272727272,70.18181818181817
15663_terrestrial,283,154,180,201,437,63.60424028268551,71.02473498233216
15664_terrestrial,289,153,184,205,442,63.667820069204154,70.93425605536332
15665_terrestrial,295,155,190,208,450,64.40677966101694,70.50847457627118
15666_terrestrial,337,168,207,244,505,61.42433234421365,72.40356083086054
15667_terrestrial,359,189,229,257,548,63.788300835654596,71.58774373259052
15668_terrestrial,350,208,223,242,558,63.714285714285715,69.14285714285714
15669_terrestrial,339,211,216,230,550,63.716814159292035,67.84660766961652
15670_terrestrial,325,205,206,221,530,63.38461538461539,68
15671_terrestrial,295,200,177,193,495,60,65.42372881355932
15672_terrestrial,307,209,191,197,516,62.21498371335505,64.16938110749186
15673_terrestrial,363,208,219,248,571,60.33057851239669,68.31955922865014
15674_terrestrial,398,224,239,270,622,60.050251256281406,67.8391959798995
15675_terrestrial,327,191,193,223,518,59.021406727828754,68.19571865443424
15676_terrestrial,329,181,197,231,510,59.87841945288754,70.2127659574468
15677_terrestrial,332,183,211,240,515,63.55421686746988,72.28915662650603
15678_terrestrial,315,169,197,219,484,62.53968253968254,69.52380952380952
15679_terrestrial,314,175,195,219,489,62.101910828025474,69.7452229299363
15680_terrestrial,302,175,193,209,477,63.90728476821192,69.20529801324503
15681_terrestrial,304,166,198,212,470,65.13157894736842,69.73684210526315
15682_terrestrial,322,171,201,221,493,62.422360248447205,68.63354037267081
15683_terrestrial,317,176,184,219,493,58.0441640378549,69.08517350157729
15684_terrestrial,302,176,179,210,478,59.27152317880795,69.5364238410596
15685_terrestrial,310,174,182,213,484,58.70967741935483,68.70967741935485
15686_terrestrial,291,179,168,202,470,57.73195876288659,69.41580756013745
15687_terrestrial,317,165,185,220,482,58.359621451104104,69.4006309148265
15688_terrestrial,305,165,192,207,470,62.95081967213115,67.8688524590164
15689_terrestrial,334,184,220,238,518,65.86826347305389,71.25748502994011
15690_terrestrial,341,182,228,235,523,66.86217008797654,68.91495601173021
15691_terrestrial,391,212,275,241,603,70.33248081841433,61.63682864450127
15692_terrestrial,367,210,261,225,577,71.11716621253406,61.30790190735694
15693_terrestrial,362,218,256,223,580,70.71823204419888,61.60220994475139
15694_terrestrial,365,221,266,228,586,72.87671232876713,62.465753424657535
15695_terrestrial,320,176,234,212,496,73.125,66.25
15696_terrestrial,291,160,210,187,451,72.16494845360825,64.26116838487972
15697_terrestrial,286,159,207,183,445,72.37762237762237,63.98601398601399
15698_terrestrial,320,166,229,207,486,71.5625,64.6875
15699_terrestrial,310,160,222,197,470,71.61290322580646,63.54838709677419
15700_terrestrial,274,144,189,192,418,68.97810218978103,70.07299270072993
15701_terrestrial,269,154,189,189,423,70.26022304832715,70.26022304832715
15702_terrestrial,257,148,174,185,405,67.70428015564202,71.98443579766537
15703_terrestrial,237,136,158,176,373,66.66666666666666,74.26160337552743
15704_terrestrial,226,125,149,168,351,65.929203539823,74.33628318584071
15705_terrestrial,227,118,152,165,345,66.96035242290749,72.68722466960352
15706_terrestrial,213,104,139,156,317,65.25821596244131,73.23943661971832
15707_terrestrial,252,140,172,168,392,68.25396825396825,66.66666666666666
15708_terrestrial,254,143,176,170,397,69.29133858267717,66.92913385826772
15709_terrestrial,263,151,185,168,414,70.34220532319392,63.87832699619772
15710_terrestrial,265,139,185,170,404,69.81132075471697,64.15094339622641
15711_terrestrial,228,107,160,148,335,70.17543859649122,64.91228070175438
15712_terrestrial,216,115,154,135,331,71.29629629629629,62.5
15713_terrestrial,219,110,154,135,329,70.31963470319634,61.64383561643836
15714_terrestrial,218,120,151,129,338,69.26605504587155,59.174311926605505
15715_terrestrial,153,96,97,107,249,63.39869281045751,69.93464052287581
15716_terrestrial,144,98,91,100,242,63.19444444444444,69.44444444444444
15717_terrestrial,148,96,94,98,244,63.51351351351351,66.21621621621621
15741_terrestrial,239,141,141,183,380,58.995815899581594,76.56903765690377
15742_terrestrial,250,150,151,188,400,60.4,75.2
15743_terrestrial,254,165,156,194,419,61.417322834645674,76.37795275590551
15755_terrestrial,188,116,113,139,304,60.1063829787234,73.93617021276596
15756_terrestrial,181,114,105,139,295,58.011049723756905,76.79558011049724
15757_terrestrial,183,118,111,140,301,60.65573770491803,76.50273224043715
15758_terrestrial,181,129,108,133,310,59.66850828729282,73.48066298342542
15759_terrestrial,188,128,113,138,316,60.1063829787234,73.40425531914893
15760_terrestrial,191,123,114,138,314,59.68586387434554,72.25130890052355
15761_terrestrial,187,125,112,132,312,59.893048128342244,70.58823529411765
15762_terrestrial,173,125,104,124,298,60.115606936416185,71.67630057803468
15763_terrestrial,173,122,104,123,295,60.115606936416185,71.09826589595376
15764_terrestrial,169,112,103,119,281,60.946745562130175,70.41420118343196
15765_terrestrial,166,103,100,114,269,60.24096385542169,68.67469879518072
15766_terrestrial,157,97,97,110,254,61.78343949044586,70.06369426751591
15767_terrestrial,156,91,99,108,247,63.46153846153846,69.23076923076923
15768_terrestrial,155,90,100,105,245,64.51612903225806,67.74193548387096
15769_terrestrial,153,96,97,103,249,63.39869281045751,67.3202614379085
15770_terrestrial,156,93,98,104,249,62.82051282051282,66.66666666666666
15771_terrestrial,154,95,98,105,249,63.63636363636363,68.18181818181817
15772_terrestrial,147,93,96,101,240,65.3061224489796,68.70748299319727
15773_terrestrial,144,88,97,103,232,67.36111111111111,71.52777777777779
15774_terrestrial,137,83,91,98,220,66.42335766423358,71.53284671532847
15775_terrestrial,143,83,95,103,226,66.43356643356644,72.02797202797203
15776_terrestrial,143,83,94,106,226,65.73426573426573,74.12587412587412
15777_terrestrial,165,92,107,121,257,64.84848484848484,73.33333333333333
15778_terrestrial,175,100,106,130,275,60.57142857142858,74.28571428571429
15779_terrestrial,197,103,122,144,300,61.92893401015228,73.09644670050761
15780_terrestrial,217,116,140,157,333,64.51612903225806,72.35023041474655
15781_terrestrial,224,109,143,164,333,63.83928571428571,73.21428571428571
15782_terrestrial,240,123,155,180,363,64.58333333333334,75
15783_terrestrial,249,124,163,191,373,65.46184738955823,76.70682730923694
15784_terrestrial,241,131,158,186,372,65.56016597510373,77.17842323651453
15785_terrestrial,243,124,159,189,367,65.4320987654321,77.77777777777779
15786_terrestrial,243,112,162,190,355,66.66666666666666,78.18930041152264
15787_terrestrial,253,122,170,199,375,67.19367588932806,78.65612648221344
15788_terrestrial,265,126,176,209,391,66.41509433962264,78.8679245283019
15789_terrestrial,271,137,178,209,408,65.68265682656826,77.12177121771218
15790_terrestrial,275,134,178,208,409,64.72727272727272,75.63636363636364
15791_terrestrial,270,137,173,205,407,64.07407407407408,75.92592592592592
15792_terrestrial,271,144,178,205,415,65.68265682656826,75.64575645756457
15793_terrestrial,272,150,176,203,422,64.70588235294117,74.63235294117648
15794_terrestrial,287,154,187,216,441,65.1567944250871,75.26132404181185
15795_terrestrial,283,151,186,212,434,65.7243816254417,74.91166077738515
15796_terrestrial,260,133,170,199,393,65.38461538461539,76.53846153846153
15797_terrestrial,251,124,163,190,375,64.9402390438247,75.69721115537848
15798_terrestrial,246,117,159,181,363,64.63414634146342,73.57723577235772
15799_terrestrial,288,137,193,185,425,67.01388888888889,64.23611111111111
15802_terrestrial,268,131,179,176,399,66.7910447761194,65.67164179104478
15803_terrestrial,284,149,192,177,433,67.6056338028169,62.323943661971825
15804_terrestrial,261,140,175,174,401,67.04980842911877,66.66666666666666
15896_terrestrial,314,226,166,189,540,52.86624203821656,60.19108280254777
15897_terrestrial,342,292,177,215,634,51.75438596491229,62.86549707602339
15898_terrestrial,240,264,83,191,504,34.583333333333336,79.58333333333333
15899_terrestrial,252,275,84,200,527,33.33333333333333,79.36507936507937
15900_terrestrial,236,242,87,186,478,36.86440677966102,78.8135593220339
15901_terrestrial,242,215,84,192,457,34.710743801652896,79.33884297520662
15902_terrestrial,251,221,84,197,472,33.46613545816733,78.48605577689243
15903_terrestrial,247,202,82,191,449,33.198380566801625,77.32793522267207
15904_terrestrial,238,205,74,185,443,31.092436974789916,77.73109243697479
15905_terrestrial,226,175,65,176,401,28.761061946902654,77.87610619469027
15906_terrestrial,232,182,73,173,414,31.46551724137931,74.56896551724138
15907_terrestrial,246,192,78,185,438,31.70731707317073,75.20325203252033
15908_terrestrial,245,189,79,188,434,32.244897959183675,76.73469387755102
15909_terrestrial,257,189,87,194,446,33.85214007782101,75.4863813229572
15910_terrestrial,257,199,88,192,456,34.24124513618677,74.70817120622569
15911_terrestrial,254,198,82,197,452,32.28346456692913,77.55905511811024
15912_terrestrial,248,191,79,192,439,31.85483870967742,77.41935483870968
15913_terrestrial,236,189,76,183,425,32.20338983050847,77.54237288135593
15914_terrestrial,224,180,72,175,404,32.142857142857146,78.125
15915_terrestrial,227,176,73,174,403,32.158590308370044,76.65198237885463
15916_terrestrial,230,178,77,176,408,33.47826086956522,76.52173913043478
15917_terrestrial,224,170,70,178,394,31.25,79.46428571428571
15918_terrestrial,224,153,71,180,377,31.69642857142857,80.35714285714286
15919_terrestrial,227,166,70,186,393,30.837004405286343,81.93832599118943
15920_terrestrial,246,166,81,205,412,32.926829268292686,83.33333333333334
15921_terrestrial,243,179,75,202,422,30.864197530864196,83.1275720164609
15922_terrestrial,230,173,69,189,403,30,82.17391304347827
15923_terrestrial,245,210,71,207,455,28.97959183673469,84.48979591836735
15924_terrestrial,249,225,73,212,474,29.31726907630522,85.14056224899599
15925_terrestrial,254,230,76,211,484,29.92125984251969,83.07086614173228
15926_terrestrial,260,217,76,219,477,29.230769230769234,84.23076923076923
15927_terrestrial,270,270,76,229,540,28.14814814814815,84.81481481481481
15928_terrestrial,275,302,79,230,577,28.72727272727273,83.63636363636363
15929_terrestrial,266,292,79,221,558,29.69924812030075,83.0827067669173
15930_terrestrial,252,280,77,208,532,30.555555555555557,82.53968253968253
15931_terrestrial,256,265,79,212,521,30.859375,82.8125
15932_terrestrial,254,252,78,208,506,30.708661417322837,81.88976377952756
15933_terrestrial,270,259,84,221,529,31.11111111111111,81.85185185185185
15934_terrestrial,266,234,81,217,500,30.451127819548873,81.57894736842105
15935_terrestrial,258,262,79,212,520,30.620155038759687,82.17054263565892
15936_terrestrial,260,291,82,214,551,31.538461538461537,82.3076923076923
15937_terrestrial,264,267,83,217,531,31.439393939393938,82.1969696969697
15938_terrestrial,178,99,59,167,277,33.146067415730336,93.82022471910112
15939_terrestrial,259,239,80,215,498,30.888030888030887,83.01158301158301
15940_terrestrial,247,216,75,202,463,30.364372469635626,81.78137651821862
15941_terrestrial,246,222,76,201,468,30.89430894308943,81.70731707317073
15942_terrestrial,225,201,64,181,426,28.444444444444443,80.44444444444444
15943_terrestrial,239,213,68,192,452,28.451882845188287,80.3347280334728
15944_terrestrial,246,212,70,199,458,28.455284552845526,80.89430894308943
15945_terrestrial,249,224,73,202,473,29.31726907630522,81.12449799196787
15946_terrestrial,299,311,103,228,610,34.448160535117054,76.2541806020067
15947_terrestrial,290,301,98,224,591,33.793103448275865,77.24137931034483
15948_terrestrial,234,237,71,190,471,30.34188034188034,81.19658119658119
15949_terrestrial,236,220,71,185,456,30.08474576271186,78.38983050847457
15950_terrestrial,221,203,67,175,424,30.316742081447963,79.18552036199095
15951_terrestrial,216,194,67,171,410,31.01851851851852,79.16666666666666
15952_terrestrial,222,198,71,177,420,31.98198198198198,79.72972972972973
15953_terrestrial,345,254,172,206,599,49.85507246376812,59.710144927536234
15954_terrestrial,344,218,175,206,562,50.872093023255815,59.883720930232556
15955_terrestrial,331,218,172,198,549,51.963746223564954,59.818731117824775
15956_terrestrial,320,216,165,189,536,51.5625,59.06249999999999
15957_terrestrial,312,203,161,183,515,51.60256410256411,58.65384615384615
15958_terrestrial,311,211,158,194,522,50.80385852090033,62.37942122186495
15959_terrestrial,305,204,155,182,509,50.81967213114754,59.67213114754099
15960_terrestrial,249,129,132,156,378,53.01204819277109,62.65060240963856
15961_terrestrial,239,123,128,154,362,53.55648535564853,64.43514644351464
16019_terrestrial,491,257,375,221,748,76.37474541751527,45.010183299389
16020_terrestrial,510,261,386,238,771,75.68627450980392,46.666666666666664
16021_terrestrial,267,154,172,189,421,64.41947565543072,70.78651685393258
16022_terrestrial,266,150,168,190,416,63.1578947368421,71.42857142857143
16023_terrestrial,286,162,181,205,448,63.286713286713294,71.67832167832168
16024_terrestrial,289,162,181,209,451,62.629757785467135,72.31833910034602
16025_terrestrial,319,180,201,221,499,63.00940438871473,69.27899686520375
16026_terrestrial,343,184,213,240,527,62.09912536443149,69.97084548104957
16027_terrestrial,342,210,210,236,552,61.40350877192983,69.00584795321637
16028_terrestrial,357,209,225,249,566,63.02521008403361,69.74789915966386
16029_terrestrial,355,192,227,255,547,63.94366197183099,71.83098591549296
16030_terrestrial,338,189,206,244,527,60.946745562130175,72.18934911242604
16031_terrestrial,337,206,209,248,543,62.01780415430267,73.59050445103857
16032_terrestrial,368,207,229,271,575,62.22826086956522,73.6413043478261
16033_terrestrial,560,325,403,286,885,71.96428571428571,51.07142857142857
16034_terrestrial,601,342,423,303,943,70.38269550748753,50.41597337770383
16035_terrestrial,584,364,406,281,948,69.52054794520548,48.11643835616438
16036_terrestrial,371,214,213,250,585,57.41239892183289,67.38544474393531
16037_terrestrial,311,179,190,218,490,61.09324758842444,70.09646302250803
16038_terrestrial,313,173,195,221,486,62.30031948881789,70.6070287539936
16039_terrestrial,325,178,204,231,503,62.76923076923077,71.07692307692308
16040_terrestrial,320,183,202,225,503,63.125,70.3125
16041_terrestrial,319,185,203,226,504,63.63636363636363,70.84639498432603
16042_terrestrial,336,193,204,232,529,60.71428571428571,69.04761904761905
16043_terrestrial,303,202,174,208,505,57.42574257425742,68.64686468646865
16044_terrestrial,303,179,171,211,482,56.43564356435643,69.63696369636963
16045_terrestrial,308,185,175,212,493,56.81818181818182,68.83116883116884
16046_terrestrial,309,182,178,214,491,57.60517799352751,69.25566343042071
16047_terrestrial,338,189,207,238,527,61.24260355029586,70.41420118343196
16048_terrestrial,349,179,224,245,528,64.18338108882521,70.20057306590259
16049_terrestrial,374,201,256,261,575,68.44919786096256,69.78609625668449
16050_terrestrial,420,239,296,260,659,70.47619047619048,61.904761904761905
16051_terrestrial,363,191,255,219,554,70.24793388429752,60.33057851239669
16053_terrestrial,297,166,217,190,463,73.06397306397307,63.97306397306397
16054_terrestrial,350,197,246,223,547,70.28571428571428,63.714285714285715
16055_terrestrial,332,166,234,219,498,70.48192771084338,65.96385542168674
16056_terrestrial,343,193,244,215,536,71.13702623906705,62.68221574344023
16057_terrestrial,367,202,262,228,569,71.38964577656675,62.125340599455036
16058_terrestrial,348,201,247,215,549,70.97701149425288,61.7816091954023
16059_terrestrial,347,188,239,228,535,68.87608069164266,65.70605187319885
16060_terrestrial,289,155,189,214,444,65.39792387543253,74.0484429065744
16061_terrestrial,273,155,171,208,428,62.637362637362635,76.19047619047619
16062_terrestrial,269,162,170,202,431,63.19702602230484,75.09293680297398
16063_terrestrial,253,152,165,192,405,65.21739130434783,75.8893280632411
16064_terrestrial,236,137,159,176,373,67.37288135593221,74.57627118644068
16065_terrestrial,230,127,156,170,357,67.82608695652173,73.91304347826086
16066_terrestrial,242,130,172,162,372,71.07438016528926,66.94214876033058
16067_terrestrial,253,129,175,170,382,69.1699604743083,67.19367588932806
16068_terrestrial,266,141,185,177,407,69.54887218045113,66.54135338345864
16069_terrestrial,244,127,174,163,371,71.31147540983606,66.80327868852459
16073_terrestrial,179,110,120,109,289,67.0391061452514,60.893854748603346
16074_terrestrial,176,107,117,106,283,66.47727272727273,60.22727272727273
16075_terrestrial,145,92,94,97,237,64.82758620689654,66.89655172413794
16100_terrestrial,277,169,161,209,446,58.12274368231047,75.45126353790613
16101_terrestrial,271,176,160,206,447,59.040590405904055,76.01476014760148
16102_terrestrial,261,177,155,200,438,59.38697318007663,76.62835249042146
16119_terrestrial,164,109,101,114,273,61.58536585365854,69.51219512195121
16120_terrestrial,165,113,102,115,278,61.81818181818181,69.6969696969697
16121_terrestrial,162,118,99,111,280,61.111111111111114,68.51851851851852
16122_terrestrial,158,119,99,108,277,62.65822784810127,68.35443037974683
16123_terrestrial,152,115,91,104,267,59.86842105263158,68.42105263157895
16124_terrestrial,150,108,93,105,258,62,70
16125_terrestrial,145,95,91,104,240,62.758620689655174,71.72413793103448
16126_terrestrial,136,93,89,95,229,65.44117647058823,69.85294117647058
16127_terrestrial,139,92,91,95,231,65.46762589928058,68.34532374100719
16128_terrestrial,133,90,87,91,223,65.41353383458647,68.42105263157895
16129_terrestrial,136,92,91,90,228,66.91176470588235,66.17647058823529
16130_terrestrial,133,95,90,89,228,67.66917293233082,66.9172932330827
16131_terrestrial,133,89,89,89,222,66.9172932330827,66.9172932330827
16132_terrestrial,135,92,89,94,227,65.92592592592592,69.62962962962963
16133_terrestrial,134,96,89,93,230,66.4179104477612,69.40298507462687
16134_terrestrial,139,88,93,96,227,66.90647482014388,69.06474820143885
16135_terrestrial,135,97,88,98,232,65.18518518518519,72.5925925925926
16136_terrestrial,144,92,94,107,236,65.27777777777779,74.30555555555556
16137_terrestrial,162,100,102,121,262,62.96296296296296,74.69135802469135
16138_terrestrial,174,99,110,129,273,63.2183908045977,74.13793103448276
16139_terrestrial,186,93,117,140,279,62.903225806451616,75.26881720430107
16140_terrestrial,209,101,134,155,310,64.11483253588517,74.16267942583733
16141_terrestrial,232,108,150,177,340,64.65517241379311,76.29310344827587
16142_terrestrial,240,108,158,182,348,65.83333333333333,75.83333333333333
16143_terrestrial,236,113,161,182,349,68.22033898305084,77.11864406779661
16144_terrestrial,246,121,166,189,367,67.47967479674797,76.82926829268293
16145_terrestrial,236,123,159,187,359,67.37288135593221,79.23728813559322
16146_terrestrial,237,115,160,188,352,67.51054852320675,79.32489451476793
16147_terrestrial,255,133,171,205,388,67.05882352941175,80.3921568627451
16148_terrestrial,266,141,176,208,407,66.16541353383458,78.19548872180451
16149_terrestrial,265,148,175,203,413,66.0377358490566,76.60377358490567
16150_terrestrial,271,144,179,208,415,66.05166051660517,76.75276752767527
16151_terrestrial,269,155,178,207,424,66.17100371747212,76.95167286245353
16152_terrestrial,292,159,191,223,451,65.41095890410958,76.36986301369863
16153_terrestrial,296,155,193,223,451,65.2027027027027,75.33783783783784
16154_terrestrial,293,155,195,224,448,66.55290102389078,76.45051194539249
16155_terrestrial,274,145,183,206,419,66.78832116788321,75.18248175182481
16156_terrestrial,264,132,176,196,396,66.66666666666666,74.24242424242425
16157_terrestrial,320,149,221,209,469,69.0625,65.3125
16158_terrestrial,296,143,200,192,439,67.56756756756756,64.86486486486487
16162_terrestrial,379,226,258,242,605,68.07387862796834,63.852242744063325
16163_terrestrial,373,198,253,240,571,67.828418230563,64.343163538874
16256_terrestrial,318,234,170,193,552,53.459119496855344,60.691823899371066
16257_terrestrial,241,234,86,192,475,35.684647302904565,79.66804979253112
16258_terrestrial,239,252,80,189,491,33.47280334728033,79.07949790794979
16259_terrestrial,246,270,82,197,516,33.33333333333333,80.08130081300813
16260_terrestrial,229,219,76,186,448,33.18777292576419,81.22270742358079
16261_terrestrial,237,206,77,194,443,32.48945147679325,81.85654008438819
16262_terrestrial,237,219,76,189,456,32.06751054852321,79.74683544303798
16263_terrestrial,249,228,80,193,477,32.1285140562249,77.51004016064257
16264_terrestrial,243,232,78,187,475,32.098765432098766,76.95473251028807
16265_terrestrial,229,194,72,178,423,31.4410480349345,77.72925764192141
16266_terrestrial,229,194,70,174,423,30.567685589519648,75.9825327510917
16267_terrestrial,237,208,77,179,445,32.48945147679325,75.52742616033755
16268_terrestrial,244,196,81,185,440,33.19672131147541,75.81967213114754
16269_terrestrial,259,199,90,195,458,34.74903474903475,75.2895752895753
16270_terrestrial,259,190,87,193,449,33.59073359073359,74.5173745173745
16271_terrestrial,253,194,81,194,447,32.015810276679844,76.6798418972332
16272_terrestrial,241,189,76,185,430,31.535269709543567,76.76348547717843
16273_terrestrial,236,192,74,184,428,31.35593220338983,77.96610169491525
16274_terrestrial,235,186,76,181,421,32.340425531914896,77.02127659574468
16275_terrestrial,237,179,79,183,416,33.33333333333333,77.21518987341773
16276_terrestrial,242,184,80,188,426,33.057851239669425,77.68595041322314
16277_terrestrial,241,193,75,192,434,31.12033195020747,79.66804979253112
16278_terrestrial,234,175,73,189,409,31.196581196581196,80.76923076923077
16279_terrestrial,237,167,73,196,404,30.801687763713083,82.70042194092827
16280_terrestrial,246,177,78,205,423,31.70731707317073,83.33333333333334
16281_terrestrial,253,175,79,212,428,31.225296442687743,83.79446640316206
16282_terrestrial,244,172,74,203,416,30.327868852459016,83.19672131147541
16283_terrestrial,246,196,74,204,442,30.081300813008134,82.92682926829268
16284_terrestrial,239,220,72,203,459,30.125523012552303,84.93723849372385
16285_terrestrial,237,229,71,201,466,29.957805907172997,84.81012658227847
16286_terrestrial,236,231,70,199,467,29.66101694915254,84.32203389830508
16287_terrestrial,251,281,72,215,532,28.68525896414343,85.65737051792829
16288_terrestrial,265,308,77,223,573,29.056603773584904,84.15094339622642
16289_terrestrial,275,328,76,232,603,27.636363636363637,84.36363636363636
16290_terrestrial,272,315,77,231,587,28.308823529411764,84.92647058823529
16291_terrestrial,272,271,81,233,543,29.77941176470588,85.66176470588235
16292_terrestrial,278,298,86,234,576,30.935251798561154,84.17266187050359
16293_terrestrial,273,283,84,231,556,30.76923076923077,84.61538461538461
16294_terrestrial,246,241,77,206,487,31.300813008130078,83.73983739837398
16295_terrestrial,248,253,77,208,501,31.048387096774192,83.87096774193549
16296_terrestrial,242,236,71,205,478,29.338842975206614,84.71074380165288
16297_terrestrial,264,246,80,225,510,30.303030303030305,85.22727272727273
16298_terrestrial,226,211,71,193,437,31.41592920353982,85.39823008849558
16299_terrestrial,247,220,78,208,467,31.57894736842105,84.21052631578947
16300_terrestrial,255,228,80,214,483,31.372549019607842,83.92156862745098
16301_terrestrial,280,243,90,230,523,32.142857142857146,82.14285714285714
16302_terrestrial,276,207,88,226,483,31.88405797101449,81.88405797101449
16303_terrestrial,281,226,92,232,507,32.74021352313167,82.56227758007117
16304_terrestrial,297,303,98,245,600,32.996632996633,82.49158249158249
16305_terrestrial,311,343,109,243,654,35.048231511254016,78.13504823151125
16306_terrestrial,292,335,102,222,627,34.93150684931507,76.02739726027397
16307_terrestrial,249,285,80,206,534,32.1285140562249,82.73092369477911
16308_terrestrial,239,243,75,196,482,31.380753138075313,82.00836820083683
16309_terrestrial,238,216,73,191,454,30.672268907563026,80.25210084033614
16310_terrestrial,261,202,86,213,463,32.95019157088122,81.60919540229885
16311_terrestrial,366,265,180,230,631,49.18032786885246,62.841530054644814
16312_terrestrial,365,260,183,226,625,50.136986301369866,61.917808219178085
16313_terrestrial,350,236,178,210,586,50.857142857142854,60
16314_terrestrial,343,254,178,209,597,51.89504373177842,60.932944606414
16315_terrestrial,313,192,160,188,505,51.118210862619804,60.063897763578275
16316_terrestrial,321,201,164,194,522,51.09034267912772,60.43613707165109
16317_terrestrial,309,199,166,182,508,53.72168284789643,58.89967637540453
16318_terrestrial,287,185,149,172,472,51.91637630662021,59.93031358885017
16379_terrestrial,478,253,370,210,731,77.40585774058577,43.93305439330544
16380_terrestrial,304,160,208,209,464,68.42105263157895,68.75
16381_terrestrial,270,156,172,185,426,63.70370370370371,68.51851851851852
16382_terrestrial,272,163,166,184,435,61.029411764705884,67.64705882352942
16383_terrestrial,283,171,172,199,454,60.7773851590106,70.31802120141343
16384_terrestrial,339,198,206,223,537,60.766961651917406,65.78171091445427
16385_terrestrial,341,200,217,227,541,63.63636363636363,66.56891495601172
16386_terrestrial,329,189,197,228,518,59.87841945288754,69.30091185410335
16387_terrestrial,326,214,192,222,540,58.895705521472394,68.09815950920245
16388_terrestrial,347,221,212,227,568,61.09510086455331,65.4178674351585
16389_terrestrial,534,321,396,237,855,74.15730337078652,44.38202247191011
16390_terrestrial,545,328,405,244,873,74.31192660550458,44.77064220183487
16391_terrestrial,560,331,418,253,891,74.64285714285714,45.17857142857143
16392_terrestrial,344,204,222,243,548,64.53488372093024,70.63953488372093
16393_terrestrial,515,297,388,245,812,75.33980582524272,47.57281553398058
16394_terrestrial,418,255,305,171,673,72.96650717703349,40.909090909090914
16395_terrestrial,498,324,348,230,822,69.87951807228916,46.1847389558233
16396_terrestrial,582,357,409,287,939,70.27491408934708,49.312714776632305
16397_terrestrial,376,249,227,255,625,60.37234042553191,67.81914893617021
16398_terrestrial,336,198,202,226,534,60.11904761904761,67.26190476190477
16399_terrestrial,322,194,191,226,516,59.3167701863354,70.1863354037267
16400_terrestrial,332,194,202,235,526,60.8433734939759,70.78313253012048
16401_terrestrial,316,192,193,224,508,61.07594936708861,70.88607594936708
16402_terrestrial,340,201,203,240,541,59.705882352941174,70.58823529411765
16403_terrestrial,360,207,216,252,567,60,70
16404_terrestrial,329,194,203,235,523,61.702127659574465,71.42857142857143
16405_terrestrial,315,177,197,221,492,62.53968253968254,70.15873015873015
16406_terrestrial,330,177,206,231,507,62.42424242424243,70
16407_terrestrial,345,201,221,243,546,64.05797101449275,70.43478260869566
16408_terrestrial,349,196,227,247,545,65.0429799426934,70.77363896848138
16409_terrestrial,446,249,312,267,695,69.95515695067265,59.865470852017935
16410_terrestrial,367,223,267,218,590,72.75204359673025,59.40054495912806
16414_terrestrial,318,188,218,197,506,68.55345911949685,61.94968553459119
16415_terrestrial,320,190,220,197,510,68.75,61.5625
16416_terrestrial,311,182,217,194,493,69.77491961414792,62.37942122186495
16418_terrestrial,354,199,243,220,553,68.64406779661016,62.14689265536724
16419_terrestrial,373,223,250,240,596,67.02412868632707,64.343163538874
16420_terrestrial,383,246,251,250,629,65.53524804177546,65.27415143603133
16421_terrestrial,310,190,184,232,500,59.354838709677416,74.83870967741936
16422_terrestrial,306,192,185,230,498,60.45751633986928,75.16339869281046
16423_terrestrial,297,188,181,222,485,60.94276094276094,74.74747474747475
16424_terrestrial,275,169,169,211,444,61.45454545454545,76.72727272727272
16425_terrestrial,261,162,166,198,423,63.601532567049816,75.86206896551724
16426_terrestrial,274,160,191,193,434,69.7080291970803,70.43795620437956
16427_terrestrial,278,165,196,192,443,70.50359712230215,69.06474820143885
16428_terrestrial,257,156,185,178,413,71.98443579766537,69.26070038910505
16459_terrestrial,275,160,157,209,435,57.09090909090909,76
16460_terrestrial,282,168,163,212,450,57.801418439716315,75.177304964539
16461_terrestrial,272,166,156,207,438,57.35294117647059,76.10294117647058
16462_terrestrial,263,164,152,204,427,57.79467680608364,77.56653992395437
16463_terrestrial,262,162,155,207,424,59.16030534351145,79.00763358778626
16481_terrestrial,148,109,92,100,257,62.16216216216216,67.56756756756756
16482_terrestrial,144,108,92,98,252,63.888888888888886,68.05555555555556
16483_terrestrial,139,105,89,97,244,64.02877697841727,69.7841726618705
16484_terrestrial,137,103,86,97,240,62.77372262773723,70.8029197080292
16485_terrestrial,131,93,83,93,224,63.358778625954194,70.99236641221374
16486_terrestrial,126,89,80,90,215,63.49206349206349,71.42857142857143
16487_terrestrial,124,85,80,87,209,64.51612903225806,70.16129032258065
16488_terrestrial,122,86,80,84,208,65.57377049180327,68.85245901639344
16489_terrestrial,124,92,81,86,216,65.32258064516128,69.35483870967742
16490_terrestrial,126,94,81,86,220,64.28571428571429,68.25396825396825
16491_terrestrial,128,90,85,88,218,66.40625,68.75
16492_terrestrial,128,98,83,90,226,64.84375,70.3125
16493_terrestrial,131,107,84,93,238,64.12213740458014,70.99236641221374
16494_terrestrial,128,104,83,93,232,64.84375,72.65625
16495_terrestrial,130,109,86,95,239,66.15384615384615,73.07692307692307
16496_terrestrial,145,113,97,114,258,66.89655172413794,78.62068965517241
16497_terrestrial,166,115,108,130,281,65.06024096385542,78.3132530120482
16498_terrestrial,190,110,122,144,300,64.21052631578948,75.78947368421053
16499_terrestrial,203,99,127,154,302,62.5615763546798,75.86206896551724
16500_terrestrial,228,103,146,174,331,64.03508771929825,76.31578947368422
16501_terrestrial,242,99,159,187,341,65.70247933884298,77.27272727272727
16502_terrestrial,238,104,162,183,342,68.0672268907563,76.89075630252101
16503_terrestrial,237,102,163,188,339,68.77637130801688,79.32489451476793
16504_terrestrial,241,111,165,192,352,68.46473029045643,79.66804979253112
16505_terrestrial,240,120,166,191,360,69.16666666666667,79.58333333333333
16506_terrestrial,246,126,166,195,372,67.47967479674797,79.26829268292683
16507_terrestrial,266,132,179,205,398,67.29323308270678,77.06766917293233
16508_terrestrial,272,146,182,207,418,66.91176470588235,76.10294117647058
16509_terrestrial,269,149,180,204,418,66.91449814126395,75.8364312267658
16510_terrestrial,260,152,173,200,412,66.53846153846153,76.92307692307693
16511_terrestrial,284,158,188,218,442,66.19718309859155,76.76056338028168
16512_terrestrial,294,150,193,224,444,65.64625850340136,76.19047619047619
16513_terrestrial,284,152,190,215,436,66.90140845070422,75.70422535211267
16514_terrestrial,281,155,186,216,436,66.19217081850533,76.86832740213522
16515_terrestrial,272,151,181,208,423,66.54411764705883,76.47058823529412
16516_terrestrial,330,161,231,217,491,70,65.75757575757576
16517_terrestrial,301,143,209,201,444,69.43521594684385,66.77740863787376
16616_terrestrial,325,251,169,196,576,52,60.30769230769231
16617_terrestrial,246,240,86,200,486,34.959349593495936,81.30081300813008
16618_terrestrial,243,303,82,189,546,33.744855967078195,77.77777777777779
16619_terrestrial,247,294,79,195,541,31.983805668016196,78.94736842105263
16620_terrestrial,223,221,70,183,444,31.390134529147986,82.0627802690583
16621_terrestrial,236,217,76,192,453,32.20338983050847,81.35593220338984
16622_terrestrial,234,223,78,188,457,33.33333333333333,80.34188034188034
16623_terrestrial,232,216,76,182,448,32.758620689655174,78.44827586206897
16624_terrestrial,242,220,78,188,462,32.231404958677686,77.68595041322314
16625_terrestrial,246,218,84,190,464,34.146341463414636,77.23577235772358
16626_terrestrial,250,217,83,194,467,33.2,77.60000000000001
16627_terrestrial,254,210,82,196,464,32.28346456692913,77.16535433070865
16628_terrestrial,251,208,86,195,459,34.26294820717131,77.68924302788844
16629_terrestrial,249,210,82,188,459,32.93172690763052,75.50200803212851
16630_terrestrial,241,196,82,180,437,34.024896265560166,74.68879668049793
16631_terrestrial,240,213,74,181,453,30.833333333333336,75.41666666666667
16632_terrestrial,237,194,75,185,431,31.645569620253166,78.05907172995781
16633_terrestrial,235,188,72,186,423,30.638297872340424,79.14893617021276
16634_terrestrial,240,185,76,188,425,31.666666666666664,78.33333333333333
16635_terrestrial,231,188,79,182,419,34.1991341991342,78.78787878787878
16636_terrestrial,239,200,77,188,439,32.21757322175732,78.66108786610879
16637_terrestrial,248,212,79,190,460,31.85483870967742,76.61290322580645
16638_terrestrial,249,209,80,198,458,32.1285140562249,79.51807228915662
16639_terrestrial,250,194,80,203,444,32,81.2
16640_terrestrial,245,193,80,200,438,32.6530612244898,81.63265306122449
16641_terrestrial,254,205,81,211,459,31.88976377952756,83.07086614173228
16642_terrestrial,258,224,79,215,482,30.620155038759687,83.33333333333334
16643_terrestrial,254,242,77,210,496,30.314960629921263,82.67716535433071
16644_terrestrial,252,239,76,212,491,30.158730158730158,84.12698412698413
16645_terrestrial,233,242,69,195,475,29.613733905579398,83.69098712446352
16646_terrestrial,231,237,70,193,468,30.303030303030305,83.54978354978356
16647_terrestrial,233,261,71,198,494,30.472103004291846,84.97854077253218
16648_terrestrial,246,296,73,206,542,29.67479674796748,83.73983739837398
16649_terrestrial,247,315,70,203,562,28.34008097165992,82.18623481781377
16650_terrestrial,254,318,75,211,572,29.527559055118108,83.07086614173228
16651_terrestrial,259,315,76,218,574,29.343629343629345,84.16988416988417
16652_terrestrial,262,308,75,220,570,28.62595419847328,83.96946564885496
16653_terrestrial,247,287,74,213,534,29.959514170040485,86.23481781376519
16654_terrestrial,262,254,81,223,516,30.916030534351147,85.1145038167939
16655_terrestrial,259,229,77,221,488,29.72972972972973,85.32818532818533
16656_terrestrial,260,229,75,224,489,28.846153846153843,86.15384615384616
16657_terrestrial,279,257,89,243,536,31.899641577060933,87.09677419354838
16658_terrestrial,282,308,84,247,590,29.78723404255319,87.58865248226951
16659_terrestrial,278,251,87,237,529,31.294964028776977,85.25179856115108
16660_terrestrial,276,227,84,233,503,30.434782608695656,84.42028985507247
16661_terrestrial,310,341,98,262,651,31.61290322580645,84.51612903225806
16662_terrestrial,301,339,98,253,640,32.55813953488372,84.0531561461794
16663_terrestrial,290,339,92,240,629,31.724137931034484,82.75862068965517
16664_terrestrial,304,340,99,255,644,32.56578947368421,83.88157894736842
16665_terrestrial,272,278,91,225,550,33.455882352941174,82.72058823529412
16666_terrestrial,243,264,76,199,507,31.275720164609055,81.89300411522635
16667_terrestrial,247,268,78,205,515,31.57894736842105,82.99595141700405
16668_terrestrial,242,241,73,200,483,30.165289256198346,82.64462809917356
16669_terrestrial,265,214,82,218,479,30.943396226415093,82.26415094339623
16670_terrestrial,404,278,201,254,682,49.75247524752475,62.87128712871287
16671_terrestrial,347,247,177,212,594,51.008645533141205,61.09510086455331
16674_terrestrial,302,195,162,175,497,53.64238410596026,57.94701986754966
16675_terrestrial,307,200,161,182,507,52.44299674267101,59.28338762214984
16676_terrestrial,296,192,156,175,488,52.702702702702695,59.12162162162162
16731_terrestrial,410,243,329,149,653,80.2439024390244,36.34146341463415
16732_terrestrial,451,258,357,188,709,79.15742793791574,41.68514412416852
16733_terrestrial,469,261,360,199,730,76.7590618336887,42.430703624733475
16734_terrestrial,488,274,362,205,762,74.18032786885246,42.00819672131148
16735_terrestrial,494,280,363,209,774,73.48178137651821,42.30769230769231
16736_terrestrial,498,294,366,214,792,73.49397590361446,42.971887550200805
16737_terrestrial,499,294,363,219,793,72.74549098196393,43.8877755511022
16738_terrestrial,488,291,349,211,779,71.51639344262296,43.23770491803279
16739_terrestrial,558,317,401,264,875,71.86379928315412,47.31182795698925
16740_terrestrial,316,180,198,216,496,62.65822784810127,68.35443037974683
16741_terrestrial,297,175,181,202,472,60.94276094276094,68.01346801346801
16742_terrestrial,283,182,174,194,465,61.48409893992933,68.55123674911661
16743_terrestrial,346,191,215,229,537,62.138728323699425,66.1849710982659
16744_terrestrial,581,320,429,265,901,73.8382099827883,45.61101549053356
16745_terrestrial,572,304,435,262,876,76.04895104895105,45.8041958041958
16746_terrestrial,580,302,431,262,882,74.3103448275862,45.17241379310345
16747_terrestrial,580,320,425,258,900,73.27586206896551,44.48275862068966
16748_terrestrial,527,316,386,228,843,73.24478178368122,43.26375711574953
16749_terrestrial,180,127,108,118,307,60,65.55555555555556
16750_terrestrial,366,207,300,115,573,81.9672131147541,31.420765027322407
16751_terrestrial,544,320,404,244,864,74.26470588235294,44.85294117647059
16752_terrestrial,292,190,174,200,482,59.589041095890416,68.4931506849315
16753_terrestrial,461,302,339,206,763,73.53579175704989,44.68546637744035
16754_terrestrial,433,276,317,178,709,73.21016166281755,41.10854503464203
16756_terrestrial,469,293,339,221,762,72.28144989339019,47.12153518123667
16757_terrestrial,570,343,404,279,913,70.87719298245614,48.94736842105264
16758_terrestrial,595,363,421,293,958,70.75630252100841,49.2436974789916
16759_terrestrial,336,220,193,232,556,57.44047619047619,69.04761904761905
16760_terrestrial,279,179,156,192,458,55.91397849462365,68.81720430107528
16761_terrestrial,300,173,173,214,473,57.666666666666664,71.33333333333334
16762_terrestrial,304,185,173,213,489,56.9078947368421,70.06578947368422
16763_terrestrial,359,204,218,251,563,60.724233983286915,69.91643454038997
16764_terrestrial,352,203,212,246,555,60.22727272727273,69.88636363636364
16765_terrestrial,334,204,207,235,538,61.97604790419161,70.35928143712576
16766_terrestrial,343,205,209,237,548,60.932944606414,69.09620991253644
16767_terrestrial,360,216,230,241,576,63.888888888888886,66.94444444444444
16768_terrestrial,470,272,325,274,742,69.14893617021278,58.29787234042553
16769_terrestrial,444,249,310,256,693,69.81981981981981,57.65765765765766
16780_terrestrial,335,215,217,210,550,64.77611940298507,62.68656716417911
16781_terrestrial,363,243,236,219,606,65.0137741046832,60.33057851239669
16782_terrestrial,309,210,184,219,519,59.54692556634305,70.87378640776699
16783_terrestrial,301,204,185,211,505,61.461794019933556,70.09966777408638
16784_terrestrial,293,186,176,211,479,60.068259385665534,72.01365187713311
16785_terrestrial,287,187,172,207,474,59.93031358885017,72.12543554006969
16786_terrestrial,292,186,181,219,478,61.986301369863014,75
16787_terrestrial,319,205,207,222,524,64.89028213166145,69.59247648902821
16788_terrestrial,307,198,210,217,505,68.40390879478826,70.68403908794788
16815_terrestrial,278,137,168,215,415,60.431654676258994,77.33812949640287
16816_terrestrial,299,151,177,223,450,59.19732441471572,74.5819397993311
16817_terrestrial,294,169,166,227,463,56.4625850340136,77.21088435374149
16818_terrestrial,294,180,171,226,474,58.16326530612245,76.87074829931973
16819_terrestrial,292,177,175,222,469,59.93150684931506,76.02739726027397
16820_terrestrial,273,163,159,207,436,58.24175824175825,75.82417582417582
16821_terrestrial,272,175,157,209,447,57.720588235294116,76.83823529411765
16822_terrestrial,264,160,156,207,424,59.09090909090909,78.4090909090909
16823_terrestrial,247,152,151,196,399,61.1336032388664,79.35222672064778
16824_terrestrial,232,139,141,182,371,60.775862068965516,78.44827586206897
16825_terrestrial,222,117,134,172,339,60.36036036036037,77.47747747747748
16826_terrestrial,204,117,120,158,321,58.82352941176471,77.45098039215686
16827_terrestrial,193,124,113,149,317,58.549222797927456,77.2020725388601
16828_terrestrial,180,125,107,137,305,59.44444444444444,76.11111111111111
16842_terrestrial,127,92,76,85,219,59.84251968503938,66.92913385826772
16843_terrestrial,128,99,76,86,227,59.375,67.1875
16844_terrestrial,127,101,79,86,228,62.20472440944882,67.71653543307087
16845_terrestrial,126,97,78,87,223,61.904761904761905,69.04761904761905
16846_terrestrial,123,92,76,85,215,61.78861788617886,69.10569105691057
16847_terrestrial,121,89,79,84,210,65.28925619834712,69.42148760330579
16848_terrestrial,118,90,79,83,208,66.94915254237289,70.33898305084746
16849_terrestrial,113,86,74,81,199,65.48672566371681,71.68141592920354
16850_terrestrial,117,89,78,83,206,66.66666666666666,70.94017094017094
16851_terrestrial,118,99,79,84,217,66.94915254237289,71.1864406779661
16852_terrestrial,120,96,80,85,216,66.66666666666666,70.83333333333334
16853_terrestrial,119,101,79,87,220,66.38655462184873,73.10924369747899
16854_terrestrial,120,96,79,89,216,65.83333333333333,74.16666666666667
16855_terrestrial,144,114,97,110,258,67.36111111111111,76.38888888888889
16856_terrestrial,164,121,108,127,285,65.85365853658537,77.4390243902439
16857_terrestrial,185,120,121,143,305,65.4054054054054,77.29729729729729
16858_terrestrial,200,115,127,156,315,63.5,78
16859_terrestrial,224,104,144,175,328,64.28571428571429,78.125
16860_terrestrial,244,103,160,194,347,65.57377049180327,79.50819672131148
16861_terrestrial,235,102,154,187,337,65.53191489361701,79.57446808510639
16862_terrestrial,241,110,161,191,351,66.80497925311202,79.25311203319502
16863_terrestrial,236,109,161,187,345,68.22033898305084,79.23728813559322
16864_terrestrial,235,113,159,187,348,67.65957446808511,79.57446808510639
16865_terrestrial,243,123,164,193,366,67.48971193415639,79.42386831275721
16866_terrestrial,253,125,174,197,378,68.77470355731225,77.86561264822134
16867_terrestrial,263,145,176,201,408,66.92015209125475,76.42585551330798
16868_terrestrial,271,145,179,205,416,66.05166051660517,75.64575645756457
16869_terrestrial,271,149,181,205,420,66.78966789667896,75.64575645756457
16870_terrestrial,286,156,193,213,442,67.48251748251748,74.47552447552448
16871_terrestrial,287,154,192,216,441,66.89895470383276,75.26132404181185
16872_terrestrial,390,193,275,247,583,70.51282051282051,63.33333333333333
16873_terrestrial,367,190,260,235,557,70.84468664850137,64.03269754768392
16874_terrestrial,273,147,182,207,420,66.66666666666666,75.82417582417582
16875_terrestrial,331,169,236,219,500,71.29909365558912,66.16314199395771
16876_terrestrial,326,155,226,224,481,69.32515337423312,68.71165644171779
16976_terrestrial,343,274,181,204,617,52.76967930029155,59.475218658892125
16977_terrestrial,252,276,90,200,528,35.714285714285715,79.36507936507937
16978_terrestrial,248,313,80,193,561,32.25806451612903,77.82258064516128
16979_terrestrial,240,279,79,187,519,32.916666666666664,77.91666666666667
16980_terrestrial,235,246,73,185,481,31.06382978723404,78.72340425531915
16981_terrestrial,228,220,73,184,448,32.01754385964912,80.7017543859649
16982_terrestrial,223,211,71,179,434,31.838565022421523,80.26905829596413
16983_terrestrial,221,208,71,172,429,32.126696832579185,77.82805429864254
16984_terrestrial,223,207,69,174,430,30.94170403587444,78.02690582959642
16985_terrestrial,230,207,74,181,437,32.17391304347826,78.69565217391305
16986_terrestrial,234,220,74,188,454,31.62393162393162,80.34188034188034
16987_terrestrial,244,225,79,195,469,32.37704918032787,79.91803278688525
16988_terrestrial,250,222,86,197,472,34.4,78.8
16989_terrestrial,237,218,77,181,455,32.48945147679325,76.37130801687763
16990_terrestrial,243,203,77,181,446,31.68724279835391,74.48559670781893
16991_terrestrial,240,208,69,186,448,28.749999999999996,77.5
16992_terrestrial,231,194,70,181,425,30.303030303030305,78.35497835497836
16993_terrestrial,226,189,71,181,415,31.41592920353982,80.08849557522124
16994_terrestrial,246,193,75,194,439,30.48780487804878,78.86178861788618
16995_terrestrial,249,206,78,196,455,31.32530120481928,78.714859437751
16996_terrestrial,249,224,80,198,473,32.1285140562249,79.51807228915662
16997_terrestrial,246,219,78,196,465,31.70731707317073,79.67479674796748
16998_terrestrial,249,216,78,201,465,31.32530120481928,80.72289156626506
16999_terrestrial,247,194,81,199,441,32.79352226720648,80.5668016194332
17000_terrestrial,250,190,82,202,440,32.800000000000004,80.80000000000001
17001_terrestrial,252,200,81,206,452,32.142857142857146,81.74603174603175
17002_terrestrial,258,225,79,211,483,30.620155038759687,81.78294573643412
17003_terrestrial,258,242,77,210,500,29.844961240310074,81.3953488372093
17004_terrestrial,256,274,76,207,530,29.6875,80.859375
17005_terrestrial,235,270,69,194,505,29.361702127659573,82.5531914893617
17006_terrestrial,234,243,70,193,477,29.914529914529915,82.47863247863248
17007_terrestrial,239,257,71,199,496,29.707112970711297,83.26359832635984
17008_terrestrial,246,284,74,205,530,30.081300813008134,83.33333333333334
17009_terrestrial,244,326,71,201,570,29.098360655737704,82.37704918032787
17010_terrestrial,251,336,72,207,587,28.68525896414343,82.47011952191235
17011_terrestrial,250,316,74,209,566,29.599999999999998,83.6
17012_terrestrial,260,319,77,217,579,29.615384615384617,83.46153846153847
17013_terrestrial,255,303,78,218,558,30.58823529411765,85.49019607843137
17014_terrestrial,260,278,77,223,538,29.615384615384617,85.76923076923076
17015_terrestrial,255,252,72,219,507,28.235294117647058,85.88235294117646
17016_terrestrial,249,300,74,215,549,29.71887550200803,86.34538152610442
17017_terrestrial,296,383,87,259,679,29.39189189189189,87.5
17018_terrestrial,291,344,83,252,635,28.52233676975945,86.5979381443299
17019_terrestrial,265,266,81,227,531,30.566037735849054,85.66037735849056
17020_terrestrial,290,373,86,252,663,29.655172413793103,86.89655172413792
17021_terrestrial,294,383,94,250,677,31.97278911564626,85.03401360544217
17022_terrestrial,297,377,92,252,674,30.976430976430976,84.84848484848484
17023_terrestrial,260,322,80,217,582,30.76923076923077,83.46153846153847
17024_terrestrial,253,279,76,209,532,30.039525691699602,82.6086956521739
17025_terrestrial,242,268,73,197,510,30.165289256198346,81.40495867768594
17026_terrestrial,246,273,75,202,519,30.48780487804878,82.11382113821138
17027_terrestrial,259,269,84,212,528,32.432432432432435,81.85328185328186
17028_terrestrial,268,225,85,222,493,31.716417910447763,82.83582089552239
17029_terrestrial,436,295,214,284,731,49.08256880733945,65.13761467889908
17030_terrestrial,459,288,238,290,747,51.85185185185185,63.18082788671025
17091_terrestrial,422,250,338,157,672,80.09478672985783,37.203791469194314
17092_terrestrial,496,277,383,201,773,77.21774193548387,40.524193548387096
17093_terrestrial,259,166,162,178,425,62.54826254826254,68.72586872586872
17094_terrestrial,291,183,177,197,474,60.824742268041234,67.69759450171821
17095_terrestrial,289,172,171,205,461,59.16955017301038,70.93425605536332
17096_terrestrial,288,185,172,201,473,59.72222222222222,69.79166666666666
17097_terrestrial,291,188,180,197,479,61.855670103092784,67.69759450171821
17098_terrestrial,307,200,189,206,507,61.563517915309454,67.10097719869707
17099_terrestrial,349,215,218,230,564,62.46418338108882,65.90257879656161
17100_terrestrial,332,209,200,228,541,60.24096385542169,68.67469879518072
17101_terrestrial,327,207,194,217,534,59.32721712538226,66.36085626911316
17102_terrestrial,308,197,179,199,505,58.11688311688312,64.6103896103896
17103_terrestrial,597,325,436,277,922,73.03182579564489,46.39865996649916
17104_terrestrial,537,302,408,238,839,75.97765363128491,44.320297951582866
17109_terrestrial,398,225,317,147,623,79.64824120603015,36.93467336683417
17110_terrestrial,421,222,338,164,643,80.28503562945369,38.95486935866984
17111_terrestrial,495,284,380,213,779,76.76767676767676,43.03030303030303
17112_terrestrial,512,296,386,225,808,75.390625,43.9453125
17113_terrestrial,303,184,184,207,487,60.726072607260726,68.31683168316832
17114_terrestrial,472,292,342,200,764,72.45762711864407,42.3728813559322
17115_terrestrial,474,280,349,204,754,73.62869198312237,43.037974683544306
17117_terrestrial,371,187,288,146,558,77.62803234501348,39.35309973045822
17118_terrestrial,501,295,366,245,796,73.05389221556887,48.902195608782435
17119_terrestrial,575,353,420,278,928,73.04347826086956,48.347826086956516
17120_terrestrial,600,375,433,297,975,72.16666666666667,49.5
17121_terrestrial,335,238,201,224,573,60,66.86567164179105
17122_terrestrial,324,223,189,228,547,58.333333333333336,70.37037037037037
17123_terrestrial,340,215,195,235,555,57.35294117647059,69.11764705882352
17124_terrestrial,328,208,187,228,536,57.012195121951216,69.51219512195121
17125_terrestrial,331,219,200,233,550,60.42296072507553,70.39274924471299
17126_terrestrial,336,198,201,234,534,59.82142857142857,69.64285714285714
17127_terrestrial,376,209,232,253,585,61.702127659574465,67.2872340425532
17128_terrestrial,473,262,324,283,735,68.49894291754757,59.830866807610995
17129_terrestrial,246,163,151,166,409,61.382113821138205,67.47967479674797
17134_terrestrial,259,152,181,140,411,69.88416988416989,54.054054054054056
17135_terrestrial,248,159,168,138,407,67.74193548387096,55.64516129032258
17136_terrestrial,246,162,170,136,408,69.10569105691057,55.28455284552846
17141_terrestrial,302,185,196,185,487,64.90066225165563,61.258278145695364
17142_terrestrial,373,224,245,236,597,65.68364611260054,63.27077747989276
17143_terrestrial,316,194,195,229,510,61.70886075949367,72.46835443037975
17144_terrestrial,308,204,183,217,512,59.41558441558441,70.45454545454545
17145_terrestrial,296,194,170,213,490,57.432432432432435,71.95945945945947
17146_terrestrial,296,189,175,215,485,59.12162162162162,72.63513513513513
17147_terrestrial,319,207,200,220,526,62.695924764890286,68.96551724137932
17148_terrestrial,340,203,223,237,543,65.58823529411765,69.70588235294117
17149_terrestrial,298,169,201,209,467,67.4496644295302,70.13422818791946
17175_terrestrial,272,153,170,211,425,62.5,77.57352941176471
17176_terrestrial,280,158,171,216,438,61.07142857142858,77.14285714285715
17177_terrestrial,265,145,156,206,410,58.867924528301884,77.73584905660378
17178_terrestrial,263,141,159,204,404,60.45627376425855,77.56653992395437
17179_terrestrial,267,137,165,211,404,61.79775280898876,79.02621722846442
17180_terrestrial,275,143,165,212,418,60,77.0909090909091
17181_terrestrial,268,157,164,208,425,61.19402985074627,77.61194029850746
17182_terrestrial,240,147,147,190,387,61.25000000000001,79.16666666666666
17183_terrestrial,226,139,133,175,365,58.849557522123895,77.43362831858407
17184_terrestrial,211,121,127,161,332,60.18957345971564,76.30331753554502
17185_terrestrial,203,112,125,153,315,61.57635467980296,75.36945812807882
17186_terrestrial,196,119,117,148,315,59.693877551020414,75.51020408163265
17187_terrestrial,187,120,114,138,307,60.962566844919785,73.79679144385027
17188_terrestrial,182,105,111,133,287,60.98901098901099,73.07692307692307
17201_terrestrial,117,91,70,78,208,59.82905982905983,66.66666666666666
17202_terrestrial,121,95,74,80,216,61.15702479338842,66.11570247933885
17203_terrestrial,120,92,71,84,212,59.166666666666664,70
17204_terrestrial,120,95,73,83,215,60.83333333333333,69.16666666666667
17205_terrestrial,119,97,74,83,216,62.18487394957983,69.74789915966386
17206_terrestrial,125,104,80,87,229,64,69.6
17207_terrestrial,131,106,84,92,237,64.12213740458014,70.22900763358778
17208_terrestrial,125,109,82,88,234,65.60000000000001,70.39999999999999
17209_terrestrial,124,106,83,89,230,66.93548387096774,71.7741935483871
17210_terrestrial,123,108,84,88,231,68.29268292682927,71.54471544715447
17211_terrestrial,127,104,86,91,231,67.71653543307087,71.65354330708661
17212_terrestrial,125,98,83,95,223,66.4,76
17213_terrestrial,135,111,90,104,246,66.66666666666666,77.03703703703704
17214_terrestrial,153,109,102,117,262,66.66666666666666,76.47058823529412
17215_terrestrial,169,122,112,130,291,66.27218934911244,76.92307692307693
17216_terrestrial,183,126,121,143,309,66.12021857923497,78.14207650273224
17217_terrestrial,196,124,130,152,320,66.3265306122449,77.55102040816327
17218_terrestrial,232,121,154,185,353,66.37931034482759,79.74137931034483
17219_terrestrial,256,116,170,208,372,66.40625,81.25
17220_terrestrial,257,113,168,209,370,65.36964980544747,81.32295719844358
17221_terrestrial,248,120,164,203,368,66.12903225806451,81.85483870967742
17222_terrestrial,251,116,169,206,367,67.33067729083665,82.07171314741036
17223_terrestrial,248,119,170,203,367,68.54838709677419,81.85483870967742
17224_terrestrial,254,124,174,202,378,68.50393700787401,79.52755905511812
17225_terrestrial,264,132,178,204,396,67.42424242424242,77.27272727272727
17226_terrestrial,266,130,177,204,396,66.54135338345864,76.69172932330827
17227_terrestrial,267,147,179,203,414,67.04119850187266,76.02996254681648
17228_terrestrial,274,153,181,208,427,66.05839416058394,75.91240875912408
17229_terrestrial,282,153,185,214,435,65.60283687943263,75.88652482269504
17230_terrestrial,288,154,190,219,442,65.97222222222221,76.04166666666666
17231_terrestrial,405,197,290,260,602,71.60493827160494,64.19753086419753
17232_terrestrial,355,181,252,235,536,70.98591549295776,66.19718309859155
17233_terrestrial,338,169,242,218,507,71.59763313609467,64.49704142011834
17234_terrestrial,332,167,236,215,499,71.08433734939759,64.7590361445783
17235_terrestrial,244,126,164,188,370,67.21311475409836,77.04918032786885
17241_terrestrial,353,190,263,199,543,74.5042492917847,56.37393767705382
17336_terrestrial,355,281,194,205,636,54.647887323943664,57.74647887323944
17337_terrestrial,269,292,92,214,561,34.20074349442379,79.5539033457249
17338_terrestrial,250,301,82,199,551,32.800000000000004,79.60000000000001
17339_terrestrial,251,279,87,196,530,34.66135458167331,78.08764940239044
17340_terrestrial,247,264,81,192,511,32.79352226720648,77.7327935222672
17341_terrestrial,228,227,76,181,455,33.33333333333333,79.3859649122807
17342_terrestrial,215,211,72,170,426,33.48837209302326,79.06976744186046
17343_terrestrial,212,208,70,167,420,33.0188679245283,78.77358490566037
17344_terrestrial,217,207,65,171,424,29.953917050691242,78.80184331797236
17345_terrestrial,228,218,70,177,446,30.701754385964914,77.63157894736842
17346_terrestrial,231,229,72,180,460,31.16883116883117,77.92207792207793
17347_terrestrial,233,222,74,186,455,31.759656652360512,79.82832618025752
17348_terrestrial,246,232,84,195,478,34.146341463414636,79.26829268292683
17349_terrestrial,251,232,81,195,483,32.27091633466135,77.68924302788844
17350_terrestrial,241,209,77,187,450,31.950207468879665,77.59336099585063
17351_terrestrial,239,216,75,185,455,31.380753138075313,77.40585774058577
17352_terrestrial,227,195,69,177,422,30.396475770925107,77.97356828193833
17353_terrestrial,229,199,70,179,428,30.567685589519648,78.16593886462883
17354_terrestrial,252,214,74,193,466,29.365079365079367,76.5873015873016
17355_terrestrial,261,233,74,204,494,28.35249042145594,78.16091954022988
17356_terrestrial,253,230,78,202,483,30.8300395256917,79.84189723320159
17357_terrestrial,234,218,76,185,452,32.47863247863248,79.05982905982906
17358_terrestrial,247,207,79,199,454,31.983805668016196,80.5668016194332
17359_terrestrial,250,199,82,202,449,32.800000000000004,80.80000000000001
17360_terrestrial,246,196,79,201,442,32.113821138211385,81.70731707317073
17361_terrestrial,245,185,78,201,430,31.83673469387755,82.0408163265306
17362_terrestrial,249,208,78,205,457,31.32530120481928,82.32931726907631
17363_terrestrial,252,222,76,208,474,30.158730158730158,82.53968253968253
17364_terrestrial,258,274,76,212,532,29.457364341085274,82.17054263565892
17365_terrestrial,251,278,75,209,529,29.880478087649404,83.26693227091634
17366_terrestrial,239,250,71,199,489,29.707112970711297,83.26359832635984
17367_terrestrial,244,267,69,203,511,28.278688524590162,83.19672131147541
17368_terrestrial,243,283,69,202,526,28.39506172839506,83.1275720164609
17369_terrestrial,248,328,73,207,576,29.435483870967744,83.46774193548387
17370_terrestrial,248,334,69,206,582,27.82258064516129,83.06451612903226
17371_terrestrial,240,323,68,202,563,28.333333333333332,84.16666666666667
17372_terrestrial,245,331,70,210,576,28.57142857142857,85.71428571428571
17373_terrestrial,266,328,81,228,594,30.451127819548873,85.71428571428571
17374_terrestrial,262,353,79,221,615,30.15267175572519,84.35114503816794
17375_terrestrial,246,328,68,208,574,27.64227642276423,84.5528455284553
17376_terrestrial,248,316,71,212,564,28.62903225806452,85.48387096774194
17377_terrestrial,275,342,86,236,617,31.272727272727273,85.81818181818181
17378_terrestrial,284,399,85,246,683,29.929577464788732,86.61971830985915
17379_terrestrial,259,331,80,222,590,30.888030888030887,85.71428571428571
17380_terrestrial,274,364,83,235,638,30.29197080291971,85.76642335766424
17381_terrestrial,261,299,73,223,560,27.969348659003828,85.44061302681992
17382_terrestrial,249,293,72,208,542,28.915662650602407,83.53413654618474
17383_terrestrial,244,298,72,202,542,29.508196721311474,82.78688524590164
17384_terrestrial,244,252,69,200,496,28.278688524590162,81.9672131147541
17385_terrestrial,267,281,82,221,548,30.711610486891384,82.77153558052434
17386_terrestrial,309,290,100,262,599,32.362459546925564,84.78964401294499
17387_terrestrial,506,365,270,305,871,53.359683794466406,60.27667984189723
17388_terrestrial,514,363,274,315,877,53.30739299610895,61.284046692607006
17389_terrestrial,499,337,270,302,836,54.10821643286573,60.52104208416834
17390_terrestrial,461,293,255,270,754,55.31453362255966,58.56832971800434
17391_terrestrial,401,263,215,240,664,53.61596009975062,59.85037406483791
17452_terrestrial,519,297,392,209,816,75.52986512524085,40.26974951830443
17453_terrestrial,254,176,152,172,430,59.84251968503938,67.71653543307087
17454_terrestrial,269,172,160,190,441,59.479553903345725,70.63197026022306
17455_terrestrial,273,152,171,197,425,62.637362637362635,72.16117216117216
17456_terrestrial,259,165,163,185,424,62.93436293436293,71.42857142857143
17457_terrestrial,273,189,163,195,462,59.70695970695971,71.42857142857143
17458_terrestrial,269,187,162,187,456,60.223048327137555,69.51672862453532
17459_terrestrial,294,183,182,209,477,61.904761904761905,71.08843537414967
17460_terrestrial,288,163,185,208,451,64.23611111111111,72.22222222222221
17461_terrestrial,549,288,415,251,837,75.591985428051,45.71948998178507
17462_terrestrial,547,288,406,248,835,74.22303473491773,45.3382084095064
17463_terrestrial,536,291,399,243,827,74.44029850746269,45.33582089552239
17464_terrestrial,472,268,365,191,740,77.33050847457628,40.46610169491525
17469_terrestrial,444,272,350,168,716,78.82882882882883,37.83783783783784
17470_terrestrial,455,259,358,181,714,78.68131868131869,39.78021978021978
17472_terrestrial,430,263,338,165,693,78.6046511627907,38.372093023255815
17473_terrestrial,512,298,385,224,810,75.1953125,43.75
17474_terrestrial,517,316,386,224,833,74.6615087040619,43.32688588007737
17475_terrestrial,485,284,356,215,769,73.4020618556701,44.329896907216494
17476_terrestrial,521,283,387,244,804,74.28023032629558,46.83301343570058
17477_terrestrial,502,271,383,227,773,76.29482071713147,45.21912350597609
17478_terrestrial,371,221,296,133,592,79.78436657681941,35.84905660377358
17480_terrestrial,566,327,413,286,893,72.96819787985865,50.53003533568905
17481_terrestrial,353,252,216,251,605,61.18980169971672,71.10481586402267
17482_terrestrial,361,251,221,247,612,61.21883656509696,68.42105263157895
17483_terrestrial,388,233,237,279,621,61.08247422680413,71.90721649484536
17484_terrestrial,389,232,241,280,621,61.95372750642674,71.97943444730078
17485_terrestrial,402,217,250,294,619,62.189054726368155,73.13432835820896
17486_terrestrial,613,328,437,327,941,71.28874388254486,53.344208809135395
17487_terrestrial,378,201,228,281,579,60.317460317460316,74.33862433862434
17488_terrestrial,506,276,358,258,782,70.7509881422925,50.988142292490124
17489_terrestrial,481,272,345,247,753,71.72557172557173,51.35135135135135
17490_terrestrial,407,254,293,200,661,71.99017199017199,49.14004914004914
17491_terrestrial,333,207,232,180,540,69.66966966966966,54.054054054054056
17492_terrestrial,337,199,232,187,536,68.84272997032642,55.48961424332344
17493_terrestrial,335,199,225,193,534,67.16417910447761,57.611940298507456
17494_terrestrial,338,197,222,201,535,65.68047337278107,59.46745562130178
17495_terrestrial,346,192,225,215,538,65.02890173410405,62.138728323699425
17496_terrestrial,360,195,242,237,555,67.22222222222223,65.83333333333333
17497_terrestrial,342,192,230,219,534,67.2514619883041,64.03508771929825
17498_terrestrial,287,173,188,170,460,65.50522648083623,59.23344947735192
17499_terrestrial,255,165,165,145,420,64.70588235294117,56.86274509803921
17500_terrestrial,270,177,176,156,447,65.18518518518519,57.77777777777777
17501_terrestrial,296,200,188,170,496,63.51351351351351,57.432432432432435
17502_terrestrial,418,265,267,267,683,63.8755980861244,63.8755980861244
17503_terrestrial,361,231,218,263,592,60.387811634349035,72.85318559556787
17504_terrestrial,350,218,202,261,568,57.714285714285715,74.57142857142857
17505_terrestrial,324,199,189,238,523,58.333333333333336,73.4567901234568
17506_terrestrial,338,202,201,247,540,59.46745562130178,73.07692307692307
17507_terrestrial,345,214,211,251,559,61.15942028985507,72.7536231884058
17508_terrestrial,355,212,220,247,567,61.97183098591549,69.57746478873239
17509_terrestrial,345,204,225,240,549,65.21739130434783,69.56521739130434
17510_terrestrial,267,159,178,187,426,66.66666666666666,70.0374531835206
17536_terrestrial,255,140,160,200,395,62.745098039215684,78.43137254901961
17537_terrestrial,244,143,149,191,387,61.065573770491795,78.27868852459017
17538_terrestrial,246,140,148,192,386,60.16260162601627,78.04878048780488
17539_terrestrial,245,137,149,190,382,60.816326530612244,77.55102040816327
17540_terrestrial,239,136,145,184,375,60.66945606694561,76.98744769874477
17558_terrestrial,110,83,64,77,193,58.18181818181818,70
17559_terrestrial,103,77,59,75,180,57.28155339805825,72.81553398058253
17560_terrestrial,107,80,63,79,187,58.87850467289719,73.83177570093457
17561_terrestrial,105,78,65,79,183,61.904761904761905,75.23809523809524
17562_terrestrial,108,79,65,80,187,60.18518518518518,74.07407407407408
17563_terrestrial,112,77,69,82,189,61.60714285714286,73.21428571428571
17564_terrestrial,114,87,70,81,201,61.40350877192983,71.05263157894737
17565_terrestrial,123,90,79,86,213,64.22764227642277,69.91869918699187
17566_terrestrial,130,100,86,91,230,66.15384615384615,70
17567_terrestrial,141,111,92,102,252,65.24822695035462,72.3404255319149
17568_terrestrial,142,117,91,107,259,64.08450704225352,75.35211267605634
17569_terrestrial,142,117,93,107,259,65.49295774647888,75.35211267605634
17570_terrestrial,143,108,97,108,251,67.83216783216784,75.52447552447552
17571_terrestrial,149,114,103,113,263,69.12751677852349,75.83892617449665
17572_terrestrial,159,128,108,121,287,67.9245283018868,76.10062893081762
17573_terrestrial,161,129,108,120,290,67.08074534161491,74.53416149068323
17574_terrestrial,178,122,116,138,300,65.1685393258427,77.52808988764045
17575_terrestrial,193,125,128,150,318,66.32124352331607,77.720207253886
17576_terrestrial,213,124,139,168,337,65.25821596244131,78.87323943661971
17577_terrestrial,255,136,170,207,391,66.66666666666666,81.17647058823529
17578_terrestrial,273,138,183,221,411,67.03296703296702,80.95238095238095
17579_terrestrial,279,132,185,226,411,66.30824372759857,81.00358422939068
17580_terrestrial,272,121,180,222,393,66.17647058823529,81.61764705882352
17581_terrestrial,269,132,181,218,401,67.28624535315984,81.04089219330855
17582_terrestrial,272,129,187,217,401,68.75,79.77941176470588
17583_terrestrial,283,126,195,222,409,68.90459363957598,78.4452296819788
17584_terrestrial,263,119,178,209,382,67.68060836501901,79.46768060836501
17585_terrestrial,263,119,179,203,382,68.06083650190115,77.18631178707224
17586_terrestrial,270,132,178,205,402,65.92592592592592,75.92592592592592
17587_terrestrial,283,138,185,216,421,65.37102473498233,76.32508833922262
17588_terrestrial,272,140,178,206,412,65.44117647058823,75.73529411764706
17589_terrestrial,267,143,176,199,410,65.91760299625467,74.53183520599251
17590_terrestrial,364,168,264,225,532,72.52747252747253,61.81318681318682
17591_terrestrial,319,151,228,203,470,71.47335423197492,63.63636363636363
17601_terrestrial,428,276,318,232,704,74.29906542056075,54.20560747663551
17602_terrestrial,423,275,313,228,698,73.99527186761229,53.90070921985816
17696_terrestrial,359,290,196,201,649,54.59610027855153,55.98885793871866
17697_terrestrial,264,278,92,211,542,34.84848484848485,79.92424242424242
17698_terrestrial,282,288,90,225,570,31.914893617021278,79.7872340425532
17699_terrestrial,290,286,101,225,576,34.82758620689655,77.58620689655173
17700_terrestrial,252,281,87,201,533,34.523809523809526,79.76190476190477
17701_terrestrial,229,228,79,181,457,34.49781659388647,79.03930131004367
17702_terrestrial,213,200,72,171,413,33.80281690140845,80.28169014084507
17703_terrestrial,202,202,67,160,404,33.16831683168317,79.20792079207921
17704_terrestrial,204,194,68,160,398,33.33333333333333,78.43137254901961
17705_terrestrial,213,211,75,169,424,35.2112676056338,79.34272300469483
17706_terrestrial,218,211,71,170,429,32.56880733944954,77.98165137614679
17707_terrestrial,216,211,72,172,427,33.33333333333333,79.62962962962963
17708_terrestrial,230,231,78,182,461,33.91304347826087,79.13043478260869
17709_terrestrial,246,257,81,191,503,32.926829268292686,77.64227642276423
17710_terrestrial,240,244,81,181,484,33.75,75.41666666666667
17711_terrestrial,243,241,77,184,484,31.68724279835391,75.7201646090535
17712_terrestrial,241,220,73,186,461,30.29045643153527,77.17842323651453
17713_terrestrial,238,217,71,180,455,29.831932773109244,75.63025210084034
17714_terrestrial,249,218,75,185,467,30.120481927710845,74.29718875502009
17715_terrestrial,262,248,77,200,510,29.389312977099237,76.33587786259542
17716_terrestrial,270,236,82,213,506,30.37037037037037,78.88888888888889
17717_terrestrial,250,206,82,199,456,32.800000000000004,79.60000000000001
17718_terrestrial,247,193,84,196,440,34.0080971659919,79.35222672064778
17719_terrestrial,248,185,81,200,433,32.66129032258064,80.64516129032258
17720_terrestrial,251,205,82,203,456,32.669322709163346,80.87649402390437
17721_terrestrial,248,201,78,204,449,31.451612903225808,82.25806451612904
17722_terrestrial,248,214,78,206,462,31.451612903225808,83.06451612903226
17723_terrestrial,249,218,79,206,467,31.72690763052209,82.73092369477911
17724_terrestrial,258,259,79,214,517,30.620155038759687,82.94573643410853
17725_terrestrial,260,279,81,217,539,31.153846153846153,83.46153846153847
17726_terrestrial,242,251,74,203,493,30.57851239669421,83.88429752066115
17727_terrestrial,234,254,69,194,488,29.48717948717949,82.90598290598291
17728_terrestrial,235,311,69,196,546,29.361702127659573,83.40425531914893
17729_terrestrial,240,326,69,201,566,28.749999999999996,83.75
17730_terrestrial,233,348,67,199,581,28.75536480686695,85.40772532188842
17731_terrestrial,239,333,72,205,572,30.125523012552303,85.77405857740585
17732_terrestrial,241,368,70,205,609,29.045643153526974,85.06224066390041
17733_terrestrial,246,363,74,211,609,30.081300813008134,85.77235772357723
17734_terrestrial,239,344,73,206,583,30.543933054393307,86.19246861924687
17735_terrestrial,236,325,71,204,561,30.08474576271186,86.4406779661017
17736_terrestrial,241,350,71,207,591,29.460580912863072,85.89211618257261
17737_terrestrial,241,370,71,207,611,29.460580912863072,85.89211618257261
17738_terrestrial,242,371,73,209,613,30.165289256198346,86.36363636363636
17739_terrestrial,255,368,76,223,623,29.80392156862745,87.45098039215686
17740_terrestrial,258,356,70,220,614,27.131782945736433,85.27131782945736
17741_terrestrial,250,301,70,208,551,28.000000000000004,83.2
17742_terrestrial,252,283,75,203,535,29.761904761904763,80.55555555555556
17743_terrestrial,263,261,78,215,524,29.65779467680608,81.74904942965779
17744_terrestrial,287,280,89,243,567,31.010452961672474,84.66898954703834
17745_terrestrial,303,316,100,260,619,33.003300330033,85.8085808580858
17746_terrestrial,532,431,285,327,963,53.57142857142857,61.46616541353384
17747_terrestrial,504,403,276,297,907,54.761904761904766,58.92857142857143
17748_terrestrial,400,243,239,234,643,59.75,58.5
17812_terrestrial,510,304,390,202,814,76.47058823529412,39.6078431372549
17813_terrestrial,251,181,151,169,432,60.1593625498008,67.33067729083665
17814_terrestrial,266,186,162,184,452,60.902255639097746,69.17293233082707
17815_terrestrial,271,185,167,198,456,61.62361623616236,73.06273062730627
17816_terrestrial,279,178,175,208,457,62.72401433691756,74.55197132616487
17817_terrestrial,295,189,187,219,484,63.389830508474574,74.23728813559322
17818_terrestrial,273,174,174,196,447,63.73626373626373,71.7948717948718
17819_terrestrial,260,156,162,188,416,62.30769230769231,72.3076923076923
17820_terrestrial,284,156,188,198,440,66.19718309859155,69.71830985915493
17821_terrestrial,559,281,428,256,840,76.56529516994634,45.796064400715565
17829_terrestrial,423,199,336,186,622,79.43262411347519,43.97163120567376
17830_terrestrial,396,192,309,157,588,78.03030303030303,39.64646464646464
17834_terrestrial,421,262,328,154,683,77.90973871733968,36.57957244655582
17835_terrestrial,461,282,346,185,743,75.05422993492408,40.130151843817785
17836_terrestrial,481,289,358,200,770,74.42827442827443,41.58004158004158
17837_terrestrial,498,284,372,213,782,74.69879518072288,42.77108433734939
17838_terrestrial,439,244,347,172,683,79.04328018223235,39.17995444191344
17839_terrestrial,402,228,324,151,630,80.59701492537313,37.56218905472637
17840_terrestrial,541,294,398,269,835,73.56746765249538,49.72273567467653
17841_terrestrial,371,257,233,274,628,62.8032345013477,73.8544474393531
17842_terrestrial,362,241,226,267,603,62.430939226519335,73.75690607734806
17843_terrestrial,585,330,428,304,915,73.16239316239316,51.96581196581197
17844_terrestrial,549,317,401,275,866,73.04189435336977,50.09107468123861
17845_terrestrial,547,304,398,274,851,72.76051188299817,50.09140767824497
17846_terrestrial,572,299,421,301,871,73.6013986013986,52.62237762237763
17847_terrestrial,583,317,424,297,900,72.72727272727273,50.943396226415096
17848_terrestrial,503,284,362,264,787,71.96819085487077,52.48508946322068
17849_terrestrial,516,280,370,284,796,71.70542635658916,55.03875968992248
17850_terrestrial,502,271,358,274,773,71.31474103585657,54.581673306772906
17851_terrestrial,323,193,195,233,516,60.371517027863774,72.13622291021672
17852_terrestrial,324,180,193,236,504,59.5679012345679,72.8395061728395
17853_terrestrial,303,157,178,235,460,58.745874587458744,77.55775577557755
17854_terrestrial,287,155,169,222,442,58.88501742160279,77.35191637630662
17855_terrestrial,264,144,149,206,408,56.439393939393945,78.03030303030303
17856_terrestrial,280,148,170,210,428,60.71428571428571,75
17857_terrestrial,285,157,174,211,442,61.05263157894737,74.03508771929825
17858_terrestrial,350,199,227,220,549,64.85714285714286,62.857142857142854
17859_terrestrial,340,206,213,211,546,62.64705882352941,62.05882352941177
17860_terrestrial,350,216,218,220,566,62.28571428571429,62.857142857142854
17861_terrestrial,358,240,220,221,598,61.452513966480446,61.731843575419
17862_terrestrial,304,203,172,215,507,56.57894736842105,70.72368421052632
17863_terrestrial,286,188,162,215,474,56.64335664335665,75.17482517482517
17864_terrestrial,331,217,193,252,548,58.30815709969789,76.13293051359517
17865_terrestrial,348,225,209,260,573,60.05747126436781,74.71264367816092
17866_terrestrial,352,218,221,258,570,62.78409090909091,73.29545454545455
17867_terrestrial,339,208,222,250,547,65.48672566371681,73.74631268436578
17868_terrestrial,345,191,225,258,536,65.21739130434783,74.78260869565217
17869_terrestrial,363,208,245,261,571,67.4931129476584,71.900826446281
17870_terrestrial,334,188,230,235,522,68.8622754491018,70.35928143712576
17871_terrestrial,276,148,191,189,424,69.20289855072464,68.47826086956522
17898_terrestrial,225,127,133,172,352,59.111111111111114,76.44444444444444
17917_terrestrial,134,101,81,95,235,60.447761194029844,70.8955223880597
17918_terrestrial,136,101,84,92,237,61.76470588235294,67.64705882352942
17919_terrestrial,122,95,75,90,217,61.47540983606557,73.77049180327869
17920_terrestrial,124,92,76,89,216,61.29032258064516,71.7741935483871
17921_terrestrial,116,81,68,88,197,58.620689655172406,75.86206896551724
17922_terrestrial,120,75,73,91,195,60.83333333333333,75.83333333333333
17923_terrestrial,122,79,71,93,201,58.19672131147541,76.22950819672131
17924_terrestrial,131,84,79,98,215,60.30534351145038,74.80916030534351
17925_terrestrial,137,87,84,102,224,61.31386861313869,74.45255474452554
17926_terrestrial,146,95,88,109,241,60.273972602739725,74.65753424657534
17927_terrestrial,156,111,98,118,267,62.82051282051282,75.64102564102564
17928_terrestrial,152,122,98,117,274,64.47368421052632,76.97368421052632
17929_terrestrial,157,114,104,123,271,66.2420382165605,78.343949044586
17930_terrestrial,155,117,107,119,272,69.03225806451613,76.77419354838709
17931_terrestrial,157,122,108,121,279,68.78980891719745,77.07006369426752
17932_terrestrial,173,126,117,132,299,67.63005780346822,76.30057803468208
17933_terrestrial,190,128,123,142,318,64.73684210526316,74.73684210526315
17934_terrestrial,199,130,126,151,329,63.31658291457286,75.87939698492463
17935_terrestrial,219,125,143,171,344,65.29680365296804,78.08219178082192
17936_terrestrial,264,134,175,204,398,66.28787878787878,77.27272727272727
17937_terrestrial,297,149,202,234,446,68.01346801346801,78.78787878787878
17938_terrestrial,295,148,201,232,443,68.13559322033899,78.64406779661017
17939_terrestrial,291,127,198,231,418,68.04123711340206,79.38144329896907
17940_terrestrial,419,173,316,252,592,75.41766109785203,60.14319809069213
17941_terrestrial,406,173,307,236,579,75.61576354679804,58.128078817733986
17942_terrestrial,414,180,310,243,594,74.8792270531401,58.69565217391305
17943_terrestrial,404,166,303,237,570,75,58.66336633663366
17944_terrestrial,269,115,186,207,384,69.14498141263941,76.95167286245353
17945_terrestrial,309,137,205,227,446,66.34304207119742,73.46278317152104
17946_terrestrial,292,145,189,219,437,64.72602739726028,75
17947_terrestrial,265,133,172,205,398,64.90566037735849,77.35849056603774
17948_terrestrial,354,164,252,224,518,71.1864406779661,63.2768361581921
17949_terrestrial,363,164,262,221,527,72.1763085399449,60.88154269972452
17950_terrestrial,348,159,254,210,507,72.98850574712644,60.3448275862069
17960_terrestrial,375,204,286,203,579,76.26666666666667,54.13333333333333
17961_terrestrial,382,225,289,209,607,75.6544502617801,54.712041884816756
17962_terrestrial,392,239,301,208,631,76.78571428571429,53.06122448979592
18056_terrestrial,323,242,175,186,565,54.179566563467496,57.585139318885446
18057_terrestrial,394,339,212,231,733,53.80710659898477,58.629441624365484
18058_terrestrial,286,279,91,230,565,31.818181818181817,80.41958041958041
18059_terrestrial,306,278,102,245,584,33.33333333333333,80.06535947712419
18060_terrestrial,282,302,102,219,584,36.17021276595745,77.6595744680851
18061_terrestrial,253,270,86,203,523,33.99209486166008,80.23715415019763
18062_terrestrial,228,222,80,188,450,35.08771929824561,82.45614035087719
18063_terrestrial,209,214,71,171,423,33.97129186602871,81.81818181818183
18064_terrestrial,206,204,74,166,410,35.92233009708738,80.58252427184466
18065_terrestrial,209,212,70,169,421,33.49282296650718,80.86124401913875
18066_terrestrial,205,212,67,161,417,32.6829268292683,78.53658536585367
18067_terrestrial,203,208,67,159,411,33.004926108374384,78.32512315270937
18068_terrestrial,225,229,72,172,454,32,76.44444444444444
18069_terrestrial,222,247,68,173,469,30.630630630630627,77.92792792792793
18070_terrestrial,226,253,72,174,479,31.858407079646017,76.99115044247787
18071_terrestrial,235,249,75,183,484,31.914893617021278,77.87234042553192
18072_terrestrial,235,241,74,181,476,31.48936170212766,77.02127659574468
18073_terrestrial,233,227,74,176,460,31.759656652360512,75.53648068669528
18074_terrestrial,254,211,77,190,465,30.314960629921263,74.80314960629921
18075_terrestrial,268,261,82,202,529,30.597014925373134,75.3731343283582
18076_terrestrial,276,241,82,213,517,29.71014492753623,77.17391304347827
18077_terrestrial,257,196,86,200,453,33.46303501945525,77.82101167315176
18078_terrestrial,240,174,81,190,414,33.75,79.16666666666666
18079_terrestrial,241,187,78,193,428,32.365145228215766,80.08298755186722
18080_terrestrial,232,184,76,184,416,32.758620689655174,79.3103448275862
18081_terrestrial,242,194,79,195,436,32.64462809917356,80.57851239669421
18082_terrestrial,244,211,74,201,455,30.327868852459016,82.37704918032787
18083_terrestrial,252,236,76,209,488,30.158730158730158,82.93650793650794
18084_terrestrial,258,271,76,216,529,29.457364341085274,83.72093023255815
18085_terrestrial,273,301,81,229,574,29.67032967032967,83.88278388278388
18086_terrestrial,258,298,78,216,556,30.23255813953488,83.72093023255815
18087_terrestrial,242,327,69,205,569,28.512396694214875,84.71074380165288
18088_terrestrial,232,354,61,196,586,26.29310344827586,84.48275862068965
18089_terrestrial,243,364,65,207,607,26.748971193415638,85.18518518518519
18090_terrestrial,249,358,68,210,607,27.309236947791167,84.33734939759037
18091_terrestrial,239,362,66,205,601,27.615062761506277,85.77405857740585
18092_terrestrial,243,366,68,211,609,27.983539094650205,86.83127572016461
18093_terrestrial,243,374,70,211,617,28.80658436213992,86.83127572016461
18094_terrestrial,240,339,69,209,579,28.749999999999996,87.08333333333333
18095_terrestrial,241,357,67,209,598,27.800829875518673,86.72199170124482
18096_terrestrial,237,381,68,206,618,28.691983122362867,86.91983122362869
18097_terrestrial,236,390,68,204,626,28.8135593220339,86.4406779661017
18098_terrestrial,240,394,65,206,634,27.083333333333332,85.83333333333333
18099_terrestrial,245,387,66,207,632,26.93877551020408,84.48979591836735
18100_terrestrial,248,355,71,206,603,28.62903225806452,83.06451612903226
18101_terrestrial,253,322,76,206,575,30.039525691699602,81.42292490118577
18102_terrestrial,269,288,82,222,557,30.483271375464682,82.5278810408922
18103_terrestrial,302,315,100,256,617,33.11258278145696,84.76821192052981
18104_terrestrial,537,411,297,319,948,55.3072625698324,59.40409683426443
18105_terrestrial,530,403,297,313,933,56.0377358490566,59.056603773584904
18106_terrestrial,498,363,277,290,861,55.62248995983936,58.23293172690763
18171_terrestrial,488,309,389,187,797,79.71311475409836,38.31967213114754
18172_terrestrial,535,324,417,230,859,77.94392523364486,42.99065420560748
18173_terrestrial,258,184,160,182,442,62.01550387596899,70.54263565891473
18174_terrestrial,273,177,175,199,450,64.1025641025641,72.89377289377289
18175_terrestrial,280,169,178,206,449,63.57142857142857,73.57142857142858
18176_terrestrial,278,171,180,207,449,64.74820143884892,74.46043165467626
18177_terrestrial,285,169,190,210,454,66.66666666666666,73.68421052631578
18178_terrestrial,276,147,182,205,423,65.94202898550725,74.27536231884058
18179_terrestrial,255,147,159,188,402,62.35294117647059,73.72549019607844
18180_terrestrial,536,268,415,247,804,77.42537313432835,46.082089552238806
18181_terrestrial,217,116,141,145,333,64.97695852534562,66.82027649769586
18182_terrestrial,355,154,304,118,509,85.63380281690141,33.23943661971831
18183_terrestrial,406,184,330,161,590,81.2807881773399,39.6551724137931
18184_terrestrial,419,205,336,165,624,80.1909307875895,39.37947494033413
18189_terrestrial,449,200,353,205,649,78.61915367483296,45.657015590200444
18190_terrestrial,445,197,347,200,642,77.97752808988764,44.9438202247191
18196_terrestrial,453,268,343,171,721,75.71743929359823,37.74834437086093
18197_terrestrial,500,279,377,210,779,75.4,42
18198_terrestrial,418,250,330,153,668,78.94736842105263,36.60287081339713
18199_terrestrial,386,217,311,139,603,80.56994818652849,36.01036269430052
18200_terrestrial,498,274,370,231,772,74.29718875502009,46.3855421686747
18201_terrestrial,579,343,426,298,922,73.57512953367875,51.46804835924007
18202_terrestrial,574,356,423,283,930,73.69337979094077,49.30313588850174
18203_terrestrial,525,307,380,260,832,72.38095238095238,49.523809523809526
18204_terrestrial,495,293,371,236,788,74.94949494949495,47.67676767676768
18206_terrestrial,407,186,322,175,593,79.11547911547912,42.997542997543
18207_terrestrial,503,287,379,233,790,75.3479125248509,46.3220675944334
18208_terrestrial,316,177,198,229,493,62.65822784810127,72.46835443037975
18209_terrestrial,322,171,198,247,493,61.49068322981367,76.70807453416148
18210_terrestrial,321,187,201,237,508,62.616822429906534,73.83177570093457
18211_terrestrial,304,170,184,234,474,60.526315789473685,76.97368421052632
18212_terrestrial,304,149,187,238,453,61.51315789473685,78.28947368421053
18213_terrestrial,302,142,192,241,444,63.576158940397356,79.80132450331125
18214_terrestrial,266,144,174,210,410,65.41353383458647,78.94736842105263
18215_terrestrial,246,127,154,195,373,62.601626016260155,79.26829268292683
18216_terrestrial,250,129,154,196,379,61.6,78.4
18217_terrestrial,247,128,153,196,375,61.943319838056674,79.35222672064778
18218_terrestrial,249,127,155,198,376,62.24899598393574,79.51807228915662
18219_terrestrial,236,143,137,181,379,58.05084745762712,76.69491525423729
18220_terrestrial,236,149,130,179,385,55.08474576271186,75.84745762711864
18221_terrestrial,221,147,125,165,368,56.56108597285068,74.6606334841629
18222_terrestrial,230,148,133,173,378,57.826086956521735,75.21739130434783
18223_terrestrial,238,162,138,178,400,57.98319327731093,74.78991596638656
18224_terrestrial,270,190,165,206,460,61.111111111111114,76.29629629629629
18225_terrestrial,369,227,222,275,596,60.16260162601627,74.52574525745257
18226_terrestrial,367,226,224,268,593,61.03542234332425,73.02452316076294
18227_terrestrial,349,218,211,255,567,60.458452722063036,73.06590257879655
18228_terrestrial,375,212,249,275,587,66.4,73.33333333333333
18229_terrestrial,413,233,285,295,646,69.00726392251816,71.42857142857143
18230_terrestrial,365,189,260,264,554,71.23287671232876,72.32876712328768
18234_terrestrial,214,140,145,135,354,67.7570093457944,63.084112149532714
18277_terrestrial,138,108,83,92,246,60.14492753623188,66.66666666666666
18278_terrestrial,148,122,85,100,270,57.432432432432435,67.56756756756756
18279_terrestrial,152,135,88,104,287,57.89473684210527,68.42105263157895
18280_terrestrial,160,136,91,108,296,56.875,67.5
18281_terrestrial,162,122,96,111,284,59.25925925925925,68.51851851851852
18282_terrestrial,155,108,90,120,263,58.06451612903226,77.41935483870968
18283_terrestrial,152,94,90,118,246,59.210526315789465,77.63157894736842
18284_terrestrial,150,96,87,119,246,57.99999999999999,79.33333333333333
18285_terrestrial,155,98,94,122,253,60.64516129032258,78.70967741935485
18286_terrestrial,159,125,99,121,284,62.264150943396224,76.10062893081762
18287_terrestrial,161,131,101,125,292,62.732919254658384,77.63975155279503
18288_terrestrial,160,115,102,126,275,63.74999999999999,78.75
18289_terrestrial,160,116,105,126,276,65.625,78.75
18290_terrestrial,169,114,114,130,283,67.45562130177515,76.92307692307693
18291_terrestrial,176,117,116,136,293,65.9090909090909,77.27272727272727
18292_terrestrial,193,132,123,149,325,63.730569948186535,77.2020725388601
18293_terrestrial,199,131,132,152,330,66.33165829145729,76.38190954773869
18294_terrestrial,219,128,147,168,347,67.12328767123287,76.71232876712328
18295_terrestrial,245,125,165,191,370,67.3469387755102,77.9591836734694
18296_terrestrial,276,137,182,218,413,65.94202898550725,78.98550724637681
18297_terrestrial,302,142,209,229,444,69.20529801324503,75.82781456953643
18298_terrestrial,422,179,322,245,601,76.30331753554502,58.0568720379147
18299_terrestrial,404,165,304,239,569,75.24752475247524,59.15841584158416
18300_terrestrial,406,163,311,234,569,76.60098522167488,57.635467980295566
18302_terrestrial,403,154,309,233,557,76.67493796526055,57.81637717121588
18303_terrestrial,396,156,304,224,552,76.76767676767676,56.56565656565656
18304_terrestrial,401,161,306,225,562,76.30922693266832,56.10972568578554
18305_terrestrial,442,168,328,252,610,74.2081447963801,57.01357466063348
18306_terrestrial,434,174,323,244,608,74.42396313364056,56.22119815668203
18307_terrestrial,255,121,162,203,376,63.52941176470588,79.6078431372549
18308_terrestrial,394,168,283,239,562,71.8274111675127,60.659898477157356
18320_terrestrial,384,202,296,208,586,77.08333333333334,54.166666666666664
18321_terrestrial,382,214,292,212,596,76.43979057591623,55.497382198952884
18322_terrestrial,400,244,311,212,644,77.75,53
18417_terrestrial,389,321,217,226,710,55.78406169665809,58.09768637532133
18418_terrestrial,452,368,237,270,820,52.43362831858407,59.73451327433629
18419_terrestrial,308,287,103,249,595,33.44155844155844,80.84415584415584
18420_terrestrial,303,318,102,242,621,33.663366336633665,79.86798679867987
18421_terrestrial,277,321,95,220,598,34.29602888086642,79.42238267148014
18422_terrestrial,252,254,83,197,506,32.93650793650794,78.17460317460318
18423_terrestrial,220,234,73,177,454,33.18181818181819,80.45454545454545
18424_terrestrial,205,215,67,163,420,32.6829268292683,79.51219512195122
18425_terrestrial,208,218,67,164,426,32.21153846153847,78.84615384615384
18426_terrestrial,211,226,70,165,437,33.175355450236964,78.19905213270142
18427_terrestrial,210,228,70,164,438,33.33333333333333,78.0952380952381
18428_terrestrial,218,241,68,169,459,31.19266055045872,77.52293577981652
18429_terrestrial,218,247,65,167,465,29.81651376146789,76.60550458715596
18430_terrestrial,211,250,66,164,461,31.27962085308057,77.72511848341233
18431_terrestrial,229,246,69,175,475,30.131004366812224,76.41921397379913
18432_terrestrial,232,247,71,176,479,30.603448275862068,75.86206896551724
18433_terrestrial,235,231,74,174,466,31.48936170212766,74.04255319148936
18434_terrestrial,243,220,73,178,463,30.04115226337449,73.25102880658436
18435_terrestrial,266,245,82,199,511,30.82706766917293,74.81203007518798
18436_terrestrial,278,264,83,213,542,29.856115107913666,76.61870503597122
18437_terrestrial,257,225,81,199,482,31.517509727626457,77.431906614786
18438_terrestrial,244,199,80,189,443,32.78688524590164,77.45901639344262
18439_terrestrial,239,178,77,189,417,32.21757322175732,79.07949790794979
18440_terrestrial,234,194,76,185,428,32.47863247863248,79.05982905982906
18441_terrestrial,244,210,76,196,454,31.147540983606557,80.32786885245902
18442_terrestrial,256,221,78,211,477,30.46875,82.421875
18443_terrestrial,252,261,75,209,513,29.761904761904763,82.93650793650794
18444_terrestrial,252,296,74,211,548,29.365079365079367,83.73015873015873
18445_terrestrial,260,312,76,220,572,29.230769230769234,84.61538461538461
18446_terrestrial,252,322,73,215,574,28.968253968253972,85.31746031746032
18447_terrestrial,253,346,71,217,599,28.063241106719367,85.7707509881423
18448_terrestrial,253,356,72,216,609,28.458498023715418,85.37549407114624
18449_terrestrial,251,393,70,213,644,27.88844621513944,84.86055776892431
18450_terrestrial,260,423,71,219,683,27.307692307692307,84.23076923076923
18451_terrestrial,247,404,74,212,651,29.959514170040485,85.82995951417004
18452_terrestrial,253,382,77,220,635,30.434782608695656,86.95652173913044
18453_terrestrial,252,368,76,219,620,30.158730158730158,86.90476190476191
18454_terrestrial,246,364,73,213,610,29.67479674796748,86.58536585365853
18455_terrestrial,236,349,74,202,585,31.35593220338983,85.59322033898306
18456_terrestrial,234,377,69,201,611,29.48717948717949,85.8974358974359
18457_terrestrial,234,391,68,198,625,29.059829059829063,84.61538461538461
18458_terrestrial,233,380,63,198,613,27.038626609442062,84.97854077253218
18459_terrestrial,243,368,68,202,611,27.983539094650205,83.1275720164609
18460_terrestrial,258,340,72,214,598,27.906976744186046,82.94573643410853
18461_terrestrial,261,350,75,218,611,28.735632183908045,83.5249042145594
18462_terrestrial,264,324,80,220,588,30.303030303030305,83.33333333333334
18463_terrestrial,492,430,278,282,922,56.50406504065041,57.3170731707317
18464_terrestrial,505,409,275,291,914,54.45544554455446,57.62376237623762
18465_terrestrial,500,368,276,286,868,55.2,57.199999999999996
18466_terrestrial,456,299,256,253,755,56.14035087719298,55.48245614035088
18531_terrestrial,488,300,388,187,788,79.50819672131148,38.31967213114754
18532_terrestrial,553,316,436,237,869,78.84267631103074,42.857142857142854
18533_terrestrial,253,165,163,185,418,64.42687747035573,73.12252964426878
18534_terrestrial,270,158,174,198,428,64.44444444444444,73.33333333333333
18535_terrestrial,271,154,172,199,425,63.46863468634686,73.43173431734317
18536_terrestrial,271,164,172,200,435,63.46863468634686,73.80073800738008
18537_terrestrial,280,165,179,208,445,63.92857142857142,74.28571428571429
18538_terrestrial,269,168,169,202,437,62.825278810408925,75.09293680297398
18539_terrestrial,279,162,177,198,441,63.44086021505376,70.96774193548387
18540_terrestrial,536,268,416,229,804,77.61194029850746,42.723880597014926
18541_terrestrial,439,236,348,159,675,79.27107061503416,36.21867881548975
18542_terrestrial,362,159,308,122,521,85.0828729281768,33.70165745856354
18549_terrestrial,401,195,320,165,596,79.80049875311721,41.14713216957606
18553_terrestrial,413,209,330,156,622,79.90314769975787,37.77239709443099
18554_terrestrial,430,211,339,170,641,78.83720930232559,39.53488372093023
18555_terrestrial,415,209,323,158,624,77.83132530120483,38.0722891566265
18556_terrestrial,487,298,364,185,785,74.74332648870636,37.98767967145791
18557_terrestrial,478,270,364,187,748,76.15062761506276,39.12133891213389
18558_terrestrial,407,242,320,141,649,78.62407862407862,34.64373464373464
18561_terrestrial,488,274,371,222,762,76.02459016393442,45.49180327868852
18562_terrestrial,551,336,408,270,887,74.04718693284936,49.00181488203267
18563_terrestrial,542,328,400,262,870,73.80073800738008,48.33948339483395
18564_terrestrial,504,287,382,240,791,75.79365079365078,47.61904761904761
18565_terrestrial,458,256,344,207,714,75.10917030567686,45.19650655021834
18566_terrestrial,355,160,285,132,515,80.28169014084507,37.183098591549296
18567_terrestrial,499,276,371,239,775,74.34869739478958,47.89579158316633
18568_terrestrial,522,293,377,256,815,72.22222222222221,49.042145593869726
18569_terrestrial,300,171,176,222,471,58.666666666666664,74
18570_terrestrial,297,172,175,225,469,58.92255892255892,75.75757575757575
18571_terrestrial,316,177,197,246,493,62.34177215189873,77.84810126582279
18572_terrestrial,316,173,198,246,489,62.65822784810127,77.84810126582279
18573_terrestrial,282,149,185,221,431,65.60283687943263,78.36879432624113
18574_terrestrial,250,135,166,199,385,66.4,79.60000000000001
18575_terrestrial,285,154,176,229,439,61.75438596491228,80.35087719298247
18576_terrestrial,287,165,171,229,452,59.58188153310105,79.79094076655052
18577_terrestrial,255,156,150,197,411,58.82352941176471,77.25490196078432
18578_terrestrial,232,142,137,179,374,59.05172413793104,77.15517241379311
18579_terrestrial,230,145,136,182,375,59.130434782608695,79.13043478260869
18580_terrestrial,231,139,133,179,370,57.57575757575758,77.48917748917748
18581_terrestrial,225,143,132,174,368,58.666666666666664,77.33333333333333
18582_terrestrial,245,158,143,189,403,58.36734693877551,77.14285714285715
18583_terrestrial,257,165,149,197,422,57.97665369649806,76.65369649805449
18584_terrestrial,263,167,161,198,430,61.21673003802282,75.2851711026616
18585_terrestrial,279,199,168,208,478,60.215053763440864,74.55197132616487
18586_terrestrial,330,202,199,245,532,60.303030303030305,74.24242424242425
18587_terrestrial,351,209,209,253,560,59.54415954415955,72.07977207977207
18588_terrestrial,294,194,184,206,488,62.585034013605444,70.06802721088435
18589_terrestrial,423,246,281,298,669,66.43026004728132,70.44917257683215
18639_terrestrial,162,112,93,111,274,57.407407407407405,68.51851851851852
18640_terrestrial,176,134,100,123,310,56.81818181818182,69.88636363636364
18641_terrestrial,194,149,110,139,343,56.70103092783505,71.64948453608247
18642_terrestrial,200,148,113,145,348,56.49999999999999,72.5
18643_terrestrial,190,129,105,145,319,55.26315789473685,76.31578947368422
18644_terrestrial,166,110,97,132,276,58.43373493975904,79.51807228915662
18645_terrestrial,169,109,101,134,278,59.76331360946746,79.28994082840237
18646_terrestrial,172,145,105,134,317,61.04651162790697,77.90697674418605
18647_terrestrial,176,139,113,139,315,64.20454545454545,78.97727272727273
18648_terrestrial,166,131,106,133,297,63.85542168674698,80.12048192771084
18649_terrestrial,172,127,110,131,299,63.95348837209303,76.16279069767442
18650_terrestrial,174,122,113,134,296,64.9425287356322,77.01149425287356
18651_terrestrial,187,128,118,145,315,63.101604278074866,77.54010695187165
18652_terrestrial,210,128,134,163,338,63.8095238095238,77.61904761904762
18653_terrestrial,222,130,150,171,352,67.56756756756756,77.02702702702703
18654_terrestrial,237,130,161,184,367,67.9324894514768,77.63713080168776
18655_terrestrial,246,112,163,197,358,66.26016260162602,80.08130081300813
18656_terrestrial,252,117,173,205,369,68.65079365079364,81.34920634920636
18657_terrestrial,260,118,181,205,378,69.61538461538461,78.84615384615384
18658_terrestrial,398,164,305,231,562,76.63316582914574,58.040201005025125
18659_terrestrial,375,151,294,212,526,78.4,56.53333333333334
18662_terrestrial,381,155,288,212,536,75.59055118110236,55.643044619422575
18665_terrestrial,390,157,295,208,547,75.64102564102564,53.333333333333336
18666_terrestrial,412,165,312,223,577,75.72815533980582,54.12621359223301
18667_terrestrial,269,117,176,213,386,65.4275092936803,79.182156133829
18668_terrestrial,377,158,267,236,535,70.82228116710876,62.59946949602122
18669_terrestrial,395,151,291,227,546,73.67088607594937,57.46835443037974
18679_terrestrial,330,156,253,156,486,76.66666666666667,47.27272727272727
18680_terrestrial,406,223,314,212,629,77.33990147783251,52.21674876847291
18681_terrestrial,420,244,328,214,664,78.0952380952381,50.95238095238095
18682_terrestrial,416,250,326,207,666,78.36538461538461,49.75961538461539
18778_terrestrial,443,346,237,253,789,53.49887133182845,57.11060948081265
18779_terrestrial,300,278,102,248,578,34,82.66666666666667
18780_terrestrial,290,287,90,233,577,31.03448275862069,80.3448275862069
18781_terrestrial,288,327,93,228,615,32.29166666666667,79.16666666666666
18782_terrestrial,267,318,83,211,585,31.086142322097377,79.02621722846442
18783_terrestrial,233,245,73,190,478,31.330472103004293,81.54506437768241
18784_terrestrial,208,233,65,171,441,31.25,82.21153846153845
18785_terrestrial,222,248,70,182,470,31.53153153153153,81.98198198198197
18786_terrestrial,242,260,78,199,502,32.231404958677686,82.23140495867769
18787_terrestrial,256,272,81,203,528,31.640625,79.296875
18788_terrestrial,236,263,81,187,499,34.32203389830508,79.23728813559322
18789_terrestrial,218,268,70,169,486,32.11009174311927,77.52293577981652
18790_terrestrial,209,260,69,160,469,33.014354066985646,76.55502392344498
18791_terrestrial,223,251,68,173,474,30.493273542600896,77.57847533632287
18792_terrestrial,246,256,77,187,502,31.300813008130078,76.01626016260163
18793_terrestrial,245,247,77,182,492,31.428571428571427,74.28571428571429
18794_terrestrial,238,233,74,178,471,31.092436974789916,74.78991596638656
18795_terrestrial,262,266,82,195,528,31.297709923664126,74.42748091603053
18796_terrestrial,277,276,86,210,553,31.046931407942242,75.81227436823104
18797_terrestrial,270,247,82,211,517,30.37037037037037,78.14814814814814
18798_terrestrial,253,227,78,198,480,30.8300395256917,78.26086956521739
18799_terrestrial,252,200,79,199,452,31.349206349206348,78.96825396825396
18800_terrestrial,248,212,80,198,460,32.25806451612903,79.83870967741935
18801_terrestrial,251,230,77,202,481,30.677290836653388,80.47808764940238
18802_terrestrial,260,243,78,211,503,30,81.15384615384616
18803_terrestrial,259,275,74,216,534,28.57142857142857,83.3976833976834
18804_terrestrial,258,291,76,217,549,29.457364341085274,84.10852713178295
18805_terrestrial,252,329,75,213,581,29.761904761904763,84.52380952380952
18806_terrestrial,259,357,80,222,616,30.888030888030887,85.71428571428571
18807_terrestrial,261,376,77,222,637,29.50191570881226,85.0574712643678
18808_terrestrial,258,380,77,220,638,29.844961240310074,85.27131782945736
18809_terrestrial,250,412,70,216,662,28.000000000000004,86.4
18810_terrestrial,258,467,73,219,725,28.294573643410853,84.88372093023256
18811_terrestrial,260,480,77,221,740,29.615384615384617,85
18812_terrestrial,247,456,71,214,703,28.74493927125506,86.63967611336032
18813_terrestrial,241,397,68,208,638,28.21576763485477,86.30705394190872
18814_terrestrial,236,400,69,207,636,29.23728813559322,87.71186440677965
18815_terrestrial,231,395,70,199,626,30.303030303030305,86.14718614718615
18816_terrestrial,232,374,67,196,606,28.879310344827587,84.48275862068965
18817_terrestrial,234,373,65,196,607,27.77777777777778,83.76068376068376
18818_terrestrial,239,408,68,202,647,28.451882845188287,84.51882845188284
18819_terrestrial,247,391,72,204,638,29.1497975708502,82.5910931174089
18820_terrestrial,254,355,72,214,609,28.346456692913385,84.25196850393701
18821_terrestrial,252,365,74,213,617,29.365079365079367,84.52380952380952
18822_terrestrial,237,356,71,202,593,29.957805907172997,85.23206751054853
18823_terrestrial,275,343,93,234,618,33.81818181818182,85.0909090909091
18824_terrestrial,496,434,276,279,930,55.64516129032258,56.25
18825_terrestrial,500,328,280,279,828,56.00000000000001,55.800000000000004
18892_terrestrial,562,322,437,240,884,77.75800711743773,42.704626334519574
18893_terrestrial,587,317,453,260,904,77.17206132879046,44.29301533219762
18894_terrestrial,602,306,461,274,908,76.578073089701,45.51495016611295
18895_terrestrial,312,167,206,227,479,66.02564102564102,72.75641025641025
18896_terrestrial,285,167,180,209,452,63.1578947368421,73.33333333333333
18897_terrestrial,275,162,174,200,437,63.272727272727266,72.72727272727273
18898_terrestrial,290,149,180,209,439,62.06896551724138,72.06896551724138
18899_terrestrial,521,267,395,217,788,75.81573896353166,41.65067178502879
18900_terrestrial,504,244,394,201,748,78.17460317460318,39.88095238095239
18907_terrestrial,463,226,366,176,689,79.04967602591793,38.01295896328294
18908_terrestrial,474,232,373,180,706,78.69198312236287,37.9746835443038
18909_terrestrial,478,226,378,187,704,79.07949790794979,39.12133891213389
18910_terrestrial,527,237,412,219,764,78.17836812144212,41.555977229601524
18913_terrestrial,433,204,344,166,637,79.44572748267899,38.33718244803695
18914_terrestrial,467,216,363,198,683,77.73019271948608,42.398286937901496
18915_terrestrial,500,209,386,231,709,77.2,46.2
18916_terrestrial,524,292,389,238,816,74.23664122137404,45.41984732824427
18917_terrestrial,187,120,111,118,307,59.35828877005348,63.101604278074866
18921_terrestrial,359,165,295,123,524,82.17270194986072,34.26183844011142
18922_terrestrial,485,278,364,226,763,75.05154639175258,46.597938144329895
18923_terrestrial,488,279,365,227,767,74.79508196721312,46.51639344262295
18924_terrestrial,443,265,338,187,708,76.2979683972912,42.21218961625282
18925_terrestrial,440,257,336,185,697,76.36363636363637,42.04545454545455
18926_terrestrial,365,174,294,129,539,80.54794520547945,35.342465753424655
18927_terrestrial,397,179,312,162,576,78.58942065491183,40.80604534005038
18928_terrestrial,534,283,394,267,817,73.78277153558052,50
18929_terrestrial,517,292,380,251,809,73.5009671179884,48.54932301740813
18930_terrestrial,312,196,192,234,508,61.53846153846154,75
18931_terrestrial,349,215,216,257,564,61.891117478510026,73.63896848137536
18932_terrestrial,348,209,206,253,557,59.195402298850574,72.70114942528735
18933_terrestrial,339,181,207,265,520,61.06194690265486,78.17109144542773
18934_terrestrial,342,184,217,271,526,63.450292397660824,79.23976608187134
18935_terrestrial,373,226,230,286,599,61.66219839142091,76.67560321715817
18936_terrestrial,347,218,212,262,565,61.09510086455331,75.50432276657061
18937_terrestrial,324,218,193,238,542,59.5679012345679,73.4567901234568
18938_terrestrial,275,193,155,201,468,56.36363636363636,73.0909090909091
18939_terrestrial,247,165,145,184,412,58.70445344129555,74.49392712550608
18940_terrestrial,218,143,128,162,361,58.71559633027523,74.31192660550458
18941_terrestrial,213,125,124,161,338,58.21596244131455,75.5868544600939
18942_terrestrial,231,134,136,176,365,58.87445887445888,76.19047619047619
18943_terrestrial,278,155,164,210,433,58.992805755395686,75.53956834532374
18944_terrestrial,267,158,155,203,425,58.052434456928836,76.02996254681648
18945_terrestrial,280,178,167,216,458,59.64285714285714,77.14285714285715
18946_terrestrial,249,165,149,187,414,59.83935742971887,75.1004016064257
18947_terrestrial,240,167,145,180,407,60.416666666666664,75
18948_terrestrial,256,175,156,185,431,60.9375,72.265625
18949_terrestrial,349,231,221,230,580,63.323782234957015,65.90257879656161
18950_terrestrial,327,212,211,219,539,64.52599388379205,66.97247706422019
18951_terrestrial,265,162,175,170,427,66.0377358490566,64.15094339622641
18954_terrestrial,303,167,202,204,470,66.66666666666666,67.32673267326733
18955_terrestrial,360,207,232,243,567,64.44444444444444,67.5
18999_terrestrial,165,102,96,113,267,58.18181818181818,68.48484848484848
19000_terrestrial,189,111,106,135,300,56.08465608465608,71.42857142857143
19001_terrestrial,205,138,114,146,343,55.60975609756098,71.21951219512195
19002_terrestrial,211,158,117,152,369,55.45023696682464,72.03791469194313
19003_terrestrial,214,175,119,159,389,55.60747663551402,74.29906542056075
19004_terrestrial,208,156,117,159,364,56.25,76.4423076923077
19005_terrestrial,197,157,115,151,354,58.37563451776649,76.6497461928934
19006_terrestrial,204,148,126,155,352,61.76470588235294,75.98039215686273
19007_terrestrial,191,139,121,148,330,63.35078534031413,77.4869109947644
19008_terrestrial,193,140,117,151,333,60.62176165803109,78.23834196891191
19009_terrestrial,188,131,115,147,319,61.170212765957444,78.19148936170212
19010_terrestrial,191,131,122,149,322,63.87434554973822,78.01047120418848
19011_terrestrial,205,127,132,160,332,64.39024390243902,78.04878048780488
19012_terrestrial,221,122,146,168,343,66.06334841628959,76.01809954751131
19013_terrestrial,228,121,155,173,349,67.98245614035088,75.87719298245614
19014_terrestrial,241,123,161,184,364,66.80497925311202,76.34854771784232
19015_terrestrial,239,126,157,192,365,65.69037656903765,80.3347280334728
19016_terrestrial,239,111,163,188,350,68.20083682008368,78.66108786610879
19017_terrestrial,245,113,173,193,358,70.61224489795919,78.77551020408163
19018_terrestrial,260,113,186,200,373,71.53846153846153,76.92307692307693
19019_terrestrial,391,157,304,221,548,77.74936061381074,56.52173913043478
19020_terrestrial,394,158,307,218,552,77.91878172588832,55.32994923857868
19021_terrestrial,379,153,296,205,532,78.10026385224275,54.089709762532976
19022_terrestrial,383,152,300,212,535,78.3289817232376,55.35248041775457
19023_terrestrial,395,163,311,207,558,78.73417721518987,52.40506329113924
19025_terrestrial,377,157,287,198,534,76.12732095490716,52.51989389920424
19026_terrestrial,407,163,313,215,570,76.90417690417691,52.825552825552826
19027_terrestrial,460,183,347,260,643,75.43478260869566,56.52173913043478
19028_terrestrial,423,176,320,241,599,75.65011820330969,56.973995271867615
19029_terrestrial,387,158,293,221,545,75.71059431524549,57.105943152454785
19030_terrestrial,389,154,295,215,543,75.83547557840618,55.26992287917738
19037_terrestrial,418,210,331,209,628,79.18660287081339,50
19038_terrestrial,428,229,330,223,657,77.10280373831776,52.10280373831776
19039_terrestrial,444,264,341,220,708,76.8018018018018,49.549549549549546
19040_terrestrial,407,246,311,217,653,76.41277641277642,53.31695331695332
19041_terrestrial,432,247,334,221,679,77.31481481481481,51.157407407407405
19042_terrestrial,400,220,314,201,620,78.5,50.24999999999999
19138_terrestrial,372,282,217,204,654,58.333333333333336,54.83870967741935
19139_terrestrial,464,381,263,252,845,56.68103448275862,54.310344827586206
19140_terrestrial,273,253,86,227,526,31.5018315018315,83.15018315018315
19141_terrestrial,282,291,91,226,573,32.269503546099294,80.1418439716312
19142_terrestrial,286,362,91,229,648,31.818181818181817,80.06993006993007
19143_terrestrial,254,270,80,209,524,31.496062992125985,82.28346456692913
19144_terrestrial,213,235,64,182,448,30.046948356807512,85.44600938967136
19145_terrestrial,237,259,71,199,496,29.957805907172997,83.96624472573839
19146_terrestrial,258,295,78,215,553,30.23255813953488,83.33333333333334
19147_terrestrial,250,298,81,203,548,32.4,81.2
19148_terrestrial,222,276,72,177,498,32.432432432432435,79.72972972972973
19149_terrestrial,211,282,69,168,493,32.70142180094787,79.62085308056872
19150_terrestrial,195,237,63,156,432,32.30769230769231,80
19151_terrestrial,206,242,64,163,448,31.06796116504854,79.12621359223301
19152_terrestrial,232,259,72,179,491,31.03448275862069,77.15517241379311
19153_terrestrial,250,265,80,195,515,32,78
19154_terrestrial,259,289,80,201,548,30.888030888030887,77.60617760617761
19155_terrestrial,265,290,83,201,555,31.32075471698113,75.84905660377359
19156_terrestrial,268,289,85,211,557,31.716417910447763,78.73134328358209
19157_terrestrial,269,261,84,214,530,31.226765799256505,79.5539033457249
19158_terrestrial,256,237,78,203,493,30.46875,79.296875
19159_terrestrial,257,217,78,207,474,30.35019455252918,80.54474708171206
19160_terrestrial,250,213,77,201,463,30.8,80.4
19161_terrestrial,251,232,75,203,483,29.880478087649404,80.87649402390437
19162_terrestrial,260,241,77,212,501,29.615384615384617,81.53846153846153
19163_terrestrial,257,288,72,214,545,28.01556420233463,83.26848249027238
19164_terrestrial,260,295,78,218,555,30,83.84615384615385
19165_terrestrial,260,357,79,218,617,30.384615384615383,83.84615384615385
19166_terrestrial,262,385,78,221,647,29.770992366412212,84.35114503816794
19167_terrestrial,249,371,71,208,620,28.514056224899598,83.53413654618474
19168_terrestrial,245,372,67,205,617,27.346938775510203,83.6734693877551
19169_terrestrial,248,420,68,209,668,27.419354838709676,84.2741935483871
19170_terrestrial,247,432,69,210,679,27.93522267206478,85.02024291497976
19171_terrestrial,246,441,69,209,687,28.04878048780488,84.95934959349594
19172_terrestrial,244,433,70,207,677,28.688524590163933,84.8360655737705
19173_terrestrial,246,415,71,208,661,28.86178861788618,84.5528455284553
19174_terrestrial,231,388,64,197,619,27.705627705627705,85.28138528138528
19175_terrestrial,238,401,67,202,639,28.15126050420168,84.87394957983193
19176_terrestrial,244,416,69,203,660,28.278688524590162,83.19672131147541
19177_terrestrial,247,440,71,202,687,28.74493927125506,81.78137651821862
19178_terrestrial,241,422,68,199,663,28.21576763485477,82.57261410788381
19179_terrestrial,249,440,68,207,689,27.309236947791167,83.13253012048193
19180_terrestrial,245,362,68,204,607,27.755102040816325,83.26530612244898
19181_terrestrial,233,332,64,198,565,27.467811158798284,84.97854077253218
19182_terrestrial,243,347,73,208,590,30.04115226337449,85.59670781893004
19183_terrestrial,272,341,90,237,613,33.088235294117645,87.13235294117648
19184_terrestrial,505,472,284,282,977,56.237623762376245,55.84158415841585
19185_terrestrial,486,421,274,267,907,56.37860082304527,54.93827160493827
19254_terrestrial,575,302,448,245,877,77.91304347826087,42.608695652173914
19255_terrestrial,611,325,477,266,936,78.06873977086744,43.53518821603928
19256_terrestrial,532,272,409,227,804,76.8796992481203,42.66917293233083
19257_terrestrial,504,267,390,205,771,77.38095238095238,40.67460317460318
19258_terrestrial,519,257,405,212,776,78.03468208092485,40.847784200385355
19259_terrestrial,184,110,120,116,294,65.21739130434783,63.04347826086957
19261_terrestrial,483,247,379,181,730,78.4679089026915,37.47412008281574
19262_terrestrial,486,242,379,187,728,77.9835390946502,38.477366255144034
19263_terrestrial,494,245,384,195,739,77.7327935222672,39.473684210526315
19264_terrestrial,506,254,382,211,760,75.49407114624506,41.699604743083
19265_terrestrial,504,250,384,203,754,76.19047619047619,40.27777777777778
19266_terrestrial,501,258,383,202,759,76.44710578842316,40.31936127744511
19267_terrestrial,503,252,385,205,755,76.54075546719682,40.75546719681908
19268_terrestrial,516,248,400,217,764,77.51937984496125,42.054263565891475
19269_terrestrial,535,258,412,229,793,77.00934579439253,42.80373831775701
19270_terrestrial,302,147,197,216,449,65.23178807947019,71.52317880794702
19275_terrestrial,476,220,377,200,696,79.2016806722689,42.016806722689076
19276_terrestrial,431,205,345,174,636,80.04640371229699,40.37122969837587
19282_terrestrial,415,242,324,166,657,78.07228915662651,40
19283_terrestrial,453,256,346,189,709,76.37969094922738,41.72185430463576
19284_terrestrial,414,239,322,158,653,77.77777777777779,38.164251207729464
19285_terrestrial,326,149,267,101,475,81.90184049079755,30.981595092024538
19286_terrestrial,326,150,266,107,476,81.59509202453987,32.82208588957055
19287_terrestrial,354,170,287,124,524,81.07344632768361,35.02824858757062
19288_terrestrial,483,296,369,219,779,76.3975155279503,45.3416149068323
19289_terrestrial,500,297,377,224,797,75.4,44.800000000000004
19290_terrestrial,500,282,369,231,782,73.8,46.2
19291_terrestrial,498,276,369,230,774,74.09638554216868,46.1847389558233
19292_terrestrial,485,268,352,228,753,72.57731958762886,47.01030927835051
19293_terrestrial,510,265,370,248,775,72.54901960784314,48.627450980392155
19294_terrestrial,552,271,407,286,823,73.73188405797102,51.81159420289855
19295_terrestrial,536,278,398,273,814,74.25373134328358,50.93283582089553
19296_terrestrial,533,290,399,265,823,74.85928705440901,49.71857410881801
19297_terrestrial,539,306,398,271,845,73.8404452690167,50.278293135435995
19298_terrestrial,280,173,171,209,453,61.07142857142858,74.64285714285714
19299_terrestrial,257,156,164,196,413,63.81322957198443,76.26459143968872
19300_terrestrial,233,129,149,179,362,63.94849785407726,76.82403433476395
19301_terrestrial,214,119,134,162,333,62.616822429906534,75.70093457943925
19302_terrestrial,204,97,123,158,301,60.29411764705882,77.45098039215686
19303_terrestrial,225,118,136,168,343,60.44444444444444,74.66666666666667
19304_terrestrial,249,129,140,187,378,56.22489959839358,75.1004016064257
19305_terrestrial,276,151,157,206,427,56.88405797101449,74.63768115942028
19306_terrestrial,257,160,147,192,417,57.19844357976653,74.70817120622569
19307_terrestrial,222,161,134,163,383,60.36036036036037,73.42342342342343
19308_terrestrial,209,168,130,151,377,62.20095693779905,72.24880382775119
19309_terrestrial,270,172,161,199,442,59.62962962962963,73.70370370370371
19310_terrestrial,341,210,208,236,551,60.997067448680355,69.20821114369502
19311_terrestrial,350,223,214,231,573,61.142857142857146,66
19312_terrestrial,344,207,215,225,551,62.5,65.40697674418605
19313_terrestrial,354,204,218,234,558,61.5819209039548,66.10169491525424
19314_terrestrial,368,223,228,239,591,61.95652173913043,64.94565217391305
19315_terrestrial,374,227,232,243,601,62.03208556149733,64.97326203208557
19331_terrestrial,255,153,159,192,408,62.35294117647059,75.29411764705883
19332_terrestrial,286,163,184,214,449,64.33566433566433,74.82517482517483
19333_terrestrial,291,143,195,212,434,67.0103092783505,72.85223367697594
19360_terrestrial,186,129,108,134,315,58.06451612903226,72.04301075268818
19361_terrestrial,204,142,117,145,346,57.35294117647059,71.07843137254902
19362_terrestrial,215,160,119,154,375,55.348837209302324,71.62790697674419
19363_terrestrial,223,184,126,159,407,56.502242152466366,71.30044843049326
19364_terrestrial,230,189,129,170,419,56.086956521739125,73.91304347826086
19365_terrestrial,220,163,128,168,383,58.18181818181818,76.36363636363637
19366_terrestrial,225,158,140,171,383,62.22222222222222,76
19367_terrestrial,215,158,135,159,373,62.7906976744186,73.95348837209302
19368_terrestrial,198,133,122,158,331,61.61616161616161,79.7979797979798
19369_terrestrial,208,131,132,165,339,63.46153846153846,79.32692307692307
19370_terrestrial,212,128,140,168,340,66.0377358490566,79.24528301886792
19371_terrestrial,224,129,148,175,353,66.07142857142857,78.125
19372_terrestrial,232,124,153,179,356,65.94827586206897,77.15517241379311
19373_terrestrial,237,126,161,181,363,67.9324894514768,76.37130801687763
19374_terrestrial,239,128,162,183,367,67.78242677824268,76.56903765690377
19375_terrestrial,233,124,160,178,357,68.6695278969957,76.39484978540773
19376_terrestrial,235,117,163,182,352,69.36170212765957,77.4468085106383
19377_terrestrial,244,118,172,190,362,70.49180327868852,77.8688524590164
19378_terrestrial,245,111,177,190,356,72.24489795918367,77.55102040816327
19379_terrestrial,239,105,175,188,344,73.22175732217573,78.66108786610879
19380_terrestrial,240,103,172,185,343,71.66666666666667,77.08333333333334
19381_terrestrial,410,173,326,213,583,79.51219512195122,51.951219512195124
19382_terrestrial,399,168,317,205,567,79.4486215538847,51.37844611528822
19383_terrestrial,388,163,306,196,551,78.8659793814433,50.51546391752577
19387_terrestrial,434,181,337,234,615,77.64976958525345,53.91705069124424
19388_terrestrial,411,177,314,231,588,76.39902676399026,56.20437956204379
19389_terrestrial,236,117,158,190,353,66.94915254237289,80.50847457627118
19390_terrestrial,444,173,338,237,617,76.12612612612612,53.37837837837838
19394_terrestrial,347,163,285,140,510,82.13256484149855,40.345821325648416
19397_terrestrial,470,260,366,236,730,77.87234042553192,50.212765957446805
19398_terrestrial,446,259,340,233,705,76.23318385650224,52.242152466367706
19399_terrestrial,241,171,166,187,412,68.87966804979253,77.59336099585063
19400_terrestrial,239,169,162,196,408,67.78242677824268,82.00836820083683
19401_terrestrial,475,272,365,237,747,76.84210526315789,49.89473684210527
19499_terrestrial,426,316,250,223,742,58.68544600938967,52.347417840375584
19500_terrestrial,463,363,260,256,826,56.15550755939525,55.291576673866096
19501_terrestrial,270,257,91,226,527,33.7037037037037,83.7037037037037
19502_terrestrial,265,325,87,217,590,32.83018867924528,81.88679245283019
19503_terrestrial,254,270,74,211,524,29.133858267716533,83.07086614173228
19504_terrestrial,214,231,65,183,445,30.373831775700932,85.51401869158879
19505_terrestrial,242,235,74,207,477,30.57851239669421,85.53719008264463
19506_terrestrial,252,282,76,212,534,30.158730158730158,84.12698412698413
19507_terrestrial,252,308,79,209,560,31.349206349206348,82.93650793650794
19508_terrestrial,240,301,73,192,541,30.416666666666664,80
19509_terrestrial,233,286,71,183,519,30.472103004291846,78.54077253218884
19510_terrestrial,211,240,70,167,451,33.175355450236964,79.14691943127961
19511_terrestrial,206,233,64,161,439,31.06796116504854,78.15533980582524
19512_terrestrial,214,242,64,172,456,29.906542056074763,80.37383177570094
19513_terrestrial,250,283,76,197,533,30.4,78.8
19514_terrestrial,263,318,82,207,581,31.1787072243346,78.70722433460075
19515_terrestrial,267,311,85,209,578,31.835205992509362,78.27715355805243
19516_terrestrial,271,296,90,220,567,33.210332103321036,81.18081180811808
19517_terrestrial,249,238,82,202,487,32.93172690763052,81.12449799196787
19518_terrestrial,253,224,78,207,477,30.8300395256917,81.81818181818183
19519_terrestrial,258,232,76,214,490,29.457364341085274,82.94573643410853
19520_terrestrial,247,230,70,203,477,28.34008097165992,82.18623481781377
19521_terrestrial,251,231,76,204,482,30.278884462151396,81.27490039840637
19522_terrestrial,259,252,75,212,511,28.957528957528954,81.85328185328186
19523_terrestrial,261,266,71,218,527,27.203065134099617,83.5249042145594
19524_terrestrial,259,294,74,215,553,28.57142857142857,83.01158301158301
19525_terrestrial,260,390,75,216,650,28.846153846153843,83.07692307692308
19526_terrestrial,254,425,69,211,679,27.165354330708663,83.07086614173228
19527_terrestrial,249,401,67,207,650,26.907630522088354,83.13253012048193
19528_terrestrial,251,421,69,212,672,27.490039840637447,84.4621513944223
19529_terrestrial,258,430,73,219,688,28.294573643410853,84.88372093023256
19530_terrestrial,255,441,70,216,696,27.450980392156865,84.70588235294117
19531_terrestrial,249,421,65,212,670,26.104417670682732,85.14056224899599
19532_terrestrial,235,446,66,199,681,28.085106382978726,84.68085106382979
19533_terrestrial,242,438,66,203,680,27.27272727272727,83.88429752066115
19534_terrestrial,233,398,68,195,631,29.184549356223176,83.69098712446352
19535_terrestrial,241,413,68,202,654,28.21576763485477,83.81742738589212
19536_terrestrial,249,481,71,200,730,28.514056224899598,80.32128514056225
19537_terrestrial,255,468,76,203,723,29.80392156862745,79.6078431372549
19538_terrestrial,254,453,71,206,707,27.95275590551181,81.10236220472441
19539_terrestrial,247,395,69,204,642,27.93522267206478,82.5910931174089
19540_terrestrial,235,333,66,200,568,28.085106382978726,85.1063829787234
19541_terrestrial,239,347,69,207,586,28.870292887029287,86.61087866108787
19542_terrestrial,266,351,83,231,617,31.203007518796994,86.8421052631579
19543_terrestrial,297,364,100,254,661,33.670033670033675,85.52188552188552
19544_terrestrial,510,442,291,275,952,57.05882352941176,53.92156862745098
19545_terrestrial,514,401,295,278,915,57.39299610894941,54.08560311284047
19614_terrestrial,539,236,428,219,775,79.40630797773655,40.63079777365491
19615_terrestrial,611,299,469,255,910,76.759410801964,41.734860883797054
19616_terrestrial,527,248,404,215,775,76.66034155597723,40.79696394686907
19617_terrestrial,514,252,403,199,766,78.40466926070039,38.715953307393
19618_terrestrial,533,255,417,210,788,78.23639774859286,39.39962476547842
19619_terrestrial,524,255,401,211,779,76.52671755725191,40.26717557251908
19620_terrestrial,530,265,409,213,795,77.16981132075472,40.18867924528302
19621_terrestrial,529,263,407,212,792,76.93761814744802,40.07561436672968
19622_terrestrial,258,149,162,177,407,62.7906976744186,68.6046511627907
19623_terrestrial,261,150,161,178,411,61.68582375478927,68.19923371647509
19629_terrestrial,247,153,145,175,400,58.70445344129555,70.8502024291498
19635_terrestrial,313,133,266,86,446,84.98402555910543,27.47603833865815
19644_terrestrial,355,189,278,135,544,78.30985915492957,38.028169014084504
19645_terrestrial,361,192,283,141,553,78.39335180055402,39.05817174515235
19646_terrestrial,359,184,281,141,543,78.27298050139275,39.27576601671309
19647_terrestrial,334,176,265,120,510,79.34131736526946,35.92814371257485
19648_terrestrial,366,206,296,131,572,80.87431693989072,35.79234972677596
19653_terrestrial,391,156,307,166,547,78.51662404092072,42.45524296675192
19654_terrestrial,406,155,318,183,561,78.32512315270937,45.073891625615765
19655_terrestrial,379,150,296,160,529,78.10026385224275,42.21635883905013
19656_terrestrial,448,262,333,191,710,74.33035714285714,42.63392857142857
19657_terrestrial,290,199,171,206,489,58.9655172413793,71.03448275862068
19658_terrestrial,230,137,147,173,367,63.91304347826087,75.21739130434783
19661_terrestrial,194,95,120,146,289,61.855670103092784,75.25773195876289
19662_terrestrial,167,82,98,122,249,58.68263473053892,73.05389221556887
19663_terrestrial,171,81,102,123,252,59.64912280701754,71.9298245614035
19664_terrestrial,195,90,121,145,285,62.05128205128205,74.35897435897436
19665_terrestrial,231,105,135,173,336,58.44155844155844,74.89177489177489
19666_terrestrial,265,148,159,190,413,60,71.69811320754717
19667_terrestrial,254,164,154,178,418,60.629921259842526,70.07874015748031
19668_terrestrial,223,159,132,157,382,59.19282511210763,70.4035874439462
19669_terrestrial,204,162,121,142,366,59.31372549019608,69.6078431372549
19670_terrestrial,223,162,126,160,385,56.502242152466366,71.74887892376681
19671_terrestrial,262,175,149,188,437,56.87022900763359,71.7557251908397
19672_terrestrial,291,186,168,208,477,57.73195876288659,71.47766323024055
19673_terrestrial,314,204,185,216,518,58.917197452229296,68.78980891719745
19674_terrestrial,304,188,181,209,492,59.539473684210535,68.75
19675_terrestrial,252,152,145,179,404,57.53968253968254,71.03174603174604
19691_terrestrial,303,160,185,232,463,61.05610561056105,76.56765676567657
19692_terrestrial,359,186,225,261,545,62.67409470752089,72.70194986072424
19693_terrestrial,342,189,219,257,531,64.03508771929825,75.14619883040936
19694_terrestrial,332,181,219,245,513,65.96385542168674,73.79518072289156
19695_terrestrial,296,165,191,222,461,64.52702702702703,75
19696_terrestrial,222,132,151,165,354,68.01801801801803,74.32432432432432
19697_terrestrial,187,118,130,131,305,69.5187165775401,70.05347593582889
19721_terrestrial,199,141,113,141,340,56.78391959798995,70.85427135678391
19722_terrestrial,222,163,128,161,385,57.65765765765766,72.52252252252252
19723_terrestrial,249,197,141,180,446,56.62650602409639,72.28915662650603
19724_terrestrial,258,204,149,192,462,57.751937984496124,74.4186046511628
19725_terrestrial,249,196,142,195,445,57.028112449799195,78.3132530120482
19726_terrestrial,247,184,148,189,431,59.91902834008097,76.51821862348179
19727_terrestrial,249,182,160,180,431,64.2570281124498,72.28915662650603
19728_terrestrial,242,146,162,180,388,66.94214876033058,74.3801652892562
19729_terrestrial,230,137,152,177,367,66.08695652173913,76.95652173913044
19730_terrestrial,229,133,157,179,362,68.5589519650655,78.16593886462883
19731_terrestrial,241,137,164,187,378,68.04979253112033,77.59336099585063
19732_terrestrial,253,137,173,188,390,68.37944664031622,74.30830039525692
19733_terrestrial,255,138,178,188,393,69.80392156862744,73.72549019607844
19734_terrestrial,254,130,175,195,384,68.89763779527559,76.77165354330708
19735_terrestrial,248,124,173,191,372,69.75806451612904,77.01612903225806
19736_terrestrial,234,112,161,190,346,68.80341880341881,81.19658119658119
19737_terrestrial,231,111,163,185,342,70.56277056277057,80.08658008658008
19738_terrestrial,235,109,170,186,344,72.3404255319149,79.14893617021276
19739_terrestrial,248,111,180,192,359,72.58064516129032,77.41935483870968
19740_terrestrial,410,175,324,214,585,79.02439024390245,52.19512195121951
19741_terrestrial,387,169,306,197,556,79.06976744186046,50.90439276485789
19747_terrestrial,453,191,352,235,644,77.70419426048565,51.87637969094923
19748_terrestrial,501,199,394,248,700,78.64271457085829,49.50099800399202
19749_terrestrial,526,214,411,261,740,78.13688212927757,49.619771863117876
19750_terrestrial,517,208,404,244,725,78.14313346228239,47.195357833655706
19753_terrestrial,467,242,375,227,709,80.29978586723769,48.60813704496788
19754_terrestrial,461,239,364,230,700,78.95878524945769,49.891540130151846
19755_terrestrial,461,239,363,231,700,78.74186550976138,50.108459869848154
19756_terrestrial,474,251,374,240,725,78.90295358649789,50.63291139240506
19757_terrestrial,791,444,546,417,1235,69.02654867256636,52.718078381795195
19758_terrestrial,257,186,178,204,443,69.26070038910505,79.37743190661479
19759_terrestrial,796,433,533,445,1229,66.95979899497488,55.904522613065325
19760_terrestrial,808,433,544,451,1241,67.32673267326733,55.816831683168324
19761_terrestrial,769,367,522,417,1136,67.88036410923277,54.22626788036411
19860_terrestrial,482,371,282,247,853,58.50622406639005,51.244813278008294
19861_terrestrial,502,414,294,261,916,58.56573705179283,51.992031872509955
19862_terrestrial,517,448,295,283,965,57.05996131528046,54.73887814313346
19863_terrestrial,299,325,97,254,624,32.441471571906355,84.94983277591973
19864_terrestrial,266,311,82,221,577,30.82706766917293,83.0827067669173
19865_terrestrial,235,233,67,203,468,28.510638297872344,86.38297872340426
19866_terrestrial,264,265,81,223,529,30.681818181818183,84.46969696969697
19867_terrestrial,274,288,85,224,562,31.02189781021898,81.75182481751825
19868_terrestrial,265,327,83,214,592,31.32075471698113,80.75471698113208
19869_terrestrial,262,336,80,209,598,30.53435114503817,79.77099236641222
19870_terrestrial,244,317,76,192,561,31.147540983606557,78.68852459016394
19871_terrestrial,236,276,75,183,512,31.779661016949152,77.54237288135593
19872_terrestrial,230,285,70,180,515,30.434782608695656,78.26086956521739
19873_terrestrial,258,320,78,212,578,30.23255813953488,82.17054263565892
19874_terrestrial,273,309,89,219,582,32.6007326007326,80.21978021978022
19875_terrestrial,269,306,85,216,575,31.59851301115242,80.29739776951673
19876_terrestrial,263,277,87,220,540,33.07984790874524,83.65019011406845
19877_terrestrial,254,232,82,206,486,32.28346456692913,81.10236220472441
19878_terrestrial,244,213,74,203,457,30.327868852459016,83.19672131147541
19879_terrestrial,254,215,76,211,469,29.92125984251969,83.07086614173228
19880_terrestrial,252,226,77,209,478,30.555555555555557,82.93650793650794
19881_terrestrial,255,252,79,206,507,30.980392156862745,80.7843137254902
19882_terrestrial,263,281,80,214,544,30.418250950570343,81.36882129277566
19883_terrestrial,266,296,71,220,562,26.691729323308273,82.70676691729322
19884_terrestrial,259,339,71,215,598,27.413127413127413,83.01158301158301
19885_terrestrial,260,420,72,216,680,27.692307692307693,83.07692307692308
19886_terrestrial,260,429,71,216,689,27.307692307692307,83.07692307692308
19887_terrestrial,253,408,67,211,661,26.48221343873518,83.399209486166
19888_terrestrial,250,393,68,209,643,27.200000000000003,83.6
19889_terrestrial,252,375,70,211,627,27.77777777777778,83.73015873015873
19890_terrestrial,247,416,68,209,663,27.530364372469634,84.61538461538461
19891_terrestrial,240,399,67,203,639,27.916666666666668,84.58333333333333
19892_terrestrial,241,496,66,203,737,27.385892116182575,84.23236514522821
19893_terrestrial,247,463,68,205,710,27.530364372469634,82.99595141700405
19894_terrestrial,243,443,70,201,686,28.80658436213992,82.71604938271605
19895_terrestrial,240,425,67,199,665,27.916666666666668,82.91666666666667
19896_terrestrial,257,462,73,205,719,28.404669260700388,79.76653696498055
19897_terrestrial,256,465,73,205,721,28.515625,80.078125
19898_terrestrial,249,369,68,205,618,27.309236947791167,82.32931726907631
19899_terrestrial,239,372,67,199,611,28.03347280334728,83.26359832635984
19900_terrestrial,245,368,69,212,613,28.163265306122447,86.53061224489797
19901_terrestrial,277,357,87,243,634,31.40794223826715,87.72563176895306
19902_terrestrial,294,348,93,253,642,31.63265306122449,86.05442176870748
19903_terrestrial,564,462,326,317,1026,57.801418439716315,56.205673758865245
19904_terrestrial,532,421,311,284,953,58.45864661654135,53.383458646616546
19974_terrestrial,569,257,445,239,826,78.20738137082601,42.00351493848858
19975_terrestrial,318,150,202,231,468,63.52201257861635,72.64150943396226
19976_terrestrial,318,164,197,220,482,61.94968553459119,69.18238993710692
19977_terrestrial,311,173,190,211,484,61.09324758842444,67.84565916398714
19978_terrestrial,310,173,194,206,483,62.58064516129033,66.45161290322581
19979_terrestrial,310,172,192,203,482,61.935483870967744,65.48387096774194
19980_terrestrial,277,159,168,191,436,60.64981949458483,68.95306859205776
20005_terrestrial,334,172,264,122,506,79.04191616766467,36.52694610778443
20006_terrestrial,331,170,262,122,501,79.15407854984893,36.85800604229607
20013_terrestrial,399,157,310,180,556,77.69423558897243,45.11278195488722
20014_terrestrial,398,155,310,181,553,77.88944723618091,45.47738693467337
20015_terrestrial,358,140,279,154,498,77.93296089385476,43.01675977653631
20016_terrestrial,448,268,334,187,716,74.55357142857143,41.74107142857143
20017_terrestrial,295,206,174,203,501,58.98305084745763,68.8135593220339
20021_terrestrial,164,90,101,123,254,61.58536585365854,75
20024_terrestrial,208,94,137,152,302,65.86538461538461,73.07692307692307
20025_terrestrial,236,100,152,179,336,64.40677966101694,75.84745762711864
20026_terrestrial,259,132,154,191,391,59.45945945945946,73.74517374517374
20027_terrestrial,238,151,139,171,389,58.40336134453782,71.84873949579831
20028_terrestrial,226,154,134,155,380,59.29203539823009,68.58407079646017
20029_terrestrial,204,159,121,141,363,59.31372549019608,69.11764705882352
20030_terrestrial,193,152,110,135,345,56.994818652849744,69.94818652849742
20031_terrestrial,182,156,102,121,338,56.043956043956044,66.48351648351648
20032_terrestrial,177,144,102,123,321,57.6271186440678,69.49152542372882
20033_terrestrial,167,123,96,115,290,57.48502994011976,68.8622754491018
20034_terrestrial,163,100,97,114,263,59.50920245398773,69.93865030674846
20049_terrestrial,231,147,133,171,378,57.57575757575758,74.02597402597402
20050_terrestrial,300,191,174,227,491,57.99999999999999,75.66666666666667
20051_terrestrial,335,194,197,258,529,58.805970149253724,77.01492537313432
20052_terrestrial,409,211,250,321,620,61.12469437652812,78.4841075794621
20053_terrestrial,434,220,276,341,654,63.594470046082954,78.57142857142857
20054_terrestrial,459,245,297,349,704,64.70588235294117,76.03485838779956
20055_terrestrial,391,218,258,299,609,65.98465473145781,76.47058823529412
20056_terrestrial,333,189,218,254,522,65.46546546546547,76.27627627627628
20057_terrestrial,218,124,151,153,342,69.26605504587155,70.18348623853211
20082_terrestrial,229,160,136,166,389,59.388646288209614,72.48908296943232
20083_terrestrial,271,206,159,193,477,58.671586715867164,71.21771217712177
20084_terrestrial,296,250,183,214,546,61.82432432432432,72.2972972972973
20085_terrestrial,305,251,190,227,556,62.295081967213115,74.42622950819671
20086_terrestrial,314,246,202,228,560,64.3312101910828,72.61146496815286
20087_terrestrial,324,253,215,236,577,66.35802469135803,72.8395061728395
20088_terrestrial,329,250,225,240,579,68.38905775075987,72.94832826747721
20089_terrestrial,311,234,216,231,545,69.45337620578779,74.27652733118971
20090_terrestrial,296,202,207,219,498,69.93243243243244,73.98648648648648
20091_terrestrial,291,183,204,217,474,70.10309278350515,74.5704467353952
20092_terrestrial,271,149,188,202,420,69.37269372693727,74.53874538745387
20093_terrestrial,264,137,188,188,401,71.21212121212122,71.21212121212122
20094_terrestrial,246,117,174,180,363,70.73170731707317,73.17073170731707
20095_terrestrial,234,115,160,183,349,68.37606837606837,78.2051282051282
20096_terrestrial,229,111,161,181,340,70.3056768558952,79.03930131004367
20097_terrestrial,232,113,165,181,345,71.12068965517241,78.01724137931035
20098_terrestrial,235,113,171,183,348,72.76595744680851,77.87234042553192
20099_terrestrial,253,113,182,195,366,71.93675889328063,77.07509881422925
20100_terrestrial,405,169,320,222,574,79.01234567901234,54.81481481481482
20101_terrestrial,392,158,315,206,550,80.35714285714286,52.55102040816326
20107_terrestrial,524,213,406,263,737,77.48091603053436,50.19083969465649
20108_terrestrial,530,211,418,258,741,78.8679245283019,48.679245283018865
20109_terrestrial,522,206,414,253,728,79.3103448275862,48.46743295019157
20110_terrestrial,458,204,371,170,662,81.00436681222706,37.117903930131
20111_terrestrial,548,241,440,244,789,80.2919708029197,44.52554744525548
20112_terrestrial,652,328,507,297,980,77.76073619631902,45.5521472392638
20113_terrestrial,729,391,545,347,1120,74.7599451303155,47.59945130315501
20114_terrestrial,725,399,535,348,1124,73.79310344827587,48
20115_terrestrial,861,467,607,444,1328,70.49941927990709,51.56794425087108
20116_terrestrial,850,449,590,461,1299,69.41176470588235,54.23529411764706
20117_terrestrial,843,436,584,466,1279,69.27639383155397,55.27876631079478
20118_terrestrial,779,403,539,416,1182,69.19127086007703,53.40179717586649
20119_terrestrial,796,411,539,439,1207,67.71356783919597,55.15075376884422
20120_terrestrial,795,428,529,443,1223,66.54088050314465,55.72327044025157
20220_terrestrial,332,200,236,146,532,71.08433734939759,43.97590361445783
20221_terrestrial,343,215,244,152,558,71.13702623906705,44.31486880466473
20222_terrestrial,488,364,293,251,852,60.040983606557376,51.434426229508205
20223_terrestrial,527,437,301,281,964,57.1157495256167,53.32068311195446
20224_terrestrial,296,360,93,249,656,31.41891891891892,84.12162162162163
20225_terrestrial,258,268,74,222,526,28.68217054263566,86.04651162790698
20226_terrestrial,247,260,76,208,507,30.76923076923077,84.21052631578947
20227_terrestrial,250,242,78,203,492,31.2,81.2
20228_terrestrial,263,298,83,211,561,31.55893536121673,80.22813688212928
20229_terrestrial,276,351,85,221,627,30.79710144927536,80.07246376811594
20230_terrestrial,271,365,86,214,636,31.73431734317343,78.96678966789668
20231_terrestrial,265,342,84,207,607,31.69811320754717,78.11320754716982
20232_terrestrial,263,336,81,206,599,30.798479087452474,78.32699619771863
20233_terrestrial,271,358,81,221,629,29.88929889298893,81.54981549815497
20234_terrestrial,274,340,87,223,614,31.751824817518248,81.38686131386861
20235_terrestrial,263,328,79,213,591,30.038022813688215,80.98859315589354
20236_terrestrial,272,297,82,221,569,30.14705882352941,81.25
20237_terrestrial,256,252,82,207,508,32.03125,80.859375
20238_terrestrial,240,210,74,197,450,30.833333333333336,82.08333333333333
20239_terrestrial,253,226,80,208,479,31.620553359683797,82.21343873517787
20240_terrestrial,261,225,78,214,486,29.88505747126437,81.99233716475096
20241_terrestrial,266,253,74,219,519,27.819548872180448,82.33082706766918
20242_terrestrial,276,293,78,229,569,28.26086956521739,82.97101449275362
20243_terrestrial,280,308,79,230,588,28.214285714285715,82.14285714285714
20244_terrestrial,269,323,77,223,592,28.624535315985128,82.8996282527881
20245_terrestrial,274,404,77,228,678,28.102189781021895,83.21167883211679
20246_terrestrial,265,413,71,221,678,26.79245283018868,83.39622641509435
20247_terrestrial,251,413,71,208,664,28.286852589641438,82.86852589641434
20248_terrestrial,249,376,71,208,625,28.514056224899598,83.53413654618474
20249_terrestrial,247,393,70,207,640,28.34008097165992,83.80566801619433
20250_terrestrial,241,386,68,203,627,28.21576763485477,84.23236514522821
20251_terrestrial,232,402,66,196,634,28.448275862068968,84.48275862068965
20252_terrestrial,232,383,64,197,615,27.586206896551722,84.91379310344827
20253_terrestrial,247,421,67,208,668,27.125506072874494,84.21052631578947
20254_terrestrial,241,426,67,201,667,27.800829875518673,83.40248962655602
20255_terrestrial,245,395,68,202,640,27.755102040816325,82.44897959183673
20256_terrestrial,242,385,70,202,627,28.92561983471074,83.47107438016529
20257_terrestrial,239,341,69,201,580,28.870292887029287,84.10041841004184
20258_terrestrial,247,353,76,205,600,30.76923076923077,82.99595141700405
20259_terrestrial,260,379,80,215,639,30.76923076923077,82.6923076923077
20260_terrestrial,295,371,96,255,666,32.54237288135593,86.4406779661017
20261_terrestrial,589,513,343,334,1102,58.23429541595926,56.7062818336163
20262_terrestrial,552,458,327,301,1010,59.2391304347826,54.528985507246375
20263_terrestrial,519,421,308,273,940,59.34489402697495,52.601156069364166
20334_terrestrial,556,265,429,239,821,77.15827338129496,42.985611510791365
20335_terrestrial,286,161,176,211,447,61.53846153846154,73.77622377622379
20336_terrestrial,287,174,170,207,461,59.23344947735192,72.12543554006969
20337_terrestrial,271,159,157,186,430,57.93357933579336,68.63468634686348
20338_terrestrial,229,162,135,150,391,58.951965065502186,65.50218340611353
20339_terrestrial,211,149,122,139,360,57.81990521327014,65.87677725118483
20376_terrestrial,559,339,409,273,898,73.16636851520573,48.837209302325576
20377_terrestrial,280,221,161,190,501,57.49999999999999,67.85714285714286
20386_terrestrial,252,122,159,190,374,63.095238095238095,75.39682539682539
20387_terrestrial,245,141,145,179,386,59.183673469387756,73.06122448979592
20388_terrestrial,236,150,137,166,386,58.05084745762712,70.33898305084746
20389_terrestrial,232,152,135,157,384,58.189655172413794,67.67241379310344
20390_terrestrial,212,150,126,143,362,59.43396226415094,67.45283018867924
20391_terrestrial,190,144,107,130,334,56.315789473684205,68.42105263157895
20392_terrestrial,177,130,101,118,307,57.06214689265536,66.66666666666666
20403_terrestrial,193,122,115,140,315,59.58549222797927,72.53886010362694
20404_terrestrial,189,107,111,138,296,58.730158730158735,73.01587301587301
20405_terrestrial,174,99,103,127,273,59.195402298850574,72.98850574712644
20407_terrestrial,173,106,101,129,279,58.38150289017341,74.56647398843931
20408_terrestrial,196,124,116,146,320,59.183673469387756,74.48979591836735
20409_terrestrial,228,138,130,175,366,57.01754385964912,76.75438596491229
20410_terrestrial,294,184,177,227,478,60.204081632653065,77.21088435374149
20411_terrestrial,381,191,237,297,572,62.20472440944882,77.95275590551181
20412_terrestrial,385,180,247,306,565,64.15584415584415,79.48051948051949
20413_terrestrial,391,178,264,303,569,67.51918158567774,77.49360613810742
20414_terrestrial,486,233,311,389,719,63.991769547325106,80.04115226337449
20415_terrestrial,498,245,322,394,743,64.65863453815261,79.11646586345381
20416_terrestrial,443,207,284,345,650,64.10835214446952,77.87810383747178
20417_terrestrial,352,180,230,264,532,65.3409090909091,75
20418_terrestrial,208,115,141,142,323,67.78846153846155,68.26923076923077
20440_terrestrial,195,144,116,141,339,59.48717948717949,72.3076923076923
20441_terrestrial,217,152,131,158,369,60.36866359447005,72.81105990783409
20442_terrestrial,241,171,145,181,412,60.16597510373444,75.10373443983403
20443_terrestrial,281,217,173,204,498,61.56583629893239,72.59786476868328
20444_terrestrial,340,276,216,244,616,63.52941176470588,71.76470588235294
20445_terrestrial,382,303,251,264,685,65.70680628272252,69.10994764397905
20446_terrestrial,377,288,253,266,665,67.10875331564988,70.55702917771883
20447_terrestrial,362,276,247,260,638,68.23204419889503,71.8232044198895
20448_terrestrial,363,278,251,257,641,69.14600550964187,70.79889807162535
20449_terrestrial,352,273,246,251,625,69.88636363636364,71.30681818181817
20450_terrestrial,340,240,241,241,580,70.88235294117648,70.88235294117648
20451_terrestrial,312,189,225,227,501,72.11538461538461,72.75641025641025
20452_terrestrial,287,141,206,203,428,71.77700348432056,70.73170731707317
20453_terrestrial,272,129,196,195,401,72.05882352941177,71.69117647058823
20454_terrestrial,248,113,175,184,361,70.56451612903226,74.19354838709677
20455_terrestrial,245,122,175,192,367,71.42857142857143,78.36734693877551
20456_terrestrial,232,116,165,184,348,71.12068965517241,79.3103448275862
20457_terrestrial,234,119,170,187,353,72.64957264957265,79.91452991452992
20458_terrestrial,241,108,177,193,349,73.44398340248964,80.08298755186722
20459_terrestrial,251,115,185,197,366,73.70517928286853,78.48605577689243
20460_terrestrial,274,111,204,202,385,74.45255474452554,73.72262773722628
20461_terrestrial,432,171,349,226,603,80.78703703703704,52.31481481481482
20467_terrestrial,402,157,325,165,559,80.84577114427861,41.04477611940299
20470_terrestrial,674,331,515,308,1005,76.40949554896143,45.6973293768546
20471_terrestrial,738,378,558,337,1116,75.60975609756098,45.66395663956639
20472_terrestrial,873,419,625,442,1292,71.5922107674685,50.63001145475372
20473_terrestrial,918,443,634,475,1361,69.06318082788671,51.74291938997821
20474_terrestrial,979,454,676,533,1433,69.05005107252298,54.44330949948928
20475_terrestrial,936,459,650,505,1395,69.44444444444444,53.95299145299145
20476_terrestrial,897,453,623,479,1350,69.45373467112597,53.400222965440356
20477_terrestrial,842,414,587,452,1256,69.71496437054631,53.681710213776725
20583_terrestrial,505,368,298,260,873,59.009900990099005,51.48514851485149
20584_terrestrial,544,461,302,304,1005,55.51470588235294,55.88235294117647
20585_terrestrial,302,336,90,258,638,29.80132450331126,85.43046357615894
20586_terrestrial,291,259,90,246,550,30.927835051546392,84.5360824742268
20587_terrestrial,266,250,87,216,516,32.70676691729324,81.203007518797
20588_terrestrial,254,281,78,206,535,30.708661417322837,81.10236220472441
20589_terrestrial,275,341,80,224,616,29.09090909090909,81.45454545454545
20590_terrestrial,283,382,89,223,665,31.448763250883395,78.79858657243817
20591_terrestrial,275,393,84,212,668,30.545454545454547,77.0909090909091
20592_terrestrial,278,383,78,223,661,28.05755395683453,80.2158273381295
20593_terrestrial,282,352,83,229,634,29.432624113475175,81.20567375886525
20594_terrestrial,285,330,86,233,615,30.175438596491226,81.75438596491227
20595_terrestrial,279,347,84,224,626,30.107526881720432,80.28673835125448
20596_terrestrial,280,328,82,227,608,29.28571428571429,81.07142857142857
20597_terrestrial,266,293,81,213,559,30.451127819548873,80.07518796992481
20598_terrestrial,247,226,74,200,473,29.959514170040485,80.97165991902834
20599_terrestrial,264,235,81,216,499,30.681818181818183,81.81818181818183
20600_terrestrial,261,242,76,216,503,29.118773946360154,82.75862068965517
20601_terrestrial,276,263,78,225,539,28.26086956521739,81.52173913043478
20602_terrestrial,280,272,83,231,552,29.642857142857142,82.5
20603_terrestrial,280,283,81,228,563,28.92857142857143,81.42857142857143
20604_terrestrial,275,301,80,227,576,29.09090909090909,82.54545454545455
20605_terrestrial,265,316,75,222,581,28.30188679245283,83.77358490566039
20606_terrestrial,269,333,75,225,602,27.881040892193308,83.64312267657994
20607_terrestrial,252,339,72,209,591,28.57142857142857,82.93650793650794
20608_terrestrial,241,329,66,200,570,27.385892116182575,82.98755186721992
20609_terrestrial,247,401,70,207,648,28.34008097165992,83.80566801619433
20610_terrestrial,242,424,67,204,666,27.685950413223143,84.29752066115702
20611_terrestrial,228,401,63,193,629,27.631578947368425,84.64912280701753
20612_terrestrial,230,413,60,194,643,26.08695652173913,84.34782608695653
20613_terrestrial,234,395,63,200,629,26.923076923076923,85.47008547008546
20614_terrestrial,235,412,64,200,647,27.23404255319149,85.1063829787234
20615_terrestrial,244,419,71,205,663,29.098360655737704,84.01639344262296
20616_terrestrial,251,367,77,206,618,30.677290836653388,82.07171314741036
20617_terrestrial,244,362,73,203,606,29.918032786885245,83.19672131147541
20618_terrestrial,256,337,81,213,593,31.640625,83.203125
20619_terrestrial,304,367,101,255,671,33.223684210526315,83.88157894736842
20620_terrestrial,593,499,344,332,1092,58.01011804384486,55.98650927487352
20621_terrestrial,558,451,326,303,1009,58.422939068100355,54.3010752688172
20683_terrestrial,243,115,214,50,358,88.06584362139918,20.5761316872428
20684_terrestrial,247,118,218,50,365,88.25910931174089,20.242914979757085
20691_terrestrial,487,229,394,181,716,80.9034907597536,37.16632443531827
20692_terrestrial,495,239,394,195,734,79.5959595959596,39.39393939393939
20693_terrestrial,263,150,170,188,413,64.63878326996198,71.48288973384031
20694_terrestrial,257,161,156,184,418,60.70038910505836,71.59533073929961
20695_terrestrial,274,175,164,190,449,59.854014598540154,69.34306569343066
20696_terrestrial,267,181,156,179,448,58.42696629213483,67.04119850187266
20697_terrestrial,226,158,133,144,384,58.849557522123895,63.716814159292035
20698_terrestrial,177,133,104,105,310,58.75706214689266,59.32203389830508
20699_terrestrial,186,126,105,108,312,56.451612903225815,58.06451612903226
20735_terrestrial,518,275,386,242,793,74.5173745173745,46.71814671814672
20736_terrestrial,590,343,425,292,933,72.03389830508475,49.49152542372882
20737_terrestrial,289,177,164,208,466,56.747404844290664,71.97231833910035
20747_terrestrial,263,127,167,192,390,63.49809885931559,73.00380228136882
20748_terrestrial,283,148,170,210,431,60.07067137809188,74.20494699646643
20749_terrestrial,276,165,159,193,441,57.608695652173914,69.92753623188406
20750_terrestrial,256,169,148,179,425,57.8125,69.921875
20751_terrestrial,230,152,135,159,382,58.69565217391305,69.1304347826087
20752_terrestrial,204,133,117,140,337,57.35294117647059,68.62745098039215
20753_terrestrial,165,117,97,111,282,58.78787878787879,67.27272727272727
20762_terrestrial,186,117,122,135,303,65.59139784946237,72.58064516129032
20763_terrestrial,182,109,115,136,291,63.18681318681318,74.72527472527473
20764_terrestrial,175,116,105,129,291,60,73.71428571428571
20765_terrestrial,168,104,99,123,272,58.92857142857143,73.21428571428571
20766_terrestrial,177,106,106,131,283,59.887005649717516,74.01129943502825
20767_terrestrial,197,120,116,149,317,58.88324873096447,75.63451776649747
20768_terrestrial,205,134,117,159,339,57.073170731707314,77.5609756097561
20769_terrestrial,220,135,125,173,355,56.81818181818182,78.63636363636364
20770_terrestrial,301,147,190,242,448,63.12292358803987,80.39867109634552
20771_terrestrial,372,154,241,299,526,64.78494623655914,80.3763440860215
20772_terrestrial,352,132,241,276,484,68.4659090909091,78.4090909090909
20773_terrestrial,343,141,233,259,484,67.93002915451895,75.51020408163265
20774_terrestrial,398,162,273,303,560,68.5929648241206,76.13065326633166
20775_terrestrial,498,199,334,396,697,67.06827309236948,79.51807228915662
20776_terrestrial,593,243,382,472,836,64.41821247892075,79.59527824620574
20777_terrestrial,555,252,352,432,807,63.42342342342342,77.83783783783784
20778_terrestrial,392,202,248,295,594,63.26530612244898,75.25510204081633
20779_terrestrial,232,142,151,161,374,65.08620689655173,69.39655172413794
20797_terrestrial,171,137,99,116,308,57.89473684210527,67.83625730994152
20798_terrestrial,193,148,118,129,341,61.13989637305699,66.83937823834198
20799_terrestrial,203,154,127,140,357,62.5615763546798,68.96551724137932
20800_terrestrial,217,157,132,157,374,60.82949308755761,72.35023041474655
20801_terrestrial,249,165,151,184,414,60.6425702811245,73.89558232931726
20802_terrestrial,285,199,173,213,484,60.70175438596491,74.73684210526315
20803_terrestrial,329,245,201,239,574,61.09422492401215,72.64437689969606
20804_terrestrial,391,304,249,275,695,63.68286445012787,70.33248081841433
20805_terrestrial,427,317,281,299,744,65.807962529274,70.02341920374707
20806_terrestrial,392,296,268,284,688,68.36734693877551,72.44897959183673
20807_terrestrial,362,258,251,260,620,69.33701657458563,71.8232044198895
20808_terrestrial,349,251,241,251,600,69.05444126074498,71.91977077363897
20809_terrestrial,353,249,248,248,602,70.25495750708215,70.25495750708215
20810_terrestrial,349,224,252,250,573,72.20630372492836,71.63323782234957
20811_terrestrial,323,180,235,239,503,72.75541795665634,73.9938080495356
20812_terrestrial,308,140,230,222,448,74.67532467532467,72.07792207792207
20813_terrestrial,274,117,202,203,391,73.72262773722628,74.08759124087592
20814_terrestrial,274,117,204,206,391,74.45255474452554,75.18248175182481
20815_terrestrial,275,124,201,208,399,73.0909090909091,75.63636363636364
20816_terrestrial,270,125,201,202,395,74.44444444444444,74.81481481481481
20817_terrestrial,272,119,205,213,391,75.36764705882352,78.30882352941177
20818_terrestrial,281,125,213,218,406,75.80071174377224,77.58007117437722
20819_terrestrial,322,135,247,239,457,76.70807453416148,74.22360248447205
20820_terrestrial,349,133,265,256,482,75.93123209169055,73.35243553008596
20821_terrestrial,568,213,466,299,781,82.04225352112677,52.640845070422536
20822_terrestrial,509,187,421,262,696,82.71119842829077,51.47347740667977
20829_terrestrial,528,225,409,218,753,77.46212121212122,41.28787878787879
20830_terrestrial,720,338,527,347,1058,73.19444444444444,48.19444444444444
20831_terrestrial,747,367,533,377,1114,71.3520749665328,50.46854082998661
20832_terrestrial,1053,451,718,587,1504,68.18613485280152,55.74548907882241
20833_terrestrial,1037,465,703,571,1502,67.7917068466731,55.06268081002893
20834_terrestrial,943,386,647,528,1329,68.61081654294804,55.991516436903495
20944_terrestrial,472,404,287,239,876,60.80508474576271,50.63559322033898
20945_terrestrial,260,326,84,218,586,32.30769230769231,83.84615384615385
20946_terrestrial,483,411,286,252,894,59.21325051759835,52.17391304347826
20947_terrestrial,477,402,291,242,879,61.0062893081761,50.73375262054507
20948_terrestrial,272,262,88,221,534,32.35294117647059,81.25
20949_terrestrial,288,353,80,235,641,27.77777777777778,81.59722222222221
20950_terrestrial,297,386,87,242,683,29.292929292929294,81.48148148148148
20951_terrestrial,294,389,88,234,683,29.931972789115648,79.59183673469387
20952_terrestrial,293,388,88,234,681,30.034129692832767,79.86348122866895
20953_terrestrial,275,303,88,219,578,32,79.63636363636364
20954_terrestrial,277,300,92,222,577,33.2129963898917,80.14440433212997
20955_terrestrial,274,305,87,219,579,31.751824817518248,79.92700729927007
20956_terrestrial,277,330,86,218,607,31.046931407942242,78.70036101083032
20957_terrestrial,264,315,84,205,579,31.818181818181817,77.65151515151516
20958_terrestrial,258,286,77,205,544,29.844961240310074,79.45736434108527
20959_terrestrial,257,274,72,206,531,28.01556420233463,80.1556420233463
20960_terrestrial,259,259,70,211,518,27.027027027027028,81.46718146718148
20961_terrestrial,268,257,75,217,525,27.985074626865668,80.97014925373134
20962_terrestrial,281,282,82,228,563,29.181494661921707,81.13879003558719
20963_terrestrial,277,322,83,227,599,29.96389891696751,81.94945848375451
20964_terrestrial,277,337,86,226,614,31.046931407942242,81.58844765342961
20965_terrestrial,271,322,79,225,593,29.15129151291513,83.02583025830258
20966_terrestrial,272,316,78,223,588,28.676470588235293,81.98529411764706
20967_terrestrial,269,334,77,221,603,28.624535315985128,82.15613382899627
20968_terrestrial,260,347,71,217,607,27.307692307692307,83.46153846153847
20969_terrestrial,268,437,73,226,705,27.238805970149254,84.32835820895522
20970_terrestrial,262,423,72,220,685,27.480916030534353,83.96946564885496
20971_terrestrial,272,413,76,232,685,27.941176470588236,85.29411764705883
20972_terrestrial,279,446,81,239,725,29.03225806451613,85.66308243727599
20973_terrestrial,282,446,80,238,728,28.368794326241137,84.39716312056737
20974_terrestrial,275,428,79,232,703,28.72727272727273,84.36363636363636
20975_terrestrial,264,374,78,221,638,29.545454545454547,83.71212121212122
20976_terrestrial,258,350,81,215,608,31.3953488372093,83.33333333333334
20977_terrestrial,259,352,83,215,611,32.04633204633205,83.01158301158301
20978_terrestrial,271,343,86,227,614,31.73431734317343,83.76383763837639
20979_terrestrial,598,487,352,329,1085,58.862876254180605,55.01672240802675
20980_terrestrial,550,399,326,295,949,59.27272727272728,53.63636363636364
21051_terrestrial,518,258,411,197,776,79.34362934362935,38.030888030888036
21052_terrestrial,278,163,174,195,441,62.589928057553955,70.14388489208633
21053_terrestrial,272,177,169,193,449,62.13235294117647,70.95588235294117
21054_terrestrial,266,186,153,182,452,57.5187969924812,68.42105263157895
21055_terrestrial,256,182,148,169,438,57.8125,66.015625
21056_terrestrial,223,159,127,147,382,56.95067264573991,65.91928251121077
21057_terrestrial,187,133,113,120,320,60.42780748663101,64.171122994652407
21089_terrestrial,358,142,281,115,500,78.49162011173185,32.122905027932966
21090_terrestrial,474,190,362,196,664,76.37130801687763,41.35021097046413
21091_terrestrial,511,197,392,213,708,76.71232876712328,41.68297455968688
21092_terrestrial,517,183,399,223,700,77.17601547388782,43.133462282398455
21093_terrestrial,549,185,415,251,734,75.591985428051,45.71948998178507
21094_terrestrial,446,176,340,187,622,76.23318385650224,41.92825112107623
21095_terrestrial,589,295,427,287,884,72.49575551782682,48.72665534804754
21096_terrestrial,368,226,214,256,594,58.152173913043484,69.56521739130434
21097_terrestrial,258,146,143,190,404,55.42635658914728,73.64341085271317
21098_terrestrial,173,85,97,126,258,56.06936416184971,72.83236994219652
21108_terrestrial,283,116,181,212,399,63.957597173144876,74.91166077738515
21109_terrestrial,262,139,153,189,401,58.396946564885496,72.13740458015268
21110_terrestrial,291,165,171,209,456,58.76288659793815,71.8213058419244
21111_terrestrial,267,168,159,187,435,59.55056179775281,70.0374531835206
21112_terrestrial,238,139,140,166,377,58.82352941176471,69.74789915966386
21113_terrestrial,205,115,124,138,320,60.48780487804878,67.31707317073172
21114_terrestrial,168,100,107,115,268,63.69047619047619,68.45238095238095
21121_terrestrial,199,128,131,141,327,65.82914572864321,70.85427135678391
21122_terrestrial,207,123,137,149,330,66.18357487922705,71.98067632850241
21123_terrestrial,197,106,127,146,303,64.46700507614213,74.11167512690355
21124_terrestrial,169,108,105,122,277,62.1301775147929,72.18934911242604
21125_terrestrial,165,105,99,120,270,60,72.72727272727273
21126_terrestrial,185,119,114,140,304,61.62162162162163,75.67567567567568
21127_terrestrial,229,133,137,173,362,59.82532751091703,75.54585152838428
21128_terrestrial,232,142,137,175,374,59.05172413793104,75.43103448275862
21129_terrestrial,254,152,155,196,406,61.023622047244096,77.16535433070865
21130_terrestrial,302,147,193,243,449,63.90728476821192,80.4635761589404
21131_terrestrial,348,133,231,276,481,66.37931034482759,79.3103448275862
21132_terrestrial,314,112,217,239,426,69.10828025477707,76.11464968152866
21133_terrestrial,312,114,221,233,426,70.83333333333334,74.67948717948718
21134_terrestrial,336,132,241,258,468,71.72619047619048,76.78571428571429
21135_terrestrial,393,163,278,302,556,70.73791348600508,76.84478371501272
21136_terrestrial,507,209,333,399,716,65.68047337278107,78.69822485207101
21137_terrestrial,612,263,393,484,875,64.2156862745098,79.08496732026144
21138_terrestrial,576,269,362,451,845,62.84722222222222,78.29861111111111
21139_terrestrial,442,235,273,335,677,61.76470588235294,75.7918552036199
21140_terrestrial,260,148,163,185,408,62.69230769230769,71.15384615384616
21156_terrestrial,168,118,94,121,286,55.952380952380956,72.02380952380952
21157_terrestrial,182,133,104,128,315,57.14285714285714,70.32967032967034
21158_terrestrial,208,148,127,141,356,61.057692307692314,67.78846153846155
21159_terrestrial,222,163,135,156,385,60.810810810810814,70.27027027027027
21160_terrestrial,249,170,153,177,419,61.44578313253012,71.08433734939759
21161_terrestrial,279,182,169,206,461,60.57347670250897,73.83512544802868
21162_terrestrial,337,212,201,246,549,59.64391691394659,72.99703264094956
21163_terrestrial,396,298,248,278,694,62.62626262626263,70.2020202020202
21164_terrestrial,446,329,282,321,775,63.22869955156951,71.97309417040358
21165_terrestrial,421,299,280,305,720,66.5083135391924,72.44655581947742
21166_terrestrial,357,217,255,263,574,71.42857142857143,73.66946778711485
21167_terrestrial,336,207,242,244,543,72.02380952380952,72.61904761904762
21168_terrestrial,346,236,247,247,582,71.38728323699422,71.38728323699422
21169_terrestrial,356,245,257,252,601,72.19101123595506,70.78651685393258
21170_terrestrial,366,244,268,261,610,73.224043715847,71.31147540983606
21171_terrestrial,359,218,261,256,577,72.70194986072424,71.3091922005571
21172_terrestrial,352,170,260,256,522,73.86363636363636,72.72727272727273
21173_terrestrial,297,118,221,224,415,74.41077441077442,75.42087542087542
21174_terrestrial,299,125,222,226,424,74.24749163879598,75.58528428093646
21175_terrestrial,306,133,232,230,439,75.81699346405229,75.16339869281046
21176_terrestrial,310,140,238,228,450,76.77419354838709,73.54838709677419
21177_terrestrial,324,152,247,241,476,76.23456790123457,74.38271604938271
21178_terrestrial,351,153,270,253,504,76.92307692307693,72.07977207977207
21179_terrestrial,387,160,298,264,547,77.00258397932816,68.21705426356588
21180_terrestrial,382,169,293,269,551,76.70157068062828,70.41884816753927
21181_terrestrial,583,248,479,305,831,82.16123499142367,52.315608919382505
21182_terrestrial,598,237,492,306,835,82.2742474916388,51.17056856187291
21190_terrestrial,580,258,419,243,838,72.24137931034483,41.89655172413793
21191_terrestrial,1030,434,698,587,1464,67.76699029126215,56.99029126213592
21192_terrestrial,1031,434,698,579,1465,67.70126091173618,56.15906886517944
21304_terrestrial,436,342,276,211,778,63.30275229357798,48.39449541284404
21305_terrestrial,473,427,285,245,900,60.25369978858352,51.79704016913319
21306_terrestrial,438,410,268,220,848,61.18721461187214,50.2283105022831
21307_terrestrial,417,353,259,209,770,62.11031175059952,50.11990407673861
21308_terrestrial,472,406,289,237,878,61.228813559322035,50.21186440677966
21309_terrestrial,252,286,74,203,538,29.365079365079367,80.55555555555556
21310_terrestrial,265,349,74,212,614,27.92452830188679,80
21311_terrestrial,277,380,83,217,657,29.96389891696751,78.33935018050542
21312_terrestrial,283,400,86,226,683,30.3886925795053,79.85865724381625
21313_terrestrial,276,336,84,217,612,30.434782608695656,78.62318840579711
21314_terrestrial,239,278,73,191,517,30.543933054393307,79.9163179916318
21315_terrestrial,254,298,78,201,552,30.708661417322837,79.13385826771653
21316_terrestrial,275,329,88,211,604,32,76.72727272727272
21317_terrestrial,264,330,79,202,594,29.924242424242426,76.51515151515152
21318_terrestrial,266,324,80,207,590,30.075187969924812,77.81954887218046
21319_terrestrial,266,304,74,212,570,27.819548872180448,79.69924812030075
21320_terrestrial,262,290,70,212,552,26.717557251908396,80.91603053435115
21321_terrestrial,268,286,74,221,554,27.611940298507463,82.46268656716418
21322_terrestrial,283,316,82,229,599,28.975265017667844,80.91872791519434
21323_terrestrial,285,335,81,236,620,28.421052631578945,82.80701754385966
21324_terrestrial,291,333,85,247,624,29.20962199312715,84.87972508591065
21325_terrestrial,315,345,93,266,660,29.523809523809526,84.44444444444444
21326_terrestrial,336,348,99,284,684,29.464285714285715,84.52380952380952
21327_terrestrial,590,472,299,368,1062,50.67796610169491,62.37288135593221
21328_terrestrial,314,329,92,270,643,29.29936305732484,85.98726114649682
21329_terrestrial,305,416,86,262,721,28.196721311475407,85.90163934426229
21330_terrestrial,572,551,303,338,1123,52.972027972027966,59.09090909090909
21331_terrestrial,612,585,325,360,1197,53.10457516339869,58.82352941176471
21332_terrestrial,609,604,330,351,1213,54.187192118226605,57.635467980295566
21333_terrestrial,605,566,334,340,1171,55.20661157024793,56.19834710743802
21334_terrestrial,592,522,327,336,1114,55.23648648648649,56.75675675675676
21335_terrestrial,601,540,330,340,1141,54.90848585690515,56.57237936772047
21336_terrestrial,620,537,343,360,1157,55.32258064516129,58.06451612903226
21337_terrestrial,601,502,339,346,1103,56.40599001663894,57.570715474209656
21338_terrestrial,283,319,92,238,602,32.50883392226148,84.09893992932862
21339_terrestrial,599,462,349,336,1061,58.263772954924875,56.093489148580964
21411_terrestrial,554,278,431,224,832,77.79783393501805,40.43321299638989
21412_terrestrial,286,197,177,189,483,61.88811188811189,66.08391608391608
21413_terrestrial,269,192,154,180,461,57.249070631970255,66.91449814126395
21414_terrestrial,235,154,133,155,389,56.59574468085107,65.95744680851064
21415_terrestrial,185,133,105,116,318,56.75675675675676,62.70270270270271
21416_terrestrial,149,116,81,89,265,54.36241610738255,59.73154362416108
21449_terrestrial,401,152,311,145,553,77.55610972568579,36.15960099750624
21450_terrestrial,501,194,380,217,695,75.84830339321357,43.31337325349301
21451_terrestrial,333,153,208,218,486,62.46246246246246,65.46546546546547
21452_terrestrial,345,160,210,231,505,60.86956521739131,66.95652173913044
21453_terrestrial,819,353,535,469,1172,65.32356532356532,57.26495726495726
21454_terrestrial,223,115,126,154,338,56.502242152466366,69.05829596412556
21455_terrestrial,265,176,148,173,441,55.84905660377358,65.28301886792453
21456_terrestrial,258,183,130,181,441,50.3875968992248,70.15503875968993
21468_terrestrial,538,231,386,288,769,71.74721189591078,53.53159851301115
21469_terrestrial,539,244,390,284,783,72.35621521335807,52.69016697588126
21470_terrestrial,504,248,357,252,752,70.83333333333334,50
21471_terrestrial,530,279,364,268,809,68.67924528301886,50.56603773584906
21472_terrestrial,269,160,164,189,429,60.966542750929364,70.26022304832715
21473_terrestrial,225,135,138,156,360,61.33333333333333,69.33333333333334
21474_terrestrial,193,107,117,131,300,60.62176165803109,67.87564766839378
21475_terrestrial,170,97,108,121,267,63.52941176470588,71.17647058823529
21476_terrestrial,143,93,89,98,236,62.23776223776224,68.53146853146853
21477_terrestrial,136,93,81,89,229,59.55882352941176,65.44117647058823
21480_terrestrial,148,115,94,99,263,63.51351351351351,66.8918918918919
21481_terrestrial,191,125,121,134,316,63.35078534031413,70.15706806282722
21482_terrestrial,208,121,136,146,329,65.38461538461539,70.1923076923077
21483_terrestrial,183,96,121,135,279,66.12021857923497,73.77049180327869
21484_terrestrial,160,97,104,113,257,65,70.625
21485_terrestrial,168,104,107,122,272,63.69047619047619,72.61904761904762
21486_terrestrial,192,109,122,144,301,63.541666666666664,75
21487_terrestrial,247,147,154,185,394,62.34817813765182,74.89878542510121
21488_terrestrial,258,142,161,194,400,62.4031007751938,75.1937984496124
21489_terrestrial,268,135,165,209,403,61.56716417910447,77.98507462686567
21490_terrestrial,304,110,199,236,414,65.46052631578947,77.63157894736842
21491_terrestrial,320,115,216,245,435,67.5,76.5625
21492_terrestrial,297,105,204,226,402,68.68686868686868,76.0942760942761
21493_terrestrial,288,106,201,219,394,69.79166666666666,76.04166666666666
21494_terrestrial,310,115,217,233,425,70,75.16129032258064
21495_terrestrial,340,129,243,261,469,71.47058823529412,76.76470588235294
21496_terrestrial,397,150,281,304,547,70.7808564231738,76.57430730478589
21497_terrestrial,537,212,341,431,749,63.50093109869647,80.26070763500931
21498_terrestrial,670,300,427,529,970,63.731343283582085,78.95522388059702
21499_terrestrial,697,318,431,544,1015,61.83644189383071,78.04878048780488
21500_terrestrial,549,288,336,413,837,61.20218579234973,75.22768670309654
21501_terrestrial,419,243,252,319,662,60.14319809069213,76.13365155131265
21502_terrestrial,280,168,169,202,448,60.357142857142854,72.14285714285714
21503_terrestrial,205,111,127,145,316,61.951219512195124,70.73170731707317
21516_terrestrial,253,171,147,188,424,58.10276679841897,74.30830039525692
21517_terrestrial,260,161,157,191,421,60.38461538461538,73.46153846153847
21518_terrestrial,268,177,165,189,445,61.56716417910447,70.52238805970148
21519_terrestrial,277,179,173,194,456,62.454873646209386,70.03610108303249
21520_terrestrial,298,197,185,212,495,62.08053691275168,71.14093959731544
21521_terrestrial,313,201,191,221,514,61.0223642172524,70.6070287539936
21522_terrestrial,378,280,235,269,658,62.16931216931217,71.16402116402116
21523_terrestrial,459,353,288,323,812,62.745098039215684,70.37037037037037
21524_terrestrial,473,359,307,340,832,64.90486257928119,71.8816067653277
21525_terrestrial,355,222,249,260,577,70.14084507042253,73.23943661971832
21526_terrestrial,335,189,243,248,524,72.53731343283583,74.02985074626865
21527_terrestrial,328,188,240,236,516,73.17073170731707,71.95121951219512
21528_terrestrial,351,211,254,252,562,72.36467236467237,71.7948717948718
21529_terrestrial,362,249,268,257,611,74.03314917127072,70.99447513812154
21530_terrestrial,368,234,276,259,602,75,70.38043478260869
21531_terrestrial,376,225,277,263,601,73.67021276595744,69.9468085106383
21532_terrestrial,378,182,280,269,560,74.07407407407408,71.16402116402116
21533_terrestrial,320,129,236,243,449,73.75,75.9375
21534_terrestrial,314,125,235,236,439,74.84076433121018,75.15923566878982
21535_terrestrial,330,139,247,248,469,74.84848484848486,75.15151515151514
21536_terrestrial,336,162,251,252,498,74.70238095238095,75
21537_terrestrial,381,188,291,269,569,76.37795275590551,70.60367454068242
21538_terrestrial,399,194,307,281,593,76.94235588972431,70.42606516290726
21539_terrestrial,419,218,323,288,637,77.08830548926015,68.73508353221956
21540_terrestrial,428,212,332,297,640,77.57009345794393,69.39252336448598
21541_terrestrial,681,307,564,338,988,82.81938325991189,49.632892804698976
21542_terrestrial,688,278,566,342,966,82.26744186046511,49.7093023255814
21543_terrestrial,492,182,414,230,674,84.14634146341463,46.7479674796748
21551_terrestrial,942,426,630,514,1368,66.87898089171973,54.56475583864119
21552_terrestrial,902,372,608,501,1274,67.40576496674058,55.54323725055432
21665_terrestrial,455,350,280,231,805,61.53846153846154,50.76923076923077
21666_terrestrial,501,441,322,240,942,64.27145708582835,47.90419161676647
21667_terrestrial,441,415,276,211,856,62.585034013605444,47.84580498866213
21668_terrestrial,507,470,308,249,977,60.74950690335306,49.112426035502956
21669_terrestrial,244,250,77,201,494,31.557377049180328,82.37704918032787
21670_terrestrial,254,298,71,210,552,27.95275590551181,82.67716535433071
21671_terrestrial,266,355,73,219,621,27.44360902255639,82.33082706766918
21672_terrestrial,271,369,80,219,640,29.520295202952028,80.81180811808119
21673_terrestrial,270,350,79,217,620,29.259259259259256,80.37037037037037
21674_terrestrial,232,293,65,186,525,28.01724137931034,80.17241379310344
21675_terrestrial,238,284,71,189,522,29.831932773109244,79.41176470588235
21676_terrestrial,264,320,81,203,584,30.681818181818183,76.89393939393939
21677_terrestrial,265,328,78,206,593,29.433962264150942,77.73584905660378
21678_terrestrial,268,337,80,209,605,29.850746268656714,77.98507462686567
21679_terrestrial,278,341,88,218,619,31.654676258992804,78.41726618705036
21680_terrestrial,280,336,79,225,616,28.214285714285715,80.35714285714286
21681_terrestrial,279,309,76,230,588,27.24014336917563,82.43727598566308
21682_terrestrial,298,353,82,241,651,27.516778523489933,80.87248322147651
21683_terrestrial,323,358,91,269,681,28.173374613003094,83.28173374613003
21684_terrestrial,333,316,99,286,649,29.72972972972973,85.88588588588588
21685_terrestrial,641,479,331,392,1120,51.6380655226209,61.15444617784711
21686_terrestrial,598,463,308,360,1061,51.50501672240802,60.200668896321076
21687_terrestrial,576,452,310,346,1028,53.81944444444444,60.06944444444444
21688_terrestrial,569,384,308,338,953,54.13005272407732,59.40246045694201
21689_terrestrial,560,419,303,329,979,54.107142857142854,58.75
21690_terrestrial,557,392,302,322,949,54.219030520646314,57.809694793536806
21691_terrestrial,545,391,303,313,936,55.596330275229356,57.43119266055046
21695_terrestrial,584,489,330,326,1073,56.5068493150685,55.821917808219176
21696_terrestrial,581,495,332,324,1076,57.14285714285714,55.76592082616179
21697_terrestrial,583,465,335,328,1048,57.46140651801029,56.26072041166381
21698_terrestrial,608,493,346,345,1101,56.9078947368421,56.74342105263158
21699_terrestrial,603,461,348,335,1064,57.711442786069654,55.55555555555556
21700_terrestrial,563,392,338,302,955,60.03552397868561,53.641207815275315
21770_terrestrial,487,232,382,183,719,78.4394250513347,37.57700205338809
21771_terrestrial,557,256,427,222,813,76.66068222621185,39.85637342908438
21772_terrestrial,241,150,141,158,391,58.50622406639005,65.56016597510373
21773_terrestrial,181,123,100,112,304,55.24861878453039,61.87845303867403
21774_terrestrial,146,101,72,84,247,49.31506849315068,57.534246575342465
21810_terrestrial,188,84,113,129,272,60.1063829787234,68.61702127659575
21811_terrestrial,310,132,192,208,442,61.935483870967744,67.0967741935484
21812_terrestrial,336,144,200,225,480,59.523809523809526,66.96428571428571
21829_terrestrial,509,236,364,256,745,71.51277013752456,50.29469548133595
21831_terrestrial,471,245,337,220,716,71.54989384288747,46.70912951167728
21832_terrestrial,270,159,163,187,429,60.370370370370374,69.25925925925925
21833_terrestrial,246,150,146,175,396,59.34959349593496,71.13821138211382
21834_terrestrial,208,129,125,145,337,60.09615384615385,69.71153846153845
21835_terrestrial,196,111,120,134,307,61.224489795918366,68.36734693877551
21836_terrestrial,183,106,110,123,289,60.10928961748634,67.21311475409836
21837_terrestrial,172,114,100,113,286,58.139534883720934,65.69767441860465
21840_terrestrial,149,109,89,97,258,59.73154362416108,65.1006711409396
21841_terrestrial,175,132,108,117,307,61.71428571428571,66.85714285714286
21842_terrestrial,182,134,112,126,316,61.53846153846154,69.23076923076923
21843_terrestrial,167,112,106,115,279,63.47305389221557,68.8622754491018
21844_terrestrial,164,104,104,109,268,63.41463414634146,66.46341463414635
21845_terrestrial,176,108,111,117,284,63.06818181818182,66.47727272727273
21846_terrestrial,204,117,128,150,321,62.745098039215684,73.52941176470588
21847_terrestrial,251,151,158,187,402,62.94820717131474,74.5019920318725
21848_terrestrial,274,142,175,211,416,63.868613138686136,77.00729927007299
21849_terrestrial,291,113,189,227,404,64.94845360824742,78.00687285223368
21850_terrestrial,294,104,198,229,398,67.3469387755102,77.89115646258503
21851_terrestrial,296,118,204,228,414,68.91891891891892,77.02702702702703
21852_terrestrial,290,108,195,216,398,67.24137931034483,74.48275862068967
21853_terrestrial,287,109,192,213,396,66.89895470383276,74.21602787456446
21854_terrestrial,296,115,204,218,411,68.91891891891892,73.64864864864865
21855_terrestrial,330,109,232,245,439,70.3030303030303,74.24242424242425
21856_terrestrial,358,125,256,273,483,71.50837988826815,76.25698324022346
21857_terrestrial,406,156,284,308,562,69.95073891625616,75.86206896551724
21858_terrestrial,518,207,350,391,725,67.56756756756756,75.4826254826255
21859_terrestrial,703,296,439,549,999,62.44665718349929,78.09388335704125
21860_terrestrial,736,319,460,571,1055,62.5,77.58152173913044
21861_terrestrial,692,336,420,534,1028,60.69364161849711,77.16763005780348
21862_terrestrial,510,264,308,386,774,60.3921568627451,75.68627450980392
21863_terrestrial,412,240,250,309,652,60.679611650485434,75
21864_terrestrial,317,174,196,223,491,61.82965299684543,70.347003154574125
21865_terrestrial,232,121,143,165,353,61.63793103448276,71.12068965517241
21875_terrestrial,444,257,270,319,701,60.810810810810814,71.84684684684684
21876_terrestrial,470,288,282,341,758,60,72.5531914893617
21877_terrestrial,415,237,256,298,652,61.686746987951814,71.80722891566265
21878_terrestrial,346,207,221,243,553,63.8728323699422,70.23121387283237
21879_terrestrial,354,229,228,247,583,64.40677966101694,69.77401129943502
21880_terrestrial,358,247,232,253,605,64.80446927374301,70.6703910614525
21881_terrestrial,347,239,218,251,586,62.824207492795395,72.3342939481268
21882_terrestrial,406,300,252,295,706,62.06896551724138,72.66009852216749
21883_terrestrial,481,371,305,347,852,63.409563409563404,72.14137214137214
21884_terrestrial,477,358,319,340,835,66.87631027253668,71.27882599580713
21885_terrestrial,386,224,271,281,610,70.20725388601036,72.7979274611399
21886_terrestrial,355,201,258,251,556,72.67605633802818,70.70422535211267
21887_terrestrial,387,230,283,262,617,73.1266149870801,67.70025839793283
21888_terrestrial,387,236,281,265,623,72.60981912144703,68.47545219638242
21889_terrestrial,379,230,279,259,609,73.61477572559367,68.33773087071239
21890_terrestrial,383,232,284,264,615,74.1514360313316,68.9295039164491
21891_terrestrial,390,231,289,269,621,74.1025641025641,68.97435897435898
21892_terrestrial,373,174,279,261,547,74.79892761394102,69.97319034852548
21893_terrestrial,345,155,261,243,500,75.65217391304347,70.43478260869566
21894_terrestrial,363,158,276,260,521,76.03305785123968,71.62534435261708
21895_terrestrial,358,162,275,259,520,76.81564245810057,72.3463687150838
21896_terrestrial,364,181,278,265,545,76.37362637362637,72.8021978021978
21897_terrestrial,396,188,301,274,584,76.01010101010101,69.1919191919192
21898_terrestrial,413,210,317,290,623,76.75544794188862,70.2179176755448
21899_terrestrial,430,223,331,296,653,76.9767441860465,68.83720930232559
21900_terrestrial,437,210,331,307,647,75.74370709382151,70.25171624713958
21901_terrestrial,438,196,337,306,634,76.9406392694064,69.86301369863014
21902_terrestrial,741,290,616,355,1031,83.13090418353576,47.908232118758434
21903_terrestrial,636,261,528,299,897,83.01886792452831,47.0125786163522
22026_terrestrial,435,336,270,217,771,62.06896551724138,49.88505747126437
22027_terrestrial,437,406,270,213,843,61.784897025171624,48.74141876430206
22028_terrestrial,520,525,311,252,1045,59.80769230769231,48.46153846153846
22029_terrestrial,513,464,308,251,977,60.03898635477582,48.927875243664715
22030_terrestrial,282,285,88,236,567,31.20567375886525,83.68794326241135
22031_terrestrial,305,365,77,256,670,25.245901639344265,83.93442622950819
22032_terrestrial,287,385,76,237,672,26.480836236933797,82.57839721254355
22033_terrestrial,271,356,77,223,627,28.413284132841326,82.28782287822878
22034_terrestrial,247,313,69,202,560,27.93522267206478,81.78137651821862
22035_terrestrial,228,278,64,180,506,28.07017543859649,78.94736842105263
22036_terrestrial,232,277,69,181,509,29.74137931034483,78.01724137931035
22037_terrestrial,251,310,77,197,561,30.677290836653388,78.48605577689243
22038_terrestrial,251,322,75,197,573,29.880478087649404,78.48605577689243
22039_terrestrial,258,312,81,201,570,31.3953488372093,77.90697674418605
22040_terrestrial,274,295,88,220,569,32.11678832116788,80.2919708029197
22041_terrestrial,292,298,85,242,590,29.10958904109589,82.87671232876713
22042_terrestrial,308,312,89,253,620,28.8961038961039,82.14285714285714
22043_terrestrial,621,463,317,376,1084,51.04669887278583,60.547504025764894
22044_terrestrial,610,452,314,364,1062,51.47540983606558,59.67213114754099
22045_terrestrial,573,404,304,339,977,53.054101221640494,59.16230366492147
22051_terrestrial,507,348,287,286,855,56.60749506903353,56.41025641025641
22058_terrestrial,612,471,349,348,1083,57.02614379084967,56.86274509803921
22059_terrestrial,278,297,89,233,575,32.014388489208635,83.81294964028777
22060_terrestrial,647,478,378,350,1125,58.42349304482226,54.09582689335394
22122_terrestrial,74,41,56,51,115,75.67567567567568,68.91891891891892
22123_terrestrial,344,160,302,86,504,87.79069767441861,25
22124_terrestrial,369,166,321,102,535,86.99186991869918,27.64227642276423
22125_terrestrial,355,144,312,96,499,87.88732394366198,27.042253521126757
22126_terrestrial,345,152,302,90,497,87.53623188405797,26.08695652173913
22127_terrestrial,351,152,307,95,503,87.46438746438746,27.065527065527068
22128_terrestrial,427,189,347,140,616,81.26463700234193,32.78688524590164
22129_terrestrial,476,216,377,167,692,79.2016806722689,35.08403361344538
22130_terrestrial,494,220,384,181,714,77.7327935222672,36.63967611336032
22131_terrestrial,214,112,117,141,326,54.67289719626168,65.88785046728972
22132_terrestrial,149,97,73,92,246,48.99328859060403,61.74496644295302
22169_terrestrial,115,53,64,74,168,55.65217391304348,64.34782608695652
22170_terrestrial,141,67,84,91,208,59.57446808510638,64.53900709219859
22171_terrestrial,261,107,162,173,368,62.06896551724138,66.28352490421456
22172_terrestrial,272,106,166,181,378,61.029411764705884,66.54411764705883
22191_terrestrial,425,213,306,192,638,72,45.1764705882353
22192_terrestrial,463,232,331,208,695,71.49028077753779,44.9244060475162
22193_terrestrial,237,131,142,160,368,59.91561181434599,67.51054852320675
22194_terrestrial,222,123,137,155,345,61.711711711711715,69.81981981981981
22195_terrestrial,207,129,128,145,336,61.83574879227053,70.04830917874396
22196_terrestrial,203,132,125,139,335,61.57635467980296,68.4729064039409
22197_terrestrial,224,131,136,151,355,60.71428571428571,67.41071428571429
22198_terrestrial,206,118,124,143,324,60.19417475728155,69.41747572815534
22199_terrestrial,179,116,106,118,295,59.217877094972074,65.92178770949721
22200_terrestrial,166,106,91,105,272,54.81927710843374,63.25301204819277
22201_terrestrial,170,117,101,102,287,59.411764705882355,60
22202_terrestrial,171,117,101,108,288,59.06432748538012,63.1578947368421
22203_terrestrial,159,107,96,100,266,60.37735849056604,62.893081761006286
22204_terrestrial,148,107,93,94,255,62.83783783783784,63.51351351351351
22205_terrestrial,166,106,107,106,272,64.45783132530121,63.85542168674698
22206_terrestrial,195,118,129,135,313,66.15384615384615,69.23076923076923
22207_terrestrial,243,120,153,176,363,62.96296296296296,72.42798353909465
22208_terrestrial,309,116,201,230,425,65.0485436893204,74.4336569579288
22209_terrestrial,308,115,213,235,423,69.15584415584416,76.2987012987013
22210_terrestrial,298,115,208,225,413,69.79865771812081,75.50335570469798
22211_terrestrial,287,116,197,213,403,68.6411149825784,74.21602787456446
22212_terrestrial,265,105,182,195,370,68.67924528301886,73.58490566037736
22213_terrestrial,260,103,174,192,363,66.92307692307692,73.84615384615385
22214_terrestrial,285,109,196,213,394,68.77192982456141,74.73684210526315
22215_terrestrial,315,114,217,231,429,68.88888888888889,73.33333333333333
22216_terrestrial,352,125,253,263,477,71.875,74.7159090909091
22217_terrestrial,386,135,273,289,521,70.72538860103627,74.87046632124353
22218_terrestrial,446,143,319,328,589,71.52466367713004,73.54260089686099
22219_terrestrial,480,159,341,361,639,71.04166666666667,75.20833333333333
22220_terrestrial,578,202,384,439,780,66.43598615916954,75.9515570934256
22221_terrestrial,714,290,450,553,1004,63.02521008403361,77.45098039215686
22222_terrestrial,750,330,462,576,1080,61.6,76.8
22223_terrestrial,684,318,411,527,1002,60.08771929824561,77.046783625731
22224_terrestrial,620,317,381,470,937,61.45161290322581,75.80645161290323
22225_terrestrial,590,315,350,454,905,59.32203389830508,76.94915254237287
22226_terrestrial,494,289,288,375,783,58.2995951417004,75.91093117408907
22227_terrestrial,344,195,210,254,539,61.04651162790697,73.83720930232558
22229_terrestrial,252,164,172,159,416,68.25396825396825,63.095238095238095
22230_terrestrial,258,142,168,175,400,65.11627906976744,67.82945736434108
22232_terrestrial,266,143,168,193,409,63.1578947368421,72.55639097744361
22233_terrestrial,370,199,222,276,569,60,74.5945945945946
22234_terrestrial,525,279,311,389,804,59.238095238095234,74.09523809523809
22235_terrestrial,653,319,401,484,972,61.40888208269525,74.11944869831547
22236_terrestrial,719,331,452,550,1050,62.865090403337966,76.49513212795549
22237_terrestrial,698,373,434,520,1071,62.17765042979943,74.49856733524355
22238_terrestrial,598,367,384,413,965,64.21404682274247,69.06354515050167
22239_terrestrial,557,378,374,371,935,67.14542190305207,66.6068222621185
22240_terrestrial,447,316,298,314,763,66.66666666666666,70.24608501118567
22241_terrestrial,417,309,266,299,726,63.78896882494005,71.70263788968825
22242_terrestrial,455,315,290,331,770,63.73626373626373,72.74725274725274
22243_terrestrial,469,339,295,342,808,62.89978678038379,72.92110874200426
22244_terrestrial,485,345,326,344,830,67.21649484536083,70.9278350515464
22245_terrestrial,455,272,318,315,727,69.89010989010988,69.23076923076923
22246_terrestrial,423,261,308,283,684,72.81323877068559,66.903073286052
22247_terrestrial,420,260,306,278,680,72.85714285714285,66.19047619047619
22248_terrestrial,409,256,300,267,665,73.34963325183375,65.28117359413203
22249_terrestrial,409,252,300,273,661,73.34963325183375,66.74816625916871
22250_terrestrial,414,228,310,272,642,74.8792270531401,65.70048309178745
22251_terrestrial,387,185,296,271,572,76.48578811369508,70.02583979328165
22252_terrestrial,367,177,277,262,544,75.47683923705722,71.38964577656675
22253_terrestrial,355,164,268,255,519,75.49295774647888,71.83098591549296
22254_terrestrial,358,163,273,256,521,76.25698324022346,71.50837988826815
22255_terrestrial,353,173,272,253,526,77.05382436260622,71.671388101983
22256_terrestrial,380,176,293,270,556,77.10526315789473,71.05263157894737
22257_terrestrial,406,182,306,286,588,75.36945812807882,70.44334975369459
22258_terrestrial,454,205,339,321,659,74.66960352422907,70.70484581497797
22259_terrestrial,463,242,350,326,705,75.5939524838013,70.41036717062636
22260_terrestrial,461,223,342,335,684,74.18655097613883,72.66811279826464
22261_terrestrial,797,331,643,401,1128,80.67754077791719,50.31367628607277
22262_terrestrial,764,315,626,378,1079,81.93717277486911,49.47643979057592
22270_terrestrial,1088,469,681,652,1557,62.591911764705884,59.92647058823529
22388_terrestrial,470,415,286,218,885,60.851063829787236,46.38297872340426
22389_terrestrial,487,444,298,237,931,61.19096509240246,48.6652977412731
22390_terrestrial,548,523,323,278,1071,58.941605839416056,50.72992700729927
22391_terrestrial,634,586,335,353,1220,52.83911671924291,55.678233438485805
22392_terrestrial,320,436,78,271,756,24.375,84.6875
22393_terrestrial,295,400,80,244,695,27.11864406779661,82.71186440677965
22394_terrestrial,259,352,69,217,611,26.640926640926644,83.78378378378379
22395_terrestrial,230,316,67,184,546,29.130434782608695,80
22396_terrestrial,222,283,64,180,505,28.82882882882883,81.08108108108108
22397_terrestrial,219,257,65,172,476,29.68036529680365,78.53881278538812
22398_terrestrial,227,295,71,177,522,31.277533039647576,77.97356828193833
22399_terrestrial,249,319,78,196,568,31.32530120481928,78.714859437751
22400_terrestrial,267,276,84,211,543,31.46067415730337,79.02621722846442
22401_terrestrial,296,281,90,244,577,30.405405405405407,82.43243243243244
22402_terrestrial,318,302,94,268,620,29.559748427672954,84.27672955974843
22403_terrestrial,624,455,322,369,1079,51.60256410256411,59.13461538461539
22418_terrestrial,629,438,365,354,1067,58.028616852146264,56.27980922098569
22419_terrestrial,278,268,94,232,546,33.81294964028777,83.45323741007195
22420_terrestrial,653,475,381,352,1128,58.34609494640123,53.905053598774884
22485_terrestrial,352,155,309,96,507,87.7840909090909,27.27272727272727
22487_terrestrial,437,194,360,139,631,82.37986270022884,31.80778032036613
22488_terrestrial,453,206,367,154,659,81.01545253863135,33.99558498896248
22489_terrestrial,186,104,113,121,290,60.752688172043015,65.05376344086021
22490_terrestrial,140,86,73,89,226,52.142857142857146,63.57142857142857
22529_terrestrial,97,44,56,60,141,57.73195876288659,61.855670103092784
22531_terrestrial,239,90,148,158,329,61.92468619246861,66.10878661087865
22532_terrestrial,239,92,148,158,331,61.92468619246861,66.10878661087865
22552_terrestrial,421,203,307,186,624,72.92161520190024,44.180522565320665
22553_terrestrial,440,215,318,196,655,72.27272727272728,44.54545454545455
22554_terrestrial,440,206,316,196,646,71.81818181818181,44.54545454545455
22555_terrestrial,204,112,123,136,316,60.29411764705882,66.66666666666666
22556_terrestrial,478,251,346,214,729,72.38493723849372,44.76987447698745
22557_terrestrial,541,289,397,234,830,73.38262476894639,43.253234750462106
22558_terrestrial,224,130,135,148,354,60.26785714285714,66.07142857142857
22559_terrestrial,182,113,108,117,295,59.34065934065934,64.28571428571429
22560_terrestrial,174,114,102,112,288,58.620689655172406,64.36781609195403
22561_terrestrial,164,113,94,101,277,57.3170731707317,61.58536585365854
22562_terrestrial,162,104,95,99,266,58.64197530864198,61.111111111111114
22563_terrestrial,158,99,91,101,257,57.59493670886076,63.92405063291139
22564_terrestrial,160,105,99,100,265,61.875,62.5
22565_terrestrial,157,102,102,98,259,64.96815286624204,62.42038216560509
22566_terrestrial,188,97,119,129,285,63.297872340425535,68.61702127659575
22567_terrestrial,262,111,168,191,373,64.12213740458014,72.90076335877863
22568_terrestrial,337,121,233,251,458,69.13946587537092,74.4807121661721
22569_terrestrial,318,108,222,237,426,69.81132075471697,74.52830188679245
22570_terrestrial,299,118,207,217,417,69.23076923076923,72.5752508361204
22571_terrestrial,254,109,172,182,363,67.71653543307087,71.65354330708661
22572_terrestrial,241,101,163,173,342,67.63485477178423,71.78423236514523
22573_terrestrial,265,99,181,195,364,68.30188679245282,73.58490566037736
22574_terrestrial,305,116,211,221,421,69.18032786885246,72.45901639344262
22575_terrestrial,333,114,233,243,447,69.96996996996997,72.97297297297297
22576_terrestrial,351,136,247,262,487,70.37037037037037,74.64387464387464
22577_terrestrial,388,143,268,289,531,69.0721649484536,74.48453608247422
22578_terrestrial,411,147,288,299,558,70.07299270072993,72.74939172749392
22579_terrestrial,445,141,317,325,586,71.23595505617978,73.03370786516854
22580_terrestrial,443,130,311,329,573,70.20316027088036,74.2663656884876
22581_terrestrial,470,152,326,350,622,69.36170212765957,74.46808510638297
22582_terrestrial,549,202,368,419,751,67.03096539162114,76.32058287795994
22583_terrestrial,662,255,419,521,917,63.29305135951662,78.70090634441088
22584_terrestrial,748,323,480,574,1071,64.171122994652407,76.7379679144385
22585_terrestrial,804,381,507,612,1185,63.059701492537314,76.11940298507463
22586_terrestrial,787,389,485,601,1176,61.62642947903431,76.36594663278272
22587_terrestrial,737,390,445,566,1127,60.379918588873814,76.79782903663501
22588_terrestrial,703,390,427,524,1093,60.73968705547653,74.53769559032717
22589_terrestrial,747,447,457,548,1194,61.178045515394906,73.36010709504686
22590_terrestrial,641,349,392,489,990,61.15444617784711,76.28705148205928
22591_terrestrial,616,287,377,486,903,61.201298701298704,78.8961038961039
22592_terrestrial,643,313,396,502,956,61.58631415241057,78.0715396578538
22593_terrestrial,753,363,467,582,1116,62.01859229747676,77.29083665338645
22594_terrestrial,765,336,488,596,1101,63.79084967320261,77.90849673202615
22595_terrestrial,742,348,480,584,1090,64.6900269541779,78.70619946091644
22596_terrestrial,803,367,533,596,1170,66.3760896637609,74.22166874221668
22597_terrestrial,792,412,520,575,1204,65.65656565656566,72.6010101010101
22598_terrestrial,755,429,493,543,1184,65.29801324503312,71.9205298013245
22599_terrestrial,717,463,471,516,1180,65.69037656903765,71.96652719665272
22600_terrestrial,538,354,350,380,892,65.05576208178438,70.63197026022306
22601_terrestrial,478,333,305,342,811,63.80753138075313,71.54811715481172
22602_terrestrial,467,319,299,344,786,64.02569593147751,73.66167023554604
22603_terrestrial,454,322,295,334,776,64.97797356828194,73.568281938326
22604_terrestrial,473,291,318,341,764,67.23044397463002,72.09302325581395
22605_terrestrial,449,282,310,312,731,69.04231625835189,69.48775055679288
22606_terrestrial,435,270,311,299,705,71.49425287356321,68.73563218390805
22607_terrestrial,435,267,316,292,702,72.64367816091955,67.1264367816092
22608_terrestrial,432,257,314,287,689,72.68518518518519,66.43518518518519
22609_terrestrial,437,246,323,290,683,73.91304347826086,66.36155606407323
22610_terrestrial,419,217,311,286,636,74.22434367541766,68.25775656324582
22611_terrestrial,404,180,309,272,584,76.48514851485149,67.32673267326733
22612_terrestrial,373,172,282,267,545,75.60321715817693,71.58176943699732
22613_terrestrial,354,166,262,259,520,74.01129943502825,73.1638418079096
22614_terrestrial,374,173,286,266,547,76.47058823529412,71.12299465240642
22615_terrestrial,396,183,299,279,579,75.5050505050505,70.45454545454545
22616_terrestrial,410,181,309,293,591,75.36585365853658,71.46341463414633
22617_terrestrial,437,202,325,314,639,74.37070938215103,71.85354691075516
22618_terrestrial,487,236,364,339,723,74.74332648870636,69.60985626283367
22619_terrestrial,520,249,387,354,769,74.42307692307692,68.07692307692308
22620_terrestrial,520,227,392,357,747,75.38461538461539,68.65384615384616
22621_terrestrial,844,348,687,409,1192,81.39810426540285,48.459715639810426
22629_terrestrial,1069,456,670,641,1525,62.67539756782039,59.96258185219831
22630_terrestrial,141,111,96,99,252,68.08510638297872,70.2127659574468
22748_terrestrial,512,455,326,229,967,63.671875,44.7265625
22749_terrestrial,493,451,311,223,944,63.083164300202846,45.233265720081135
22751_terrestrial,598,549,341,314,1147,57.02341137123745,52.508361204013376
22752_terrestrial,348,426,97,286,774,27.873563218390807,82.18390804597702
22753_terrestrial,318,442,79,263,760,24.842767295597483,82.70440251572327
22754_terrestrial,287,390,74,241,677,25.78397212543554,83.97212543554006
22755_terrestrial,257,340,70,210,597,27.237354085603112,81.71206225680933
22756_terrestrial,226,280,67,183,506,29.646017699115045,80.97345132743364
22757_terrestrial,221,257,66,178,478,29.86425339366516,80.54298642533936
22758_terrestrial,232,293,74,182,525,31.896551724137932,78.44827586206897
22759_terrestrial,256,325,78,205,581,30.46875,80.078125
22760_terrestrial,291,323,89,231,614,30.584192439862544,79.38144329896907
22761_terrestrial,323,326,97,263,649,30.030959752321984,81.42414860681114
22762_terrestrial,354,332,111,298,686,31.35593220338983,84.18079096045197
22763_terrestrial,633,447,325,385,1080,51.342812006319114,60.821484992101105
22778_terrestrial,604,403,364,332,1007,60.264900662251655,54.966887417218544
22779_terrestrial,627,402,364,347,1029,58.0542264752791,55.34290271132376
22780_terrestrial,673,437,378,374,1110,56.16641901931649,55.57206537890045
22782_terrestrial,469,327,284,265,796,60.5543710021322,56.50319829424307
22783_terrestrial,459,307,273,265,766,59.47712418300654,57.73420479302832
22847_terrestrial,413,192,334,120,605,80.87167070217917,29.055690072639223
22848_terrestrial,149,81,79,101,230,53.02013422818792,67.78523489932886
22889_terrestrial,89,37,48,55,126,53.93258426966292,61.79775280898876
22892_terrestrial,240,86,147,158,326,61.25000000000001,65.83333333333333
22893_terrestrial,262,95,164,169,357,62.59541984732825,64.50381679389314
22910_terrestrial,421,181,294,197,602,69.83372921615202,46.79334916864608
22911_terrestrial,429,205,306,196,634,71.32867132867133,45.68764568764569
22914_terrestrial,423,206,311,180,629,73.5224586288416,42.5531914893617
22915_terrestrial,437,218,322,189,655,73.68421052631578,43.24942791762014
22916_terrestrial,444,226,335,188,670,75.45045045045045,42.34234234234234
22917_terrestrial,592,340,444,262,932,75,44.25675675675676
22918_terrestrial,536,275,403,223,811,75.18656716417911,41.6044776119403
22919_terrestrial,186,110,114,120,296,61.29032258064516,64.51612903225806
22920_terrestrial,189,111,116,122,300,61.37566137566137,64.55026455026454
22921_terrestrial,194,105,115,127,299,59.27835051546392,65.4639175257732
22922_terrestrial,205,106,122,132,311,59.512195121951216,64.39024390243902
22923_terrestrial,193,104,115,123,297,59.58549222797927,63.730569948186535
22924_terrestrial,187,103,113,121,290,60.42780748663101,64.70588235294117
22925_terrestrial,190,104,118,127,294,62.10526315789474,66.84210526315789
22926_terrestrial,231,103,147,163,334,63.63636363636363,70.56277056277057
22927_terrestrial,315,113,214,225,428,67.93650793650794,71.42857142857143
22928_terrestrial,339,133,235,251,472,69.32153392330383,74.04129793510324
22929_terrestrial,316,115,217,235,431,68.67088607594937,74.36708860759494
22930_terrestrial,301,101,206,217,402,68.43853820598007,72.09302325581395
22931_terrestrial,249,96,173,179,345,69.47791164658635,71.8875502008032
22932_terrestrial,259,96,176,182,355,67.95366795366795,70.27027027027027
22933_terrestrial,288,113,196,209,401,68.05555555555556,72.56944444444444
22934_terrestrial,327,123,227,242,450,69.41896024464832,74.00611620795107
22935_terrestrial,343,122,244,253,465,71.13702623906705,73.76093294460642
22936_terrestrial,353,131,251,261,484,71.10481586402267,73.93767705382436
22937_terrestrial,388,150,268,282,538,69.0721649484536,72.68041237113401
22938_terrestrial,396,150,275,286,546,69.44444444444444,72.22222222222221
22939_terrestrial,410,144,288,300,554,70.24390243902438,73.17073170731707
22940_terrestrial,416,131,287,305,547,68.99038461538461,73.3173076923077
22941_terrestrial,409,131,284,303,540,69.43765281173594,74.08312958435208
22942_terrestrial,418,131,289,314,549,69.13875598086125,75.11961722488039
22943_terrestrial,429,139,299,326,568,69.6969696969697,75.990675990676
22944_terrestrial,449,152,308,344,601,68.59688195991092,76.61469933184856
22945_terrestrial,533,200,361,400,733,67.7298311444653,75.046904315197
22946_terrestrial,575,234,386,432,809,67.13043478260869,75.13043478260869
22947_terrestrial,753,317,476,575,1070,63.213811420982736,76.36122177954847
22948_terrestrial,818,378,514,620,1196,62.8361858190709,75.79462102689487
22949_terrestrial,847,439,540,635,1286,63.75442739079102,74.97048406139315
22950_terrestrial,816,387,520,628,1203,63.725490196078425,76.9607843137255
22951_terrestrial,817,379,525,629,1196,64.2594859241126,76.9889840881273
22952_terrestrial,823,392,534,622,1215,64.88456865127581,75.5771567436209
22953_terrestrial,812,372,526,622,1184,64.77832512315271,76.60098522167488
22954_terrestrial,757,331,506,565,1088,66.84280052840158,74.63672391017172
22955_terrestrial,770,357,505,576,1127,65.5844155844156,74.8051948051948
22956_terrestrial,776,373,519,560,1149,66.88144329896907,72.16494845360825
22957_terrestrial,686,327,460,501,1013,67.05539358600583,73.03206997084548
22958_terrestrial,712,389,472,520,1101,66.29213483146067,73.03370786516854
22959_terrestrial,760,456,503,547,1216,66.1842105263158,71.97368421052632
22960_terrestrial,605,375,397,438,980,65.6198347107438,72.39669421487604
22961_terrestrial,516,343,324,380,859,62.7906976744186,73.64341085271317
22962_terrestrial,478,316,310,356,794,64.85355648535564,74.47698744769873
22963_terrestrial,461,300,311,338,761,67.46203904555314,73.31887201735357
22964_terrestrial,468,271,319,335,739,68.16239316239316,71.58119658119658
22965_terrestrial,474,256,326,340,730,68.77637130801688,71.72995780590718
22966_terrestrial,469,245,329,325,714,70.1492537313433,69.29637526652452
22967_terrestrial,477,239,344,320,716,72.11740041928721,67.08595387840671
22968_terrestrial,481,265,352,325,746,73.18087318087319,67.56756756756756
22969_terrestrial,474,246,352,313,720,74.26160337552743,66.03375527426161
22970_terrestrial,466,224,348,306,690,74.67811158798283,65.66523605150213
22971_terrestrial,463,210,347,300,673,74.94600431965442,64.79481641468684
22972_terrestrial,450,213,338,294,663,75.1111111111111,65.33333333333333
22973_terrestrial,413,198,309,290,611,74.818401937046,70.2179176755448
22974_terrestrial,427,201,323,299,628,75.64402810304449,70.02341920374707
22975_terrestrial,431,211,325,307,642,75.4060324825986,71.22969837587007
22976_terrestrial,428,204,326,309,632,76.16822429906543,72.19626168224299
22977_terrestrial,463,226,347,333,689,74.94600431965442,71.92224622030238
22978_terrestrial,484,234,360,348,718,74.3801652892562,71.900826446281
22979_terrestrial,535,241,401,366,776,74.95327102803738,68.41121495327103
22980_terrestrial,958,418,755,470,1376,78.81002087682673,49.06054279749478
22981_terrestrial,835,348,672,403,1183,80.47904191616766,48.26347305389221
22988_terrestrial,1114,484,701,666,1598,62.92639138240575,59.78456014362658
22989_terrestrial,1110,492,699,666,1602,62.972972972972975,60
23109_terrestrial,513,458,322,238,971,62.768031189083814,46.393762183235864
23111_terrestrial,475,418,306,227,893,64.42105263157895,47.78947368421053
23112_terrestrial,543,512,321,286,1055,59.11602209944752,52.67034990791897
23113_terrestrial,567,585,294,330,1152,51.85185185185185,58.201058201058196
23114_terrestrial,323,422,79,271,745,24.458204334365323,83.90092879256966
23115_terrestrial,271,380,67,230,651,24.723247232472325,84.87084870848709
23116_terrestrial,244,318,70,200,562,28.688524590163933,81.9672131147541
23117_terrestrial,223,283,68,180,506,30.493273542600896,80.71748878923766
23118_terrestrial,227,281,70,181,508,30.837004405286343,79.73568281938326
23119_terrestrial,249,326,78,200,575,31.32530120481928,80.32128514056225
23120_terrestrial,307,424,90,253,731,29.31596091205212,82.41042345276874
23121_terrestrial,330,364,90,268,694,27.27272727272727,81.21212121212122
23122_terrestrial,326,290,101,266,616,30.981595092024538,81.59509202453987
23123_terrestrial,605,437,320,363,1042,52.892561983471076,60
23139_terrestrial,670,434,381,370,1104,56.865671641791046,55.223880597014926
23140_terrestrial,694,463,395,383,1157,56.9164265129683,55.18731988472623
23142_terrestrial,464,297,281,262,761,60.560344827586206,56.46551724137932
23143_terrestrial,479,344,286,275,823,59.707724425887264,57.41127348643006
23144_terrestrial,452,294,273,253,746,60.39823008849557,55.97345132743363
23231_terrestrial,79,47,37,39,126,46.835443037974684,49.36708860759494
23249_terrestrial,101,39,58,67,140,57.42574257425742,66.33663366336634
23250_terrestrial,112,44,65,74,156,58.03571428571429,66.07142857142857
23252_terrestrial,218,73,131,140,291,60.09174311926605,64.22018348623854
23253_terrestrial,248,84,153,157,332,61.693548387096776,63.306451612903224
23254_terrestrial,266,94,167,161,360,62.78195488721805,60.526315789473685
23270_terrestrial,166,77,95,120,243,57.22891566265061,72.28915662650603
23271_terrestrial,442,220,316,200,662,71.49321266968326,45.248868778280546
23278_terrestrial,536,273,408,218,809,76.11940298507463,40.67164179104478
23279_terrestrial,524,262,400,208,786,76.33587786259542,39.69465648854962
23280_terrestrial,502,261,385,187,763,76.69322709163346,37.25099601593625
23281_terrestrial,509,256,387,192,765,76.03143418467585,37.721021611001966
23282_terrestrial,545,275,413,205,820,75.77981651376146,37.61467889908257
23283_terrestrial,518,267,400,185,785,77.22007722007721,35.714285714285715
23284_terrestrial,523,289,411,188,812,78.58508604206502,35.94646271510516
23285_terrestrial,530,278,413,195,808,77.9245283018868,36.79245283018868
23286_terrestrial,558,269,437,222,827,78.31541218637993,39.784946236559136
23287_terrestrial,657,306,506,300,963,77.01674277016743,45.662100456621005
23288_terrestrial,374,130,265,264,504,70.85561497326202,70.58823529411765
23289_terrestrial,340,115,236,249,455,69.41176470588235,73.23529411764706
23290_terrestrial,309,98,214,227,407,69.25566343042071,73.46278317152104
23291_terrestrial,287,109,198,213,396,68.98954703832753,74.21602787456446
23292_terrestrial,296,115,205,219,411,69.25675675675676,73.98648648648648
23293_terrestrial,330,133,230,247,463,69.6969696969697,74.84848484848486
23294_terrestrial,363,127,255,269,490,70.24793388429752,74.10468319559229
23295_terrestrial,366,127,261,271,493,71.31147540983606,74.04371584699454
23296_terrestrial,368,129,261,275,497,70.92391304347827,74.72826086956522
23297_terrestrial,372,141,262,270,513,70.43010752688173,72.58064516129032
23298_terrestrial,374,137,261,275,511,69.78609625668449,73.52941176470588
23299_terrestrial,383,129,265,283,512,69.19060052219321,73.89033942558747
23300_terrestrial,384,124,264,281,508,68.75,73.17708333333334
23301_terrestrial,397,123,270,293,520,68.01007556675063,73.80352644836272
23302_terrestrial,404,121,276,296,525,68.31683168316832,73.26732673267327
23303_terrestrial,407,122,283,295,529,69.53316953316954,72.48157248157248
23304_terrestrial,416,132,284,308,548,68.26923076923077,74.03846153846155
23305_terrestrial,422,141,293,309,563,69.43127962085308,73.22274881516587
23306_terrestrial,454,149,324,333,603,71.36563876651982,73.34801762114537
23307_terrestrial,461,150,325,343,611,70.49891540130152,74.40347071583514
23308_terrestrial,468,158,330,352,626,70.51282051282051,75.21367521367522
23309_terrestrial,449,155,312,340,604,69.48775055679288,75.7238307349666
23310_terrestrial,572,250,392,412,822,68.53146853146853,72.02797202797203
23311_terrestrial,687,324,465,509,1011,67.68558951965066,74.09024745269286
23312_terrestrial,758,371,502,554,1129,66.2269129287599,73.08707124010554
23313_terrestrial,742,351,487,553,1093,65.63342318059298,74.52830188679245
23314_terrestrial,758,356,509,554,1114,67.15039577836411,73.08707124010554
23315_terrestrial,791,400,540,552,1191,68.26801517067004,69.78508217446272
23316_terrestrial,708,327,482,511,1035,68.07909604519774,72.17514124293785
23317_terrestrial,666,296,453,495,962,68.01801801801803,74.32432432432432
23318_terrestrial,799,453,530,572,1252,66.33291614518147,71.58948685857321
23319_terrestrial,786,482,527,556,1268,67.04834605597965,70.73791348600508
23320_terrestrial,660,386,430,488,1046,65.15151515151516,73.93939393939394
23321_terrestrial,581,361,376,428,942,64.71600688468159,73.66609294320138
23322_terrestrial,525,313,343,395,838,65.33333333333333,75.23809523809524
23323_terrestrial,530,291,360,382,821,67.9245283018868,72.0754716981132
23324_terrestrial,513,265,354,369,778,69.00584795321637,71.9298245614035
23325_terrestrial,503,254,355,356,757,70.57654075546719,70.77534791252485
23326_terrestrial,504,251,358,355,755,71.03174603174604,70.43650793650794
23327_terrestrial,508,242,365,353,750,71.8503937007874,69.48818897637796
23328_terrestrial,527,259,384,355,786,72.86527514231499,67.36242884250474
23329_terrestrial,496,265,366,334,761,73.79032258064517,67.33870967741935
23330_terrestrial,503,260,374,328,763,74.35387673956262,65.20874751491054
23331_terrestrial,507,247,377,330,754,74.35897435897436,65.08875739644971
23332_terrestrial,485,232,361,320,717,74.43298969072166,65.97938144329896
23333_terrestrial,463,241,346,318,704,74.73002159827213,68.68250539956804
23334_terrestrial,474,232,356,335,706,75.10548523206751,70.67510548523207
23335_terrestrial,466,217,350,332,683,75.10729613733905,71.24463519313305
23336_terrestrial,470,201,358,331,671,76.17021276595744,70.42553191489361
23337_terrestrial,485,216,361,345,701,74.43298969072166,71.1340206185567
23338_terrestrial,509,220,375,366,729,73.6738703339882,71.90569744597249
23339_terrestrial,1074,433,841,545,1507,78.30540037243948,50.74487895716946
23340_terrestrial,1076,435,850,525,1511,78.99628252788105,48.79182156133829
23342_terrestrial,1398,561,1003,741,1959,71.7453505007153,53.00429184549357
23472_terrestrial,470,418,294,232,888,62.5531914893617,49.361702127659576
23473_terrestrial,555,538,321,292,1093,57.83783783783784,52.61261261261261
23474_terrestrial,378,467,108,317,845,28.57142857142857,83.86243386243386
23475_terrestrial,330,447,82,278,777,24.848484848484848,84.24242424242424
23476_terrestrial,259,376,66,218,635,25.482625482625483,84.16988416988417
23477_terrestrial,230,302,66,191,532,28.695652173913043,83.04347826086956
23478_terrestrial,211,268,61,173,479,28.90995260663507,81.99052132701422
23479_terrestrial,227,289,72,184,516,31.718061674008812,81.05726872246696
23480_terrestrial,291,404,87,238,695,29.896907216494846,81.78694158075601
23481_terrestrial,350,430,92,292,780,26.285714285714285,83.42857142857143
23482_terrestrial,337,312,101,280,649,29.970326409495552,83.08605341246292
23483_terrestrial,578,381,307,339,959,53.11418685121107,58.65051903114187
23500_terrestrial,635,414,372,336,1049,58.58267716535433,52.91338582677165
23502_terrestrial,468,294,285,264,762,60.89743589743589,56.41025641025641
23503_terrestrial,480,317,289,275,797,60.20833333333333,57.291666666666664
23504_terrestrial,451,303,272,253,754,60.310421286031044,56.09756097560976
23505_terrestrial,448,293,270,252,741,60.26785714285714,56.25
23506_terrestrial,435,281,266,243,716,61.149425287356316,55.86206896551724
23591_terrestrial,78,54,36,41,132,46.15384615384615,52.56410256410257
23610_terrestrial,83,35,45,51,118,54.21686746987952,61.44578313253012
23611_terrestrial,117,43,64,81,160,54.700854700854705,69.23076923076923
23613_terrestrial,251,79,155,158,330,61.75298804780876,62.94820717131474
23614_terrestrial,252,85,154,158,337,61.111111111111114,62.698412698412696
23628_terrestrial,107,71,53,75,178,49.532710280373834,70.09345794392523
23647_terrestrial,622,291,486,264,913,78.13504823151125,42.443729903536976
23648_terrestrial,689,315,536,322,1004,77.79390420899854,46.73439767779391
23649_terrestrial,394,129,278,273,523,70.55837563451777,69.28934010152284
23650_terrestrial,360,120,251,266,480,69.72222222222221,73.88888888888889
23651_terrestrial,346,123,238,262,469,68.78612716763006,75.72254335260115
23652_terrestrial,358,131,245,270,489,68.43575418994413,75.41899441340783
23653_terrestrial,381,145,262,286,526,68.76640419947506,75.06561679790026
23654_terrestrial,387,140,270,288,527,69.76744186046511,74.4186046511628
23655_terrestrial,372,132,264,278,504,70.96774193548387,74.73118279569893
23656_terrestrial,375,130,269,280,505,71.73333333333333,74.66666666666667
23657_terrestrial,370,125,260,275,495,70.27027027027027,74.32432432432432
23658_terrestrial,379,132,262,281,511,69.12928759894459,74.14248021108179
23659_terrestrial,386,131,263,288,517,68.13471502590673,74.61139896373057
23660_terrestrial,385,129,257,288,514,66.75324675324676,74.8051948051948
23661_terrestrial,396,131,267,300,527,67.42424242424242,75.75757575757575
23662_terrestrial,413,129,275,312,542,66.58595641646488,75.54479418886199
23663_terrestrial,422,129,288,316,551,68.24644549763033,74.88151658767772
23664_terrestrial,431,132,297,322,563,68.90951276102089,74.70997679814386
23665_terrestrial,435,147,295,329,582,67.81609195402298,75.63218390804597
23666_terrestrial,440,137,298,334,577,67.72727272727272,75.9090909090909
23667_terrestrial,427,138,297,324,565,69.55503512880561,75.87822014051523
23668_terrestrial,423,148,289,323,571,68.32151300236407,76.35933806146572
23669_terrestrial,439,152,308,324,591,70.15945330296127,73.80410022779044
23670_terrestrial,679,257,493,389,936,72.60677466863034,57.2901325478645
23671_terrestrial,488,172,341,363,660,69.87704918032787,74.38524590163934
23672_terrestrial,580,209,400,423,789,68.96551724137932,72.93103448275862
23673_terrestrial,701,295,475,516,996,67.76034236804564,73.60912981455064
23674_terrestrial,747,371,510,539,1118,68.27309236947792,72.15528781793842
23675_terrestrial,741,348,506,534,1089,68.28609986504723,72.06477732793523
23676_terrestrial,590,244,415,435,834,70.33898305084746,73.72881355932203
23677_terrestrial,623,269,443,451,892,71.107544141252,72.3916532905297
23678_terrestrial,798,460,536,558,1258,67.16791979949875,69.92481203007519
23679_terrestrial,752,447,504,526,1199,67.02127659574468,69.9468085106383
23680_terrestrial,672,395,444,500,1067,66.07142857142857,74.40476190476191
23681_terrestrial,636,378,418,472,1014,65.72327044025157,74.21383647798741
23682_terrestrial,599,356,400,448,955,66.7779632721202,74.79131886477462
23683_terrestrial,587,304,403,416,891,68.6541737649063,70.86882453151618
23684_terrestrial,539,288,381,383,827,70.68645640074212,71.05751391465677
23685_terrestrial,536,268,380,379,804,70.8955223880597,70.7089552238806
23686_terrestrial,535,262,381,378,797,71.21495327102804,70.65420560747664
23687_terrestrial,537,255,388,368,792,72.25325884543761,68.52886405959032
23688_terrestrial,517,238,377,355,755,72.92069632495163,68.66537717601547
23689_terrestrial,522,232,388,349,754,74.32950191570882,66.85823754789271
23690_terrestrial,535,249,399,360,784,74.57943925233644,67.28971962616822
23691_terrestrial,542,273,402,364,815,74.16974169741697,67.15867158671587
23692_terrestrial,529,250,390,368,779,73.72400756143668,69.56521739130434
23693_terrestrial,517,244,385,359,761,74.46808510638297,69.43907156673113
23694_terrestrial,505,232,377,358,737,74.65346534653466,70.89108910891089
23695_terrestrial,503,226,376,357,729,74.75149105367794,70.9741550695825
23696_terrestrial,501,210,375,360,711,74.8502994011976,71.8562874251497
23697_terrestrial,520,212,388,374,732,74.61538461538461,71.92307692307692
23698_terrestrial,1078,445,834,563,1523,77.36549165120594,52.22634508348795
23699_terrestrial,1094,435,850,557,1529,77.6965265082267,50.914076782449726
23701_terrestrial,1397,599,1004,743,1996,71.86828919112384,53.18539727988547
23702_terrestrial,1506,696,1053,809,2202,69.9203187250996,53.71845949535192
23704_terrestrial,1045,434,669,621,1479,64.01913875598086,59.42583732057416
23705_terrestrial,1036,422,664,618,1458,64.0926640926641,59.65250965250966
23706_terrestrial,1029,401,659,616,1430,64.0427599611273,59.863945578231295
23830_terrestrial,501,439,326,232,940,65.06986027944112,46.30738522954092
23831_terrestrial,541,483,348,250,1024,64.32532347504622,46.21072088724584
23833_terrestrial,462,396,281,231,858,60.82251082251082,50
23834_terrestrial,652,676,355,356,1328,54.44785276073619,54.601226993865026
23835_terrestrial,399,549,111,331,948,27.819548872180448,82.95739348370927
23836_terrestrial,293,441,75,245,734,25.597269624573375,83.61774744027304
23837_terrestrial,250,326,70,207,576,28.000000000000004,82.8
23838_terrestrial,218,265,63,178,483,28.899082568807337,81.65137614678899
23839_terrestrial,211,265,65,170,476,30.80568720379147,80.56872037914692
23840_terrestrial,260,339,80,212,599,30.76923076923077,81.53846153846153
23841_terrestrial,392,522,103,330,914,26.27551020408163,84.18367346938776
23842_terrestrial,368,380,109,302,748,29.6195652173913,82.06521739130434
23843_terrestrial,541,398,277,328,939,51.20147874306839,60.62846580406654
23857_terrestrial,185,154,75,154,339,40.54054054054054,83.24324324324324
23858_terrestrial,543,348,341,289,891,62.79926335174954,53.22283609576427
23859_terrestrial,545,370,344,287,915,63.11926605504588,52.66055045871559
23860_terrestrial,530,335,334,278,865,63.0188679245283,52.45283018867924
23863_terrestrial,463,278,280,263,741,60.475161987041034,56.803455723542115
23864_terrestrial,448,270,273,251,718,60.9375,56.02678571428571
23865_terrestrial,455,289,277,255,744,60.879120879120876,56.043956043956044
23866_terrestrial,456,297,278,257,753,60.96491228070175,56.35964912280702
23972_terrestrial,167,56,102,102,223,61.07784431137725,61.07784431137725
23973_terrestrial,245,73,157,147,318,64.08163265306122,60
23974_terrestrial,241,84,155,142,325,64.31535269709543,58.921161825726145
24008_terrestrial,632,279,493,284,911,78.00632911392405,44.936708860759495
24009_terrestrial,708,311,544,335,1019,76.8361581920904,47.31638418079096
24010_terrestrial,396,128,281,276,524,70.95959595959596,69.6969696969697
24011_terrestrial,704,293,533,356,997,75.71022727272727,50.56818181818182
24012_terrestrial,392,140,272,289,532,69.38775510204081,73.72448979591837
24013_terrestrial,424,158,293,316,582,69.10377358490565,74.52830188679245
24014_terrestrial,418,166,287,308,584,68.6602870813397,73.68421052631578
24015_terrestrial,393,145,272,296,538,69.21119592875317,75.31806615776081
24016_terrestrial,389,134,277,294,523,71.2082262210797,75.57840616966581
24017_terrestrial,391,139,266,295,530,68.03069053708441,75.44757033248082
24018_terrestrial,400,143,269,300,543,67.25,75
24019_terrestrial,405,146,267,304,551,65.92592592592592,75.06172839506173
24020_terrestrial,413,138,269,310,551,65.13317191283294,75.06053268765133
24021_terrestrial,413,141,271,312,554,65.61743341404357,75.54479418886199
24022_terrestrial,405,128,268,310,533,66.17283950617285,76.5432098765432
24023_terrestrial,413,127,278,317,540,67.31234866828088,76.75544794188862
24024_terrestrial,418,128,277,313,546,66.26794258373205,74.88038277511961
24025_terrestrial,427,145,280,324,572,65.57377049180327,75.87822014051523
24026_terrestrial,440,143,289,337,583,65.68181818181819,76.5909090909091
24027_terrestrial,442,151,296,336,593,66.9683257918552,76.01809954751131
24028_terrestrial,457,151,307,340,608,67.17724288840262,74.39824945295405
24029_terrestrial,463,167,317,332,630,68.46652267818575,71.70626349892008
24030_terrestrial,715,270,514,390,985,71.88811188811188,54.54545454545454
24031_terrestrial,764,293,557,413,1057,72.90575916230367,54.05759162303665
24032_terrestrial,552,204,392,387,756,71.01449275362319,70.1086956521739
24033_terrestrial,655,271,449,484,926,68.54961832061068,73.89312977099237
24034_terrestrial,688,317,465,508,1005,67.58720930232558,73.83720930232558
24035_terrestrial,729,316,499,523,1045,68.44993141289437,71.74211248285323
24036_terrestrial,575,248,402,420,823,69.91304347826087,73.04347826086956
24037_terrestrial,701,321,485,514,1022,69.18687589158345,73.32382310984308
24038_terrestrial,742,404,497,538,1146,66.98113207547169,72.50673854447439
24039_terrestrial,718,406,477,523,1124,66.43454038997214,72.84122562674095
24040_terrestrial,710,412,478,506,1122,67.32394366197182,71.26760563380282
24041_terrestrial,665,369,443,487,1034,66.61654135338347,73.23308270676692
24042_terrestrial,661,375,444,475,1036,67.17095310136158,71.86081694402421
24043_terrestrial,653,358,444,467,1011,67.99387442572741,71.51607963246555
24044_terrestrial,653,367,455,464,1020,69.67840735068913,71.05666156202145
24045_terrestrial,671,370,463,466,1041,69.00149031296571,69.44858420268257
24046_terrestrial,670,345,465,470,1015,69.40298507462687,70.1492537313433
24047_terrestrial,627,294,442,434,921,70.49441786283892,69.21850079744817
24048_terrestrial,571,244,416,392,815,72.85464098073555,68.65148861646234
24049_terrestrial,552,232,406,372,784,73.55072463768117,67.3913043478261
24050_terrestrial,547,244,404,372,791,73.85740402193784,68.00731261425959
24051_terrestrial,550,254,404,378,804,73.45454545454545,68.72727272727272
24052_terrestrial,535,235,390,382,770,72.89719626168224,71.40186915887851
24053_terrestrial,555,224,410,395,779,73.87387387387388,71.17117117117117
24054_terrestrial,1074,443,814,597,1517,75.79143389199255,55.58659217877096
24055_terrestrial,551,221,411,388,772,74.59165154264973,70.41742286751361
24056_terrestrial,508,192,379,364,700,74.60629921259843,71.65354330708661
24057_terrestrial,1019,416,788,542,1435,77.3307163886163,53.189401373895976
24058_terrestrial,1009,415,783,531,1424,77.60158572844401,52.62636273538157
24061_terrestrial,1437,653,1019,774,2090,70.91162143354211,53.86221294363257
24062_terrestrial,1416,654,969,795,2070,68.4322033898305,56.144067796610166
24140_terrestrial,404,161,284,223,565,70.29702970297029,55.1980198019802
24141_terrestrial,432,185,300,251,617,69.44444444444444,58.10185185185185
24190_terrestrial,502,402,316,244,904,62.94820717131474,48.60557768924303
24191_terrestrial,510,454,324,244,964,63.52941176470588,47.84313725490196
24194_terrestrial,279,334,98,214,613,35.12544802867383,76.70250896057348
24195_terrestrial,677,750,359,387,1427,53.028064992614475,57.163958641063516
24197_terrestrial,272,400,72,225,672,26.47058823529412,82.72058823529412
24198_terrestrial,247,332,73,202,579,29.554655870445345,81.78137651821862
24199_terrestrial,228,286,71,185,514,31.140350877192986,81.14035087719299
24200_terrestrial,249,342,73,204,591,29.31726907630522,81.92771084337349
24201_terrestrial,399,521,113,328,920,28.32080200501253,82.20551378446115
24202_terrestrial,392,427,111,325,819,28.316326530612244,82.90816326530613
24203_terrestrial,586,418,302,352,1004,51.5358361774744,60.068259385665534
24216_terrestrial,542,374,336,292,916,61.99261992619927,53.874538745387454
24217_terrestrial,544,384,339,292,928,62.31617647058824,53.67647058823529
24218_terrestrial,529,344,326,287,873,61.62570888468809,54.25330812854442
24219_terrestrial,534,355,326,292,889,61.04868913857678,54.68164794007491
24220_terrestrial,549,383,342,294,932,62.295081967213115,53.551912568306015
24221_terrestrial,542,363,337,291,905,62.17712177121771,53.69003690036901
24222_terrestrial,534,355,332,286,889,62.172284644194754,53.558052434456926
24223_terrestrial,521,309,329,275,830,63.14779270633397,52.783109404990405
24226_terrestrial,450,293,272,253,743,60.44444444444444,56.222222222222214
24227_terrestrial,433,272,265,243,705,61.20092378752887,56.12009237875289
24332_terrestrial,222,60,148,129,282,66.66666666666666,58.108108108108105
24333_terrestrial,219,65,144,127,284,65.75342465753424,57.99086757990868
24334_terrestrial,215,69,135,118,284,62.7906976744186,54.88372093023256
24369_terrestrial,345,117,250,229,462,72.46376811594203,66.3768115942029
24370_terrestrial,696,292,535,337,988,76.86781609195403,48.41954022988506
24371_terrestrial,717,301,542,352,1018,75.59274755927476,49.09344490934449
24372_terrestrial,405,142,277,293,547,68.39506172839506,72.34567901234567
24373_terrestrial,805,330,599,414,1135,74.40993788819877,51.42857142857142
24374_terrestrial,468,179,316,343,647,67.52136752136752,73.29059829059828
24375_terrestrial,427,157,283,323,584,66.27634660421545,75.64402810304449
24376_terrestrial,413,146,276,307,559,66.82808716707022,74.33414043583535
24377_terrestrial,417,147,278,311,564,66.66666666666666,74.58033573141488
24378_terrestrial,418,146,278,311,564,66.50717703349282,74.4019138755981
24379_terrestrial,428,150,284,321,578,66.35514018691589,75
24380_terrestrial,437,143,289,329,580,66.13272311212815,75.28604118993135
24381_terrestrial,423,141,278,323,564,65.72104018912529,76.35933806146572
24382_terrestrial,416,135,276,311,551,66.34615384615384,74.75961538461539
24383_terrestrial,407,133,270,307,540,66.33906633906635,75.42997542997543
24384_terrestrial,431,142,284,322,573,65.89327146171694,74.70997679814386
24385_terrestrial,437,148,283,332,585,64.75972540045767,75.97254004576659
24386_terrestrial,450,161,297,340,611,66,75.55555555555556
24387_terrestrial,507,171,347,371,678,68.44181459566076,73.17554240631164
24388_terrestrial,528,181,367,372,709,69.50757575757575,70.45454545454545
24389_terrestrial,844,365,621,422,1209,73.5781990521327,50
24390_terrestrial,756,317,556,385,1073,73.54497354497354,50.92592592592593
24391_terrestrial,738,309,552,368,1047,74.79674796747967,49.86449864498645
24392_terrestrial,806,348,600,417,1154,74.44168734491315,51.736972704714645
24393_terrestrial,952,414,666,556,1366,69.9579831932773,58.40336134453782
24394_terrestrial,681,291,460,502,972,67.54772393538914,73.7151248164464
24395_terrestrial,653,276,448,475,929,68.60643185298622,72.74119448698315
24396_terrestrial,562,234,395,407,796,70.2846975088968,72.41992882562278
24397_terrestrial,692,334,476,511,1026,68.78612716763006,73.84393063583815
24398_terrestrial,668,325,448,504,993,67.06586826347305,75.44910179640718
24399_terrestrial,663,318,439,502,981,66.21417797888385,75.71644042232278
24400_terrestrial,720,385,479,517,1105,66.52777777777777,71.80555555555556
24401_terrestrial,719,374,478,512,1093,66.48122392211405,71.21001390820584
24402_terrestrial,766,441,522,528,1207,68.1462140992167,68.9295039164491
24403_terrestrial,776,467,531,536,1243,68.4278350515464,69.0721649484536
24404_terrestrial,759,530,511,525,1289,67.3254281949934,69.1699604743083
24405_terrestrial,746,511,507,515,1257,67.96246648793566,69.0348525469169
24406_terrestrial,691,397,466,483,1088,67.43849493487699,69.8986975397974
24407_terrestrial,680,366,466,475,1046,68.52941176470588,69.85294117647058
24408_terrestrial,606,282,436,417,888,71.94719471947195,68.8118811881188
24409_terrestrial,577,255,417,394,832,72.27036395147314,68.2842287694974
24410_terrestrial,543,211,399,380,754,73.48066298342542,69.9815837937385
24411_terrestrial,528,217,386,379,745,73.10606060606061,71.78030303030303
24412_terrestrial,526,202,385,373,728,73.19391634980988,70.91254752851711
24413_terrestrial,1012,412,761,569,1424,75.19762845849802,56.22529644268774
24414_terrestrial,1086,488,832,576,1574,76.61141804788214,53.03867403314917
24415_terrestrial,1068,475,826,572,1543,77.34082397003745,53.558052434456926
24416_terrestrial,1000,423,770,540,1423,77,54
24417_terrestrial,960,400,745,496,1360,77.60416666666666,51.66666666666667
24421_terrestrial,1487,678,1035,813,2165,69.60322797579018,54.67383994620041
24422_terrestrial,1398,632,951,792,2030,68.02575107296137,56.65236051502146
24500_terrestrial,406,169,285,224,575,70.19704433497537,55.172413793103445
24501_terrestrial,430,177,298,251,607,69.30232558139535,58.372093023255815
24502_terrestrial,479,200,320,291,679,66.80584551148226,60.75156576200418
24503_terrestrial,490,206,328,298,696,66.93877551020408,60.816326530612244
24504_terrestrial,444,180,305,258,624,68.69369369369369,58.108108108108105
24555_terrestrial,640,709,356,350,1349,55.625,54.6875
24556_terrestrial,388,553,110,321,941,28.350515463917525,82.73195876288659
24557_terrestrial,287,453,75,240,740,26.132404181184672,83.62369337979094
24558_terrestrial,265,390,70,221,655,26.41509433962264,83.39622641509435
24559_terrestrial,244,325,69,200,569,28.278688524590162,81.9672131147541
24560_terrestrial,250,348,71,211,598,28.4,84.39999999999999
24561_terrestrial,390,555,112,320,945,28.717948717948715,82.05128205128204
24562_terrestrial,429,561,125,364,990,29.13752913752914,84.84848484848484
24563_terrestrial,642,501,342,382,1143,53.271028037383175,59.50155763239875
24570_terrestrial,620,419,353,329,1039,56.935483870967744,53.064516129032256
24571_terrestrial,633,415,360,344,1048,56.872037914691944,54.34439178515008
24572_terrestrial,638,444,358,356,1082,56.112852664576806,55.79937304075236
24573_terrestrial,688,498,382,389,1186,55.52325581395349,56.5406976744186
24574_terrestrial,687,507,389,384,1194,56.62299854439592,55.895196506550214
24576_terrestrial,541,365,337,290,906,62.292051756007396,53.60443622920518
24577_terrestrial,528,354,328,284,882,62.121212121212125,53.78787878787878
24578_terrestrial,507,291,314,272,798,61.93293885601578,53.64891518737672
24580_terrestrial,522,337,323,282,859,61.877394636015325,54.02298850574713
24581_terrestrial,519,337,318,284,856,61.27167630057804,54.72061657032755
24582_terrestrial,539,339,336,288,878,62.33766233766234,53.432282003710576
24583_terrestrial,536,348,331,286,884,61.75373134328358,53.35820895522389
24584_terrestrial,519,309,323,276,828,62.23506743737958,53.179190751445084
24585_terrestrial,516,295,323,273,811,62.5968992248062,52.90697674418605
24587_terrestrial,437,254,267,244,691,61.098398169336384,55.83524027459954
24588_terrestrial,437,254,264,247,691,60.41189931350115,56.52173913043478
24589_terrestrial,424,232,258,237,656,60.84905660377359,55.89622641509434
24647_terrestrial,89,58,45,54,147,50.56179775280899,60.67415730337079
24672_terrestrial,63,37,26,33,100,41.269841269841265,52.38095238095239
24673_terrestrial,53,28,24,29,81,45.28301886792453,54.71698113207547
24691_terrestrial,191,60,121,111,251,63.35078534031413,58.1151832460733
24692_terrestrial,212,60,137,119,272,64.62264150943396,56.132075471698116
24730_terrestrial,681,278,516,325,959,75.77092511013215,47.72393538913363
24731_terrestrial,695,280,515,348,975,74.10071942446042,50.07194244604316
24732_terrestrial,720,294,540,354,1014,75,49.166666666666664
24733_terrestrial,796,333,589,408,1129,73.99497487437185,51.256281407035175
24734_terrestrial,789,342,580,417,1131,73.51077313054499,52.851711026615966
24735_terrestrial,430,183,284,320,613,66.04651162790698,74.4186046511628
24736_terrestrial,422,158,281,314,580,66.58767772511848,74.40758293838863
24737_terrestrial,409,161,279,301,570,68.21515892420538,73.59413202933986
24738_terrestrial,400,158,269,293,558,67.25,73.25
24739_terrestrial,404,159,270,296,563,66.83168316831683,73.26732673267327
24740_terrestrial,416,157,277,308,573,66.58653846153845,74.03846153846155
24741_terrestrial,416,153,279,311,569,67.0673076923077,74.75961538461539
24742_terrestrial,418,140,278,308,558,66.50717703349282,73.68421052631578
24743_terrestrial,407,142,270,303,549,66.33906633906635,74.44717444717445
24744_terrestrial,425,149,276,319,574,64.94117647058823,75.05882352941177
24745_terrestrial,458,155,300,343,613,65.50218340611353,74.89082969432314
24746_terrestrial,473,170,317,352,643,67.01902748414376,74.4186046511628
24747_terrestrial,839,357,599,455,1196,71.39451728247914,54.23122765196663
24748_terrestrial,811,346,587,427,1157,72.37977805178791,52.651048088779284
24749_terrestrial,765,327,573,376,1092,74.90196078431373,49.15032679738562
24750_terrestrial,717,313,538,356,1030,75.03486750348675,49.651324965132495
24751_terrestrial,647,273,489,313,920,75.57959814528593,48.37712519319938
24752_terrestrial,687,286,515,348,973,74.96360989810772,50.65502183406113
24753_terrestrial,948,419,671,538,1367,70.78059071729957,56.75105485232067
24754_terrestrial,690,289,463,505,979,67.10144927536233,73.18840579710145
24755_terrestrial,664,301,444,499,965,66.86746987951807,75.15060240963855
24756_terrestrial,522,230,365,383,752,69.92337164750958,73.37164750957854
24757_terrestrial,687,348,469,506,1035,68.26783114992722,73.65356622998544
24758_terrestrial,653,328,440,488,981,67.3813169984686,74.73200612557427
24759_terrestrial,664,333,437,498,997,65.8132530120482,75
24760_terrestrial,720,372,476,525,1092,66.11111111111111,72.91666666666666
24761_terrestrial,762,425,514,543,1187,67.45406824146981,71.25984251968504
24762_terrestrial,780,427,537,528,1207,68.84615384615384,67.6923076923077
24763_terrestrial,724,378,491,520,1102,67.81767955801105,71.8232044198895
24764_terrestrial,714,434,486,501,1148,68.0672268907563,70.16806722689076
24765_terrestrial,700,455,475,494,1155,67.85714285714286,70.57142857142857
24766_terrestrial,686,407,474,468,1093,69.09620991253644,68.22157434402332
24767_terrestrial,1096,536,800,609,1632,72.99270072992701,55.565693430656935
24768_terrestrial,1092,524,803,596,1616,73.53479853479854,54.57875457875458
24769_terrestrial,1019,435,766,550,1454,75.17173699705594,53.974484789008834
24770_terrestrial,929,387,704,501,1316,75.78040904198062,53.92895586652314
24771_terrestrial,949,394,721,516,1343,75.97471022128556,54.373024236037935
24772_terrestrial,935,389,710,514,1324,75.93582887700535,54.97326203208556
24773_terrestrial,968,408,730,533,1376,75.41322314049587,55.061983471074385
24781_terrestrial,1393,601,963,771,1994,69.1313711414214,55.348169418521174
24863_terrestrial,416,165,288,237,581,69.23076923076923,56.97115384615385
24864_terrestrial,447,186,306,259,633,68.45637583892618,57.94183445190156
24865_terrestrial,467,184,315,284,651,67.45182012847965,60.81370449678801
24915_terrestrial,627,709,351,341,1336,55.980861244019145,54.385964912280706
24916_terrestrial,356,537,101,297,893,28.370786516853936,83.42696629213484
24917_terrestrial,299,525,80,250,824,26.755852842809364,83.61204013377926
24918_terrestrial,282,453,75,236,735,26.595744680851062,83.68794326241135
24919_terrestrial,267,370,72,227,637,26.96629213483146,85.0187265917603
24920_terrestrial,262,342,72,219,604,27.480916030534353,83.58778625954199
24921_terrestrial,302,427,91,247,729,30.132450331125828,81.78807947019867
24922_terrestrial,410,621,124,343,1031,30.24390243902439,83.65853658536585
24923_terrestrial,714,717,365,437,1431,51.120448179271705,61.20448179271709
24924_terrestrial,596,458,330,344,1054,55.369127516778526,57.71812080536913
24930_terrestrial,645,450,366,343,1095,56.74418604651162,53.17829457364341
24931_terrestrial,308,288,106,243,596,34.41558441558442,78.8961038961039
24932_terrestrial,304,326,98,243,630,32.23684210526316,79.93421052631578
24933_terrestrial,702,565,376,411,1267,53.561253561253565,58.54700854700855
24934_terrestrial,685,544,374,395,1229,54.598540145985396,57.66423357664233
24942_terrestrial,513,302,318,275,815,61.98830409356725,53.606237816764136
24943_terrestrial,525,339,324,282,864,61.71428571428571,53.714285714285715
24944_terrestrial,189,209,78,157,398,41.269841269841265,83.06878306878306
24945_terrestrial,538,378,339,284,916,63.01115241635687,52.78810408921933
24946_terrestrial,538,389,337,286,927,62.639405204460964,53.159851301115246
24947_terrestrial,429,239,262,240,668,61.07226107226107,55.94405594405595
25007_terrestrial,98,64,47,62,162,47.95918367346938,63.26530612244898
25008_terrestrial,98,60,46,59,158,46.93877551020408,60.204081632653065
25021_terrestrial,85,43,37,49,128,43.529411764705884,57.647058823529406
25022_terrestrial,85,51,36,49,136,42.35294117647059,57.647058823529406
25028_terrestrial,76,49,31,42,125,40.78947368421053,55.26315789473685
25029_terrestrial,83,51,34,46,134,40.963855421686745,55.42168674698795
25030_terrestrial,80,51,33,44,131,41.25,55.00000000000001
25032_terrestrial,69,37,29,39,106,42.028985507246375,56.52173913043478
25033_terrestrial,60,33,26,33,93,43.333333333333336,55.00000000000001
25050_terrestrial,144,42,90,85,186,62.5,59.02777777777778
25051_terrestrial,193,61,119,118,254,61.6580310880829,61.13989637305699
25052_terrestrial,179,55,112,107,234,62.56983240223464,59.77653631284916
25091_terrestrial,672,263,507,328,935,75.44642857142857,48.80952380952381
25092_terrestrial,690,265,524,333,955,75.94202898550725,48.26086956521739
25093_terrestrial,782,327,596,387,1109,76.21483375959079,49.48849104859335
25094_terrestrial,491,192,329,348,683,67.0061099796334,70.87576374745417
25095_terrestrial,422,157,285,307,579,67.53554502369668,72.74881516587678
25096_terrestrial,391,144,266,285,535,68.03069053708441,72.89002557544757
25097_terrestrial,376,144,259,271,520,68.88297872340425,72.07446808510637
25098_terrestrial,372,144,261,268,516,70.16129032258065,72.04301075268818
25099_terrestrial,391,144,270,283,535,69.0537084398977,72.37851662404093
25100_terrestrial,410,143,275,299,553,67.07317073170732,72.92682926829268
25101_terrestrial,420,144,279,313,564,66.42857142857143,74.52380952380952
25102_terrestrial,420,133,274,307,553,65.23809523809524,73.09523809523809
25103_terrestrial,415,141,271,307,556,65.3012048192771,73.97590361445782
25104_terrestrial,447,155,292,327,602,65.32438478747203,73.15436241610739
25105_terrestrial,483,163,327,357,646,67.70186335403726,73.91304347826086
25106_terrestrial,506,175,347,366,681,68.57707509881423,72.33201581027669
25107_terrestrial,822,347,597,438,1169,72.62773722627736,53.284671532846716
25113_terrestrial,842,362,609,465,1204,72.32779097387173,55.225653206650826
25114_terrestrial,1005,413,702,596,1418,69.85074626865672,59.30348258706468
25115_terrestrial,693,290,470,511,983,67.82106782106783,73.73737373737373
25116_terrestrial,524,232,363,387,756,69.27480916030534,73.85496183206108
25117_terrestrial,683,342,464,503,1025,67.93557833089312,73.64568081991216
25118_terrestrial,676,330,456,497,1006,67.45562130177515,73.5207100591716
25119_terrestrial,680,359,454,508,1039,66.76470588235294,74.70588235294117
25120_terrestrial,736,401,487,545,1137,66.16847826086956,74.04891304347827
25121_terrestrial,748,385,508,540,1133,67.9144385026738,72.19251336898395
25122_terrestrial,712,361,489,512,1073,68.67977528089888,71.91011235955057
25123_terrestrial,696,355,480,493,1051,68.96551724137932,70.83333333333334
25124_terrestrial,690,375,475,489,1065,68.84057971014492,70.86956521739131
25125_terrestrial,696,395,475,495,1091,68.24712643678161,71.12068965517241
25126_terrestrial,700,397,489,478,1097,69.85714285714286,68.28571428571428
25127_terrestrial,976,473,729,526,1449,74.69262295081968,53.893442622950815
25128_terrestrial,915,406,684,490,1321,74.75409836065575,53.551912568306015
25130_terrestrial,839,344,627,451,1183,74.73182359952324,53.75446960667462
25131_terrestrial,990,427,732,528,1417,73.93939393939394,53.333333333333336
25224_terrestrial,83,25,60,68,108,72.28915662650603,81.92771084337349
25225_terrestrial,461,189,312,277,650,67.67895878524945,60.08676789587852
25226_terrestrial,443,181,302,266,624,68.17155756207674,60.0451467268623
25275_terrestrial,579,616,326,305,1195,56.303972366148535,52.67702936096719
25276_terrestrial,651,790,347,364,1441,53.3026113671275,55.91397849462365
25277_terrestrial,373,593,107,308,966,28.686327077747993,82.57372654155496
25278_terrestrial,313,559,89,261,872,28.434504792332266,83.38658146964856
25279_terrestrial,306,517,88,252,823,28.75816993464052,82.35294117647058
25280_terrestrial,282,472,74,237,754,26.24113475177305,84.04255319148936
25281_terrestrial,288,484,90,233,772,31.25,80.90277777777779
25282_terrestrial,327,525,113,261,852,34.5565749235474,79.81651376146789
25283_terrestrial,440,742,138,361,1182,31.363636363636367,82.04545454545455
25284_terrestrial,704,714,362,423,1418,51.42045454545454,60.08522727272727
25285_terrestrial,607,448,337,340,1055,55.51894563426688,56.01317957166392
25289_terrestrial,617,419,349,339,1036,56.56401944894651,54.94327390599676
25290_terrestrial,676,488,376,373,1164,55.62130177514793,55.17751479289941
25291_terrestrial,301,307,99,238,608,32.89036544850498,79.06976744186046
25292_terrestrial,341,346,117,270,687,34.31085043988269,79.17888563049853
25293_terrestrial,675,543,371,388,1218,54.962962962962955,57.48148148148148
25299_terrestrial,425,243,266,234,668,62.588235294117645,55.05882352941176
25300_terrestrial,402,192,259,215,594,64.42786069651741,53.482587064676615
25301_terrestrial,411,197,265,221,608,64.47688564476886,53.771289537712896
25303_terrestrial,520,349,320,281,869,61.53846153846154,54.03846153846153
25304_terrestrial,515,356,319,278,871,61.94174757281553,53.980582524271846
25305_terrestrial,519,354,323,279,873,62.23506743737958,53.75722543352601
25306_terrestrial,516,325,321,278,841,62.2093023255814,53.875968992248055
25308_terrestrial,486,391,311,258,877,63.991769547325106,53.086419753086425
25309_terrestrial,481,368,304,260,849,63.20166320166321,54.054054054054056
25310_terrestrial,482,354,306,260,836,63.48547717842323,53.941908713692946
25311_terrestrial,482,334,307,259,816,63.69294605809128,53.7344398340249
25312_terrestrial,147,123,64,125,270,43.53741496598639,85.03401360544217
25381_terrestrial,97,51,47,56,148,48.45360824742268,57.73195876288659
25382_terrestrial,104,59,51,60,163,49.03846153846153,57.692307692307686
25388_terrestrial,104,73,42,66,177,40.38461538461539,63.46153846153846
25389_terrestrial,110,80,46,65,190,41.81818181818181,59.09090909090909
25390_terrestrial,106,73,46,61,179,43.39622641509434,57.54716981132076
25391_terrestrial,78,50,35,43,128,44.871794871794876,55.12820512820513
25410_terrestrial,146,49,85,90,195,58.21917808219178,61.64383561643836
25411_terrestrial,194,68,117,120,262,60.30927835051546,61.855670103092784
25413_terrestrial,205,73,126,129,278,61.46341463414634,62.926829268292686
25414_terrestrial,203,83,120,131,286,59.11330049261084,64.5320197044335
25415_terrestrial,174,69,98,112,243,56.32183908045977,64.36781609195403
25422_terrestrial,681,325,426,371,1006,62.55506607929515,54.478707782672544
25423_terrestrial,163,123,72,114,286,44.171779141104295,69.93865030674846
25453_terrestrial,782,354,596,386,1136,76.21483375959079,49.36061381074169
25454_terrestrial,841,384,623,436,1225,74.07847800237812,51.843043995243754
25455_terrestrial,421,167,291,304,588,69.12114014251782,72.20902612826603
25456_terrestrial,379,136,263,272,515,69.39313984168865,71.76781002638522
25457_terrestrial,369,135,261,263,504,70.73170731707317,71.27371273712737
25458_terrestrial,362,136,259,258,498,71.54696132596685,71.27071823204419
25459_terrestrial,385,134,268,275,519,69.61038961038962,71.42857142857143
25460_terrestrial,401,145,273,294,546,68.07980049875312,73.31670822942642
25461_terrestrial,413,151,272,307,564,65.85956416464892,74.33414043583535
25462_terrestrial,417,142,271,307,559,64.98800959232614,73.621103117506
25463_terrestrial,425,151,277,317,576,65.17647058823529,74.58823529411764
25464_terrestrial,456,162,303,340,618,66.44736842105263,74.56140350877193
25465_terrestrial,879,377,634,474,1256,72.12741751990899,53.92491467576792
25466_terrestrial,852,376,623,445,1228,73.12206572769952,52.230046948356815
25467_terrestrial,749,331,557,373,1080,74.36582109479306,49.799732977303066
25473_terrestrial,456,202,339,187,658,74.3421052631579,41.00877192982456
25474_terrestrial,854,360,608,493,1214,71.19437939110071,57.72833723653395
25475_terrestrial,963,415,685,568,1378,71.1318795430945,58.98234683281412
25476_terrestrial,540,228,372,401,768,68.88888888888889,74.25925925925925
25477_terrestrial,703,337,477,510,1040,67.85206258890469,72.54623044096729
25478_terrestrial,741,390,506,532,1131,68.28609986504723,71.7948717948718
25479_terrestrial,764,420,518,544,1184,67.80104712041884,71.20418848167539
25480_terrestrial,751,414,512,534,1165,68.1757656458056,71.1051930758988
25481_terrestrial,729,381,505,520,1110,69.27297668038409,71.33058984910838
25482_terrestrial,726,368,505,510,1094,69.55922865013774,70.24793388429752
25483_terrestrial,713,356,491,506,1069,68.86395511921458,70.96774193548387
25484_terrestrial,726,378,502,513,1104,69.14600550964187,70.66115702479338
25485_terrestrial,751,414,525,516,1165,69.90679094540613,68.70838881491345
25486_terrestrial,1105,563,805,632,1668,72.85067873303167,57.1945701357466
25487_terrestrial,855,393,638,456,1248,74.61988304093568,53.333333333333336
25489_terrestrial,832,362,635,429,1194,76.32211538461539,51.5625
25490_terrestrial,866,391,664,442,1257,76.6743648960739,51.03926096997691
25491_terrestrial,876,386,663,457,1262,75.68493150684932,52.1689497716895
25492_terrestrial,787,320,595,403,1107,75.60355781448538,51.207115628970776
25585_terrestrial,81,25,59,68,106,72.8395061728395,83.9506172839506
25636_terrestrial,269,343,92,214,612,34.20074349442379,79.5539033457249
25637_terrestrial,608,736,326,339,1344,53.61842105263158,55.75657894736842
25638_terrestrial,333,498,98,277,831,29.429429429429426,83.18318318318319
25639_terrestrial,360,510,104,305,870,28.888888888888886,84.72222222222221
25640_terrestrial,291,496,83,244,787,28.52233676975945,83.8487972508591
25641_terrestrial,284,521,82,234,805,28.87323943661972,82.3943661971831
25642_terrestrial,291,478,89,236,769,30.584192439862544,81.09965635738831
25643_terrestrial,422,689,127,346,1111,30.09478672985782,81.99052132701422
25644_terrestrial,476,758,145,387,1234,30.462184873949578,81.30252100840336
25645_terrestrial,703,708,362,422,1411,51.493598862019915,60.02844950213371
25646_terrestrial,688,644,364,414,1332,52.90697674418605,60.17441860465116
25647_terrestrial,641,522,357,367,1163,55.69422776911076,57.25429017160687
25648_terrestrial,653,507,360,375,1160,55.13016845329249,57.42725880551301
25649_terrestrial,696,551,381,405,1247,54.741379310344826,58.189655172413794
25650_terrestrial,351,364,124,280,715,35.32763532763533,79.77207977207978
25651_terrestrial,305,369,99,238,674,32.459016393442624,78.0327868852459
25652_terrestrial,689,644,378,395,1333,54.862119013062404,57.32946298984035
25653_terrestrial,673,587,370,384,1260,54.9777117384844,57.05794947994056
25663_terrestrial,475,346,299,257,821,62.94736842105263,54.10526315789473
25664_terrestrial,466,330,293,248,796,62.8755364806867,53.21888412017167
25666_terrestrial,476,417,306,250,893,64.28571428571429,52.52100840336135
25667_terrestrial,480,432,308,251,912,64.16666666666667,52.29166666666667
25668_terrestrial,482,448,308,254,930,63.90041493775933,52.69709543568465
25669_terrestrial,492,466,315,264,958,64.02439024390245,53.65853658536586
25670_terrestrial,484,399,310,257,883,64.0495867768595,53.099173553719005
25671_terrestrial,488,364,315,258,852,64.54918032786885,52.86885245901639
25672_terrestrial,479,359,312,251,838,65.1356993736952,52.4008350730689
25673_terrestrial,517,397,333,279,914,64.41005802707932,53.9651837524178
25674_terrestrial,526,381,336,289,907,63.87832699619772,54.94296577946768
25675_terrestrial,520,408,332,286,928,63.84615384615384,55.00000000000001
25676_terrestrial,468,324,311,240,792,66.45299145299145,51.28205128205128
25677_terrestrial,404,285,271,205,689,67.07920792079209,50.742574257425744
25678_terrestrial,394,253,268,195,647,68.02030456852792,49.49238578680203
25747_terrestrial,113,65,46,73,178,40.707964601769916,64.60176991150442
25748_terrestrial,125,82,49,81,207,39.2,64.8
25749_terrestrial,135,94,58,85,229,42.96296296296296,62.96296296296296
25750_terrestrial,125,88,55,77,213,44,61.6
25751_terrestrial,93,68,40,57,161,43.01075268817204,61.29032258064516
25771_terrestrial,204,72,119,130,276,58.333333333333336,63.725490196078425
25772_terrestrial,214,77,129,134,291,60.280373831775705,62.616822429906534
25773_terrestrial,220,87,132,140,307,60,63.63636363636363
25774_terrestrial,229,96,132,149,325,57.64192139737992,65.06550218340611
25775_terrestrial,231,99,131,150,330,56.709956709956714,64.93506493506493
25782_terrestrial,686,337,437,373,1023,63.70262390670553,54.3731778425656
25783_terrestrial,204,136,100,144,340,49.01960784313725,70.58823529411765
25813_terrestrial,784,347,597,393,1131,76.14795918367348,50.12755102040817
25814_terrestrial,863,418,639,442,1281,74.04403244495944,51.216685979142525
25815_terrestrial,440,186,305,309,626,69.31818181818183,70.22727272727273
25816_terrestrial,380,129,266,271,509,70,71.3157894736842
25817_terrestrial,353,132,250,255,485,70.82152974504248,72.23796033994334
25818_terrestrial,356,134,252,256,490,70.78651685393258,71.91011235955057
25819_terrestrial,376,131,263,269,507,69.9468085106383,71.54255319148936
25820_terrestrial,392,139,269,286,531,68.62244897959184,72.95918367346938
25821_terrestrial,412,151,276,303,563,66.99029126213593,73.54368932038835
25822_terrestrial,424,154,281,317,578,66.27358490566037,74.76415094339622
25823_terrestrial,460,164,305,338,624,66.30434782608695,73.47826086956522
25824_terrestrial,835,367,595,451,1202,71.25748502994011,54.011976047904184
25825_terrestrial,794,342,572,421,1136,72.04030226700252,53.02267002518891
25834_terrestrial,765,308,547,430,1073,71.50326797385621,56.209150326797385
25835_terrestrial,939,410,669,541,1349,71.24600638977637,57.61448349307774
25836_terrestrial,572,236,399,416,808,69.75524475524476,72.72727272727273
25837_terrestrial,725,341,497,519,1066,68.55172413793103,71.58620689655173
25838_terrestrial,798,399,551,554,1197,69.04761904761905,69.42355889724311
25839_terrestrial,751,417,508,530,1168,67.64314247669773,70.57256990679095
25840_terrestrial,701,373,478,498,1074,68.188302425107,71.0413694721826
25841_terrestrial,655,348,464,458,1003,70.83969465648855,69.92366412213741
25842_terrestrial,715,352,501,495,1067,70.06993006993008,69.23076923076923
25843_terrestrial,726,348,504,503,1074,69.42148760330579,69.28374655647383
25844_terrestrial,771,381,537,528,1152,69.64980544747081,68.48249027237354
25845_terrestrial,827,449,588,548,1276,71.10036275695283,66.26360338573156
25846_terrestrial,1198,594,874,679,1792,72.95492487479132,56.677796327212015
25847_terrestrial,968,423,708,541,1391,73.14049586776859,55.888429752066116
25849_terrestrial,844,373,638,440,1217,75.59241706161137,52.13270142180095
25850_terrestrial,853,401,643,450,1254,75.3810082063306,52.754982415005856
25851_terrestrial,836,373,630,444,1209,75.35885167464114,53.110047846889955
25861_terrestrial,1369,647,882,827,2016,64.42658875091307,60.40905770635501
25862_terrestrial,1369,686,878,836,2055,64.13440467494522,61.066471877282694
25863_terrestrial,1345,626,858,829,1971,63.79182156133829,61.63568773234201
25998_terrestrial,525,570,300,274,1095,57.14285714285714,52.19047619047619
25999_terrestrial,613,688,318,349,1301,51.876019575856446,56.933115823817296
26000_terrestrial,626,807,321,358,1433,51.2779552715655,57.18849840255591
26001_terrestrial,359,614,105,296,973,29.247910863509752,82.45125348189416
26002_terrestrial,299,527,90,243,826,30.100334448160538,81.27090301003345
26003_terrestrial,293,527,85,235,820,29.01023890784983,80.2047781569966
26004_terrestrial,432,813,117,357,1245,27.083333333333332,82.63888888888889
26005_terrestrial,429,711,122,357,1140,28.438228438228435,83.21678321678321
26006_terrestrial,402,582,129,330,984,32.08955223880597,82.08955223880598
26007_terrestrial,455,704,140,373,1159,30.76923076923077,81.97802197802197
26008_terrestrial,436,676,130,367,1112,29.81651376146789,84.17431192660551
26009_terrestrial,409,573,132,331,982,32.27383863080684,80.92909535452323
26010_terrestrial,347,459,114,279,806,32.85302593659942,80.403458213256485
26011_terrestrial,339,464,106,271,803,31.268436578171094,79.9410029498525
26012_terrestrial,727,755,383,430,1482,52.68225584594223,59.147180192572215
26013_terrestrial,439,323,281,198,762,64.00911161731207,45.10250569476082
26023_terrestrial,470,332,297,250,802,63.191489361702125,53.191489361702125
26024_terrestrial,472,336,298,252,808,63.13559322033898,53.38983050847458
26029_terrestrial,478,384,307,252,862,64.22594142259415,52.719665271966534
26033_terrestrial,501,342,326,266,843,65.06986027944112,53.093812375249506
26034_terrestrial,500,363,325,265,863,65,53
26035_terrestrial,490,333,316,261,823,64.48979591836735,53.265306122448976
26036_terrestrial,459,312,304,229,771,66.23093681917211,49.89106753812636
26037_terrestrial,359,240,246,161,599,68.52367688022284,44.84679665738162
26038_terrestrial,421,330,281,219,751,66.7458432304038,52.01900237529691
26075_terrestrial,244,99,211,55,343,86.47540983606558,22.540983606557376
26076_terrestrial,242,92,209,55,334,86.36363636363636,22.727272727272727
26085_terrestrial,323,128,180,213,451,55.72755417956656,65.94427244582043
26086_terrestrial,278,111,148,189,389,53.23741007194245,67.98561151079137
26087_terrestrial,221,84,118,147,305,53.39366515837104,66.51583710407239
26088_terrestrial,183,84,98,116,267,53.551912568306015,63.387978142076506
26089_terrestrial,159,80,82,100,239,51.57232704402516,62.893081761006286
26090_terrestrial,142,71,74,94,213,52.112676056338024,66.19718309859155
26091_terrestrial,133,66,72,88,199,54.13533834586466,66.16541353383458
26105_terrestrial,125,69,64,77,194,51.2,61.6
26106_terrestrial,130,69,62,81,199,47.69230769230769,62.30769230769231
26107_terrestrial,136,83,59,88,219,43.38235294117647,64.70588235294117
26108_terrestrial,148,96,59,98,244,39.86486486486486,66.21621621621621
26109_terrestrial,147,101,64,91,248,43.53741496598639,61.904761904761905
26110_terrestrial,138,94,63,86,232,45.65217391304348,62.31884057971014
26111_terrestrial,112,74,54,68,186,48.214285714285715,60.71428571428571
26122_terrestrial,126,59,59,82,185,46.82539682539682,65.07936507936508
26123_terrestrial,128,57,57,85,185,44.53125,66.40625
26131_terrestrial,205,82,120,135,287,58.536585365853654,65.85365853658537
26132_terrestrial,221,85,131,144,306,59.276018099547514,65.15837104072398
26134_terrestrial,269,114,146,181,383,54.27509293680297,67.28624535315984
26135_terrestrial,254,113,140,172,367,55.118110236220474,67.71653543307087
26136_terrestrial,188,87,105,124,275,55.85106382978723,65.95744680851064
26174_terrestrial,857,409,637,439,1266,74.32905484247374,51.22520420070011
26175_terrestrial,456,199,313,327,655,68.64035087719299,71.71052631578947
26176_terrestrial,380,129,269,273,509,70.78947368421052,71.84210526315789
26177_terrestrial,349,131,252,254,480,72.20630372492836,72.77936962750717
26178_terrestrial,351,133,253,253,484,72.07977207977207,72.07977207977207
26179_terrestrial,349,132,252,252,481,72.20630372492836,72.20630372492836
26180_terrestrial,372,143,262,273,515,70.43010752688173,73.38709677419355
26181_terrestrial,404,144,279,297,548,69.05940594059405,73.51485148514851
26182_terrestrial,458,170,312,335,628,68.12227074235808,73.14410480349345
26183_terrestrial,842,384,608,446,1226,72.20902612826603,52.96912114014252
26184_terrestrial,792,348,581,405,1140,73.35858585858585,51.13636363636363
26195_terrestrial,915,389,645,525,1304,70.49180327868852,57.377049180327866
26196_terrestrial,536,234,365,400,770,68.09701492537313,74.6268656716418
26197_terrestrial,1042,452,753,591,1494,72.26487523992321,56.717850287907865
26198_terrestrial,1160,537,838,657,1697,72.24137931034483,56.63793103448276
26199_terrestrial,772,389,533,534,1161,69.04145077720207,69.17098445595855
26200_terrestrial,665,328,466,460,993,70.07518796992481,69.17293233082707
26201_terrestrial,663,336,471,450,999,71.04072398190046,67.87330316742081
26202_terrestrial,693,354,498,459,1047,71.86147186147186,66.23376623376623
26203_terrestrial,587,286,426,389,873,72.57240204429301,66.26916524701873
26204_terrestrial,498,240,358,343,738,71.8875502008032,68.87550200803213
26205_terrestrial,753,387,529,501,1140,70.2523240371846,66.53386454183267
26206_terrestrial,850,454,599,555,1304,70.47058823529412,65.29411764705883
26207_terrestrial,1180,582,839,679,1762,71.10169491525423,57.54237288135593
26208_terrestrial,906,375,632,529,1281,69.75717439293598,58.38852097130243
26221_terrestrial,1370,691,879,832,2061,64.16058394160584,60.72992700729927
26222_terrestrial,348,358,233,259,706,66.95402298850574,74.42528735632183
26223_terrestrial,1370,672,876,838,2042,63.94160583941606,61.16788321167883
26360_terrestrial,519,537,299,268,1056,57.61078998073218,51.637764932562625
26361_terrestrial,597,691,325,325,1288,54.438860971524285,54.438860971524285
26362_terrestrial,606,736,323,336,1342,53.3003300330033,55.44554455445545
26363_terrestrial,350,595,107,284,945,30.571428571428573,81.14285714285714
26364_terrestrial,369,671,109,303,1040,29.539295392953928,82.11382113821138
26365_terrestrial,674,900,333,403,1574,49.40652818991098,59.79228486646885
26366_terrestrial,664,873,338,387,1537,50.903614457831324,58.28313253012048
26367_terrestrial,679,890,322,421,1569,47.42268041237113,62.00294550810015
26368_terrestrial,371,660,104,311,1031,28.03234501347709,83.82749326145552
26369_terrestrial,414,701,118,339,1115,28.502415458937197,81.88405797101449
26370_terrestrial,358,534,109,283,892,30.446927374301673,79.05027932960894
26371_terrestrial,383,539,122,305,922,31.853785900783286,79.63446475195822
26372_terrestrial,708,781,367,424,1489,51.836158192090394,59.887005649717516
26374_terrestrial,410,323,277,178,733,67.5609756097561,43.41463414634146
26375_terrestrial,658,628,352,385,1286,53.49544072948328,58.51063829787234
26398_terrestrial,395,294,273,188,689,69.11392405063292,47.59493670886076
26435_terrestrial,247,104,214,57,351,86.63967611336032,23.076923076923077
26436_terrestrial,249,106,215,57,355,86.34538152610442,22.89156626506024
26438_terrestrial,250,105,218,57,355,87.2,22.8
26444_terrestrial,791,318,561,344,1109,70.92288242730721,43.48925410872314
26445_terrestrial,466,188,256,309,654,54.93562231759657,66.30901287553648
26446_terrestrial,402,172,208,271,574,51.741293532338304,67.41293532338308
26447_terrestrial,357,155,180,251,512,50.42016806722689,70.30812324929971
26448_terrestrial,282,133,144,199,415,51.06382978723404,70.56737588652481
26449_terrestrial,249,116,120,174,365,48.19277108433735,69.87951807228916
26450_terrestrial,207,98,108,139,305,52.17391304347826,67.14975845410628
26451_terrestrial,193,99,105,134,292,54.40414507772021,69.43005181347151
26452_terrestrial,187,90,97,136,277,51.87165775401069,72.72727272727273
26453_terrestrial,191,93,95,143,284,49.73821989528796,74.86910994764398
26454_terrestrial,198,97,102,143,295,51.515151515151516,72.22222222222221
26455_terrestrial,269,115,154,174,384,57.249070631970255,64.68401486988847
26456_terrestrial,342,136,189,228,478,55.26315789473685,66.66666666666666
26457_terrestrial,390,154,199,265,544,51.02564102564102,67.94871794871796
26458_terrestrial,385,152,197,261,537,51.16883116883116,67.79220779220779
26459_terrestrial,366,141,187,247,507,51.09289617486339,67.4863387978142
26460_terrestrial,352,138,175,239,490,49.715909090909086,67.89772727272727
26461_terrestrial,340,135,173,225,475,50.882352941176464,66.17647058823529
26462_terrestrial,287,121,151,190,408,52.613240418118465,66.2020905923345
26463_terrestrial,229,110,112,161,339,48.90829694323144,70.3056768558952
26464_terrestrial,202,107,99,141,309,49.00990099009901,69.80198019801979
26465_terrestrial,181,107,91,123,288,50.27624309392266,67.95580110497238
26466_terrestrial,176,98,85,119,274,48.29545454545455,67.61363636363636
26467_terrestrial,174,97,82,116,271,47.12643678160919,66.66666666666666
26468_terrestrial,178,106,79,119,284,44.38202247191011,66.85393258426966
26469_terrestrial,167,108,78,108,275,46.706586826347305,64.67065868263472
26470_terrestrial,153,95,74,98,248,48.366013071895424,64.05228758169935
26471_terrestrial,137,81,65,91,218,47.44525547445255,66.42335766423358
26472_terrestrial,136,77,68,86,213,50,63.23529411764706
26473_terrestrial,120,68,60,75,188,50,62.5
26482_terrestrial,166,71,82,111,237,49.39759036144578,66.86746987951807
26483_terrestrial,160,67,79,110,227,49.375,68.75
26491_terrestrial,193,81,106,131,274,54.92227979274611,67.87564766839378
26492_terrestrial,220,102,125,148,322,56.81818181818182,67.27272727272727
26493_terrestrial,294,138,165,205,432,56.12244897959183,69.72789115646259
26494_terrestrial,300,131,171,201,431,56.99999999999999,67
26495_terrestrial,269,108,148,183,377,55.01858736059479,68.02973977695167
26496_terrestrial,246,96,135,170,342,54.87804878048781,69.10569105691057
26497_terrestrial,280,114,142,198,394,50.71428571428571,70.71428571428572
26498_terrestrial,350,158,151,259,508,43.142857142857146,74
26534_terrestrial,857,398,634,448,1255,73.97899649941657,52.275379229871646
26535_terrestrial,501,233,334,361,734,66.66666666666666,72.0558882235529
26536_terrestrial,388,157,272,282,545,70.10309278350515,72.68041237113401
26537_terrestrial,356,141,252,258,497,70.78651685393258,72.47191011235955
26538_terrestrial,350,129,255,254,479,72.85714285714285,72.57142857142857
26539_terrestrial,377,161,267,272,538,70.82228116710876,72.14854111405835
26540_terrestrial,410,184,290,287,594,70.73170731707317,70
26541_terrestrial,402,151,283,280,553,70.39800995024875,69.65174129353234
26542_terrestrial,767,353,577,383,1120,75.22816166883963,49.934810951760106
26543_terrestrial,732,335,555,350,1067,75.81967213114754,47.81420765027322
26555_terrestrial,852,354,603,484,1206,70.77464788732394,56.8075117370892
26556_terrestrial,857,359,609,477,1216,71.06184364060677,55.65927654609102
26557_terrestrial,848,366,620,459,1214,73.11320754716981,54.12735849056604
26558_terrestrial,1031,467,748,563,1498,72.55092143549952,54.607177497575165
26559_terrestrial,824,388,583,543,1212,70.75242718446601,65.89805825242718
26560_terrestrial,731,324,521,484,1055,71.27222982216142,66.21067031463748
26561_terrestrial,633,301,452,420,934,71.40600315955766,66.35071090047393
26562_terrestrial,646,322,464,421,968,71.8266253869969,65.17027863777089
26563_terrestrial,538,272,389,354,810,72.30483271375465,65.79925650557621
26564_terrestrial,436,217,328,283,653,75.22935779816514,64.90825688073394
26565_terrestrial,522,254,369,358,776,70.6896551724138,68.5823754789272
26566_terrestrial,680,340,476,471,1020,70,69.26470588235294
26567_terrestrial,798,413,559,532,1211,70.0501253132832,66.66666666666666
26568_terrestrial,1201,572,860,688,1773,71.60699417152372,57.285595337218986
26569_terrestrial,1042,447,726,609,1489,69.67370441458733,58.44529750479847
26580_terrestrial,1314,602,833,813,1916,63.39421613394216,61.87214611872146
26581_terrestrial,1380,693,882,839,2073,63.91304347826087,60.79710144927536
26582_terrestrial,1387,727,878,852,2114,63.30209084354722,61.42754145638067
26583_terrestrial,1367,674,865,848,2041,63.27724945135332,62.033650329188006
26723_terrestrial,548,603,308,288,1151,56.20437956204379,52.55474452554745
26724_terrestrial,558,683,307,298,1241,55.017921146953405,53.40501792114696
26725_terrestrial,544,594,308,282,1138,56.61764705882353,51.83823529411765
26727_terrestrial,602,707,320,346,1309,53.156146179402,57.475083056478404
26728_terrestrial,423,688,134,346,1111,31.678486997635936,81.7966903073286
26729_terrestrial,413,779,113,345,1192,27.36077481840194,83.53510895883777
26730_terrestrial,406,711,109,337,1117,26.84729064039409,83.00492610837439
26731_terrestrial,454,779,131,371,1233,28.854625550660796,81.71806167400881
26732_terrestrial,771,986,378,473,1757,49.0272373540856,61.348897535667966
26733_terrestrial,739,869,375,450,1608,50.74424898511503,60.893098782138026
26734_terrestrial,713,832,363,434,1545,50.911640953716685,60.86956521739131
26735_terrestrial,720,824,371,434,1544,51.52777777777777,60.27777777777777
26736_terrestrial,668,715,353,399,1383,52.84431137724551,59.73053892215569
26737_terrestrial,667,629,360,396,1296,53.973013493253376,59.37031484257871
26759_terrestrial,459,350,300,241,809,65.359477124183,52.505446623093675
26796_terrestrial,38,18,24,28,56,63.1578947368421,73.68421052631578
26797_terrestrial,253,110,218,60,363,86.16600790513834,23.715415019762844
26798_terrestrial,39,17,28,27,56,71.7948717948718,69.23076923076923
26803_terrestrial,721,305,512,300,1026,71.0124826629681,41.60887656033287
26804_terrestrial,807,345,564,352,1152,69.88847583643123,43.6183395291202
26805_terrestrial,447,184,242,296,631,54.138702460850105,66.2192393736018
26806_terrestrial,395,172,209,259,567,52.911392405063296,65.56962025316456
26807_terrestrial,376,180,191,254,556,50.797872340425535,67.5531914893617
26808_terrestrial,373,183,187,253,556,50.134048257372655,67.828418230563
26809_terrestrial,340,153,163,236,493,47.94117647058824,69.41176470588235
26810_terrestrial,286,139,143,193,425,50,67.48251748251748
26811_terrestrial,267,133,141,174,400,52.80898876404494,65.1685393258427
26812_terrestrial,245,137,127,166,382,51.83673469387755,67.75510204081633
26813_terrestrial,256,138,126,181,394,49.21875,70.703125
26814_terrestrial,323,146,170,216,469,52.63157894736842,66.87306501547987
26815_terrestrial,383,165,195,261,548,50.91383812010444,68.1462140992167
26816_terrestrial,442,189,222,292,631,50.2262443438914,66.06334841628959
26817_terrestrial,444,196,221,295,640,49.77477477477478,66.44144144144144
26818_terrestrial,406,175,200,284,581,49.26108374384236,69.95073891625616
26819_terrestrial,384,160,192,265,544,50,69.01041666666666
26820_terrestrial,364,156,180,253,520,49.45054945054945,69.5054945054945
26821_terrestrial,359,153,180,247,512,50.13927576601671,68.80222841225627
26822_terrestrial,337,148,166,235,485,49.25816023738873,69.73293768545994
26823_terrestrial,297,134,141,215,431,47.474747474747474,72.39057239057239
26824_terrestrial,255,133,116,191,388,45.490196078431374,74.90196078431373
26825_terrestrial,254,125,122,185,379,48.031496062992126,72.83464566929135
26826_terrestrial,238,120,107,176,358,44.957983193277315,73.94957983193278
26827_terrestrial,237,116,114,169,353,48.10126582278481,71.30801687763713
26828_terrestrial,229,118,104,165,347,45.414847161572055,72.0524017467249
26829_terrestrial,214,117,99,156,331,46.26168224299065,72.89719626168224
26830_terrestrial,203,113,96,146,316,47.29064039408867,71.92118226600985
26831_terrestrial,195,110,92,138,305,47.179487179487175,70.76923076923077
26832_terrestrial,195,103,95,129,298,48.717948717948715,66.15384615384615
26833_terrestrial,185,91,89,122,276,48.10810810810811,65.94594594594595
26834_terrestrial,185,86,92,120,271,49.72972972972973,64.86486486486487
26835_terrestrial,177,85,92,112,262,51.9774011299435,63.2768361581921
26849_terrestrial,187,87,93,135,274,49.73262032085562,72.19251336898395
26850_terrestrial,193,95,103,139,288,53.36787564766839,72.02072538860104
26851_terrestrial,216,104,114,156,320,52.77777777777778,72.22222222222221
26852_terrestrial,309,138,174,201,447,56.310679611650485,65.0485436893204
26853_terrestrial,359,163,194,241,522,54.038997214484674,67.1309192200557
26854_terrestrial,357,165,184,244,522,51.540616246498594,68.34733893557423
26855_terrestrial,298,120,144,215,418,48.322147651006716,72.14765100671141
26856_terrestrial,309,121,152,219,430,49.19093851132686,70.87378640776699
26857_terrestrial,353,147,163,255,500,46.1756373937677,72.23796033994334
26858_terrestrial,395,182,172,291,577,43.54430379746835,73.67088607594937
26859_terrestrial,453,267,195,331,720,43.04635761589404,73.06843267108167
26860_terrestrial,949,472,535,581,1421,56.37513171759747,61.22233930453108
26894_terrestrial,877,404,646,461,1281,73.66020524515393,52.56556442417332
26895_terrestrial,935,457,679,495,1392,72.62032085561498,52.94117647058824
26896_terrestrial,448,202,308,326,650,68.75,72.76785714285714
26897_terrestrial,381,157,272,269,538,71.39107611548556,70.60367454068242
26898_terrestrial,355,149,254,255,504,71.54929577464789,71.83098591549296
26899_terrestrial,388,168,271,273,556,69.84536082474226,70.36082474226805
26900_terrestrial,415,172,292,287,587,70.36144578313252,69.1566265060241
26901_terrestrial,791,358,593,381,1149,74.96839443742098,48.1668773704172
26902_terrestrial,718,314,543,339,1032,75.6267409470752,47.21448467966574
26915_terrestrial,817,329,580,458,1146,70.99143206854345,56.05875152998776
26916_terrestrial,820,315,583,454,1135,71.09756097560975,55.365853658536594
26918_terrestrial,1009,446,708,567,1455,70.16848364717542,56.19425173439049
26919_terrestrial,823,389,578,545,1212,70.23086269744836,66.22114216281896
26920_terrestrial,782,345,556,522,1127,71.0997442455243,66.75191815856778
26921_terrestrial,552,242,400,365,794,72.46376811594203,66.12318840579711
26922_terrestrial,605,281,437,394,886,72.23140495867769,65.12396694214875
26923_terrestrial,482,239,361,308,721,74.89626556016597,63.90041493775933
26924_terrestrial,408,201,305,270,609,74.75490196078431,66.17647058823529
26925_terrestrial,435,212,328,286,647,75.40229885057471,65.74712643678161
26926_terrestrial,643,294,458,441,937,71.22861586314151,68.58475894245724
26927_terrestrial,739,360,516,512,1099,69.82408660351827,69.2828146143437
26928_terrestrial,776,432,548,511,1208,70.61855670103093,65.85051546391753
26929_terrestrial,1223,563,862,732,1786,70.48242027800491,59.8528209321341
26940_terrestrial,1338,630,848,824,1968,63.37817638266069,61.58445440956651
26941_terrestrial,1382,687,882,838,2069,63.8205499276411,60.63675832127352
26942_terrestrial,1430,772,899,885,2202,62.86713286713287,61.88811188811189
26943_terrestrial,1286,560,792,792,1846,61.58631415241057,61.58631415241057
27088_terrestrial,578,671,314,323,1249,54.325259515570934,55.88235294117647
27089_terrestrial,566,735,281,347,1301,49.64664310954063,61.30742049469965
27090_terrestrial,404,601,116,335,1005,28.71287128712871,82.92079207920791
27091_terrestrial,403,662,114,337,1065,28.287841191067,83.62282878411911
27092_terrestrial,375,649,107,302,1024,28.53333333333333,80.53333333333333
27093_terrestrial,345,603,105,273,948,30.434782608695656,79.13043478260869
27094_terrestrial,372,582,107,301,954,28.763440860215056,80.91397849462365
27095_terrestrial,375,593,117,297,968,31.2,79.2
27096_terrestrial,358,530,112,290,888,31.28491620111732,81.00558659217877
27097_terrestrial,690,673,370,413,1363,53.62318840579711,59.85507246376811
27156_terrestrial,245,103,210,56,348,85.71428571428571,22.857142857142858
27157_terrestrial,250,105,215,59,355,86,23.599999999999998
27163_terrestrial,793,353,543,348,1146,68.47414880201765,43.88398486759142
27164_terrestrial,830,388,551,380,1218,66.38554216867469,45.78313253012048
27165_terrestrial,489,258,248,324,747,50.715746421267895,66.25766871165644
27166_terrestrial,455,243,230,299,698,50.54945054945055,65.71428571428571
27167_terrestrial,440,219,227,289,659,51.590909090909086,65.68181818181819
27168_terrestrial,445,215,221,296,660,49.66292134831461,66.51685393258427
27169_terrestrial,393,217,188,267,610,47.837150127226465,67.93893129770993
27170_terrestrial,368,191,179,247,559,48.641304347826086,67.11956521739131
27171_terrestrial,362,178,179,241,540,49.447513812154696,66.57458563535911
27172_terrestrial,348,178,172,232,526,49.42528735632184,66.66666666666666
27173_terrestrial,343,181,168,231,524,48.97959183673469,67.3469387755102
27174_terrestrial,420,203,214,271,623,50.95238095238095,64.52380952380953
27175_terrestrial,465,222,231,304,687,49.67741935483871,65.3763440860215
27176_terrestrial,478,226,241,309,704,50.418410041841,64.64435146443515
27177_terrestrial,462,228,232,305,690,50.21645021645021,66.01731601731602
27178_terrestrial,420,211,204,285,631,48.57142857142857,67.85714285714286
27179_terrestrial,385,201,184,264,586,47.79220779220779,68.57142857142857
27180_terrestrial,350,183,155,249,533,44.285714285714285,71.14285714285714
27181_terrestrial,375,183,174,261,558,46.400000000000006,69.6
27182_terrestrial,393,175,190,265,568,48.346055979643765,67.43002544529261
27183_terrestrial,356,156,171,250,512,48.03370786516854,70.2247191011236
27184_terrestrial,321,155,153,233,476,47.66355140186916,72.58566978193146
27185_terrestrial,321,150,153,233,471,47.66355140186916,72.58566978193146
27186_terrestrial,328,145,159,235,473,48.47560975609756,71.64634146341463
27187_terrestrial,299,135,141,222,434,47.15719063545151,74.24749163879598
27188_terrestrial,285,132,130,216,417,45.614035087719294,75.78947368421053
27189_terrestrial,280,134,128,211,414,45.714285714285715,75.35714285714286
27190_terrestrial,283,128,131,211,411,46.28975265017668,74.55830388692578
27191_terrestrial,297,129,144,215,426,48.484848484848484,72.39057239057239
27192_terrestrial,290,133,142,213,423,48.96551724137931,73.44827586206897
27193_terrestrial,343,147,180,232,490,52.47813411078717,67.63848396501457
27194_terrestrial,368,155,207,238,523,56.25,64.67391304347827
27195_terrestrial,353,139,196,224,492,55.524079320113316,63.45609065155807
27196_terrestrial,308,122,167,201,430,54.22077922077923,65.25974025974025
27197_terrestrial,241,106,121,175,347,50.20746887966805,72.61410788381743
27198_terrestrial,232,104,113,167,336,48.706896551724135,71.98275862068965
27207_terrestrial,226,111,105,173,337,46.46017699115044,76.54867256637168
27208_terrestrial,228,106,108,169,334,47.368421052631575,74.12280701754386
27209_terrestrial,232,108,112,174,340,48.275862068965516,75
27210_terrestrial,253,109,118,191,362,46.6403162055336,75.49407114624506
27211_terrestrial,272,119,129,205,391,47.42647058823529,75.36764705882352
27212_terrestrial,350,155,180,241,505,51.42857142857142,68.85714285714286
27213_terrestrial,379,174,194,262,553,51.187335092348285,69.12928759894459
27214_terrestrial,394,177,204,265,571,51.776649746192895,67.25888324873097
27215_terrestrial,373,174,189,263,547,50.67024128686327,70.50938337801608
27216_terrestrial,363,146,181,255,509,49.862258953168045,70.24793388429752
27217_terrestrial,383,165,172,275,548,44.90861618798956,71.80156657963447
27218_terrestrial,405,208,171,294,613,42.22222222222222,72.5925925925926
27219_terrestrial,436,245,177,328,681,40.596330275229356,75.22935779816514
27220_terrestrial,450,267,195,333,717,43.333333333333336,74
27255_terrestrial,967,442,702,510,1409,72.59565667011375,52.74043433298863
27256_terrestrial,540,264,364,381,804,67.4074074074074,70.55555555555556
27257_terrestrial,389,162,270,276,551,69.40874035989717,70.95115681233933
27258_terrestrial,359,148,253,260,507,70.47353760445682,72.42339832869081
27259_terrestrial,378,157,260,272,535,68.78306878306879,71.95767195767195
27260_terrestrial,422,169,293,293,591,69.43127962085308,69.43127962085308
27261_terrestrial,794,351,595,382,1145,74.93702770780857,48.11083123425693
27278_terrestrial,1130,424,767,650,1554,67.87610619469027,57.52212389380531
27279_terrestrial,1382,553,945,805,1935,68.37916063675831,58.24891461649783
27280_terrestrial,821,370,584,531,1191,71.13276492082827,64.67722289890378
27281_terrestrial,598,284,422,397,882,70.5685618729097,66.38795986622074
27282_terrestrial,669,306,482,442,975,72.04783258594918,66.06875934230195
27283_terrestrial,613,284,433,417,897,70.63621533442088,68.02610114192495
27284_terrestrial,584,235,412,407,819,70.54794520547945,69.6917808219178
27285_terrestrial,569,235,397,396,804,69.77152899824253,69.59578207381371
27286_terrestrial,634,284,440,437,918,69.4006309148265,68.92744479495269
27287_terrestrial,724,330,511,493,1054,70.58011049723757,68.0939226519337
27288_terrestrial,744,407,519,518,1151,69.75806451612904,69.6236559139785
27289_terrestrial,1252,596,877,760,1848,70.0479233226837,60.70287539936102
27290_terrestrial,1136,447,783,682,1583,68.92605633802818,60.03521126760564
27301_terrestrial,1406,696,893,859,2102,63.51351351351351,61.095305832147936
27302_terrestrial,1458,781,924,890,2239,63.37448559670782,61.04252400548697
27303_terrestrial,1411,702,882,880,2113,62.50885896527285,62.367115520907156
27304_terrestrial,1349,640,836,846,1989,61.97183098591549,62.71312083024463
27305_terrestrial,1280,590,797,772,1870,62.265625,60.3125
27449_terrestrial,261,325,94,207,586,36.015325670498086,79.3103448275862
27450_terrestrial,295,387,101,238,682,34.23728813559322,80.67796610169492
27451_terrestrial,594,648,326,318,1242,54.882154882154886,53.535353535353536
27452_terrestrial,618,719,333,344,1337,53.883495145631066,55.663430420711975
27453_terrestrial,686,776,369,388,1462,53.790087463556844,56.559766763848394
27454_terrestrial,417,623,124,345,1040,29.73621103117506,82.73381294964028
27455_terrestrial,405,633,121,326,1038,29.876543209876544,80.49382716049382
27456_terrestrial,355,521,110,287,876,30.985915492957744,80.84507042253522
27457_terrestrial,660,667,356,391,1327,53.939393939393945,59.24242424242424
27524_terrestrial,905,456,594,422,1361,65.6353591160221,46.629834254143645
27525_terrestrial,881,438,576,411,1319,65.38024971623156,46.651532349602725
27526_terrestrial,565,313,302,351,878,53.451327433628315,62.123893805309734
27527_terrestrial,543,303,277,339,846,51.01289134438306,62.430939226519335
27528_terrestrial,500,292,247,321,792,49.4,64.2
27529_terrestrial,456,265,218,296,721,47.80701754385965,64.91228070175438
27530_terrestrial,419,239,197,276,658,47.01670644391408,65.8711217183771
27531_terrestrial,418,232,191,284,650,45.69377990430622,67.94258373205741
27532_terrestrial,452,236,222,288,688,49.11504424778761,63.716814159292035
27533_terrestrial,472,232,241,294,704,51.059322033898304,62.28813559322034
27534_terrestrial,478,222,242,302,700,50.627615062761514,63.17991631799163
27535_terrestrial,472,226,242,300,698,51.271186440677965,63.559322033898304
27536_terrestrial,480,245,246,305,725,51.24999999999999,63.541666666666664
27537_terrestrial,454,224,228,293,678,50.22026431718062,64.53744493392071
27538_terrestrial,401,210,195,268,611,48.6284289276808,66.83291770573567
27539_terrestrial,388,206,193,262,594,49.74226804123711,67.5257731958763
27540_terrestrial,384,202,196,257,586,51.041666666666664,66.92708333333334
27541_terrestrial,400,204,196,270,604,49,67.5
27542_terrestrial,450,209,229,288,659,50.888888888888886,64
27543_terrestrial,436,214,220,287,650,50.45871559633027,65.82568807339449
27544_terrestrial,396,193,191,280,589,48.23232323232323,70.70707070707071
27545_terrestrial,401,200,195,278,601,48.6284289276808,69.32668329177058
27546_terrestrial,393,190,192,270,583,48.854961832061065,68.70229007633588
27547_terrestrial,364,178,169,260,542,46.42857142857143,71.42857142857143
27548_terrestrial,346,167,158,253,513,45.664739884393065,73.121387283237
27549_terrestrial,325,160,139,251,485,42.769230769230774,77.23076923076924
27550_terrestrial,340,153,154,251,493,45.294117647058826,73.82352941176471
27551_terrestrial,356,157,166,258,513,46.62921348314607,72.47191011235955
27552_terrestrial,370,162,182,266,532,49.18918918918919,71.89189189189189
27553_terrestrial,417,186,214,285,603,51.3189448441247,68.34532374100719
27554_terrestrial,443,184,230,295,627,51.91873589164786,66.59142212189616
27555_terrestrial,423,164,219,282,587,51.77304964539007,66.66666666666666
27556_terrestrial,406,154,213,272,560,52.463054187192114,66.99507389162561
27557_terrestrial,312,135,143,233,447,45.83333333333333,74.67948717948718
27558_terrestrial,294,124,137,219,418,46.59863945578231,74.48979591836735
27559_terrestrial,292,119,134,215,411,45.89041095890411,73.63013698630137
27560_terrestrial,284,127,128,211,411,45.07042253521127,74.29577464788733
27561_terrestrial,275,127,119,209,402,43.27272727272727,76
27562_terrestrial,285,128,119,219,413,41.75438596491228,76.84210526315789
27563_terrestrial,293,139,124,229,432,42.32081911262799,78.15699658703072
27564_terrestrial,308,154,127,243,462,41.23376623376623,78.8961038961039
27565_terrestrial,309,164,131,243,473,42.394822006472495,78.64077669902912
27566_terrestrial,285,148,123,225,433,43.15789473684211,78.94736842105263
27567_terrestrial,270,133,117,214,403,43.333333333333336,79.25925925925927
27568_terrestrial,274,132,120,215,406,43.79562043795621,78.46715328467153
27569_terrestrial,278,135,124,217,413,44.60431654676259,78.05755395683454
27570_terrestrial,294,138,129,230,432,43.87755102040816,78.2312925170068
27571_terrestrial,309,141,142,235,450,45.9546925566343,76.05177993527508
27572_terrestrial,343,169,167,250,512,48.68804664723032,72.8862973760933
27573_terrestrial,390,189,199,268,579,51.02564102564102,68.71794871794872
27574_terrestrial,412,199,207,277,611,50.24271844660194,67.23300970873787
27575_terrestrial,414,192,207,283,606,50,68.35748792270532
27576_terrestrial,397,169,189,277,566,47.607052896725435,69.77329974811083
27577_terrestrial,410,203,177,296,613,43.170731707317074,72.1951219512195
27578_terrestrial,421,231,171,316,652,40.61757719714964,75.05938242280284
27579_terrestrial,412,243,170,306,655,41.262135922330096,74.27184466019418
27580_terrestrial,393,229,173,286,622,44.02035623409669,72.7735368956743
27581_terrestrial,344,176,165,242,520,47.96511627906977,70.34883720930233
27615_terrestrial,968,416,708,522,1384,73.14049586776859,53.925619834710744
27616_terrestrial,550,337,364,389,887,66.18181818181819,70.72727272727273
27617_terrestrial,432,191,291,322,623,67.36111111111111,74.53703703703704
27618_terrestrial,388,164,269,281,552,69.3298969072165,72.42268041237114
27619_terrestrial,396,173,275,284,569,69.44444444444444,71.71717171717171
27620_terrestrial,455,185,322,311,640,70.76923076923077,68.35164835164835
27621_terrestrial,849,364,632,422,1213,74.44051825677266,49.705535924617195
27633_terrestrial,700,261,461,419,961,65.85714285714286,59.857142857142854
27634_terrestrial,700,265,461,419,965,65.85714285714286,59.857142857142854
27639_terrestrial,1411,563,935,834,1974,66.26506024096386,59.107016300496106
27640_terrestrial,1379,625,990,782,2004,71.79115300942712,56.70775924583032
27641_terrestrial,1159,549,856,624,1708,73.8567730802416,53.83951682484901
27642_terrestrial,696,313,500,458,1009,71.83908045977012,65.80459770114942
27643_terrestrial,680,309,475,464,989,69.85294117647058,68.23529411764706
27644_terrestrial,613,238,443,415,851,72.26753670473083,67.69983686786297
27645_terrestrial,587,226,427,402,813,72.7427597955707,68.48381601362861
27646_terrestrial,586,241,415,407,827,70.81911262798634,69.45392491467577
27647_terrestrial,612,252,430,432,864,70.26143790849673,70.58823529411765
27648_terrestrial,697,322,487,484,1019,69.87087517934003,69.44045911047347
27649_terrestrial,700,352,487,480,1052,69.57142857142857,68.57142857142857
27650_terrestrial,1194,472,823,715,1666,68.92797319932998,59.882747068676714
27661_terrestrial,1448,742,921,881,2190,63.60497237569061,60.842541436464096
27662_terrestrial,1488,787,947,904,2275,63.642473118279575,60.752688172043015
27663_terrestrial,1428,714,899,874,2142,62.95518207282913,61.20448179271709
27664_terrestrial,1389,718,868,858,2107,62.491000719942406,61.77105831533477
27665_terrestrial,1385,701,867,854,2086,62.59927797833935,61.66064981949459
27685_terrestrial,691,227,465,422,918,67.29377713458756,61.070911722141815
27813_terrestrial,583,585,340,297,1168,58.31903945111492,50.943396226415096
27814_terrestrial,646,712,345,366,1358,53.40557275541795,56.656346749226
27815_terrestrial,414,656,125,343,1070,30.193236714975846,82.85024154589372
27816_terrestrial,350,535,116,279,885,33.14285714285714,79.71428571428572
27817_terrestrial,667,684,360,394,1351,53.973013493253376,59.070464767616194
27828_terrestrial,630,567,365,353,1197,57.936507936507944,56.03174603174603
27829_terrestrial,637,576,368,357,1213,57.77080062794349,56.043956043956044
27830_terrestrial,660,646,385,368,1306,58.333333333333336,55.757575757575765
27831_terrestrial,654,697,379,374,1351,57.95107033639144,57.18654434250765
27832_terrestrial,449,356,313,208,805,69.71046770601336,46.32516703786192
27884_terrestrial,870,420,579,387,1290,66.55172413793103,44.48275862068966
27885_terrestrial,586,313,319,350,899,54.436860068259385,59.72696245733788
27886_terrestrial,569,320,324,328,889,56.94200351493849,57.64499121265377
27887_terrestrial,553,313,306,322,866,55.33453887884268,58.22784810126582
27888_terrestrial,536,317,286,323,853,53.35820895522389,60.26119402985075
27889_terrestrial,483,294,243,305,777,50.31055900621118,63.14699792960663
27890_terrestrial,440,274,207,295,714,47.04545454545455,67.04545454545455
27891_terrestrial,455,277,215,300,732,47.25274725274725,65.93406593406593
27892_terrestrial,494,295,249,310,789,50.40485829959515,62.75303643724697
27893_terrestrial,479,281,237,308,760,49.478079331941544,64.30062630480167
27894_terrestrial,462,258,229,300,720,49.56709956709957,64.93506493506493
27895_terrestrial,418,234,196,287,652,46.889952153110045,68.6602870813397
27896_terrestrial,431,235,215,283,666,49.88399071925754,65.66125290023201
27897_terrestrial,410,225,206,268,635,50.24390243902439,65.3658536585366
27898_terrestrial,430,225,211,285,655,49.06976744186046,66.27906976744185
27899_terrestrial,439,229,221,285,668,50.34168564920274,64.92027334851936
27900_terrestrial,421,218,215,274,639,51.06888361045131,65.08313539192399
27901_terrestrial,432,221,215,279,653,49.76851851851852,64.58333333333334
27902_terrestrial,466,239,230,304,705,49.35622317596567,65.23605150214593
27903_terrestrial,488,244,241,320,732,49.385245901639344,65.57377049180327
27904_terrestrial,498,232,249,319,730,50,64.05622489959839
27905_terrestrial,461,225,231,304,686,50.108459869848154,65.94360086767897
27906_terrestrial,432,216,211,290,648,48.842592592592595,67.12962962962963
27907_terrestrial,435,216,211,296,651,48.50574712643678,68.04597701149426
27908_terrestrial,421,218,198,296,639,47.03087885985748,70.30878859857482
27909_terrestrial,416,217,191,302,633,45.91346153846153,72.59615384615384
27910_terrestrial,430,215,204,303,645,47.44186046511628,70.46511627906978
27911_terrestrial,422,201,201,294,623,47.6303317535545,69.66824644549763
27912_terrestrial,404,206,193,283,610,47.77227722772277,70.04950495049505
27913_terrestrial,448,216,231,306,664,51.5625,68.30357142857143
27914_terrestrial,474,227,244,318,701,51.47679324894515,67.08860759493672
27915_terrestrial,482,223,246,324,705,51.037344398340245,67.21991701244814
27916_terrestrial,459,196,236,312,655,51.4161220043573,67.97385620915033
27917_terrestrial,354,159,162,264,513,45.76271186440678,74.57627118644068
27918_terrestrial,330,140,146,249,470,44.24242424242424,75.45454545454545
27919_terrestrial,337,145,154,251,482,45.6973293768546,74.4807121661721
27920_terrestrial,329,142,145,247,471,44.07294832826747,75.07598784194529
27921_terrestrial,334,142,146,254,476,43.712574850299404,76.04790419161677
27922_terrestrial,330,145,145,247,475,43.93939393939394,74.84848484848486
27923_terrestrial,345,157,153,263,502,44.34782608695652,76.23188405797102
27924_terrestrial,342,171,143,270,513,41.812865497076025,78.94736842105263
27925_terrestrial,329,174,139,259,503,42.24924012158054,78.72340425531915
27926_terrestrial,301,157,129,239,458,42.857142857142854,79.40199335548172
27927_terrestrial,284,146,123,222,430,43.309859154929576,78.16901408450704
27928_terrestrial,285,148,121,224,433,42.45614035087719,78.59649122807018
27929_terrestrial,284,150,120,222,434,42.25352112676056,78.16901408450704
27930_terrestrial,303,158,129,239,461,42.57425742574257,78.87788778877888
27931_terrestrial,315,161,136,246,476,43.17460317460318,78.0952380952381
27932_terrestrial,359,176,173,259,535,48.18941504178273,72.14484679665738
27933_terrestrial,383,196,189,274,579,49.34725848563969,71.54046997389034
27934_terrestrial,421,208,207,293,629,49.16864608076009,69.59619952494062
27935_terrestrial,446,203,218,305,649,48.87892376681614,68.38565022421524
27936_terrestrial,435,194,211,298,629,48.50574712643678,68.50574712643677
27937_terrestrial,456,247,201,330,703,44.07894736842105,72.36842105263158
27938_terrestrial,437,273,184,329,710,42.10526315789473,75.28604118993135
27939_terrestrial,398,244,172,294,642,43.21608040201005,73.86934673366834
27940_terrestrial,389,216,170,290,605,43.70179948586118,74.55012853470437
27941_terrestrial,346,173,155,251,519,44.797687861271676,72.54335260115607
27942_terrestrial,296,143,147,207,439,49.66216216216216,69.93243243243244
27975_terrestrial,454,196,318,321,650,70.04405286343612,70.70484581497797
27976_terrestrial,1030,546,740,574,1576,71.84466019417476,55.72815533980583
27977_terrestrial,520,289,341,380,809,65.57692307692308,73.07692307692307
27978_terrestrial,433,187,299,311,620,69.05311778290994,71.82448036951502
27979_terrestrial,424,199,292,304,623,68.86792452830188,71.69811320754717
27980_terrestrial,916,396,667,481,1312,72.81659388646288,52.51091703056768
27981_terrestrial,848,362,630,427,1210,74.29245283018868,50.35377358490566
27993_terrestrial,705,273,464,424,978,65.81560283687942,60.141843971631204
27994_terrestrial,616,228,409,349,844,66.3961038961039,56.65584415584416
27998_terrestrial,986,305,632,596,1291,64.09736308316431,60.446247464503045
27999_terrestrial,1399,552,931,816,1951,66.54753395282344,58.32737669764118
28000_terrestrial,1351,635,970,754,1986,71.79866765358993,55.81051073279053
28001_terrestrial,1121,515,825,611,1636,73.5950044603033,54.504906333630686
28002_terrestrial,1155,532,846,631,1687,73.24675324675324,54.63203463203463
28003_terrestrial,1247,591,905,704,1838,72.57417802726543,56.45549318364074
28004_terrestrial,697,290,500,468,987,71.73601147776183,67.14490674318509
28005_terrestrial,640,258,461,439,898,72.03125,68.59375
28006_terrestrial,598,234,427,423,832,71.40468227424749,70.73578595317726
28007_terrestrial,651,266,459,453,917,70.50691244239631,69.5852534562212
28008_terrestrial,703,325,490,489,1028,69.70128022759602,69.55903271692745
28009_terrestrial,701,387,482,481,1088,68.75891583452211,68.61626248216834
28010_terrestrial,1250,517,853,755,1767,68.24,60.4
28020_terrestrial,1231,520,776,751,1751,63.03818034118602,61.00731112916328
28021_terrestrial,1399,692,886,852,2091,63.330950679056464,60.90064331665476
28022_terrestrial,1390,685,877,839,2075,63.093525179856115,60.35971223021582
28023_terrestrial,1294,617,810,774,1911,62.59659969088099,59.8145285935085
28024_terrestrial,1410,705,885,870,2115,62.76595744680851,61.702127659574465
28025_terrestrial,1443,786,904,900,2229,62.64726264726265,62.37006237006237
28026_terrestrial,1321,646,813,813,1967,61.544284632853895,61.544284632853895
28174_terrestrial,577,597,337,295,1174,58.4055459272097,51.12651646447141
28175_terrestrial,740,975,383,433,1715,51.75675675675676,58.513513513513516
28176_terrestrial,415,627,135,336,1042,32.53012048192771,80.96385542168674
28177_terrestrial,656,741,360,384,1397,54.87804878048781,58.536585365853654
28186_terrestrial,754,859,412,448,1613,54.64190981432361,59.41644562334217
28187_terrestrial,761,853,402,457,1614,52.82522996057819,60.05256241787122
28188_terrestrial,755,801,407,446,1556,53.907284768211916,59.0728476821192
28189_terrestrial,694,685,398,394,1379,57.34870317002881,56.77233429394812
28190_terrestrial,671,674,382,382,1345,56.92995529061102,56.92995529061102
28191_terrestrial,705,700,395,403,1405,56.02836879432624,57.16312056737589
28192_terrestrial,698,660,400,394,1358,57.306590257879655,56.446991404011456
28196_terrestrial,498,363,335,229,861,67.26907630522089,45.98393574297189
28197_terrestrial,499,352,336,232,851,67.33466933867736,46.49298597194389
28200_terrestrial,486,378,317,234,864,65.22633744855966,48.148148148148145
28244_terrestrial,769,348,538,324,1117,69.96098829648895,42.132639791937585
28245_terrestrial,827,388,572,350,1215,69.16565900846433,42.32164449818622
28246_terrestrial,847,422,583,350,1269,68.83116883116884,41.32231404958678
28247_terrestrial,510,302,284,290,812,55.68627450980392,56.86274509803921
28248_terrestrial,502,303,281,280,805,55.97609561752988,55.77689243027888
28249_terrestrial,479,291,258,278,770,53.86221294363257,58.037578288100214
28250_terrestrial,459,285,244,272,744,53.15904139433552,59.25925925925925
28251_terrestrial,467,275,247,277,742,52.890792291220556,59.314775160599574
28252_terrestrial,488,277,252,294,765,51.63934426229508,60.245901639344254
28253_terrestrial,468,277,236,292,745,50.427350427350426,62.39316239316239
28254_terrestrial,416,249,206,269,665,49.519230769230774,64.66346153846155
28255_terrestrial,459,258,240,282,717,52.28758169934641,61.43790849673203
28256_terrestrial,460,257,238,281,717,51.73913043478261,61.08695652173913
28257_terrestrial,466,258,244,283,724,52.36051502145923,60.72961373390557
28258_terrestrial,473,265,242,296,738,51.162790697674424,62.579281183932345
28259_terrestrial,453,267,220,301,720,48.56512141280353,66.44591611479028
28260_terrestrial,480,265,242,308,745,50.416666666666664,64.16666666666667
28261_terrestrial,501,279,255,314,780,50.898203592814376,62.6746506986028
28262_terrestrial,491,285,243,319,776,49.490835030549896,64.96945010183299
28263_terrestrial,490,289,242,318,779,49.38775510204081,64.89795918367346
28264_terrestrial,499,266,254,318,765,50.901803607214426,63.727454909819635
28265_terrestrial,489,259,253,310,748,51.738241308793455,63.394683026584865
28266_terrestrial,479,261,244,310,740,50.939457202505224,64.71816283924844
28267_terrestrial,481,257,239,317,738,49.68814968814969,65.9043659043659
28268_terrestrial,469,252,222,320,721,47.33475479744136,68.23027718550107
28269_terrestrial,468,258,218,325,726,46.58119658119658,69.44444444444444
28270_terrestrial,466,250,219,322,716,46.99570815450644,69.09871244635193
28271_terrestrial,461,241,218,316,702,47.288503253796094,68.54663774403471
28272_terrestrial,461,235,229,308,696,49.67462039045553,66.81127982646422
28273_terrestrial,457,233,233,303,690,50.984682713347915,66.3019693654267
28274_terrestrial,472,247,236,319,719,50,67.58474576271186
28275_terrestrial,495,237,243,329,732,49.09090909090909,66.46464646464646
28276_terrestrial,464,222,236,306,686,50.86206896551724,65.94827586206897
28277_terrestrial,410,193,201,286,603,49.02439024390244,69.7560975609756
28278_terrestrial,346,174,153,256,520,44.21965317919075,73.98843930635837
28279_terrestrial,351,168,165,250,519,47.008547008547005,71.22507122507122
28280_terrestrial,355,170,168,248,525,47.32394366197183,69.85915492957746
28281_terrestrial,351,166,167,249,517,47.57834757834758,70.94017094017094
28282_terrestrial,337,164,155,247,501,45.99406528189911,73.29376854599407
28283_terrestrial,339,162,151,253,501,44.54277286135693,74.63126843657817
28284_terrestrial,331,164,147,249,495,44.41087613293052,75.22658610271903
28285_terrestrial,314,154,144,236,468,45.85987261146497,75.15923566878982
28286_terrestrial,303,148,138,231,451,45.54455445544555,76.23762376237624
28287_terrestrial,302,139,140,227,441,46.35761589403973,75.16556291390728
28288_terrestrial,299,147,135,230,446,45.1505016722408,76.92307692307693
28289_terrestrial,306,151,137,236,457,44.771241830065364,77.12418300653596
28290_terrestrial,329,173,148,254,502,44.984802431610944,77.20364741641338
28291_terrestrial,357,181,165,267,538,46.21848739495798,74.78991596638656
28292_terrestrial,375,193,183,267,568,48.8,71.2
28293_terrestrial,386,208,190,275,594,49.22279792746114,71.24352331606218
28294_terrestrial,414,207,212,280,621,51.20772946859904,67.6328502415459
28295_terrestrial,451,205,217,313,656,48.11529933481153,69.40133037694012
28296_terrestrial,461,203,230,312,664,49.891540130151846,67.67895878524945
28297_terrestrial,475,291,214,348,766,45.05263157894737,73.26315789473684
28298_terrestrial,438,307,187,328,745,42.69406392694064,74.88584474885845
28299_terrestrial,392,260,169,295,652,43.11224489795919,75.25510204081633
28300_terrestrial,395,234,178,293,629,45.063291139240505,74.17721518987341
28301_terrestrial,389,225,173,283,614,44.473007712082264,72.75064267352185
28302_terrestrial,355,201,164,257,556,46.19718309859155,72.3943661971831
28336_terrestrial,1059,521,764,576,1580,72.14353163361662,54.39093484419264
28337_terrestrial,567,447,377,399,1014,66.49029982363317,70.37037037037037
28338_terrestrial,486,245,320,355,731,65.84362139917695,73.04526748971193
28339_terrestrial,424,208,293,298,632,69.10377358490565,70.28301886792453
28340_terrestrial,910,404,662,473,1314,72.74725274725274,51.978021978021985
28353_terrestrial,703,277,462,424,980,65.71834992887624,60.31294452347083
28354_terrestrial,616,230,409,349,846,66.3961038961039,56.65584415584416
28359_terrestrial,1377,533,911,793,1910,66.15831517792301,57.58896151053013
28360_terrestrial,1309,604,933,729,1913,71.27578304048893,55.69136745607334
28363_terrestrial,1180,534,858,662,1714,72.71186440677965,56.10169491525424
28364_terrestrial,1191,549,865,672,1740,72.62804366078926,56.42317380352645
28365_terrestrial,692,298,499,466,990,72.10982658959537,67.34104046242774
28366_terrestrial,590,227,421,418,817,71.35593220338983,70.84745762711864
28367_terrestrial,623,261,442,436,884,70.9470304975923,69.98394863563404
28368_terrestrial,693,381,474,486,1074,68.3982683982684,70.12987012987013
28369_terrestrial,1317,620,902,793,1937,68.48899012908124,60.21260440394837
28370_terrestrial,1221,482,833,730,1703,68.22276822276822,59.78705978705978
28380_terrestrial,1310,590,828,798,1900,63.20610687022901,60.91603053435114
28381_terrestrial,1243,530,784,753,1773,63.07320997586484,60.57924376508448
28382_terrestrial,1291,606,806,786,1897,62.432223082881485,60.88303640588691
28383_terrestrial,1343,646,839,814,1989,62.47207743857036,60.61057334326135
28384_terrestrial,1376,673,859,830,2049,62.42732558139535,60.31976744186046
28385_terrestrial,1445,837,908,861,2282,62.83737024221453,59.58477508650519
28386_terrestrial,1380,722,852,838,2102,61.73913043478261,60.72463768115942
28535_terrestrial,767,1087,394,458,1854,51.36897001303781,59.71316818774446
28536_terrestrial,803,1300,392,492,2103,48.81693648816937,61.27023661270237
28537_terrestrial,747,1142,375,467,1889,50.20080321285141,62.51673360107095
28545_terrestrial,698,731,395,401,1429,56.59025787965616,57.44985673352435
28546_terrestrial,765,864,412,456,1629,53.8562091503268,59.6078431372549
28547_terrestrial,488,798,163,397,1286,33.40163934426229,81.35245901639344
28548_terrestrial,575,823,244,406,1398,42.434782608695656,70.6086956521739
28549_terrestrial,719,708,409,413,1427,56.88456189151599,57.44089012517385
28550_terrestrial,362,551,120,300,913,33.14917127071823,82.87292817679558
28551_terrestrial,404,645,140,326,1049,34.65346534653465,80.6930693069307
28552_terrestrial,828,927,448,489,1755,54.106280193236714,59.05797101449275
28553_terrestrial,827,934,444,493,1761,53.68802902055623,59.6130592503023
28554_terrestrial,820,892,446,484,1712,54.390243902439025,59.02439024390244
28555_terrestrial,755,772,431,418,1527,57.086092715231786,55.36423841059602
28556_terrestrial,790,882,451,443,1672,57.08860759493671,56.075949367088604
28557_terrestrial,827,920,464,474,1747,56.10640870616687,57.31559854897219
28558_terrestrial,803,875,459,450,1678,57.16064757160647,56.039850560398506
28559_terrestrial,827,932,465,466,1759,56.2273276904474,56.34824667472793
28560_terrestrial,627,582,371,345,1209,59.17065390749602,55.02392344497608
28605_terrestrial,722,343,515,285,1065,71.32963988919667,39.473684210526315
28606_terrestrial,794,388,557,316,1182,70.15113350125944,39.79848866498741
28607_terrestrial,544,310,315,296,854,57.904411764705884,54.41176470588235
28608_terrestrial,532,349,297,292,881,55.82706766917293,54.88721804511278
28609_terrestrial,529,349,293,285,878,55.3875236294896,53.875236294896034
28610_terrestrial,494,332,269,279,826,54.453441295546554,56.477732793522264
28611_terrestrial,486,311,266,276,797,54.73251028806584,56.79012345679012
28612_terrestrial,465,290,247,273,755,53.118279569892465,58.70967741935483
28613_terrestrial,437,273,223,277,710,51.029748283752866,63.38672768878718
28614_terrestrial,456,274,238,283,730,52.19298245614035,62.06140350877193
28615_terrestrial,476,286,252,288,762,52.94117647058824,60.50420168067227
28616_terrestrial,477,280,246,287,757,51.57232704402516,60.167714884696025
28617_terrestrial,486,284,259,285,770,53.29218106995884,58.64197530864198
28618_terrestrial,484,289,245,298,773,50.6198347107438,61.57024793388429
28619_terrestrial,482,299,235,308,781,48.7551867219917,63.90041493775933
28620_terrestrial,508,303,264,317,811,51.96850393700787,62.40157480314961
28621_terrestrial,524,311,268,326,835,51.14503816793893,62.213740458015266
28622_terrestrial,505,309,255,316,814,50.495049504950494,62.57425742574257
28623_terrestrial,472,293,238,304,765,50.42372881355932,64.40677966101694
28624_terrestrial,502,296,254,317,798,50.59760956175299,63.147410358565736
28625_terrestrial,508,301,260,319,809,51.181102362204726,62.79527559055118
28626_terrestrial,484,294,247,312,778,51.03305785123967,64.46280991735537
28627_terrestrial,474,304,231,317,778,48.734177215189874,66.87763713080169
28628_terrestrial,499,301,244,333,800,48.897795591182366,66.73346693386773
28629_terrestrial,515,319,250,343,834,48.54368932038835,66.60194174757281
28630_terrestrial,492,312,228,335,804,46.34146341463415,68.08943089430895
28631_terrestrial,476,280,221,322,756,46.42857142857143,67.64705882352942
28632_terrestrial,476,266,237,308,742,49.78991596638656,64.70588235294117
28633_terrestrial,478,261,244,307,739,51.04602510460251,64.22594142259415
28634_terrestrial,496,258,255,319,754,51.41129032258065,64.31451612903226
28635_terrestrial,500,261,254,319,761,50.8,63.800000000000004
28636_terrestrial,477,239,247,308,716,51.78197064989518,64.57023060796647
28637_terrestrial,430,216,214,292,646,49.76744186046512,67.90697674418604
28638_terrestrial,419,210,210,279,629,50.11933174224343,66.5871121718377
28639_terrestrial,412,198,207,276,610,50.24271844660194,66.99029126213593
28640_terrestrial,389,195,193,263,584,49.61439588688946,67.60925449871465
28641_terrestrial,383,182,190,260,565,49.60835509138381,67.88511749347258
28642_terrestrial,380,184,176,272,564,46.31578947368421,71.57894736842105
28643_terrestrial,379,175,168,272,554,44.327176781002635,71.76781002638522
28644_terrestrial,372,170,166,269,542,44.623655913978496,72.31182795698925
28645_terrestrial,344,159,152,252,503,44.18604651162791,73.25581395348837
28646_terrestrial,338,163,151,248,501,44.67455621301775,73.37278106508876
28647_terrestrial,328,160,150,236,488,45.73170731707317,71.95121951219512
28648_terrestrial,322,156,154,228,478,47.82608695652174,70.80745341614907
28649_terrestrial,318,163,145,236,481,45.59748427672956,74.21383647798741
28650_terrestrial,355,184,170,258,539,47.88732394366197,72.67605633802818
28651_terrestrial,391,202,187,276,593,47.82608695652174,70.58823529411765
28652_terrestrial,398,218,195,279,616,48.99497487437186,70.10050251256281
28653_terrestrial,408,217,206,282,625,50.49019607843137,69.11764705882352
28654_terrestrial,395,210,186,282,605,47.08860759493671,71.39240506329114
28655_terrestrial,449,219,207,323,668,46.10244988864143,71.93763919821826
28656_terrestrial,451,241,207,321,692,45.8980044345898,71.17516629711751
28657_terrestrial,447,289,203,324,736,45.41387024608501,72.48322147651007
28658_terrestrial,427,289,189,321,716,44.26229508196721,75.17564402810304
28659_terrestrial,416,288,180,324,704,43.269230769230774,77.88461538461539
28660_terrestrial,444,284,186,342,728,41.891891891891895,77.02702702702703
28661_terrestrial,435,279,180,325,714,41.37931034482759,74.71264367816092
28662_terrestrial,404,245,173,300,649,42.82178217821782,74.25742574257426
28663_terrestrial,417,235,191,304,652,45.80335731414868,72.90167865707434
28696_terrestrial,960,393,704,511,1353,73.33333333333333,53.22916666666667
28697_terrestrial,1110,602,789,604,1712,71.08108108108108,54.414414414414416
28698_terrestrial,531,404,353,382,935,66.47834274952919,71.939736346516
28699_terrestrial,437,202,310,304,639,70.93821510297484,69.56521739130434
28700_terrestrial,1012,409,730,528,1421,72.13438735177866,52.17391304347826
28713_terrestrial,675,247,442,401,922,65.48148148148148,59.40740740740741
28719_terrestrial,1446,609,958,845,2055,66.25172890733056,58.437067773167364
28720_terrestrial,1265,597,899,703,1862,71.06719367588933,55.57312252964427
28724_terrestrial,1155,514,829,658,1669,71.77489177489178,56.96969696969697
28725_terrestrial,1209,534,872,698,1743,72.12572373862697,57.73366418527709
28726_terrestrial,1112,453,805,630,1565,72.39208633093526,56.65467625899281
28727_terrestrial,1194,490,832,701,1684,69.68174204355108,58.710217755443885
28728_terrestrial,1224,535,842,716,1759,68.79084967320262,58.496732026143796
28729_terrestrial,1140,465,778,678,1605,68.24561403508773,59.473684210526315
28739_terrestrial,1259,529,797,774,1788,63.30420969023034,61.47736298649722
28740_terrestrial,1291,570,817,788,1861,63.28427575522851,61.03795507358637
28741_terrestrial,1195,455,747,732,1650,62.51046025104603,61.255230125523006
28742_terrestrial,1300,597,807,792,1897,62.07692307692307,60.92307692307693
28743_terrestrial,1388,729,867,841,2117,62.46397694524496,60.590778097982714
28744_terrestrial,1405,713,878,849,2118,62.49110320284698,60.4270462633452
28745_terrestrial,1426,776,897,845,2202,62.903225806451616,59.256661991584856
28746_terrestrial,1388,720,857,837,2108,61.74351585014409,60.30259365994236
28747_terrestrial,1265,533,775,778,1798,61.26482213438735,61.501976284584984
28895_terrestrial,594,643,349,309,1237,58.75420875420876,52.02020202020202
28896_terrestrial,750,1141,380,447,1891,50.66666666666667,59.599999999999994
28897_terrestrial,1035,1556,549,593,2591,53.04347826086957,57.294685990338166
28898_terrestrial,779,1187,380,493,1966,48.78048780487805,63.28626444159179
28899_terrestrial,633,752,353,370,1385,55.76619273301737,58.451816745655606
28900_terrestrial,686,870,358,421,1556,52.1865889212828,61.37026239067055
28901_terrestrial,978,1323,556,537,2301,56.850715746421265,54.90797546012271
28902_terrestrial,705,956,371,432,1661,52.6241134751773,61.27659574468085
28903_terrestrial,637,792,354,377,1429,55.57299843014128,59.183673469387756
28904_terrestrial,654,665,372,375,1319,56.88073394495413,57.3394495412844
28905_terrestrial,696,744,394,402,1440,56.60919540229885,57.758620689655174
28906_terrestrial,366,525,142,290,891,38.79781420765027,79.23497267759562
28907_terrestrial,466,752,157,373,1218,33.69098712446352,80.04291845493562
28908_terrestrial,558,778,240,387,1336,43.01075268817204,69.35483870967742
28909_terrestrial,507,713,227,345,1220,44.773175542406314,68.04733727810651
28910_terrestrial,471,840,157,378,1311,33.33333333333333,80.2547770700637
28911_terrestrial,460,749,161,360,1209,35,78.26086956521739
28912_terrestrial,428,653,161,331,1081,37.61682242990654,77.33644859813083
28913_terrestrial,398,605,152,308,1003,38.19095477386934,77.38693467336684
28914_terrestrial,397,578,156,301,975,39.29471032745592,75.81863979848866
28915_terrestrial,375,550,154,281,925,41.06666666666667,74.93333333333332
28916_terrestrial,395,585,156,300,980,39.49367088607595,75.9493670886076
28917_terrestrial,407,613,158,315,1020,38.82063882063882,77.39557739557739
28918_terrestrial,755,769,451,416,1524,59.735099337748345,55.09933774834437
28919_terrestrial,723,714,429,410,1437,59.33609958506224,56.708160442600274
28920_terrestrial,684,655,401,389,1339,58.62573099415205,56.87134502923976
28967_terrestrial,836,465,575,341,1301,68.77990430622009,40.78947368421053
28968_terrestrial,601,428,331,337,1029,55.074875207986686,56.07321131447587
28969_terrestrial,619,491,355,326,1110,57.35056542810986,52.66558966074314
28970_terrestrial,612,472,346,323,1084,56.5359477124183,52.77777777777778
28971_terrestrial,527,367,293,288,894,55.597722960151806,54.64895635673624
28972_terrestrial,475,305,262,265,780,55.1578947368421,55.78947368421052
28973_terrestrial,474,298,253,280,772,53.37552742616034,59.07172995780591
28974_terrestrial,486,312,251,299,798,51.64609053497943,61.52263374485597
28975_terrestrial,493,330,248,312,823,50.30425963488844,63.28600405679513
28976_terrestrial,529,357,269,326,886,50.85066162570888,61.62570888468809
28977_terrestrial,536,359,275,323,895,51.30597014925373,60.26119402985075
28978_terrestrial,522,332,273,313,854,52.29885057471264,59.961685823754785
28979_terrestrial,505,334,262,306,839,51.881188118811885,60.59405940594059
28980_terrestrial,511,322,273,307,833,53.42465753424658,60.07827788649707
28981_terrestrial,514,324,273,308,838,53.11284046692607,59.92217898832685
28982_terrestrial,506,316,272,309,822,53.75494071146245,61.06719367588933
28983_terrestrial,490,289,258,307,779,52.6530612244898,62.65306122448979
28984_terrestrial,493,291,257,303,784,52.129817444219064,61.4604462474645
28985_terrestrial,503,310,258,313,813,51.29224652087475,62.22664015904572
28986_terrestrial,489,309,248,314,798,50.715746421267895,64.21267893660531
28987_terrestrial,495,302,248,320,797,50.101010101010104,64.64646464646465
28988_terrestrial,507,313,247,334,820,48.717948717948715,65.87771203155819
28989_terrestrial,537,346,257,356,883,47.8584729981378,66.29422718808193
28990_terrestrial,517,342,244,343,859,47.195357833655706,66.34429400386847
28991_terrestrial,475,305,229,313,780,48.21052631578947,65.89473684210526
28992_terrestrial,458,297,228,295,755,49.78165938864629,64.41048034934498
28993_terrestrial,512,287,260,316,799,50.78125,61.71875
28994_terrestrial,517,282,271,314,799,52.41779497098646,60.73500967117988
28995_terrestrial,493,263,255,305,756,51.724137931034484,61.86612576064908
28996_terrestrial,456,242,230,292,698,50.43859649122807,64.03508771929825
28997_terrestrial,432,235,213,286,667,49.30555555555556,66.20370370370371
28998_terrestrial,437,232,218,282,669,49.88558352402746,64.53089244851259
28999_terrestrial,440,232,222,280,672,50.45454545454545,63.63636363636363
29000_terrestrial,439,229,219,283,668,49.88610478359909,64.46469248291572
29001_terrestrial,448,237,218,292,685,48.660714285714285,65.17857142857143
29002_terrestrial,439,231,203,297,670,46.24145785876993,67.65375854214123
29003_terrestrial,411,219,189,281,630,45.98540145985402,68.3698296836983
29004_terrestrial,369,195,161,262,564,43.63143631436314,71.00271002710026
29005_terrestrial,341,188,149,245,529,43.6950146627566,71.8475073313783
29006_terrestrial,351,182,159,244,533,45.2991452991453,69.51566951566952
29007_terrestrial,353,174,163,244,527,46.1756373937677,69.12181303116147
29008_terrestrial,346,169,170,237,515,49.13294797687861,68.4971098265896
29009_terrestrial,361,169,185,241,530,51.24653739612188,66.7590027700831
29010_terrestrial,392,204,198,264,596,50.51020408163265,67.3469387755102
29011_terrestrial,418,217,208,285,635,49.760765550239235,68.18181818181817
29012_terrestrial,422,218,218,277,640,51.65876777251185,65.63981042654028
29013_terrestrial,430,212,216,286,642,50.23255813953489,66.51162790697674
29014_terrestrial,407,207,196,280,614,48.157248157248155,68.7960687960688
29015_terrestrial,439,220,209,305,659,47.60820045558087,69.4760820045558
29016_terrestrial,452,262,198,333,714,43.80530973451327,73.67256637168141
29017_terrestrial,460,286,202,341,746,43.913043478260875,74.1304347826087
29018_terrestrial,454,300,196,345,754,43.17180616740088,75.99118942731278
29019_terrestrial,464,314,196,354,778,42.241379310344826,76.29310344827587
29020_terrestrial,512,394,203,392,906,39.6484375,76.5625
29021_terrestrial,484,341,200,359,825,41.32231404958678,74.17355371900827
29022_terrestrial,444,312,175,339,756,39.414414414414416,76.35135135135135
29023_terrestrial,435,294,175,332,729,40.229885057471265,76.32183908045977
29057_terrestrial,1152,560,821,619,1712,71.26736111111111,53.732638888888886
29058_terrestrial,550,375,372,384,925,67.63636363636364,69.81818181818183
29059_terrestrial,1036,443,743,553,1479,71.71814671814671,53.37837837837838
29060_terrestrial,1229,495,861,677,1724,70.05695687550855,55.08543531326282
29061_terrestrial,1136,441,790,628,1577,69.54225352112677,55.28169014084507
29073_terrestrial,633,210,409,379,843,64.6129541864139,59.87361769352291
29079_terrestrial,1478,663,986,851,2141,66.71177266576454,57.57780784844384
29080_terrestrial,1292,654,911,722,1946,70.5108359133127,55.88235294117647
29081_terrestrial,915,351,652,505,1266,71.25683060109289,55.19125683060109
29085_terrestrial,1032,411,739,582,1443,71.60852713178295,56.395348837209305
29086_terrestrial,1117,445,797,626,1562,71.35183527305283,56.04297224709042
29087_terrestrial,1096,427,765,633,1523,69.7992700729927,57.75547445255474
29098_terrestrial,1254,525,793,775,1779,63.23763955342903,61.802232854864435
29099_terrestrial,1277,551,814,778,1828,63.74314800313235,60.92404072043853
29103_terrestrial,1367,663,859,828,2030,62.838332114118515,60.570592538405265
29104_terrestrial,1441,816,909,861,2257,63.08119361554476,59.75017349063151
29105_terrestrial,1369,702,849,823,2071,62.016070124178235,60.11687363038715
29106_terrestrial,1432,801,890,865,2233,62.150837988826815,60.4050279329609
29107_terrestrial,1372,692,847,845,2064,61.73469387755102,61.588921282798836
29257_terrestrial,711,998,370,411,1709,52.03938115330521,57.80590717299579
29258_terrestrial,1036,1537,566,576,2573,54.633204633204635,55.5984555984556
29259_terrestrial,1003,1308,561,552,2311,55.932203389830505,55.03489531405783
29260_terrestrial,1002,1348,551,560,2350,54.99001996007984,55.88822355289421
29261_terrestrial,725,1073,386,421,1798,53.241379310344826,58.06896551724138
29262_terrestrial,714,1035,388,417,1749,54.34173669467787,58.40336134453782
29263_terrestrial,983,1315,563,529,2298,57.273652085452696,53.81485249237029
29264_terrestrial,746,937,407,444,1683,54.557640750670245,59.51742627345844
29265_terrestrial,403,638,148,321,1041,36.72456575682382,79.65260545905707
29266_terrestrial,388,631,137,313,1019,35.30927835051546,80.6701030927835
29267_terrestrial,458,753,154,371,1211,33.624454148471614,81.00436681222706
29268_terrestrial,435,771,127,366,1206,29.195402298850574,84.13793103448276
29269_terrestrial,487,937,152,401,1424,31.211498973305957,82.34086242299796
29270_terrestrial,488,901,156,388,1389,31.967213114754102,79.50819672131148
29271_terrestrial,382,575,143,293,957,37.43455497382199,76.70157068062828
29272_terrestrial,335,504,134,253,839,40,75.5223880597015
29273_terrestrial,324,496,135,244,820,41.66666666666667,75.30864197530865
29274_terrestrial,333,503,140,251,836,42.04204204204204,75.37537537537537
29275_terrestrial,336,509,139,255,845,41.36904761904761,75.89285714285714
29276_terrestrial,364,550,144,283,914,39.56043956043956,77.74725274725274
29277_terrestrial,408,626,163,313,1034,39.950980392156865,76.7156862745098
29278_terrestrial,428,697,168,329,1125,39.25233644859813,76.86915887850468
29279_terrestrial,455,707,178,351,1162,39.120879120879124,77.14285714285715
29280_terrestrial,743,796,409,438,1539,55.047106325706594,58.950201884253026
29281_terrestrial,694,717,384,403,1411,55.3314121037464,58.06916426512968
29327_terrestrial,817,470,569,331,1287,69.64504283965728,40.514075887392906
29328_terrestrial,875,529,597,362,1404,68.22857142857143,41.37142857142857
29329_terrestrial,613,490,350,332,1103,57.09624796084829,54.15986949429038
29330_terrestrial,628,545,359,330,1173,57.16560509554141,52.547770700636946
29331_terrestrial,646,591,360,348,1237,55.72755417956656,53.86996904024768
29332_terrestrial,602,567,332,328,1169,55.14950166112956,54.48504983388705
29333_terrestrial,531,427,281,310,958,52.91902071563088,58.3804143126177
29334_terrestrial,500,376,255,308,876,51,61.6
29335_terrestrial,497,369,249,312,866,50.10060362173038,62.776659959758554
29336_terrestrial,540,406,275,326,946,50.92592592592593,60.370370370370374
29337_terrestrial,546,414,287,324,960,52.56410256410257,59.34065934065934
29338_terrestrial,547,405,300,310,952,54.844606946983546,56.672760511883006
29339_terrestrial,552,379,309,311,931,55.97826086956522,56.34057971014492
29340_terrestrial,554,362,314,311,916,56.678700361010826,56.13718411552347
29341_terrestrial,579,405,323,317,984,55.78583765112263,54.74956822107081
29342_terrestrial,519,355,287,299,874,55.29865125240848,57.61078998073218
29343_terrestrial,505,327,279,293,832,55.24752475247525,58.01980198019802
29344_terrestrial,520,318,289,299,838,55.57692307692308,57.49999999999999
29345_terrestrial,549,338,300,317,887,54.644808743169406,57.74134790528234
29346_terrestrial,530,324,282,317,854,53.20754716981132,59.81132075471698
29347_terrestrial,504,306,259,316,810,51.388888888888886,62.698412698412696
29348_terrestrial,499,291,250,317,790,50.1002004008016,63.52705410821643
29349_terrestrial,498,309,245,322,807,49.19678714859438,64.65863453815261
29350_terrestrial,495,303,247,321,798,49.898989898989896,64.84848484848484
29351_terrestrial,473,288,235,304,761,49.68287526427061,64.2706131078224
29352_terrestrial,485,294,241,305,779,49.69072164948454,62.88659793814433
29353_terrestrial,521,315,259,322,836,49.71209213051823,61.80422264875239
29354_terrestrial,530,313,272,315,843,51.320754716981135,59.43396226415094
29355_terrestrial,497,279,254,300,776,51.10663983903421,60.36217303822937
29356_terrestrial,442,245,221,281,687,50,63.57466063348416
29357_terrestrial,422,243,212,272,665,50.23696682464455,64.45497630331754
29358_terrestrial,422,234,210,273,656,49.763033175355446,64.69194312796208
29359_terrestrial,466,259,232,293,725,49.78540772532189,62.8755364806867
29360_terrestrial,477,273,231,309,750,48.42767295597484,64.77987421383648
29361_terrestrial,459,272,219,303,731,47.712418300653596,66.01307189542483
29362_terrestrial,458,265,221,301,723,48.25327510917031,65.72052401746726
29363_terrestrial,400,235,200,256,635,50,64
29364_terrestrial,363,214,175,238,577,48.209366391184574,65.56473829201101
29365_terrestrial,371,219,177,242,590,47.7088948787062,65.22911051212938
29366_terrestrial,359,215,169,239,574,47.07520891364902,66.57381615598887
29367_terrestrial,359,213,167,242,572,46.51810584958218,67.40947075208913
29368_terrestrial,373,208,178,253,581,47.72117962466488,67.828418230563
29369_terrestrial,376,206,181,254,582,48.138297872340424,67.5531914893617
29370_terrestrial,390,199,193,260,589,49.48717948717949,66.66666666666666
29371_terrestrial,418,207,209,275,625,50,65.78947368421053
29372_terrestrial,422,207,216,276,629,51.18483412322274,65.40284360189574
29373_terrestrial,426,203,217,274,629,50.93896713615024,64.31924882629107
29374_terrestrial,492,229,246,318,721,50,64.63414634146342
29375_terrestrial,548,288,264,360,836,48.175182481751825,65.69343065693431
29376_terrestrial,505,299,235,350,804,46.53465346534654,69.3069306930693
29377_terrestrial,461,316,194,348,777,42.0824295010846,75.48806941431671
29378_terrestrial,478,326,195,370,804,40.79497907949791,77.40585774058577
29379_terrestrial,504,372,202,385,876,40.07936507936508,76.38888888888889
29380_terrestrial,522,416,213,392,938,40.804597701149426,75.09578544061303
29381_terrestrial,494,347,207,360,841,41.902834008097166,72.8744939271255
29382_terrestrial,410,279,167,313,689,40.731707317073166,76.34146341463415
29383_terrestrial,358,236,149,265,594,41.62011173184357,74.02234636871509
29417_terrestrial,1086,483,779,586,1569,71.73112338858195,53.95948434622467
29418_terrestrial,1135,633,796,634,1768,70.13215859030836,55.85903083700441
29419_terrestrial,981,379,707,518,1360,72.06931702344546,52.803261977573904
29420_terrestrial,1150,464,796,632,1614,69.21739130434783,54.95652173913044
29421_terrestrial,1136,438,781,636,1574,68.75,55.98591549295775
29422_terrestrial,1110,413,759,631,1523,68.37837837837839,56.846846846846844
29434_terrestrial,654,222,424,389,876,64.83180428134557,59.480122324159026
29439_terrestrial,1502,709,1008,855,2211,67.11051930758988,56.924101198402134
29440_terrestrial,1299,663,911,734,1962,70.13086989992303,56.5050038491147
29441_terrestrial,1176,571,838,641,1747,71.25850340136054,54.506802721088434
29445_terrestrial,1018,406,726,576,1424,71.31630648330058,56.581532416502945
29446_terrestrial,1019,412,716,587,1431,70.26496565260058,57.605495583905785
29447_terrestrial,715,274,510,356,989,71.32867132867133,49.790209790209786
29457_terrestrial,1139,426,715,700,1565,62.774363476733974,61.45741878841089
29458_terrestrial,1284,561,824,778,1845,64.17445482866043,60.59190031152648
29459_terrestrial,1248,498,791,767,1746,63.381410256410255,61.458333333333336
29463_terrestrial,1322,654,817,820,1976,61.80030257186082,62.02723146747352
29464_terrestrial,1360,753,841,838,2113,61.83823529411765,61.617647058823536
29465_terrestrial,1365,781,845,841,2146,61.904761904761905,61.61172161172161
29466_terrestrial,1359,793,838,843,2152,61.66298749080206,62.03090507726269
29467_terrestrial,1352,692,835,837,2044,61.7603550295858,61.908284023668635
29619_terrestrial,639,747,362,355,1386,56.65101721439749,55.55555555555556
29620_terrestrial,642,756,360,357,1398,56.074766355140184,55.60747663551402
29622_terrestrial,653,915,368,364,1568,56.35528330781011,55.742725880551305
29623_terrestrial,770,1238,406,445,2008,52.72727272727272,57.7922077922078
29624_terrestrial,791,1129,412,488,1920,52.08596713021492,61.694058154235144
29625_terrestrial,486,966,166,385,1452,34.15637860082305,79.21810699588477
29626_terrestrial,424,766,150,339,1190,35.37735849056604,79.95283018867924
29627_terrestrial,469,865,149,380,1334,31.769722814498934,81.02345415778251
29628_terrestrial,475,961,135,392,1436,28.421052631578945,82.52631578947368
29629_terrestrial,502,876,170,394,1378,33.86454183266932,78.48605577689243
29630_terrestrial,390,599,149,294,989,38.205128205128204,75.38461538461539
29631_terrestrial,345,516,144,260,861,41.73913043478261,75.36231884057972
29632_terrestrial,331,493,142,249,824,42.90030211480362,75.22658610271903
29633_terrestrial,361,548,152,277,909,42.10526315789473,76.73130193905817
29634_terrestrial,428,670,170,332,1098,39.719626168224295,77.57009345794393
29635_terrestrial,448,725,170,351,1173,37.94642857142857,78.34821428571429
29636_terrestrial,445,702,169,348,1147,37.97752808988764,78.20224719101122
29637_terrestrial,440,716,168,346,1156,38.18181818181819,78.63636363636364
29638_terrestrial,438,722,162,346,1160,36.986301369863014,78.99543378995433
29639_terrestrial,427,738,157,337,1165,36.768149882903984,78.92271662763466
29640_terrestrial,429,707,156,340,1136,36.36363636363637,79.25407925407926
29641_terrestrial,694,792,375,417,1486,54.03458213256484,60.086455331412104
29642_terrestrial,708,810,391,420,1518,55.225988700564976,59.32203389830508
29688_terrestrial,796,479,567,305,1275,71.23115577889448,38.31658291457287
29689_terrestrial,848,584,584,336,1432,68.86792452830188,39.62264150943396
29690_terrestrial,577,505,335,310,1082,58.05892547660312,53.7261698440208
29691_terrestrial,559,547,319,301,1106,57.066189624329155,53.84615384615385
29692_terrestrial,599,623,342,320,1222,57.095158597662774,53.42237061769616
29693_terrestrial,586,578,327,324,1164,55.80204778156996,55.2901023890785
29694_terrestrial,564,514,299,327,1078,53.01418439716312,57.97872340425532
29695_terrestrial,555,495,295,325,1050,53.153153153153156,58.55855855855856
29696_terrestrial,564,466,304,324,1030,53.90070921985816,57.446808510638306
29697_terrestrial,562,471,306,315,1033,54.44839857651246,56.04982206405694
29698_terrestrial,589,475,335,312,1064,56.8760611205433,52.97113752122241
29699_terrestrial,590,469,342,313,1059,57.96610169491525,53.050847457627114
29700_terrestrial,584,429,336,314,1013,57.534246575342465,53.76712328767124
29701_terrestrial,623,438,348,339,1061,55.85874799357945,54.41412520064205
29702_terrestrial,587,378,327,323,965,55.70698466780238,55.02555366269165
29703_terrestrial,562,384,308,321,946,54.804270462633454,57.11743772241993
29704_terrestrial,566,438,292,338,1004,51.590106007067135,59.717314487632514
29705_terrestrial,589,454,316,341,1043,53.65025466893039,57.89473684210527
29706_terrestrial,562,423,295,331,985,52.49110320284698,58.89679715302491
29707_terrestrial,541,339,283,324,880,52.31053604436229,59.88909426987061
29708_terrestrial,522,318,276,319,840,52.87356321839081,61.111111111111114
29709_terrestrial,498,300,263,304,798,52.81124497991968,61.044176706827315
29710_terrestrial,515,326,269,315,841,52.23300970873787,61.165048543689316
29711_terrestrial,518,374,253,326,892,48.84169884169884,62.93436293436293
29712_terrestrial,545,419,259,343,964,47.522935779816514,62.93577981651376
29713_terrestrial,551,407,264,343,958,47.91288566243194,62.25045372050817
29714_terrestrial,508,349,240,323,857,47.24409448818898,63.582677165354326
29715_terrestrial,470,303,219,305,773,46.59574468085106,64.8936170212766
29716_terrestrial,434,269,212,277,703,48.8479262672811,63.824884792626726
29717_terrestrial,426,251,212,267,677,49.76525821596244,62.676056338028175
29718_terrestrial,432,243,216,268,675,50,62.03703703703704
29719_terrestrial,463,255,234,282,718,50.53995680345572,60.90712742980562
29720_terrestrial,454,266,222,286,720,48.89867841409692,62.99559471365639
29721_terrestrial,423,255,210,265,678,49.645390070921984,62.64775413711584
29722_terrestrial,395,243,204,244,638,51.64556962025316,61.77215189873417
29723_terrestrial,355,232,182,219,587,51.267605633802816,61.69014084507042
29724_terrestrial,319,220,160,199,539,50.15673981191222,62.38244514106584
29725_terrestrial,356,226,177,222,582,49.71910112359551,62.35955056179775
29726_terrestrial,363,228,177,229,591,48.760330578512395,63.08539944903582
29727_terrestrial,372,232,178,242,604,47.8494623655914,65.05376344086021
29728_terrestrial,368,230,166,253,598,45.108695652173914,68.75
29729_terrestrial,383,237,180,263,620,46.99738903394256,68.66840731070496
29730_terrestrial,395,220,193,262,615,48.860759493670884,66.32911392405063
29731_terrestrial,423,211,212,275,634,50.11820330969267,65.01182033096927
29732_terrestrial,422,221,215,274,643,50.947867298578196,64.92890995260665
29733_terrestrial,412,224,211,268,636,51.213592233009706,65.0485436893204
29734_terrestrial,481,243,250,301,724,51.975051975051976,62.57796257796257
29735_terrestrial,548,310,264,361,858,48.175182481751825,65.87591240875912
29736_terrestrial,526,331,248,360,857,47.14828897338403,68.44106463878326
29737_terrestrial,477,361,200,352,838,41.92872117400419,73.79454926624737
29738_terrestrial,505,362,206,385,867,40.79207920792079,76.23762376237624
29739_terrestrial,510,412,207,383,922,40.588235294117645,75.09803921568627
29740_terrestrial,484,376,200,359,860,41.32231404958678,74.17355371900827
29741_terrestrial,434,307,180,321,741,41.474654377880185,73.963133640553
29742_terrestrial,351,233,147,267,584,41.88034188034188,76.06837606837607
29780_terrestrial,1143,476,787,637,1619,68.85389326334209,55.730533683289586
29781_terrestrial,444,340,303,303,784,68.24324324324324,68.24324324324324
29782_terrestrial,1162,479,789,658,1641,67.90017211703959,56.62650602409639
29794_terrestrial,683,243,439,406,926,64.27525622254758,59.443631039531475
29799_terrestrial,1360,629,909,770,1989,66.83823529411764,56.61764705882353
29800_terrestrial,1454,733,960,844,2187,66.02475928473177,58.04676753782668
29801_terrestrial,1276,670,882,721,1946,69.12225705329153,56.50470219435737
29817_terrestrial,1134,423,710,696,1557,62.61022927689594,61.37566137566137
29818_terrestrial,1341,565,834,815,1906,62.19239373601789,60.77554064131245
29822_terrestrial,1315,658,817,807,1973,62.12927756653992,61.368821292775664
29823_terrestrial,1345,701,833,823,2046,61.933085501858734,61.18959107806692
29824_terrestrial,1354,715,838,833,2069,61.89069423929099,61.52141802067946
29825_terrestrial,1350,765,839,831,2115,62.14814814814815,61.55555555555555
29826_terrestrial,1369,768,850,841,2137,62.089116143170195,61.431701972242514
29827_terrestrial,1352,695,837,835,2047,61.908284023668635,61.7603550295858
29983_terrestrial,660,928,383,352,1588,58.03030303030303,53.333333333333336
29984_terrestrial,463,1025,165,364,1488,35.63714902807775,78.61771058315334
29985_terrestrial,434,1026,139,345,1460,32.02764976958525,79.49308755760369
29986_terrestrial,440,888,153,346,1328,34.77272727272727,78.63636363636364
29987_terrestrial,449,959,145,368,1408,32.29398663697104,81.9599109131403
29988_terrestrial,480,915,146,403,1395,30.416666666666664,83.95833333333333
29989_terrestrial,443,689,168,338,1132,37.92325056433409,76.2979683972912
29990_terrestrial,350,535,140,266,885,40,76
29991_terrestrial,347,520,151,258,867,43.51585014409222,74.35158501440922
29992_terrestrial,354,555,154,265,909,43.50282485875706,74.85875706214689
29993_terrestrial,441,729,179,337,1170,40.58956916099773,76.41723356009071
29994_terrestrial,446,752,170,351,1198,38.11659192825112,78.69955156950674
29995_terrestrial,430,724,160,341,1154,37.2093023255814,79.30232558139535
29996_terrestrial,420,708,155,331,1128,36.904761904761905,78.80952380952381
29997_terrestrial,417,713,152,328,1130,36.45083932853717,78.65707434052757
29998_terrestrial,439,815,153,345,1254,34.851936218678816,78.5876993166287
29999_terrestrial,445,860,153,350,1305,34.38202247191011,78.65168539325843
30000_terrestrial,436,796,150,347,1232,34.403669724770644,79.58715596330275
30001_terrestrial,452,729,167,357,1181,36.94690265486726,78.98230088495575
30002_terrestrial,748,890,406,447,1638,54.278074866310156,59.759358288770045
30003_terrestrial,723,863,390,435,1586,53.941908713692946,60.16597510373444
30049_terrestrial,776,494,543,303,1270,69.9742268041237,39.04639175257732
30050_terrestrial,768,529,535,305,1297,69.66145833333334,39.71354166666667
30051_terrestrial,525,460,306,280,985,58.285714285714285,53.333333333333336
30052_terrestrial,531,497,311,271,1028,58.568738229755176,51.03578154425612
30053_terrestrial,510,530,301,261,1040,59.01960784313726,51.17647058823529
30054_terrestrial,551,527,320,286,1078,58.076225045372055,51.90562613430127
30055_terrestrial,564,522,317,308,1086,56.205673758865245,54.60992907801418
30056_terrestrial,576,513,321,311,1089,55.729166666666664,53.99305555555556
30057_terrestrial,550,522,313,296,1072,56.90909090909091,53.81818181818182
30058_terrestrial,514,507,294,281,1021,57.19844357976653,54.6692607003891
30059_terrestrial,567,515,324,300,1082,57.14285714285714,52.910052910052904
30060_terrestrial,662,532,379,355,1194,57.250755287009056,53.625377643504535
30061_terrestrial,668,479,374,362,1147,55.98802395209581,54.191616766467064
30062_terrestrial,859,499,567,371,1358,66.0069848661234,43.189755529685684
30063_terrestrial,809,505,523,361,1314,64.6477132262052,44.6229913473424
30064_terrestrial,821,549,529,366,1370,64.43361753958587,44.579780755176614
30065_terrestrial,784,537,520,341,1321,66.3265306122449,43.494897959183675
30066_terrestrial,519,412,273,310,931,52.601156069364166,59.73025048169557
30067_terrestrial,602,416,327,342,1018,54.31893687707641,56.810631229235874
30068_terrestrial,569,401,307,332,970,53.95430579964851,58.34797891036907
30069_terrestrial,570,453,288,345,1023,50.526315789473685,60.526315789473685
30070_terrestrial,602,567,320,354,1169,53.156146179402,58.80398671096345
30071_terrestrial,572,550,291,347,1122,50.87412587412587,60.66433566433567
30072_terrestrial,561,502,276,342,1063,49.19786096256685,60.962566844919785
30073_terrestrial,553,463,278,331,1016,50.27124773960217,59.85533453887884
30074_terrestrial,533,414,273,313,947,51.21951219512195,58.724202626641656
30075_terrestrial,465,341,234,284,806,50.32258064516129,61.0752688172043
30076_terrestrial,444,282,230,263,726,51.80180180180181,59.23423423423423
30077_terrestrial,417,257,216,250,674,51.798561151079134,59.95203836930456
30078_terrestrial,418,255,223,240,673,53.34928229665071,57.41626794258373
30079_terrestrial,423,264,223,248,687,52.71867612293144,58.62884160756501
30080_terrestrial,424,263,222,247,687,52.358490566037744,58.25471698113207
30081_terrestrial,427,266,239,234,693,55.97189695550351,54.80093676814989
30082_terrestrial,385,246,209,219,631,54.285714285714285,56.88311688311688
30083_terrestrial,349,228,188,200,577,53.86819484240688,57.306590257879655
30084_terrestrial,339,234,177,200,573,52.21238938053098,58.99705014749262
30085_terrestrial,345,242,174,208,587,50.43478260869565,60.28985507246377
30086_terrestrial,360,252,182,221,612,50.55555555555556,61.38888888888889
30087_terrestrial,389,259,195,238,648,50.128534704370175,61.18251928020566
30088_terrestrial,386,260,180,257,646,46.63212435233161,66.58031088082902
30089_terrestrial,405,265,192,265,670,47.40740740740741,65.4320987654321
30090_terrestrial,403,252,198,260,655,49.13151364764268,64.51612903225806
30091_terrestrial,430,244,209,287,674,48.604651162790695,66.74418604651163
30092_terrestrial,449,252,222,298,701,49.44320712694877,66.36971046770601
30093_terrestrial,441,246,219,294,687,49.65986394557823,66.66666666666666
30094_terrestrial,430,232,215,282,662,50,65.58139534883722
30095_terrestrial,506,263,250,325,769,49.40711462450593,64.2292490118577
30096_terrestrial,549,335,260,369,884,47.35883424408014,67.21311475409836
30097_terrestrial,533,358,230,382,891,43.151969981238274,71.66979362101313
30098_terrestrial,529,423,223,392,952,42.15500945179584,74.10207939508507
30099_terrestrial,513,408,213,383,921,41.52046783625731,74.6588693957115
30100_terrestrial,445,362,186,323,807,41.79775280898876,72.58426966292136
30101_terrestrial,418,308,174,306,726,41.62679425837321,73.20574162679426
30140_terrestrial,1111,459,763,618,1570,68.67686768676867,55.62556255625562
30141_terrestrial,1174,637,799,659,1811,68.05792163543441,56.132879045996596
30142_terrestrial,1170,485,792,661,1655,67.6923076923077,56.495726495726494
30154_terrestrial,667,233,428,396,900,64.16791604197901,59.37031484257871
30160_terrestrial,1343,729,890,775,2072,66.269545793000745,57.7066269545793
30161_terrestrial,1528,851,1030,867,2379,67.40837696335078,56.74083769633508
30162_terrestrial,1341,772,903,787,2113,67.33780760626398,58.6875466070097
30163_terrestrial,1262,662,849,732,1924,67.2741679873217,58.00316957210776
30177_terrestrial,1486,1004,924,904,2490,62.18034993270525,60.83445491251682
30178_terrestrial,1451,818,896,879,2269,61.75051688490696,60.57891109579601
30179_terrestrial,1365,703,839,835,2068,61.46520146520147,61.172161172161175
30181_terrestrial,1137,440,701,704,1577,61.65347405452947,61.917326297273526
30182_terrestrial,1353,702,851,827,2055,62.897265336289735,61.12342941611234
30183_terrestrial,1350,692,843,826,2042,62.44444444444445,61.18518518518519
30184_terrestrial,1317,626,813,818,1943,61.731207289293856,62.110858010630224
30185_terrestrial,1340,713,828,827,2053,61.791044776119406,61.71641791044776
30186_terrestrial,1370,759,848,838,2129,61.8978102189781,61.16788321167883
30187_terrestrial,1333,679,826,826,2012,61.9654913728432,61.9654913728432
30343_terrestrial,634,877,372,328,1511,58.67507886435332,51.73501577287066
30344_terrestrial,479,1099,165,371,1578,34.44676409185804,77.45302713987473
30345_terrestrial,457,1141,146,363,1598,31.947483588621445,79.43107221006565
30346_terrestrial,459,1025,150,375,1484,32.6797385620915,81.69934640522875
30347_terrestrial,452,945,142,379,1397,31.41592920353982,83.8495575221239
30348_terrestrial,494,876,168,402,1370,34.0080971659919,81.37651821862349
30349_terrestrial,397,607,149,310,1004,37.531486146095716,78.08564231738035
30350_terrestrial,355,527,153,266,882,43.098591549295776,74.92957746478874
30351_terrestrial,355,528,153,270,883,43.098591549295776,76.05633802816901
30352_terrestrial,390,610,163,299,1000,41.794871794871796,76.66666666666667
30353_terrestrial,448,766,172,346,1214,38.392857142857146,77.23214285714286
30354_terrestrial,429,780,159,338,1209,37.06293706293706,78.78787878787878
30355_terrestrial,415,749,154,330,1164,37.10843373493976,79.51807228915662
30356_terrestrial,405,727,149,317,1132,36.79012345679013,78.2716049382716
30357_terrestrial,418,717,148,327,1135,35.406698564593306,78.22966507177034
30358_terrestrial,427,805,146,337,1232,34.19203747072599,78.92271662763466
30359_terrestrial,448,867,147,357,1315,32.8125,79.6875
30360_terrestrial,477,952,160,379,1429,33.542976939203356,79.45492662473794
30361_terrestrial,467,889,163,370,1356,34.90364025695932,79.22912205567452
30362_terrestrial,467,814,175,366,1281,37.47323340471092,78.37259100642399
30363_terrestrial,743,912,397,448,1655,53.43203230148048,60.296096904441455
30364_terrestrial,726,905,388,436,1631,53.4435261707989,60.05509641873278
30365_terrestrial,731,936,399,436,1667,54.58276333789329,59.64432284541724
30366_terrestrial,726,925,388,441,1651,53.4435261707989,60.74380165289256
30367_terrestrial,733,932,393,444,1665,53.61527967257844,60.572987721691675
30368_terrestrial,718,898,378,442,1616,52.64623955431755,61.55988857938719
30410_terrestrial,698,452,494,272,1150,70.77363896848138,38.96848137535817
30411_terrestrial,741,507,527,282,1248,71.12010796221323,38.05668016194332
30412_terrestrial,481,441,284,254,922,59.04365904365905,52.80665280665281
30413_terrestrial,488,493,290,247,981,59.42622950819673,50.614754098360656
30414_terrestrial,513,485,306,266,998,59.64912280701754,51.85185185185185
30415_terrestrial,789,567,547,309,1356,69.32826362484157,39.163498098859314
30416_terrestrial,812,594,560,321,1406,68.96551724137932,39.532019704433495
30417_terrestrial,806,576,564,311,1382,69.97518610421837,38.58560794044665
30418_terrestrial,781,588,552,294,1369,70.6786171574904,37.64404609475032
30419_terrestrial,798,615,538,327,1413,67.41854636591479,40.97744360902256
30420_terrestrial,873,615,581,365,1488,66.55211912943871,41.809851088201604
30421_terrestrial,828,533,551,349,1361,66.54589371980676,42.149758454106276
30422_terrestrial,731,420,487,311,1151,66.62106703146374,42.54445964432285
30425_terrestrial,636,430,430,265,1066,67.61006289308176,41.66666666666667
30426_terrestrial,761,485,520,313,1246,68.3311432325887,41.13009198423128
30427_terrestrial,547,408,315,302,955,57.586837294332724,55.21023765996343
30428_terrestrial,556,421,311,309,977,55.93525179856115,55.57553956834532
30429_terrestrial,597,636,327,336,1233,54.773869346733676,56.28140703517588
30430_terrestrial,645,855,345,369,1500,53.48837209302325,57.20930232558139
30431_terrestrial,614,770,335,353,1384,54.56026058631922,57.49185667752443
30432_terrestrial,512,547,271,302,1059,52.9296875,58.984375
30433_terrestrial,504,492,270,286,996,53.57142857142857,56.74603174603175
30434_terrestrial,494,483,270,271,977,54.655870445344135,54.8582995951417
30435_terrestrial,454,403,247,258,857,54.40528634361234,56.82819383259912
30436_terrestrial,399,315,217,234,714,54.385964912280706,58.64661654135338
30437_terrestrial,396,306,213,233,702,53.78787878787878,58.838383838383834
30438_terrestrial,412,291,224,235,703,54.36893203883495,57.03883495145631
30439_terrestrial,508,345,299,272,853,58.85826771653543,53.54330708661418
30440_terrestrial,483,352,278,270,835,57.55693581780539,55.90062111801242
30441_terrestrial,497,345,295,268,842,59.356136820925556,53.923541247484906
30442_terrestrial,481,327,293,248,808,60.91476091476091,51.559251559251564
30443_terrestrial,388,287,216,217,675,55.670103092783506,55.927835051546396
30444_terrestrial,387,283,203,228,670,52.4547803617571,58.91472868217055
30445_terrestrial,405,308,206,245,713,50.864197530864196,60.49382716049383
30446_terrestrial,418,309,216,254,727,51.674641148325364,60.76555023923444
30447_terrestrial,419,319,206,264,738,49.16467780429594,63.0071599045346
30448_terrestrial,476,337,231,299,813,48.529411764705884,62.81512605042017
30449_terrestrial,440,315,207,286,755,47.04545454545455,65
30450_terrestrial,435,307,208,283,742,47.81609195402299,65.05747126436782
30451_terrestrial,445,298,218,296,743,48.98876404494382,66.51685393258427
30452_terrestrial,496,320,233,336,816,46.975806451612904,67.74193548387096
30453_terrestrial,488,321,224,339,809,45.90163934426229,69.4672131147541
30454_terrestrial,466,290,216,323,756,46.3519313304721,69.31330472103005
30455_terrestrial,493,314,223,341,807,45.233265720081135,69.1683569979716
30456_terrestrial,547,363,249,377,910,45.52102376599635,68.92138939670932
30457_terrestrial,551,391,244,385,942,44.283121597096184,69.87295825771325
30458_terrestrial,537,433,230,386,970,42.83054003724395,71.88081936685289
30459_terrestrial,498,368,201,369,866,40.36144578313253,74.09638554216868
30460_terrestrial,420,305,164,316,725,39.04761904761905,75.23809523809524
30501_terrestrial,1092,430,741,617,1522,67.85714285714286,56.501831501831504
30516_terrestrial,1292,676,810,798,1968,62.693498452012385,61.76470588235294
30517_terrestrial,1261,680,787,787,1941,62.41078509119746,62.41078509119746
30518_terrestrial,1197,672,767,716,1869,64.07685881370092,59.81620718462823
30521_terrestrial,1426,883,943,829,2309,66.12903225806451,58.13464235624124
30522_terrestrial,770,634,483,523,1404,62.727272727272734,67.92207792207792
30523_terrestrial,1354,794,896,791,2148,66.17429837518463,58.41949778434269
30524_terrestrial,1248,648,825,723,1896,66.10576923076923,57.932692307692314
30535_terrestrial,426,418,242,295,844,56.8075117370892,69.24882629107981
30536_terrestrial,1361,951,867,806,2312,63.70315944158706,59.221160911094785
30537_terrestrial,1353,993,855,818,2346,63.19290465631929,60.45824094604583
30538_terrestrial,1470,932,899,899,2402,61.156462585034014,61.156462585034014
30539_terrestrial,1447,842,890,882,2289,61.506565307532824,60.95369730476848
30540_terrestrial,1491,813,920,908,2304,61.70355466130114,60.898725687458075
30541_terrestrial,1190,486,742,725,1676,62.35294117647059,60.924369747899156
30542_terrestrial,1144,454,706,704,1598,61.713286713286706,61.53846153846154
30545_terrestrial,318,307,206,229,625,64.77987421383648,72.0125786163522
30546_terrestrial,1343,676,837,825,2019,62.32315711094565,61.42963514519732
30703_terrestrial,631,909,372,321,1540,58.9540412044374,50.871632329635496
30704_terrestrial,501,1141,169,392,1642,33.73253493013972,78.2435129740519
30705_terrestrial,455,999,146,364,1454,32.08791208791209,80
30706_terrestrial,481,1001,159,398,1482,33.056133056133056,82.74428274428274
30707_terrestrial,532,1038,174,442,1570,32.70676691729324,83.0827067669173
30708_terrestrial,423,746,155,343,1169,36.64302600472813,81.08747044917257
30709_terrestrial,357,564,141,282,921,39.49579831932773,78.99159663865547
30710_terrestrial,351,548,141,275,899,40.17094017094017,78.34757834757835
30711_terrestrial,361,536,145,281,897,40.16620498614959,77.8393351800554
30712_terrestrial,396,611,155,310,1007,39.141414141414145,78.28282828282829
30713_terrestrial,439,772,174,331,1211,39.63553530751708,75.39863325740319
30714_terrestrial,415,767,163,319,1182,39.277108433734945,76.86746987951807
30715_terrestrial,409,752,155,320,1161,37.89731051344744,78.239608801956
30716_terrestrial,408,748,159,311,1156,38.970588235294116,76.22549019607843
30717_terrestrial,403,711,147,312,1114,36.47642679900744,77.41935483870968
30718_terrestrial,428,756,146,339,1184,34.112149532710276,79.2056074766355
30719_terrestrial,458,852,158,368,1310,34.49781659388647,80.34934497816593
30720_terrestrial,481,878,158,388,1359,32.84823284823285,80.66528066528068
30721_terrestrial,465,837,158,373,1302,33.97849462365591,80.21505376344086
30722_terrestrial,445,803,160,352,1248,35.95505617977528,79.10112359550561
30723_terrestrial,417,771,152,329,1188,36.45083932853717,78.8968824940048
30724_terrestrial,407,774,147,323,1181,36.11793611793612,79.36117936117935
30725_terrestrial,410,768,145,325,1178,35.36585365853659,79.26829268292683
30726_terrestrial,416,787,150,333,1203,36.05769230769231,80.04807692307693
30727_terrestrial,461,820,166,371,1281,36.00867678958785,80.4772234273319
30728_terrestrial,726,951,374,449,1677,51.515151515151516,61.84573002754821
30729_terrestrial,731,930,386,440,1661,52.804377564979475,60.191518467852255
30771_terrestrial,400,329,239,210,729,59.75,52.5
30772_terrestrial,694,491,494,257,1185,71.18155619596543,37.03170028818444
30773_terrestrial,725,538,517,267,1263,71.3103448275862,36.82758620689655
30774_terrestrial,739,522,534,272,1261,72.25981055480379,36.80649526387009
30775_terrestrial,690,486,495,253,1176,71.73913043478261,36.666666666666664
30778_terrestrial,713,515,506,268,1228,70.96774193548387,37.58765778401122
30779_terrestrial,701,510,497,264,1211,70.89871611982882,37.660485021398
30786_terrestrial,705,428,495,282,1133,70.2127659574468,40
30787_terrestrial,756,474,533,300,1230,70.5026455026455,39.682539682539684
30788_terrestrial,757,495,525,307,1252,69.35270805812418,40.554821664464995
30789_terrestrial,808,763,535,346,1571,66.21287128712872,42.82178217821782
30790_terrestrial,838,976,548,370,1814,65.39379474940334,44.1527446300716
30791_terrestrial,585,775,323,331,1360,55.21367521367522,56.58119658119658
30792_terrestrial,554,701,313,307,1255,56.49819494584838,55.415162454873645
30793_terrestrial,493,618,276,276,1111,55.98377281947262,55.98377281947262
30794_terrestrial,484,566,266,267,1050,54.958677685950406,55.16528925619835
30795_terrestrial,471,531,267,248,1002,56.68789808917197,52.653927813163484
30796_terrestrial,414,465,231,226,879,55.79710144927537,54.589371980676326
30797_terrestrial,417,450,228,236,867,54.67625899280576,56.594724220623505
30798_terrestrial,496,496,260,288,992,52.41935483870967,58.06451612903226
30799_terrestrial,581,514,330,316,1095,56.79862306368331,54.38898450946644
30800_terrestrial,575,445,342,306,1020,59.47826086956521,53.21739130434783
30801_terrestrial,534,406,315,288,940,58.98876404494382,53.93258426966292
30802_terrestrial,528,408,319,275,936,60.416666666666664,52.083333333333336
30803_terrestrial,541,424,328,281,965,60.62846580406654,51.940850277264325
30804_terrestrial,466,382,258,262,848,55.36480686695279,56.22317596566524
30805_terrestrial,418,389,216,256,807,51.674641148325364,61.24401913875598
30806_terrestrial,497,421,267,286,918,53.72233400402414,57.54527162977867
30807_terrestrial,503,428,269,297,931,53.47912524850894,59.04572564612326
30808_terrestrial,515,453,254,323,968,49.320388349514566,62.71844660194175
30809_terrestrial,560,496,284,340,1056,50.71428571428571,60.71428571428571
30810_terrestrial,562,480,293,336,1042,52.135231316725985,59.7864768683274
30811_terrestrial,594,443,313,358,1037,52.69360269360269,60.26936026936027
30812_terrestrial,560,425,254,384,985,45.357142857142854,68.57142857142857
30813_terrestrial,607,471,262,429,1078,43.163097199341024,70.67545304777595
30814_terrestrial,586,449,247,418,1035,42.15017064846416,71.33105802047781
30815_terrestrial,525,363,222,380,888,42.285714285714285,72.38095238095238
30816_terrestrial,503,344,243,337,847,48.31013916500994,66.99801192842942
30817_terrestrial,510,361,237,340,871,46.470588235294116,66.66666666666666
30818_terrestrial,465,348,201,337,813,43.225806451612904,72.47311827956989
30819_terrestrial,420,305,168,320,725,40,76.19047619047619
30820_terrestrial,378,260,149,279,638,39.41798941798942,73.80952380952381
30854_terrestrial,672,167,434,400,839,64.58333333333334,59.523809523809526
30876_terrestrial,576,430,340,408,1006,59.02777777777778,70.83333333333334
30877_terrestrial,1257,709,776,801,1966,61.73428798727129,63.72315035799523
30878_terrestrial,1251,776,797,760,2027,63.70903277378097,60.75139888089528
30879_terrestrial,1202,702,787,704,1904,65.47420965058237,58.56905158069884
30881_terrestrial,1356,794,896,794,2150,66.07669616519173,58.55457227138643
30882_terrestrial,767,648,468,531,1415,61.016949152542374,69.23076923076923
30883_terrestrial,690,568,417,488,1258,60.43478260869565,70.72463768115942
30884_terrestrial,1314,730,866,754,2044,65.90563165905633,57.3820395738204
30889_terrestrial,872,374,562,486,1246,64.44954128440367,55.73394495412845
30894_terrestrial,1176,705,743,683,1881,63.18027210884354,58.078231292517
30895_terrestrial,1296,910,828,764,2206,63.888888888888886,58.95061728395061
30896_terrestrial,1326,978,839,782,2304,63.27300150829562,58.97435897435898
30897_terrestrial,501,628,286,351,1129,57.08582834331337,70.05988023952095
30898_terrestrial,1435,930,877,886,2365,61.11498257839722,61.74216027874564
30899_terrestrial,1418,851,871,870,2269,61.424541607898455,61.3540197461213
30907_terrestrial,1072,428,659,655,1500,61.473880597014926,61.100746268656714
31063_terrestrial,703,1098,384,389,1801,54.623044096728314,55.33428165007113
31064_terrestrial,542,1239,179,433,1781,33.025830258302584,79.88929889298892
31065_terrestrial,400,811,126,322,1211,31.5,80.5
31066_terrestrial,537,1008,184,439,1545,34.26443202979516,81.75046554934823
31067_terrestrial,485,903,170,396,1388,35.051546391752574,81.64948453608247
31068_terrestrial,392,651,147,312,1043,37.5,79.59183673469387
31069_terrestrial,358,575,139,281,933,38.8268156424581,78.49162011173185
31070_terrestrial,351,555,138,272,906,39.31623931623932,77.49287749287748
31071_terrestrial,371,577,148,286,948,39.892183288409704,77.088948787062
31072_terrestrial,386,660,149,301,1046,38.60103626943005,77.97927461139896
31073_terrestrial,416,779,159,318,1195,38.22115384615385,76.4423076923077
31074_terrestrial,406,796,155,316,1202,38.17733990147783,77.83251231527095
31075_terrestrial,394,829,152,307,1223,38.578680203045685,77.91878172588832
31076_terrestrial,391,732,150,304,1123,38.36317135549872,77.74936061381074
31077_terrestrial,386,708,144,304,1094,37.30569948186528,78.75647668393782
31078_terrestrial,413,728,148,329,1141,35.83535108958838,79.66101694915254
31079_terrestrial,441,753,160,357,1194,36.281179138321995,80.95238095238095
31080_terrestrial,449,768,163,361,1217,36.30289532293987,80.40089086859689
31081_terrestrial,451,797,159,360,1248,35.254988913525494,79.82261640798227
31082_terrestrial,434,804,158,342,1238,36.405529953917046,78.80184331797236
31083_terrestrial,395,770,148,308,1165,37.46835443037975,77.9746835443038
31084_terrestrial,383,760,141,301,1143,36.81462140992167,78.59007832898173
31085_terrestrial,373,745,138,292,1118,36.99731903485255,78.28418230563003
31086_terrestrial,380,752,141,298,1132,37.10526315789473,78.42105263157895
31087_terrestrial,392,775,142,313,1167,36.224489795918366,79.8469387755102
31088_terrestrial,455,818,170,353,1273,37.362637362637365,77.58241758241759
31089_terrestrial,713,920,386,420,1633,54.137447405329596,58.90603085553997
31090_terrestrial,651,779,356,382,1430,54.68509984639017,58.67895545314901
31149_terrestrial,421,376,320,132,797,76.00950118764845,31.353919239904986
31150_terrestrial,785,820,539,321,1605,68.6624203821656,40.89171974522293
31151_terrestrial,545,728,312,296,1273,57.247706422018354,54.31192660550459
31152_terrestrial,526,726,295,292,1252,56.083650190114064,55.51330798479087
31153_terrestrial,479,662,264,265,1141,55.11482254697286,55.323590814196244
31154_terrestrial,439,618,238,244,1057,54.21412300683372,55.58086560364465
31155_terrestrial,409,580,224,226,989,54.76772616136919,55.256723716381416
31156_terrestrial,393,540,210,220,933,53.43511450381679,55.97964376590331
31157_terrestrial,434,551,240,241,985,55.29953917050692,55.52995391705069
31158_terrestrial,432,531,228,251,963,52.77777777777778,58.10185185185185
31159_terrestrial,505,538,287,278,1043,56.83168316831683,55.049504950495056
31160_terrestrial,493,463,293,264,956,59.43204868154158,53.54969574036511
31161_terrestrial,444,417,256,245,861,57.65765765765766,55.18018018018018
31162_terrestrial,489,444,305,251,933,62.372188139059304,51.32924335378323
31163_terrestrial,470,433,286,246,903,60.851063829787236,52.34042553191489
31164_terrestrial,484,465,286,260,949,59.09090909090909,53.71900826446281
31165_terrestrial,520,521,303,283,1041,58.269230769230774,54.42307692307692
31166_terrestrial,555,544,326,297,1099,58.73873873873874,53.51351351351351
31167_terrestrial,555,546,317,299,1101,57.117117117117125,53.873873873873876
31168_terrestrial,580,569,313,333,1149,53.96551724137931,57.41379310344827
31169_terrestrial,634,615,339,361,1249,53.47003154574133,56.94006309148265
31170_terrestrial,644,610,345,373,1254,53.57142857142857,57.919254658385086
31171_terrestrial,648,532,330,399,1180,50.92592592592593,61.57407407407407
31172_terrestrial,602,469,269,413,1071,44.6843853820598,68.6046511627907
31173_terrestrial,616,468,265,427,1084,43.01948051948052,69.31818181818183
31174_terrestrial,596,463,251,415,1059,42.11409395973154,69.63087248322147
31175_terrestrial,552,390,236,391,942,42.7536231884058,70.83333333333334
31176_terrestrial,459,335,222,309,794,48.366013071895424,67.3202614379085
31177_terrestrial,441,288,218,288,729,49.43310657596372,65.3061224489796
31178_terrestrial,395,285,178,280,680,45.063291139240505,70.88607594936708
31179_terrestrial,377,269,158,278,646,41.90981432360743,73.74005305039788
31180_terrestrial,342,218,142,250,560,41.52046783625731,73.09941520467837
31186_terrestrial,286,201,119,207,487,41.60839160839161,72.37762237762237
31237_terrestrial,1260,685,777,799,1945,61.66666666666667,63.41269841269841
31238_terrestrial,1312,770,812,831,2082,61.890243902439025,63.338414634146346
31239_terrestrial,1252,809,803,765,2061,64.1373801916933,61.102236421725244
31240_terrestrial,1185,666,775,706,1851,65.40084388185655,59.57805907172996
31241_terrestrial,1221,636,812,710,1857,66.5028665028665,58.14905814905815
31242_terrestrial,1386,906,916,815,2292,66.08946608946609,58.8023088023088
31243_terrestrial,712,610,441,494,1322,61.93820224719101,69.3820224719101
31244_terrestrial,1348,751,891,775,2099,66.0979228486647,57.49258160237388
31246_terrestrial,840,312,550,462,1152,65.47619047619048,55.00000000000001
31247_terrestrial,755,287,521,388,1042,69.00662251655629,51.39072847682119
31249_terrestrial,876,370,566,486,1246,64.61187214611871,55.47945205479452
31253_terrestrial,1123,635,724,658,1758,64.47016918967053,58.59305431878896
31254_terrestrial,1210,826,768,710,2036,63.47107438016529,58.67768595041323
31255_terrestrial,543,705,313,383,1248,57.6427255985267,70.5340699815838
31256_terrestrial,489,672,286,335,1161,58.48670756646217,68.50715746421268
31257_terrestrial,506,569,297,344,1075,58.69565217391305,67.98418972332016
31258_terrestrial,1364,751,841,845,2115,61.65689149560117,61.950146627565985
31267_terrestrial,1066,426,655,653,1492,61.444652908067546,61.257035647279544
31422_terrestrial,577,752,347,290,1329,60.13864818024264,50.25996533795494
31423_terrestrial,753,1232,391,433,1985,51.92563081009296,57.50332005312085
31424_terrestrial,471,1058,152,374,1529,32.27176220806794,79.40552016985139
31425_terrestrial,568,1123,185,465,1691,32.57042253521127,81.86619718309859
31426_terrestrial,523,968,182,418,1491,34.79923518164436,79.92351816443595
31427_terrestrial,448,764,158,359,1212,35.267857142857146,80.13392857142857
31428_terrestrial,402,659,149,320,1061,37.06467661691542,79.60199004975125
31429_terrestrial,388,630,150,305,1018,38.659793814432994,78.6082474226804
31430_terrestrial,383,633,152,294,1016,39.686684073107045,76.76240208877284
31431_terrestrial,383,629,150,295,1012,39.1644908616188,77.02349869451697
31432_terrestrial,389,664,149,301,1053,38.303341902313626,77.37789203084833
31433_terrestrial,402,747,157,306,1149,39.0547263681592,76.11940298507463
31434_terrestrial,389,756,156,298,1145,40.102827763496144,76.60668380462725
31435_terrestrial,390,767,154,301,1157,39.48717948717949,77.17948717948718
31436_terrestrial,384,740,153,295,1124,39.84375,76.82291666666666
31437_terrestrial,371,711,147,285,1082,39.62264150943396,76.81940700808624
31438_terrestrial,386,685,146,305,1071,37.82383419689119,79.01554404145078
31439_terrestrial,429,738,161,341,1167,37.52913752913753,79.48717948717949
31440_terrestrial,448,758,167,355,1206,37.276785714285715,79.24107142857143
31441_terrestrial,436,766,157,348,1202,36.00917431192661,79.81651376146789
31442_terrestrial,401,735,150,316,1136,37.406483790523694,78.80299251870323
31443_terrestrial,393,744,148,307,1137,37.659033078880405,78.11704834605598
31444_terrestrial,400,752,149,311,1152,37.25,77.75
31445_terrestrial,402,740,156,305,1142,38.80597014925373,75.87064676616916
31446_terrestrial,386,741,153,291,1127,39.637305699481864,75.38860103626943
31447_terrestrial,383,750,148,293,1133,38.642297650130544,76.50130548302873
31448_terrestrial,411,766,158,316,1177,38.44282238442822,76.88564476885644
31449_terrestrial,455,745,179,350,1200,39.34065934065934,76.92307692307693
31450_terrestrial,683,829,368,403,1512,53.879941434846266,59.004392386530014
31510_terrestrial,715,706,492,283,1421,68.8111888111888,39.58041958041958
31511_terrestrial,493,665,280,264,1158,56.79513184584179,53.54969574036511
31512_terrestrial,450,666,249,243,1116,55.333333333333336,54
31513_terrestrial,422,639,226,233,1061,53.55450236966824,55.21327014218009
31514_terrestrial,394,592,211,219,986,53.55329949238579,55.58375634517766
31515_terrestrial,377,581,206,207,958,54.64190981432361,54.907161803713535
31516_terrestrial,397,559,218,222,956,54.91183879093199,55.91939546599496
31517_terrestrial,407,544,226,224,951,55.528255528255535,55.03685503685504
31518_terrestrial,356,453,197,201,809,55.33707865168539,56.46067415730337
31519_terrestrial,435,484,250,238,919,57.47126436781609,54.71264367816092
31520_terrestrial,415,418,238,228,833,57.34939759036145,54.93975903614457
31521_terrestrial,422,420,255,219,842,60.426540284360186,51.8957345971564
31522_terrestrial,434,448,269,218,882,61.9815668202765,50.23041474654379
31523_terrestrial,426,457,263,222,883,61.737089201877936,52.112676056338024
31524_terrestrial,436,461,262,233,897,60.09174311926605,53.44036697247706
31525_terrestrial,497,528,300,262,1025,60.36217303822937,52.716297786720325
31526_terrestrial,514,554,304,275,1068,59.143968871595334,53.50194552529183
31527_terrestrial,518,567,309,273,1085,59.65250965250966,52.702702702702695
31528_terrestrial,513,593,300,271,1106,58.47953216374269,52.826510721247566
31529_terrestrial,560,610,319,310,1170,56.96428571428571,55.35714285714286
31530_terrestrial,638,668,350,367,1306,54.858934169278996,57.52351097178683
31531_terrestrial,685,651,327,439,1336,47.737226277372265,64.08759124087591
31532_terrestrial,665,592,302,433,1257,45.41353383458647,65.11278195488723
31533_terrestrial,590,445,274,386,1035,46.440677966101696,65.42372881355932
31534_terrestrial,554,390,253,373,944,45.667870036101085,67.32851985559567
31535_terrestrial,578,409,254,400,987,43.944636678200695,69.20415224913495
31536_terrestrial,524,394,233,363,918,44.465648854961835,69.27480916030534
31537_terrestrial,515,364,240,354,879,46.601941747572816,68.73786407766991
31538_terrestrial,448,326,200,317,774,44.642857142857146,70.75892857142857
31539_terrestrial,366,266,165,261,632,45.08196721311475,71.31147540983606
31540_terrestrial,310,187,144,218,497,46.45161290322581,70.3225806451613
31542_terrestrial,278,166,114,202,444,41.007194244604314,72.66187050359713
31543_terrestrial,290,208,108,224,498,37.24137931034483,77.24137931034483
31544_terrestrial,259,200,99,197,459,38.22393822393823,76.06177606177607
31545_terrestrial,314,227,131,229,541,41.71974522292994,72.92993630573248
31546_terrestrial,874,421,533,514,1295,60.983981693363845,58.81006864988558
31596_terrestrial,877,335,562,521,1212,64.08209806157355,59.40706955530216
31597_terrestrial,859,335,547,516,1194,63.67869615832363,60.06984866123399
31598_terrestrial,1281,706,802,802,1987,62.60733801717409,62.60733801717409
31599_terrestrial,1314,743,810,841,2057,61.64383561643836,64.00304414003044
31600_terrestrial,1218,708,791,729,1926,64.9425287356322,59.85221674876847
31601_terrestrial,1159,633,767,670,1792,66.17773943054357,57.80845556514237
31602_terrestrial,1437,966,974,811,2403,67.78009742519137,56.437021572720944
31603_terrestrial,1320,782,875,766,2102,66.28787878787878,58.03030303030303
31604_terrestrial,1335,758,876,779,2093,65.61797752808988,58.352059925093634
31605_terrestrial,1285,730,841,728,2015,65.44747081712062,56.65369649805447
31606_terrestrial,840,313,550,462,1153,65.47619047619048,55.00000000000001
31610_terrestrial,1116,638,726,634,1754,65.05376344086021,56.81003584229391
31612_terrestrial,1164,684,756,667,1848,64.94845360824742,57.302405498281786
31613_terrestrial,1165,729,746,684,1894,64.0343347639485,58.712446351931334
31614_terrestrial,519,607,303,370,1126,58.38150289017341,71.29094412331408
31615_terrestrial,469,579,269,334,1048,57.356076759061835,71.21535181236673
31616_terrestrial,434,492,257,299,926,59.21658986175116,68.89400921658986
31617_terrestrial,452,467,258,318,919,57.07964601769911,70.35398230088495
31618_terrestrial,1353,719,828,841,2072,61.19733924611973,62.158167036215815
31619_terrestrial,1308,661,798,814,1969,61.00917431192661,62.23241590214067
31628_terrestrial,1149,552,680,710,1701,59.181897302001744,61.792863359443
31629_terrestrial,1176,566,705,714,1742,59.94897959183674,60.71428571428571
31781_terrestrial,604,762,356,309,1366,58.94039735099338,51.158940397350996
31782_terrestrial,758,1198,394,435,1956,51.97889182058047,57.38786279683378
31783_terrestrial,513,1114,160,409,1627,31.189083820662766,79.72709551656921
31784_terrestrial,577,1259,185,462,1836,32.06239168110919,80.06932409012131
31785_terrestrial,531,1135,185,418,1666,34.83992467043315,78.71939736346516
31786_terrestrial,418,774,154,327,1192,36.84210526315789,78.22966507177034
31787_terrestrial,398,694,145,316,1092,36.4321608040201,79.39698492462311
31788_terrestrial,391,671,150,308,1062,38.36317135549872,78.77237851662404
31789_terrestrial,388,658,149,305,1046,38.402061855670105,78.6082474226804
31790_terrestrial,387,689,147,303,1076,37.98449612403101,78.29457364341084
31791_terrestrial,395,725,154,302,1120,38.9873417721519,76.45569620253164
31792_terrestrial,386,685,149,293,1071,38.60103626943005,75.90673575129534
31793_terrestrial,402,752,157,301,1154,39.0547263681592,74.87562189054727
31794_terrestrial,416,804,162,313,1220,38.94230769230769,75.24038461538461
31795_terrestrial,397,794,158,298,1191,39.79848866498741,75.06297229219143
31796_terrestrial,382,771,160,287,1153,41.8848167539267,75.13089005235602
31797_terrestrial,375,714,157,283,1089,41.86666666666667,75.46666666666667
31798_terrestrial,372,675,155,281,1047,41.66666666666667,75.53763440860214
31799_terrestrial,393,709,156,301,1102,39.69465648854962,76.59033078880407
31800_terrestrial,409,720,161,314,1129,39.36430317848411,76.77261613691931
31801_terrestrial,396,728,156,306,1124,39.39393939393939,77.27272727272727
31802_terrestrial,393,737,153,301,1130,38.93129770992366,76.59033078880407
31803_terrestrial,388,721,153,293,1109,39.43298969072165,75.51546391752578
31804_terrestrial,398,729,153,303,1127,38.44221105527638,76.13065326633166
31805_terrestrial,396,705,157,299,1101,39.64646464646464,75.5050505050505
31806_terrestrial,377,687,156,281,1064,41.37931034482759,74.53580901856765
31807_terrestrial,371,707,152,277,1078,40.97035040431267,74.66307277628033
31808_terrestrial,394,727,156,300,1121,39.59390862944163,76.14213197969542
31809_terrestrial,448,726,172,350,1174,38.392857142857146,78.125
31810_terrestrial,711,834,379,426,1545,53.30520393811533,59.91561181434599
31811_terrestrial,678,770,367,401,1448,54.12979351032449,59.14454277286135
31870_terrestrial,687,676,473,271,1363,68.85007278020379,39.44687045123727
31871_terrestrial,452,595,257,243,1047,56.85840707964602,53.76106194690266
31872_terrestrial,416,597,236,222,1013,56.730769230769226,53.36538461538461
31873_terrestrial,392,574,213,220,966,54.33673469387755,56.12244897959183
31874_terrestrial,388,571,216,210,959,55.670103092783506,54.123711340206185
31875_terrestrial,434,609,238,241,1043,54.83870967741935,55.52995391705069
31876_terrestrial,421,590,239,230,1011,56.76959619952494,54.63182897862233
31877_terrestrial,406,538,234,218,944,57.635467980295566,53.69458128078818
31878_terrestrial,371,455,210,203,826,56.60377358490566,54.71698113207547
31879_terrestrial,383,436,221,208,819,57.702349869451695,54.308093994778076
31880_terrestrial,390,411,233,205,801,59.743589743589745,52.56410256410257
31881_terrestrial,375,404,220,196,779,58.666666666666664,52.26666666666666
31882_terrestrial,358,368,209,190,726,58.37988826815642,53.072625698324025
31883_terrestrial,416,425,255,212,841,61.29807692307693,50.96153846153846
31884_terrestrial,450,477,284,212,927,63.11111111111111,47.11111111111111
31885_terrestrial,502,511,331,226,1013,65.93625498007968,45.0199203187251
31886_terrestrial,453,505,282,225,958,62.251655629139066,49.668874172185426
31887_terrestrial,476,533,298,236,1009,62.60504201680672,49.57983193277311
31888_terrestrial,494,568,306,246,1062,61.943319838056674,49.797570850202426
31889_terrestrial,532,601,312,286,1133,58.64661654135338,53.75939849624061
31890_terrestrial,633,720,312,390,1353,49.28909952606635,61.61137440758294
31891_terrestrial,722,733,346,450,1455,47.92243767313019,62.32686980609419
31892_terrestrial,655,609,302,426,1264,46.10687022900763,65.0381679389313
31893_terrestrial,592,490,275,394,1082,46.4527027027027,66.55405405405406
31894_terrestrial,568,472,263,379,1040,46.30281690140845,66.72535211267606
31895_terrestrial,676,593,300,460,1269,44.37869822485207,68.04733727810651
31896_terrestrial,671,590,294,464,1261,43.81520119225038,69.150521609538
31897_terrestrial,590,478,251,421,1068,42.54237288135593,71.35593220338983
31898_terrestrial,537,402,232,384,939,43.20297951582867,71.50837988826815
31899_terrestrial,413,279,188,290,692,45.52058111380145,70.2179176755448
31902_terrestrial,256,166,110,189,422,42.96875,73.828125
31903_terrestrial,322,233,122,242,555,37.88819875776397,75.15527950310559
31904_terrestrial,349,249,155,242,598,44.412607449856736,69.34097421203438
31905_terrestrial,891,406,535,528,1297,60.04489337822672,59.25925925925925
31906_terrestrial,852,367,519,502,1219,60.91549295774647,58.920187793427225
31958_terrestrial,941,387,592,573,1328,62.911795961742826,60.89266737513284
31959_terrestrial,1290,707,798,812,1997,61.86046511627907,62.945736434108525
31960_terrestrial,633,515,377,447,1148,59.55766192733017,70.61611374407583
31961_terrestrial,1167,633,772,683,1800,66.15252784918594,58.5261353898886
31962_terrestrial,1163,649,781,658,1812,67.15391229578675,56.57781599312124
31963_terrestrial,1373,889,927,757,2262,67.51638747268754,55.1347414420976
31964_terrestrial,1458,895,968,830,2353,66.3923182441701,56.92729766803841
31965_terrestrial,1346,748,897,753,2094,66.64190193164933,55.943536404160476
31969_terrestrial,1122,605,743,621,1727,66.22103386809269,55.3475935828877
31970_terrestrial,1221,799,798,691,2020,65.35626535626535,56.59295659295659
31971_terrestrial,1225,858,804,698,2083,65.63265306122449,56.97959183673469
31972_terrestrial,1222,797,800,699,2019,65.46644844517185,57.20130932896891
31973_terrestrial,532,580,319,368,1112,59.962406015037594,69.17293233082707
31974_terrestrial,496,580,294,347,1076,59.2741935483871,69.95967741935483
31975_terrestrial,457,543,265,325,1000,57.98687089715536,71.11597374179432
31976_terrestrial,404,419,235,280,823,58.168316831683164,69.3069306930693
31977_terrestrial,430,411,235,310,841,54.65116279069767,72.09302325581395
31978_terrestrial,1347,701,813,842,2048,60.35634743875279,62.509279881217516
31979_terrestrial,1319,674,796,832,1993,60.34874905231236,63.07808946171342
31981_terrestrial,1268,590,778,776,1858,61.3564668769716,61.198738170347
31982_terrestrial,1279,590,786,783,1869,61.45426114151681,61.21970289288507
31983_terrestrial,1270,574,780,778,1844,61.417322834645674,61.25984251968504
31985_terrestrial,1311,636,804,800,1947,61.327231121281464,61.02212051868803
31986_terrestrial,1305,626,800,796,1931,61.30268199233716,60.996168582375475
31988_terrestrial,1158,558,686,714,1716,59.240069084628665,61.6580310880829
31989_terrestrial,1152,555,685,708,1707,59.46180555555556,61.458333333333336
32140_terrestrial,592,660,354,301,1252,59.797297297297305,50.8445945945946
32141_terrestrial,663,932,379,349,1595,57.16440422322775,52.6395173453997
32142_terrestrial,489,1137,148,400,1626,30.265848670756647,81.79959100204499
32143_terrestrial,595,1396,182,478,1991,30.58823529411765,80.33613445378151
32144_terrestrial,536,1239,181,426,1775,33.76865671641791,79.47761194029852
32145_terrestrial,419,898,159,325,1317,37.94749403341289,77.56563245823389
32146_terrestrial,403,801,157,314,1204,38.95781637717122,77.91563275434244
32147_terrestrial,390,731,152,304,1121,38.97435897435898,77.94871794871796
32148_terrestrial,397,721,155,308,1118,39.042821158690174,77.58186397984886
32149_terrestrial,398,712,156,307,1110,39.19597989949749,77.1356783919598
32150_terrestrial,394,712,156,301,1106,39.59390862944163,76.39593908629442
32151_terrestrial,393,726,157,299,1119,39.94910941475827,76.08142493638677
32152_terrestrial,383,715,152,291,1098,39.686684073107045,75.97911227154047
32153_terrestrial,402,748,165,299,1150,41.04477611940299,74.37810945273633
32154_terrestrial,415,828,166,310,1243,40,74.69879518072288
32155_terrestrial,397,804,159,299,1201,40.050377833753146,75.31486146095719
32156_terrestrial,379,723,161,285,1102,42.480211081794195,75.19788918205805
32157_terrestrial,371,686,162,276,1057,43.66576819407008,74.39353099730458
32158_terrestrial,376,673,161,279,1049,42.819148936170215,74.20212765957447
32159_terrestrial,383,695,161,282,1078,42.03655352480418,73.62924281984334
32160_terrestrial,378,670,156,283,1048,41.269841269841265,74.86772486772487
32161_terrestrial,375,664,156,282,1039,41.6,75.2
32162_terrestrial,368,669,154,275,1037,41.84782608695652,74.72826086956522
32163_terrestrial,369,667,155,274,1036,42.00542005420054,74.25474254742548
32164_terrestrial,374,660,159,276,1034,42.513368983957214,73.79679144385027
32165_terrestrial,374,656,157,277,1030,41.97860962566845,74.06417112299465
32166_terrestrial,370,666,156,272,1036,42.16216216216216,73.51351351351352
32167_terrestrial,372,685,153,278,1057,41.12903225806452,74.73118279569893
32168_terrestrial,407,730,159,310,1137,39.06633906633907,76.16707616707616
32169_terrestrial,701,887,369,426,1588,52.63908701854494,60.770328102710415
32170_terrestrial,714,857,377,435,1571,52.801120448179276,60.924369747899156
32227_terrestrial,280,148,228,79,428,81.42857142857143,28.214285714285715
32230_terrestrial,675,610,468,260,1285,69.33333333333334,38.51851851851852
32231_terrestrial,432,555,246,231,987,56.94444444444444,53.47222222222222
32232_terrestrial,423,566,239,226,989,56.50118203309693,53.42789598108747
32233_terrestrial,410,583,222,224,993,54.146341463414636,54.63414634146342
32234_terrestrial,394,580,220,212,974,55.83756345177665,53.80710659898477
32235_terrestrial,444,588,242,246,1032,54.5045045045045,55.4054054054054
32236_terrestrial,403,543,222,226,946,55.08684863523573,56.07940446650124
32237_terrestrial,388,475,221,209,863,56.95876288659794,53.865979381443296
32238_terrestrial,382,428,218,208,810,57.06806282722513,54.45026178010471
32239_terrestrial,450,480,270,229,930,60,50.888888888888886
32240_terrestrial,397,405,235,209,802,59.19395465994962,52.64483627204031
32241_terrestrial,331,344,182,188,675,54.98489425981873,56.797583081571
32242_terrestrial,314,329,170,180,643,54.14012738853503,57.324840764331206
32243_terrestrial,331,333,184,187,664,55.58912386706949,56.49546827794561
32244_terrestrial,421,416,266,202,837,63.18289786223278,47.980997624703086
32245_terrestrial,522,527,354,221,1049,67.81609195402298,42.337164750957854
32246_terrestrial,519,531,353,221,1050,68.01541425818883,42.58188824662813
32247_terrestrial,386,438,233,200,824,60.362694300518136,51.813471502590666
32248_terrestrial,408,484,243,214,892,59.55882352941176,52.450980392156865
32249_terrestrial,513,607,263,310,1120,51.267056530214425,60.42884990253411
32250_terrestrial,706,841,334,442,1547,47.30878186968839,62.606232294617556
32251_terrestrial,700,786,325,451,1486,46.42857142857143,64.42857142857143
32252_terrestrial,574,540,262,387,1114,45.64459930313589,67.42160278745645
32253_terrestrial,660,537,355,380,1197,53.78787878787878,57.57575757575758
32254_terrestrial,681,563,362,396,1244,53.15712187958884,58.14977973568281
32255_terrestrial,750,665,376,456,1415,50.13333333333333,60.8
32256_terrestrial,709,677,299,502,1386,42.17207334273625,70.80394922425953
32257_terrestrial,671,592,295,469,1263,43.96423248882265,69.89567809239941
32258_terrestrial,637,567,272,453,1204,42.700156985871274,71.11459968602826
32259_terrestrial,525,415,231,363,940,44,69.14285714285714
32261_terrestrial,285,170,142,196,455,49.824561403508774,68.77192982456141
32262_terrestrial,305,191,139,205,496,45.57377049180328,67.21311475409836
32263_terrestrial,369,261,160,254,630,43.360433604336045,68.83468834688347
32264_terrestrial,907,429,536,545,1336,59.09592061742006,60.088202866593164
32318_terrestrial,939,382,593,568,1321,63.15228966986155,60.48988285410011
32319_terrestrial,1215,609,758,746,1824,62.38683127572017,61.39917695473252
32320_terrestrial,1335,745,829,835,2080,62.09737827715356,62.546816479400746
32321_terrestrial,639,517,381,454,1156,59.624413145539904,71.04851330203444
32322_terrestrial,587,439,359,413,1026,61.158432708688245,70.35775127768314
32323_terrestrial,1251,682,838,704,1933,66.98641087130297,56.27498001598721
32324_terrestrial,1295,700,874,710,1995,67.49034749034749,54.826254826254825
32325_terrestrial,1040,475,693,567,1515,66.63461538461539,54.51923076923077
32329_terrestrial,1161,636,769,646,1797,66.23600344530577,55.64168819982773
32330_terrestrial,1210,704,798,684,1914,65.95041322314049,56.528925619834716
32331_terrestrial,518,501,311,359,1019,60.03861003861004,69.3050193050193
32332_terrestrial,517,507,317,353,1024,61.315280464216634,68.27852998065764
32333_terrestrial,507,503,306,345,1010,60.35502958579882,68.04733727810651
32334_terrestrial,478,498,281,331,976,58.78661087866108,69.24686192468619
32335_terrestrial,429,490,252,297,919,58.74125874125874,69.23076923076923
32336_terrestrial,461,455,263,325,916,57.04989154013015,70.49891540130152
32337_terrestrial,483,443,277,340,926,57.34989648033127,70.39337474120083
32338_terrestrial,1259,644,792,761,1903,62.90706910246227,60.444797458300236
32339_terrestrial,1306,661,798,813,1967,61.102603369065854,62.25114854517611
32340_terrestrial,1294,580,810,773,1874,62.59659969088099,59.737248840803716
32341_terrestrial,1311,617,816,789,1928,62.24256292906178,60.18306636155606
32342_terrestrial,1288,610,791,788,1898,61.41304347826087,61.18012422360248
32343_terrestrial,1298,625,801,788,1923,61.71032357473035,60.708782742681045
32344_terrestrial,1299,629,803,786,1928,61.816782140107776,60.5080831408776
32345_terrestrial,1305,633,805,792,1938,61.68582375478927,60.689655172413794
32348_terrestrial,1195,576,721,718,1771,60.33472803347281,60.0836820083682
32349_terrestrial,1160,558,690,714,1718,59.48275862068966,61.55172413793103
32350_terrestrial,1058,484,624,652,1542,58.97920604914933,61.62570888468809
32500_terrestrial,595,626,362,298,1221,60.84033613445378,50.08403361344538
32501_terrestrial,402,854,130,330,1256,32.33830845771145,82.08955223880598
32502_terrestrial,486,1224,137,397,1710,28.189300411522634,81.6872427983539
32503_terrestrial,591,1478,185,474,2069,31.302876480541453,80.20304568527918
32504_terrestrial,453,1051,160,354,1504,35.32008830022075,78.1456953642384
32505_terrestrial,443,998,163,346,1441,36.794582392776526,78.1038374717833
32506_terrestrial,408,889,159,316,1297,38.970588235294116,77.45098039215686
32507_terrestrial,393,786,155,305,1179,39.44020356234097,77.60814249363868
32508_terrestrial,385,775,150,295,1160,38.961038961038966,76.62337662337663
32509_terrestrial,385,751,154,293,1136,40,76.1038961038961
32510_terrestrial,394,728,158,300,1122,40.10152284263959,76.14213197969542
32511_terrestrial,396,750,159,301,1146,40.15151515151515,76.01010101010101
32512_terrestrial,388,727,159,295,1115,40.97938144329897,76.03092783505154
32513_terrestrial,402,747,170,301,1149,42.28855721393035,74.87562189054727
32514_terrestrial,406,756,172,302,1162,42.364532019704434,74.38423645320196
32515_terrestrial,394,737,171,290,1131,43.401015228426395,73.60406091370558
32516_terrestrial,387,725,169,285,1112,43.669250645994836,73.64341085271317
32517_terrestrial,390,723,173,284,1113,44.35897435897436,72.82051282051282
32518_terrestrial,399,734,172,292,1133,43.10776942355889,73.1829573934837
32519_terrestrial,396,725,167,294,1121,42.17171717171717,74.24242424242425
32520_terrestrial,387,686,163,290,1073,42.11886304909561,74.93540051679587
32521_terrestrial,372,687,155,278,1059,41.66666666666667,74.73118279569893
32522_terrestrial,372,678,158,275,1050,42.473118279569896,73.9247311827957
32523_terrestrial,376,675,160,277,1051,42.5531914893617,73.67021276595744
32524_terrestrial,379,678,159,280,1057,41.952506596306065,73.87862796833772
32525_terrestrial,383,675,161,283,1058,42.03655352480418,73.89033942558747
32526_terrestrial,385,676,157,287,1061,40.77922077922078,74.54545454545455
32527_terrestrial,406,705,161,306,1111,39.6551724137931,75.36945812807882
32528_terrestrial,441,757,172,340,1198,39.002267573696145,77.09750566893425
32529_terrestrial,714,901,384,428,1615,53.78151260504202,59.943977591036415
32530_terrestrial,698,804,370,424,1502,53.00859598853869,60.74498567335244
32531_terrestrial,677,747,363,401,1424,53.61890694239291,59.23190546528804
32532_terrestrial,721,813,388,438,1534,53.81414701803051,60.74895977808599
32533_terrestrial,685,735,380,402,1420,55.47445255474452,58.68613138686132
32534_terrestrial,672,685,379,386,1357,56.398809523809526,57.44047619047619
32589_terrestrial,667,549,466,255,1216,69.86506746626686,38.23088455772114
32590_terrestrial,696,600,483,268,1296,69.39655172413794,38.50574712643678
32591_terrestrial,441,548,248,237,989,56.235827664399096,53.74149659863946
32592_terrestrial,411,542,221,225,953,53.771289537712896,54.74452554744526
32593_terrestrial,386,513,208,210,899,53.8860103626943,54.40414507772021
32594_terrestrial,393,538,220,211,931,55.97964376590331,53.68956743002544
32595_terrestrial,352,494,193,193,846,54.82954545454546,54.82954545454546
32596_terrestrial,362,437,203,200,799,56.07734806629834,55.24861878453039
32597_terrestrial,375,412,202,211,787,53.86666666666666,56.266666666666666
32598_terrestrial,449,453,267,230,902,59.46547884187082,51.224944320712694
32599_terrestrial,448,455,273,224,903,60.9375,50
32600_terrestrial,394,401,238,203,795,60.40609137055838,51.52284263959391
32601_terrestrial,373,384,218,195,757,58.4450402144772,52.27882037533512
32602_terrestrial,330,322,184,181,652,55.757575757575765,54.848484848484844
32603_terrestrial,351,348,197,191,699,56.12535612535613,54.41595441595442
32604_terrestrial,352,349,200,186,701,56.81818181818182,52.84090909090909
32605_terrestrial,360,343,212,189,703,58.88888888888889,52.5
32606_terrestrial,463,447,315,199,910,68.03455723542116,42.98056155507559
32607_terrestrial,348,375,207,188,723,59.48275862068966,54.02298850574713
32608_terrestrial,384,439,227,211,823,59.114583333333336,54.947916666666664
32609_terrestrial,555,654,267,347,1209,48.10810810810811,62.52252252252253
32610_terrestrial,694,822,327,437,1516,47.11815561959654,62.96829971181557
32611_terrestrial,625,676,282,419,1301,45.12,67.04
32612_terrestrial,667,543,362,381,1210,54.27286356821589,57.12143928035982
32613_terrestrial,622,483,339,352,1105,54.5016077170418,56.59163987138264
32614_terrestrial,577,405,326,316,982,56.499133448873486,54.76603119584056
32615_terrestrial,728,561,376,433,1289,51.64835164835166,59.47802197802198
32616_terrestrial,693,623,301,480,1316,43.43434343434344,69.26406926406926
32617_terrestrial,666,639,294,461,1305,44.14414414414414,69.21921921921921
32618_terrestrial,641,584,273,455,1225,42.58970358814352,70.98283931357254
32619_terrestrial,531,391,237,366,922,44.632768361581924,68.92655367231639
32621_terrestrial,377,251,187,246,628,49.602122015915114,65.25198938992042
32622_terrestrial,945,409,561,565,1354,59.36507936507937,59.78835978835979
32623_terrestrial,934,423,557,561,1357,59.63597430406852,60.064239828693786
32679_terrestrial,937,422,599,561,1359,63.92742796157951,59.87193169690501
32680_terrestrial,1240,659,765,777,1899,61.693548387096776,62.66129032258064
32681_terrestrial,1366,784,856,853,2150,62.664714494875554,62.44509516837482
32682_terrestrial,621,485,368,443,1106,59.25925925925925,71.33655394524959
32683_terrestrial,604,442,371,410,1046,61.423841059602644,67.88079470198676
32684_terrestrial,1266,677,849,699,1943,67.06161137440758,55.21327014218009
32685_terrestrial,966,419,651,526,1385,67.3913043478261,54.45134575569358
32690_terrestrial,1213,649,803,683,1862,66.19950535861501,56.306677658697446
32691_terrestrial,517,428,314,353,945,60.73500967117988,68.27852998065764
32692_terrestrial,472,415,283,325,887,59.95762711864406,68.85593220338984
32693_terrestrial,456,448,272,315,904,59.64912280701754,69.07894736842105
32694_terrestrial,451,443,263,314,894,58.31485587583148,69.62305986696231
32695_terrestrial,456,460,267,319,916,58.55263157894737,69.95614035087719
32696_terrestrial,468,436,279,329,904,59.61538461538461,70.2991452991453
32697_terrestrial,490,424,296,331,914,60.40816326530612,67.55102040816327
32698_terrestrial,1201,628,775,712,1829,64.52955870108244,59.28393005828476
32700_terrestrial,1308,607,814,787,1915,62.23241590214067,60.16819571865444
32701_terrestrial,1279,619,785,780,1898,61.376075058639564,60.98514464425332
32702_terrestrial,1296,604,796,789,1900,61.419753086419746,60.879629629629626
32703_terrestrial,1277,596,776,788,1873,60.767423649177765,61.70712607674237
32704_terrestrial,1274,576,775,783,1850,60.832025117739406,61.45996860282574
32708_terrestrial,1181,587,712,715,1768,60.287891617273495,60.54191363251482
32709_terrestrial,1151,554,686,707,1705,59.600347523892275,61.424847958297136
32710_terrestrial,1070,511,636,654,1581,59.439252336448604,61.12149532710281
32711_terrestrial,1222,696,722,758,1918,59.08346972176759,62.02945990180033
32712_terrestrial,1265,745,748,787,2010,59.130434782608695,62.21343873517786
32713_terrestrial,1185,716,683,755,1901,57.63713080168776,63.71308016877637
32714_terrestrial,1183,729,685,745,1912,57.903634826711745,62.975486052409124
32715_terrestrial,1164,655,683,731,1819,58.67697594501718,62.80068728522337
32716_terrestrial,1025,496,612,632,1521,59.70731707317073,61.65853658536585
32717_terrestrial,1013,490,600,632,1503,59.23000987166831,62.38894373149062
32860_terrestrial,611,634,367,305,1245,60.06546644844517,49.91816693944354
32861_terrestrial,411,723,137,333,1134,33.33333333333333,81.02189781021897
32862_terrestrial,497,1187,143,403,1684,28.772635814889334,81.08651911468813
32863_terrestrial,510,1311,178,400,1821,34.90196078431372,78.43137254901961
32864_terrestrial,416,996,154,329,1412,37.019230769230774,79.08653846153845
32865_terrestrial,418,967,157,325,1385,37.55980861244019,77.75119617224881
32866_terrestrial,415,925,160,318,1340,38.55421686746988,76.62650602409639
32867_terrestrial,404,876,154,309,1280,38.11881188118812,76.48514851485149
32868_terrestrial,392,780,150,304,1172,38.265306122448976,77.55102040816327
32869_terrestrial,392,767,150,304,1159,38.265306122448976,77.55102040816327
32870_terrestrial,395,776,157,303,1171,39.74683544303797,76.70886075949367
32871_terrestrial,396,789,160,299,1185,40.4040404040404,75.5050505050505
32872_terrestrial,388,736,159,293,1124,40.97938144329897,75.51546391752578
32873_terrestrial,387,723,163,290,1110,42.11886304909561,74.93540051679587
32874_terrestrial,388,748,165,289,1136,42.52577319587629,74.48453608247422
32875_terrestrial,390,731,167,289,1121,42.82051282051282,74.1025641025641
32876_terrestrial,379,712,163,279,1091,43.007915567282325,73.61477572559367
32877_terrestrial,385,712,162,287,1097,42.077922077922075,74.54545454545455
32878_terrestrial,406,757,175,300,1163,43.103448275862064,73.89162561576354
32879_terrestrial,434,801,184,320,1235,42.3963133640553,73.73271889400922
32880_terrestrial,426,757,172,322,1183,40.375586854460096,75.5868544600939
32881_terrestrial,404,718,165,301,1122,40.84158415841584,74.5049504950495
32882_terrestrial,397,709,162,299,1106,40.80604534005038,75.31486146095719
32883_terrestrial,430,743,171,324,1173,39.76744186046511,75.34883720930232
32884_terrestrial,456,801,177,346,1257,38.81578947368421,75.87719298245614
32885_terrestrial,488,855,188,372,1343,38.52459016393443,76.22950819672131
32886_terrestrial,472,803,182,361,1275,38.559322033898304,76.48305084745762
32887_terrestrial,489,841,196,373,1330,40.081799591002046,76.27811860940696
32888_terrestrial,506,838,203,385,1344,40.11857707509881,76.08695652173914
32889_terrestrial,496,819,198,383,1315,39.91935483870967,77.21774193548387
32890_terrestrial,688,840,360,422,1528,52.32558139534884,61.337209302325576
32891_terrestrial,725,845,384,441,1570,52.96551724137931,60.827586206896555
32892_terrestrial,731,851,391,449,1582,53.48837209302325,61.42270861833106
32893_terrestrial,442,631,177,348,1073,40.04524886877828,78.73303167420815
32894_terrestrial,682,704,381,396,1386,55.86510263929618,58.06451612903226
32895_terrestrial,668,617,389,378,1285,58.23353293413174,56.58682634730538
32896_terrestrial,621,573,370,345,1194,59.58132045088567,55.55555555555556
32949_terrestrial,411,429,235,220,840,57.17761557177615,53.52798053527981
32950_terrestrial,693,590,475,275,1283,68.54256854256853,39.682539682539684
32951_terrestrial,444,525,241,246,969,54.27927927927928,55.4054054054054
32952_terrestrial,386,532,193,223,918,50,57.77202072538861
32953_terrestrial,377,525,201,209,902,53.315649867374006,55.437665782493376
32954_terrestrial,395,499,206,227,894,52.151898734177216,57.46835443037974
32955_terrestrial,394,484,206,223,878,52.28426395939086,56.598984771573605
32956_terrestrial,423,409,230,241,832,54.37352245862884,56.973995271867615
32957_terrestrial,489,458,282,261,947,57.668711656441715,53.37423312883436
32958_terrestrial,461,426,266,244,887,57.70065075921909,52.92841648590022
32959_terrestrial,389,360,232,202,749,59.6401028277635,51.9280205655527
32960_terrestrial,345,325,199,186,670,57.68115942028985,53.91304347826087
32961_terrestrial,308,309,167,177,617,54.22077922077923,57.467532467532465
32962_terrestrial,300,308,161,173,608,53.666666666666664,57.666666666666664
32963_terrestrial,351,337,203,186,688,57.83475783475783,52.991452991452995
32964_terrestrial,344,329,198,183,673,57.55813953488372,53.19767441860465
32965_terrestrial,330,309,195,172,639,59.09090909090909,52.121212121212125
32966_terrestrial,362,345,229,175,707,63.25966850828729,48.34254143646409
32967_terrestrial,348,345,213,176,693,61.206896551724135,50.57471264367817
32968_terrestrial,388,410,220,212,798,56.70103092783505,54.63917525773196
32969_terrestrial,591,746,281,375,1337,47.54653130287648,63.45177664974619
32970_terrestrial,660,836,299,435,1496,45.3030303030303,65.9090909090909
32971_terrestrial,600,630,267,410,1230,44.5,68.33333333333333
32972_terrestrial,639,470,349,367,1109,54.61658841940532,57.43348982785602
32973_terrestrial,483,312,295,251,795,61.07660455486542,51.96687370600414
32974_terrestrial,564,354,333,298,918,59.04255319148937,52.836879432624116
32975_terrestrial,694,486,363,404,1180,52.305475504322764,58.21325648414985
32976_terrestrial,677,573,299,462,1250,44.16543574593796,68.24224519940915
32977_terrestrial,669,607,288,465,1276,43.04932735426009,69.50672645739911
32978_terrestrial,628,538,269,444,1166,42.8343949044586,70.70063694267516
32979_terrestrial,525,405,235,366,930,44.761904761904766,69.71428571428572
32980_terrestrial,455,325,213,301,780,46.81318681318681,66.15384615384615
32981_terrestrial,1122,570,678,651,1692,60.42780748663101,58.02139037433155
32982_terrestrial,1054,512,636,614,1566,60.341555977229596,58.254269449715366
33039_terrestrial,912,386,585,544,1298,64.14473684210526,59.64912280701754
33040_terrestrial,912,381,585,544,1293,64.14473684210526,59.64912280701754
33041_terrestrial,1342,742,846,831,2084,63.04023845007451,61.92250372578242
33042_terrestrial,652,537,387,458,1189,59.355828220858896,70.24539877300614
33043_terrestrial,589,433,352,412,1022,59.7623089983022,69.94906621392191
33044_terrestrial,1263,679,844,717,1942,66.82501979414094,56.76959619952494
33045_terrestrial,1285,678,861,720,1963,67.00389105058365,56.03112840466926
33046_terrestrial,1039,464,698,586,1503,67.17998075072185,56.40038498556304
33047_terrestrial,1028,457,689,577,1485,67.02334630350194,56.1284046692607
33049_terrestrial,948,359,633,518,1307,66.77215189873418,54.641350210970465
33050_terrestrial,1153,621,758,650,1774,65.74154379878577,56.37467476149176
33051_terrestrial,1168,682,767,658,1850,65.66780821917808,56.33561643835616
33052_terrestrial,454,406,267,319,860,58.81057268722467,70.26431718061674
33053_terrestrial,438,388,254,311,826,57.99086757990868,71.00456621004567
33054_terrestrial,450,402,268,315,852,59.55555555555555,70
33055_terrestrial,467,423,277,323,890,59.314775160599574,69.16488222698072
33056_terrestrial,499,432,293,349,931,58.717434869739485,69.93987975951904
33057_terrestrial,1207,635,778,708,1842,64.4573322286661,58.657829328914666
33058_terrestrial,1168,588,754,688,1756,64.55479452054794,58.9041095890411
33060_terrestrial,1297,625,810,774,1922,62.451811873554355,59.67617579028527
33061_terrestrial,1283,676,785,790,1959,61.184723304754485,61.574434918160556
33062_terrestrial,1288,629,785,793,1917,60.9472049689441,61.568322981366464
33063_terrestrial,1299,637,799,792,1936,61.50885296381831,60.969976905311775
33064_terrestrial,1290,623,795,781,1913,61.627906976744185,60.54263565891473
33068_terrestrial,1113,505,656,699,1618,58.93980233602875,62.8032345013477
33069_terrestrial,1100,500,648,692,1600,58.909090909090914,62.909090909090914
33070_terrestrial,1142,555,674,710,1697,59.01926444833625,62.17162872154116
33071_terrestrial,1274,717,758,786,1991,59.49764521193093,61.69544740973313
33072_terrestrial,1242,713,731,773,1955,58.85668276972624,62.23832528180354
33073_terrestrial,1217,728,709,759,1945,58.25801150369762,62.36647493837305
33074_terrestrial,317,390,170,210,707,53.62776025236593,66.24605678233438
33075_terrestrial,1211,772,709,753,1983,58.54665565648225,62.18001651527663
33076_terrestrial,1114,618,667,678,1732,59.87432675044884,60.86175942549371
33077_terrestrial,1114,646,667,678,1760,59.87432675044884,60.86175942549371
33078_terrestrial,1136,631,659,720,1767,58.01056338028169,63.38028169014085
33079_terrestrial,1126,604,648,724,1730,57.548845470692726,64.29840142095915
33080_terrestrial,1112,591,645,712,1703,58.00359712230215,64.02877697841727
33087_terrestrial,956,410,566,597,1366,59.20502092050209,62.44769874476987
33088_terrestrial,960,410,570,597,1370,59.375,62.18749999999999
33220_terrestrial,576,564,350,277,1140,60.763888888888886,48.09027777777778
33221_terrestrial,732,946,377,424,1678,51.502732240437155,57.92349726775956
33222_terrestrial,509,1175,153,411,1684,30.05893909626719,80.74656188605108
33223_terrestrial,460,1080,164,363,1540,35.65217391304348,78.91304347826087
33224_terrestrial,412,957,155,321,1369,37.62135922330097,77.9126213592233
33225_terrestrial,402,916,157,311,1318,39.0547263681592,77.363184079602
33226_terrestrial,418,924,160,324,1342,38.27751196172249,77.51196172248804
33227_terrestrial,434,971,162,338,1405,37.327188940092164,77.88018433179722
33228_terrestrial,433,936,157,337,1369,36.25866050808314,77.82909930715935
33229_terrestrial,417,867,153,326,1284,36.69064748201439,78.17745803357315
33230_terrestrial,403,850,152,312,1253,37.71712158808933,77.41935483870968
33231_terrestrial,410,832,156,315,1242,38.048780487804876,76.82926829268293
33232_terrestrial,407,792,154,317,1199,37.83783783783784,77.88697788697789
33233_terrestrial,427,813,168,326,1240,39.34426229508197,76.34660421545667
33234_terrestrial,430,836,172,327,1266,40,76.04651162790698
33235_terrestrial,445,853,183,332,1298,41.12359550561798,74.6067415730337
33236_terrestrial,419,786,169,315,1205,40.334128878281625,75.17899761336515
33237_terrestrial,393,726,162,296,1119,41.221374045801525,75.31806615776081
33238_terrestrial,413,747,166,312,1160,40.19370460048426,75.54479418886199
33239_terrestrial,465,839,186,349,1304,40,75.05376344086021
33240_terrestrial,487,898,187,371,1385,38.398357289527716,76.18069815195072
33241_terrestrial,461,854,178,355,1315,38.611713665943604,77.00650759219089
33242_terrestrial,477,882,189,363,1359,39.62264150943396,76.10062893081762
33243_terrestrial,477,886,191,362,1363,40.041928721174,75.8909853249476
33244_terrestrial,486,905,195,367,1391,40.123456790123456,75.51440329218107
33245_terrestrial,506,912,200,381,1418,39.52569169960474,75.29644268774703
33246_terrestrial,507,904,198,388,1411,39.053254437869825,76.52859960552269
33247_terrestrial,488,834,195,375,1322,39.959016393442624,76.84426229508196
33248_terrestrial,473,775,191,362,1248,40.38054968287527,76.53276955602537
33249_terrestrial,457,747,189,345,1204,41.35667396061269,75.49234135667396
33250_terrestrial,447,730,180,341,1177,40.26845637583892,76.28635346756153
33251_terrestrial,458,725,190,346,1183,41.48471615720524,75.54585152838428
33252_terrestrial,425,676,167,332,1101,39.294117647058826,78.11764705882352
33253_terrestrial,414,625,161,322,1039,38.88888888888889,77.77777777777779
33254_terrestrial,403,552,158,315,955,39.20595533498759,78.16377171215882
33255_terrestrial,379,477,150,295,856,39.577836411609496,77.83641160949868
33256_terrestrial,650,615,382,365,1265,58.769230769230774,56.15384615384615
33257_terrestrial,609,517,359,345,1126,58.94909688013136,56.65024630541872
33258_terrestrial,600,496,356,343,1096,59.333333333333336,57.166666666666664
33259_terrestrial,579,475,352,323,1054,60.79447322970639,55.78583765112263
33260_terrestrial,562,449,347,313,1011,61.74377224199288,55.693950177935946
33261_terrestrial,265,307,112,211,572,42.26415094339623,79.62264150943396
33310_terrestrial,415,433,224,235,848,53.975903614457835,56.62650602409639
33311_terrestrial,699,602,469,286,1301,67.0958512160229,40.915593705293276
33312_terrestrial,436,516,233,252,952,53.44036697247706,57.798165137614674
33313_terrestrial,381,489,207,209,870,54.330708661417326,54.85564304461942
33314_terrestrial,384,472,199,222,856,51.822916666666664,57.8125
33315_terrestrial,440,439,234,253,879,53.18181818181819,57.49999999999999
33316_terrestrial,442,402,226,265,844,51.13122171945701,59.95475113122172
33317_terrestrial,521,464,296,277,985,56.813819577735124,53.16698656429942
33318_terrestrial,414,367,236,223,781,57.00483091787439,53.864734299516904
33319_terrestrial,334,321,186,183,655,55.688622754491014,54.79041916167665
33320_terrestrial,317,287,180,174,604,56.782334384858046,54.889589905362776
33321_terrestrial,306,289,169,175,595,55.22875816993464,57.18954248366013
33322_terrestrial,307,285,168,174,592,54.72312703583062,56.67752442996743
33323_terrestrial,324,298,180,183,622,55.55555555555556,56.481481481481474
33324_terrestrial,315,297,178,174,612,56.507936507936506,55.23809523809524
33325_terrestrial,331,298,189,178,629,57.09969788519638,53.776435045317214
33326_terrestrial,391,331,239,193,722,61.125319693094625,49.36061381074169
33327_terrestrial,394,346,245,195,740,62.182741116751274,49.49238578680203
33328_terrestrial,407,433,217,231,840,53.31695331695332,56.75675675675676
33329_terrestrial,626,814,298,395,1440,47.6038338658147,63.09904153354633
33330_terrestrial,599,681,266,407,1280,44.40734557595994,67.9465776293823
33331_terrestrial,539,484,244,366,1023,45.26901669758813,67.90352504638219
33332_terrestrial,624,413,359,333,1037,57.53205128205128,53.36538461538461
33333_terrestrial,571,380,334,300,951,58.49387040280211,52.53940455341506
33334_terrestrial,609,382,340,337,991,55.82922824302135,55.33661740558292
33335_terrestrial,576,415,260,390,991,45.13888888888889,67.70833333333334
33336_terrestrial,638,509,274,443,1147,42.94670846394985,69.43573667711598
33337_terrestrial,642,560,272,451,1202,42.36760124610592,70.24922118380063
33338_terrestrial,646,603,278,451,1249,43.034055727554176,69.81424148606811
33339_terrestrial,594,513,270,400,1107,45.45454545454545,67.34006734006735
33340_terrestrial,550,434,260,362,984,47.27272727272727,65.81818181818181
33341_terrestrial,1168,642,696,680,1810,59.589041095890416,58.21917808219178
33400_terrestrial,916,394,595,538,1310,64.95633187772926,58.73362445414847
33401_terrestrial,1284,694,821,786,1978,63.940809968847354,61.21495327102804
33402_terrestrial,647,522,389,446,1169,60.123647604327665,68.93353941267388
33403_terrestrial,652,502,390,458,1154,59.8159509202454,70.24539877300614
33404_terrestrial,592,412,362,415,1004,61.14864864864865,70.10135135135135
33405_terrestrial,1311,680,881,740,1991,67.20061022120518,56.44546147978642
33406_terrestrial,1347,707,908,759,2054,67.4090571640683,56.347438752783965
33407_terrestrial,1057,484,711,592,1541,67.2658467360454,56.00756859035004
33408_terrestrial,983,418,657,545,1401,66.83621566632758,55.442522889114954
33409_terrestrial,986,414,653,550,1400,66.22718052738337,55.78093306288032
33411_terrestrial,1156,633,753,659,1789,65.13840830449827,57.00692041522492
33412_terrestrial,1189,643,776,683,1832,65.26492851135409,57.44322960470984
33413_terrestrial,481,376,285,339,857,59.25155925155925,70.47817047817048
33414_terrestrial,1195,642,789,683,1837,66.02510460251047,57.154811715481166
33415_terrestrial,507,425,314,344,932,61.93293885601578,67.85009861932939
33416_terrestrial,519,432,313,358,951,60.308285163776496,68.97880539499036
33417_terrestrial,1182,602,761,690,1784,64.3824027072758,58.37563451776649
33419_terrestrial,1249,573,777,747,1822,62.20976781425141,59.80784627702162
33420_terrestrial,1263,630,789,758,1893,62.47030878859857,60.01583531274742
33421_terrestrial,1275,653,784,781,1928,61.49019607843137,61.254901960784316
33422_terrestrial,1287,648,789,790,1935,61.3053613053613,61.38306138306139
33423_terrestrial,1264,573,776,776,1837,61.39240506329114,61.39240506329114
33429_terrestrial,1158,554,701,710,1712,60.53540587219344,61.3126079447323
33430_terrestrial,1243,645,737,781,1888,59.29203539823009,62.83185840707964
33431_terrestrial,1236,627,739,770,1863,59.78964401294499,62.297734627831716
33432_terrestrial,1169,618,685,732,1787,58.59709153122326,62.61762189905903
33433_terrestrial,1202,722,697,753,1924,57.986688851913485,62.64559068219634
33434_terrestrial,1202,692,706,751,1894,58.73544093178037,62.47920133111481
33435_terrestrial,1218,772,710,755,1990,58.29228243021346,61.98686371100164
33436_terrestrial,1106,605,641,708,1711,57.95660036166366,64.01446654611212
33437_terrestrial,1157,687,670,731,1844,57.908383751080386,63.18063958513397
33438_terrestrial,1157,679,671,730,1836,57.99481417458946,63.09420916162489
33439_terrestrial,282,367,146,196,649,51.77304964539007,69.50354609929079
33440_terrestrial,1143,702,660,731,1845,57.74278215223097,63.954505686789155
33441_terrestrial,1163,711,671,740,1874,57.695614789337924,63.628546861564914
33442_terrestrial,1144,677,661,731,1821,57.77972027972028,63.89860139860139
33443_terrestrial,1100,613,631,712,1713,57.36363636363636,64.72727272727272
33447_terrestrial,963,411,572,598,1374,59.39771547248183,62.097611630321914
33448_terrestrial,969,420,578,599,1389,59.64912280701754,61.81630546955624
33451_terrestrial,1032,486,619,637,1518,59.98062015503876,61.724806201550386
33452_terrestrial,1043,489,628,637,1532,60.21093000958773,61.07382550335571
33580_terrestrial,610,608,339,315,1218,55.57377049180327,51.63934426229508
33581_terrestrial,744,998,374,431,1742,50.26881720430107,57.93010752688173
33582_terrestrial,487,1113,154,392,1600,31.622176591375773,80.49281314168378
33583_terrestrial,417,918,154,327,1335,36.930455635491604,78.41726618705036
33584_terrestrial,414,885,161,322,1299,38.88888888888889,77.77777777777779
33585_terrestrial,407,881,160,319,1288,39.31203931203931,78.37837837837837
33586_terrestrial,433,937,162,342,1370,37.41339491916859,78.9838337182448
33587_terrestrial,501,1062,177,399,1563,35.32934131736527,79.64071856287424
33588_terrestrial,475,1022,172,374,1497,36.21052631578948,78.73684210526316
33589_terrestrial,459,960,169,359,1419,36.81917211328976,78.21350762527233
33590_terrestrial,468,965,170,361,1433,36.324786324786324,77.13675213675214
33591_terrestrial,460,951,173,354,1411,37.608695652173914,76.95652173913044
33592_terrestrial,437,858,168,336,1295,38.443935926773456,76.88787185354691
33593_terrestrial,437,841,170,334,1278,38.901601830663616,76.43020594965675
33594_terrestrial,424,811,173,318,1235,40.80188679245283,75
33595_terrestrial,431,837,174,325,1268,40.37122969837587,75.4060324825986
33596_terrestrial,439,830,178,329,1269,40.546697038724375,74.94305239179954
33597_terrestrial,445,812,180,334,1257,40.44943820224719,75.0561797752809
33598_terrestrial,443,823,180,331,1266,40.63205417607224,74.7178329571106
33599_terrestrial,466,875,184,352,1341,39.48497854077253,75.53648068669528
33600_terrestrial,506,960,201,379,1466,39.723320158102766,74.90118577075098
33601_terrestrial,514,981,207,387,1495,40.27237354085603,75.29182879377431
33602_terrestrial,495,923,197,376,1418,39.7979797979798,75.95959595959596
33603_terrestrial,445,833,173,340,1278,38.87640449438202,76.40449438202246
33604_terrestrial,444,816,177,338,1260,39.86486486486486,76.12612612612612
33605_terrestrial,465,829,187,350,1294,40.215053763440864,75.26881720430107
33606_terrestrial,451,794,179,345,1245,39.689578713968956,76.49667405764967
33607_terrestrial,433,743,182,326,1176,42.032332563510394,75.28868360277137
33608_terrestrial,432,731,183,321,1163,42.36111111111111,74.30555555555556
33609_terrestrial,435,722,181,327,1157,41.60919540229885,75.17241379310344
33610_terrestrial,419,694,167,321,1113,39.856801909307876,76.6109785202864
33611_terrestrial,417,685,172,315,1102,41.247002398081534,75.53956834532374
33612_terrestrial,396,648,160,304,1044,40.4040404040404,76.76767676767676
33613_terrestrial,384,593,155,294,977,40.36458333333333,76.5625
33614_terrestrial,378,536,155,289,914,41.00529100529101,76.45502645502646
33615_terrestrial,362,479,143,280,841,39.50276243093923,77.34806629834254
33616_terrestrial,645,579,377,363,1224,58.44961240310077,56.27906976744186
33617_terrestrial,331,401,127,272,732,38.368580060422964,82.17522658610272
33618_terrestrial,323,387,129,260,710,39.93808049535604,80.4953560371517
33619_terrestrial,307,389,129,243,696,42.01954397394137,79.15309446254072
33620_terrestrial,283,360,115,227,643,40.63604240282685,80.21201413427562
33621_terrestrial,575,484,349,327,1059,60.69565217391304,56.869565217391305
33622_terrestrial,564,477,345,319,1041,61.170212765957444,56.560283687943254
33671_terrestrial,680,565,460,275,1245,67.64705882352942,40.44117647058824
33672_terrestrial,724,622,489,292,1346,67.5414364640884,40.331491712707184
33673_terrestrial,461,498,244,261,959,52.92841648590022,56.61605206073753
33674_terrestrial,383,401,192,227,784,50.13054830287206,59.268929503916446
33675_terrestrial,481,409,268,265,890,55.71725571725572,55.09355509355509
33676_terrestrial,582,502,343,300,1084,58.93470790378007,51.546391752577314
33677_terrestrial,517,429,289,281,946,55.89941972920697,54.35203094777563
33678_terrestrial,442,355,264,229,797,59.72850678733032,51.80995475113123
33679_terrestrial,363,319,215,191,682,59.22865013774105,52.61707988980716
33680_terrestrial,355,323,212,187,678,59.71830985915493,52.67605633802817
33681_terrestrial,335,305,186,186,640,55.52238805970149,55.52238805970149
33682_terrestrial,339,303,190,188,642,56.04719764011799,55.45722713864307
33683_terrestrial,340,310,188,190,650,55.294117647058826,55.88235294117647
33684_terrestrial,351,308,193,194,659,54.98575498575499,55.27065527065527
33685_terrestrial,322,298,170,178,620,52.79503105590062,55.27950310559007
33686_terrestrial,394,332,231,205,726,58.629441624365484,52.03045685279187
33687_terrestrial,418,357,251,215,775,60.04784688995215,51.43540669856459
33688_terrestrial,447,460,228,266,907,51.006711409395976,59.50782997762863
33689_terrestrial,602,710,280,388,1312,46.51162790697674,64.45182724252491
33690_terrestrial,628,899,282,421,1527,44.904458598726116,67.03821656050955
33691_terrestrial,525,451,245,344,976,46.666666666666664,65.52380952380953
33692_terrestrial,492,371,239,310,863,48.577235772357724,63.00813008130082
33693_terrestrial,601,367,334,327,968,55.574043261231274,54.409317803660564
33694_terrestrial,532,350,254,342,882,47.744360902255636,64.28571428571429
33695_terrestrial,559,400,251,383,959,44.90161001788909,68.51520572450805
33696_terrestrial,614,497,257,435,1111,41.85667752442997,70.84690553745928
33697_terrestrial,637,541,266,451,1178,41.75824175824176,70.80062794348508
33698_terrestrial,652,638,283,449,1290,43.40490797546012,68.86503067484662
33699_terrestrial,637,588,294,422,1225,46.15384615384615,66.2480376766091
33700_terrestrial,1254,729,736,741,1983,58.69218500797449,59.09090909090909
33701_terrestrial,1117,596,667,655,1713,59.71351835273053,58.639212175470014
33761_terrestrial,891,338,574,530,1229,64.42199775533109,59.48372615039281
33762_terrestrial,566,451,339,397,1017,59.8939929328622,70.14134275618375
33763_terrestrial,1354,736,846,850,2090,62.481536189069416,62.77695716395865
33764_terrestrial,637,464,383,457,1101,60.12558869701727,71.7425431711146
33765_terrestrial,601,388,367,421,989,61.064891846921796,70.04991680532446
33766_terrestrial,1330,695,876,768,2025,65.86466165413533,57.74436090225564
33767_terrestrial,1291,689,862,730,1980,66.7699457784663,56.54531371030209
33768_terrestrial,981,420,653,545,1401,66.56472986748216,55.55555555555556
33769_terrestrial,986,417,651,552,1403,66.02434077079108,55.98377281947262
33772_terrestrial,1182,621,775,676,1803,65.5668358714044,57.1912013536379
33773_terrestrial,1175,618,774,670,1793,65.87234042553192,57.02127659574469
33774_terrestrial,1190,625,783,676,1815,65.7983193277311,56.80672268907563
33775_terrestrial,1252,642,821,725,1894,65.57507987220448,57.907348242811494
33776_terrestrial,1251,636,808,736,1887,64.58832933653078,58.83293365307753
33779_terrestrial,1240,563,769,746,1803,62.016129032258064,60.16129032258064
33780_terrestrial,1271,613,784,771,1884,61.68371361132966,60.660896931549956
33781_terrestrial,1275,621,783,778,1896,61.411764705882355,61.01960784313726
33782_terrestrial,1258,621,771,769,1879,61.287758346581874,61.128775834658185
33783_terrestrial,1274,590,780,782,1864,61.224489795918366,61.38147566718995
33784_terrestrial,1138,443,694,707,1581,60.98418277680141,62.12653778558875
33787_terrestrial,1150,524,692,711,1674,60.17391304347826,61.82608695652174
33788_terrestrial,1224,635,751,736,1859,61.356209150326805,60.130718954248366
33789_terrestrial,1192,605,726,723,1797,60.90604026845637,60.65436241610739
33790_terrestrial,1155,581,694,715,1736,60.086580086580085,61.904761904761905
33791_terrestrial,1162,566,700,716,1728,60.24096385542169,61.61790017211703
33793_terrestrial,1184,699,689,743,1883,58.192567567567565,62.75337837837838
33794_terrestrial,1159,687,689,718,1846,59.44779982743744,61.94995685936152
33795_terrestrial,1226,730,712,765,1956,58.07504078303426,62.39804241435563
33796_terrestrial,1213,799,703,762,2012,57.95548227535037,62.819455894476505
33797_terrestrial,352,479,195,219,831,55.39772727272727,62.21590909090909
33798_terrestrial,323,426,178,195,749,55.10835913312694,60.371517027863774
33799_terrestrial,303,414,158,189,717,52.14521452145215,62.37623762376238
33800_terrestrial,309,395,160,203,704,51.7799352750809,65.69579288025889
33801_terrestrial,300,365,161,201,665,53.666666666666664,67
33802_terrestrial,308,436,161,210,744,52.27272727272727,68.18181818181817
33803_terrestrial,1180,764,684,749,1944,57.96610169491525,63.47457627118644
33804_terrestrial,1170,712,675,746,1882,57.692307692307686,63.760683760683754
33805_terrestrial,1150,649,662,735,1799,57.565217391304344,63.91304347826087
33812_terrestrial,1025,485,612,636,1510,59.70731707317073,62.048780487804876
33813_terrestrial,1048,507,635,638,1555,60.591603053435115,60.87786259541985
33939_terrestrial,419,368,281,168,787,67.06443914081146,40.09546539379475
33940_terrestrial,533,532,291,273,1065,54.59662288930581,51.21951219512195
33941_terrestrial,410,777,104,336,1187,25.365853658536587,81.95121951219512
33942_terrestrial,476,1008,149,384,1484,31.30252100840336,80.67226890756302
33943_terrestrial,419,910,152,329,1329,36.27684964200477,78.52028639618138
33944_terrestrial,426,886,163,333,1312,38.26291079812207,78.16901408450704
33945_terrestrial,442,923,168,347,1365,38.009049773755656,78.50678733031674
33946_terrestrial,473,1006,177,370,1479,37.420718816067655,78.22410147991543
33947_terrestrial,504,1063,181,400,1567,35.91269841269841,79.36507936507937
33948_terrestrial,449,960,169,350,1409,37.639198218262806,77.9510022271715
33949_terrestrial,439,954,169,338,1393,38.496583143507976,76.99316628701595
33950_terrestrial,464,1005,170,357,1469,36.637931034482754,76.9396551724138
33951_terrestrial,461,989,172,355,1450,37.310195227765725,77.00650759219089
33952_terrestrial,425,833,166,328,1258,39.05882352941176,77.17647058823529
33953_terrestrial,422,822,170,319,1244,40.28436018957346,75.59241706161137
33954_terrestrial,427,823,172,320,1250,40.28103044496487,74.94145199063233
33955_terrestrial,420,817,170,320,1237,40.476190476190474,76.19047619047619
33956_terrestrial,428,810,172,325,1238,40.18691588785047,75.93457943925233
33957_terrestrial,438,814,178,331,1252,40.63926940639269,75.57077625570776
33958_terrestrial,444,817,180,335,1261,40.54054054054054,75.45045045045045
33959_terrestrial,444,834,176,338,1278,39.63963963963964,76.12612612612612
33960_terrestrial,440,854,173,332,1294,39.31818181818182,75.45454545454545
33961_terrestrial,442,837,175,335,1279,39.59276018099548,75.7918552036199
33962_terrestrial,434,807,174,328,1241,40.09216589861751,75.57603686635944
33963_terrestrial,417,769,168,316,1186,40.28776978417266,75.77937649880096
33964_terrestrial,431,786,177,322,1217,41.067285382830626,74.70997679814386
33965_terrestrial,433,779,178,323,1212,41.10854503464203,74.5958429561201
33966_terrestrial,427,721,179,322,1148,41.92037470725995,75.40983606557377
33967_terrestrial,415,702,176,309,1117,42.40963855421687,74.4578313253012
33968_terrestrial,407,683,170,306,1090,41.76904176904177,75.18427518427518
33969_terrestrial,404,672,165,308,1076,40.84158415841584,76.23762376237624
33970_terrestrial,393,666,160,297,1059,40.71246819338422,75.57251908396947
33971_terrestrial,403,656,168,304,1059,41.687344913151364,75.43424317617865
33972_terrestrial,398,621,162,304,1019,40.7035175879397,76.38190954773869
33973_terrestrial,374,574,152,285,948,40.64171122994652,76.20320855614973
33974_terrestrial,359,496,142,277,855,39.55431754874652,77.15877437325905
33975_terrestrial,354,464,136,281,818,38.4180790960452,79.37853107344633
33976_terrestrial,320,411,121,261,731,37.8125,81.5625
33977_terrestrial,302,385,116,247,687,38.41059602649007,81.78807947019867
33978_terrestrial,291,384,115,235,675,39.51890034364261,80.75601374570446
33979_terrestrial,272,385,109,218,657,40.07352941176471,80.14705882352942
33980_terrestrial,267,374,105,219,641,39.325842696629216,82.02247191011236
33981_terrestrial,270,371,108,222,641,40,82.22222222222221
33982_terrestrial,581,493,355,330,1074,61.10154905335629,56.79862306368331
33983_terrestrial,568,499,356,315,1067,62.676056338028175,55.45774647887324
33984_terrestrial,551,446,347,304,997,62.976406533575314,55.172413793103445
34032_terrestrial,730,585,481,301,1315,65.89041095890411,41.23287671232877
34033_terrestrial,514,520,265,301,1034,51.55642023346303,58.5603112840467
34034_terrestrial,544,494,311,291,1038,57.16911764705882,53.49264705882353
34035_terrestrial,557,441,320,294,998,57.450628366247756,52.782764811490125
34036_terrestrial,593,491,351,304,1084,59.190556492411474,51.264755480607086
34037_terrestrial,415,357,216,243,772,52.04819277108433,58.554216867469876
34038_terrestrial,350,283,181,205,633,51.714285714285715,58.57142857142858
34039_terrestrial,372,310,210,202,682,56.451612903225815,54.3010752688172
34040_terrestrial,392,325,217,218,717,55.35714285714286,55.61224489795919
34041_terrestrial,392,332,216,223,724,55.10204081632652,56.88775510204081
34042_terrestrial,388,331,210,220,719,54.123711340206185,56.70103092783505
34043_terrestrial,424,339,233,235,763,54.95283018867924,55.42452830188679
34044_terrestrial,446,353,249,247,799,55.82959641255605,55.381165919282516
34045_terrestrial,382,323,198,221,705,51.832460732984295,57.85340314136126
34046_terrestrial,383,315,210,210,698,54.83028720626631,54.83028720626631
34047_terrestrial,409,349,228,228,758,55.74572127139364,55.74572127139364
34048_terrestrial,427,369,223,257,796,52.2248243559719,60.187353629976585
34049_terrestrial,524,547,236,354,1071,45.038167938931295,67.55725190839695
34050_terrestrial,597,812,280,390,1409,46.901172529313236,65.32663316582915
34051_terrestrial,520,419,246,334,939,47.30769230769231,64.23076923076924
34052_terrestrial,456,321,222,282,777,48.68421052631579,61.8421052631579
34053_terrestrial,468,310,219,304,778,46.794871794871796,64.95726495726495
34054_terrestrial,495,333,224,329,828,45.25252525252525,66.46464646464646
34055_terrestrial,530,367,226,371,897,42.64150943396226,70
34056_terrestrial,573,423,243,398,996,42.40837696335078,69.45898778359512
34057_terrestrial,579,444,244,408,1023,42.141623488773746,70.46632124352331
34058_terrestrial,623,545,266,437,1168,42.69662921348314,70.14446227929373
34059_terrestrial,704,712,304,482,1416,43.18181818181818,68.4659090909091
34060_terrestrial,1300,786,771,750,2086,59.30769230769231,57.692307692307686
34076_terrestrial,642,253,434,370,895,67.601246105919,57.63239875389408
34123_terrestrial,1320,686,828,828,2006,62.727272727272734,62.727272727272734
34124_terrestrial,1398,733,882,878,2131,63.0901287553648,62.80400572246065
34125_terrestrial,633,469,375,456,1102,59.241706161137444,72.03791469194313
34126_terrestrial,1425,718,919,834,2143,64.49122807017544,58.526315789473685
34135_terrestrial,1178,588,760,685,1766,64.51612903225806,58.149405772495754
34140_terrestrial,1266,581,784,764,1847,61.92733017377567,60.34755134281201
34141_terrestrial,1255,584,771,765,1839,61.43426294820718,60.95617529880478
34142_terrestrial,1268,583,775,774,1851,61.1198738170347,61.041009463722396
34143_terrestrial,1322,628,824,790,1950,62.32980332829047,59.75794251134644
34144_terrestrial,1213,521,737,753,1734,60.758450123660346,62.07749381698269
34153_terrestrial,250,269,134,173,519,53.6,69.19999999999999
34154_terrestrial,1159,660,687,719,1819,59.27523727351165,62.036238136324414
34155_terrestrial,1114,618,677,682,1732,60.77199281867145,61.22082585278277
34156_terrestrial,1183,759,721,713,1942,60.946745562130175,60.27049873203719
34157_terrestrial,738,648,480,368,1386,65.04065040650406,49.86449864498645
34158_terrestrial,719,621,472,357,1340,65.64673157162726,49.65229485396384
34159_terrestrial,365,475,198,230,840,54.24657534246575,63.013698630136986
34160_terrestrial,303,431,148,198,734,48.84488448844885,65.34653465346535
34161_terrestrial,316,445,161,198,761,50.9493670886076,62.65822784810127
34162_terrestrial,331,457,176,203,788,53.17220543806647,61.329305135951664
34163_terrestrial,326,444,170,215,770,52.14723926380368,65.95092024539878
34164_terrestrial,353,450,190,226,803,53.82436260623229,64.02266288951841
34165_terrestrial,1249,792,722,780,2041,57.806244995996806,62.44995996797438
34166_terrestrial,1209,755,695,765,1964,57.48552522746071,63.27543424317618
34172_terrestrial,1078,525,645,666,1603,59.83302411873841,61.781076066790355
34173_terrestrial,1114,589,678,671,1703,60.86175942549371,60.23339317773788
34174_terrestrial,1033,503,625,633,1536,60.50338818973863,61.27783155856727
34300_terrestrial,423,399,260,189,822,61.46572104018912,44.680851063829785
34301_terrestrial,341,663,89,282,1004,26.099706744868033,82.69794721407625
34302_terrestrial,446,911,123,372,1357,27.57847533632287,83.40807174887892
34303_terrestrial,529,1143,168,431,1672,31.758034026465026,81.47448015122873
34304_terrestrial,492,1007,176,397,1499,35.77235772357724,80.6910569105691
34305_terrestrial,475,947,171,377,1422,36,79.36842105263158
34306_terrestrial,464,971,173,365,1435,37.28448275862069,78.66379310344827
34307_terrestrial,468,992,174,368,1460,37.17948717948718,78.63247863247864
34308_terrestrial,423,918,165,325,1341,39.00709219858156,76.8321513002364
34309_terrestrial,406,854,159,313,1260,39.16256157635468,77.0935960591133
34310_terrestrial,405,854,157,312,1259,38.76543209876544,77.03703703703704
34311_terrestrial,412,856,160,317,1268,38.83495145631068,76.94174757281553
34312_terrestrial,413,847,164,315,1260,39.70944309927361,76.27118644067797
34313_terrestrial,425,836,171,320,1261,40.23529411764706,75.29411764705883
34314_terrestrial,423,811,172,316,1234,40.66193853427896,74.70449172576832
34315_terrestrial,416,804,169,315,1220,40.625,75.72115384615384
34316_terrestrial,420,815,171,316,1235,40.714285714285715,75.23809523809524
34317_terrestrial,421,816,172,317,1237,40.85510688836104,75.29691211401425
34318_terrestrial,424,820,169,322,1244,39.85849056603774,75.94339622641509
34319_terrestrial,426,822,170,323,1248,39.906103286384976,75.82159624413146
34320_terrestrial,423,803,168,320,1226,39.71631205673759,75.65011820330969
34321_terrestrial,416,779,167,316,1195,40.144230769230774,75.96153846153845
34322_terrestrial,418,748,170,320,1166,40.66985645933015,76.55502392344498
34323_terrestrial,419,745,172,316,1164,41.05011933174224,75.41766109785203
34324_terrestrial,411,740,170,307,1151,41.3625304136253,74.69586374695864
34325_terrestrial,396,705,159,302,1101,40.15151515151515,76.26262626262627
34326_terrestrial,402,670,164,302,1072,40.79601990049751,75.12437810945273
34327_terrestrial,393,661,163,295,1054,41.475826972010175,75.06361323155217
34328_terrestrial,396,647,166,297,1043,41.91919191919192,75
34329_terrestrial,397,636,163,303,1033,41.05793450881612,76.32241813602015
34330_terrestrial,394,630,158,300,1024,40.10152284263959,76.14213197969542
34331_terrestrial,400,622,159,303,1022,39.75,75.75
34332_terrestrial,384,583,147,297,967,38.28125,77.34375
34333_terrestrial,373,520,146,289,893,39.14209115281501,77.4798927613941
34334_terrestrial,357,473,141,275,830,39.49579831932773,77.03081232492998
34335_terrestrial,339,431,135,267,770,39.823008849557525,78.76106194690266
34336_terrestrial,306,391,118,247,697,38.56209150326798,80.71895424836602
34337_terrestrial,293,382,115,240,675,39.249146757679185,81.91126279863481
34338_terrestrial,281,398,112,227,679,39.8576512455516,80.78291814946618
34339_terrestrial,268,379,110,216,647,41.04477611940299,80.59701492537313
34340_terrestrial,257,366,102,213,623,39.688715953307394,82.87937743190662
34341_terrestrial,261,369,103,215,630,39.46360153256705,82.37547892720306
34342_terrestrial,260,365,104,215,625,40,82.6923076923077
34343_terrestrial,263,362,105,218,625,39.92395437262358,82.88973384030417
34344_terrestrial,560,486,350,311,1046,62.5,55.53571428571429
34345_terrestrial,577,508,360,314,1085,62.391681109185434,54.41941074523397
34393_terrestrial,781,595,505,335,1376,64.6606914212548,42.89372599231754
34394_terrestrial,611,506,357,319,1117,58.42880523731587,52.209492635024546
34395_terrestrial,511,392,288,281,903,56.360078277886494,54.99021526418787
34396_terrestrial,488,391,285,265,879,58.40163934426229,54.30327868852459
34397_terrestrial,332,292,167,206,624,50.30120481927711,62.048192771084345
34398_terrestrial,330,293,169,199,623,51.21212121212121,60.303030303030305
34399_terrestrial,357,310,183,212,667,51.26050420168067,59.38375350140056
34400_terrestrial,354,316,170,220,670,48.0225988700565,62.14689265536724
34401_terrestrial,423,355,228,246,778,53.90070921985816,58.156028368794324
34402_terrestrial,437,364,228,258,801,52.17391304347826,59.03890160183066
34403_terrestrial,473,383,260,266,856,54.96828752642706,56.236786469344615
34404_terrestrial,473,372,255,271,845,53.911205073995774,57.2938689217759
34405_terrestrial,408,332,202,247,740,49.50980392156863,60.5392156862745
34406_terrestrial,350,299,173,215,649,49.42857142857143,61.42857142857143
34407_terrestrial,413,324,215,239,737,52.05811138014528,57.869249394673126
34408_terrestrial,415,330,218,254,745,52.53012048192771,61.204819277108435
34409_terrestrial,474,414,240,300,888,50.63291139240506,63.29113924050633
34410_terrestrial,563,699,275,349,1262,48.84547069271758,61.98934280639432
34411_terrestrial,504,404,242,316,908,48.01587301587302,62.698412698412696
34412_terrestrial,457,333,217,290,790,47.4835886214442,63.45733041575492
34413_terrestrial,460,314,218,296,774,47.391304347826086,64.34782608695652
34414_terrestrial,479,313,225,312,792,46.972860125260965,65.1356993736952
34415_terrestrial,501,369,223,334,870,44.510978043912175,66.66666666666666
34416_terrestrial,534,373,229,365,907,42.88389513108614,68.35205992509363
34417_terrestrial,564,436,241,384,1000,42.730496453900706,68.08510638297872
34418_terrestrial,630,554,275,432,1184,43.65079365079365,68.57142857142857
34419_terrestrial,1333,869,756,801,2202,56.71417854463616,60.09002250562641
34420_terrestrial,1247,728,765,702,1975,61.34723336006416,56.29510825982358
34483_terrestrial,851,303,545,507,1154,64.04230317273796,59.57696827262045
34484_terrestrial,1321,682,831,829,2003,62.90688872066617,62.755488266464795
34485_terrestrial,1419,762,888,890,2181,62.579281183932345,62.720225510923186
34486_terrestrial,1666,915,1046,988,2581,62.78511404561825,59.30372148859544
34487_terrestrial,1341,616,842,808,1957,62.7889634601044,60.25354213273676
34488_terrestrial,1325,613,841,796,1938,63.471698113207545,60.075471698113205
34500_terrestrial,1283,613,792,773,1896,61.730319563523,60.24941543257989
34501_terrestrial,1287,614,792,776,1901,61.53846153846154,60.2952602952603
34502_terrestrial,1137,477,691,703,1614,60.77396657871592,61.829375549692166
34503_terrestrial,1224,544,744,753,1768,60.78431372549019,61.51960784313726
34504_terrestrial,1215,525,734,755,1740,60.41152263374485,62.139917695473244
34513_terrestrial,1059,469,652,634,1528,61.5675165250236,59.86779981114259
34514_terrestrial,1044,450,644,625,1494,61.68582375478927,59.86590038314177
34515_terrestrial,1047,501,649,629,1548,61.98662846227316,60.07640878701051
34518_terrestrial,602,429,392,310,1031,65.11627906976744,51.49501661129568
34519_terrestrial,614,455,400,318,1069,65.14657980456026,51.79153094462541
34520_terrestrial,243,256,114,181,499,46.913580246913575,74.48559670781893
34521_terrestrial,308,411,151,199,719,49.02597402597403,64.6103896103896
34522_terrestrial,335,508,176,202,843,52.537313432835816,60.298507462686565
34523_terrestrial,328,469,172,205,797,52.4390243902439,62.5
34524_terrestrial,307,430,163,186,737,53.09446254071661,60.586319218241044
34525_terrestrial,362,498,191,233,860,52.762430939226526,64.3646408839779
34526_terrestrial,1291,881,753,793,2172,58.32687838884586,61.42525174283501
34527_terrestrial,1234,767,712,770,2001,57.69854132901134,62.398703403565634
34528_terrestrial,1236,744,731,755,1980,59.14239482200647,61.084142394822
34529_terrestrial,1128,572,687,676,1700,60.90425531914894,59.9290780141844
34530_terrestrial,1078,513,645,668,1591,59.83302411873841,61.96660482374769
34531_terrestrial,1082,524,651,669,1606,60.16635859519408,61.82994454713494
34532_terrestrial,1083,537,650,666,1620,60.01846722068329,61.495844875346265
34533_terrestrial,1075,519,645,662,1594,60,61.58139534883721
34535_terrestrial,1030,523,621,635,1553,60.29126213592233,61.6504854368932
34536_terrestrial,1004,498,601,633,1502,59.8605577689243,63.047808764940235
34661_terrestrial,475,581,253,252,1056,53.26315789473684,53.05263157894737
34662_terrestrial,313,651,83,255,964,26.517571884984026,81.46964856230032
34663_terrestrial,493,1076,156,403,1569,31.643002028397564,81.7444219066937
34664_terrestrial,513,1064,178,414,1577,34.69785575048733,80.7017543859649
34665_terrestrial,490,999,176,389,1489,35.91836734693877,79.38775510204081
34666_terrestrial,453,967,173,356,1420,38.18984547461369,78.58719646799118
34667_terrestrial,427,933,165,332,1360,38.64168618266979,77.75175644028103
34668_terrestrial,410,861,161,316,1271,39.268292682926834,77.07317073170732
34669_terrestrial,401,864,162,306,1265,40.399002493765586,76.30922693266832
34670_terrestrial,409,880,160,316,1289,39.119804400978,77.26161369193154
34671_terrestrial,410,872,163,312,1282,39.75609756097561,76.09756097560975
34672_terrestrial,412,851,164,314,1263,39.80582524271845,76.2135922330097
34673_terrestrial,421,837,168,319,1258,39.90498812351544,75.77197149643705
34674_terrestrial,416,801,169,316,1217,40.625,75.96153846153845
34675_terrestrial,415,799,170,314,1214,40.963855421686745,75.66265060240964
34676_terrestrial,420,804,170,316,1224,40.476190476190474,75.23809523809524
34677_terrestrial,417,816,166,316,1233,39.80815347721823,75.77937649880096
34678_terrestrial,428,814,172,324,1242,40.18691588785047,75.70093457943925
34679_terrestrial,420,784,164,321,1204,39.04761904761905,76.42857142857142
34680_terrestrial,412,763,164,314,1175,39.80582524271845,76.2135922330097
34681_terrestrial,409,744,162,314,1153,39.60880195599022,76.77261613691931
34682_terrestrial,413,732,169,315,1145,40.92009685230024,76.27118644067797
34683_terrestrial,405,714,166,307,1119,40.98765432098765,75.80246913580247
34684_terrestrial,391,696,160,297,1087,40.92071611253197,75.95907928388746
34685_terrestrial,395,670,163,299,1065,41.265822784810126,75.69620253164557
34686_terrestrial,387,642,159,293,1029,41.08527131782946,75.71059431524549
34687_terrestrial,388,626,159,294,1014,40.97938144329897,75.77319587628865
34688_terrestrial,386,612,154,296,998,39.89637305699482,76.68393782383419
34689_terrestrial,389,608,154,300,997,39.588688946015424,77.12082262210797
34690_terrestrial,393,581,153,304,974,38.93129770992366,77.35368956743002
34691_terrestrial,385,561,149,300,946,38.701298701298704,77.92207792207793
34692_terrestrial,375,526,144,294,901,38.4,78.4
34693_terrestrial,354,467,132,277,821,37.28813559322034,78.24858757062147
34694_terrestrial,331,417,131,260,748,39.577039274924466,78.54984894259819
34695_terrestrial,323,381,128,256,704,39.628482972136226,79.25696594427245
34696_terrestrial,307,387,119,248,694,38.762214983713356,80.78175895765473
34697_terrestrial,288,380,113,236,668,39.23611111111111,81.94444444444444
34698_terrestrial,277,381,109,229,658,39.35018050541516,82.67148014440433
34699_terrestrial,267,374,105,222,641,39.325842696629216,83.14606741573034
34700_terrestrial,264,379,104,218,643,39.39393939393939,82.57575757575758
34701_terrestrial,266,385,106,218,651,39.849624060150376,81.95488721804512
34702_terrestrial,261,379,105,215,640,40.229885057471265,82.37547892720306
34703_terrestrial,244,375,98,203,619,40.16393442622951,83.19672131147541
34704_terrestrial,252,387,101,210,639,40.07936507936508,83.33333333333334
34705_terrestrial,590,561,356,333,1151,60.33898305084746,56.440677966101696
34706_terrestrial,583,521,358,321,1104,61.4065180102916,55.06003430531733
34753_terrestrial,684,449,456,280,1133,66.66666666666666,40.93567251461988
34754_terrestrial,415,308,213,248,723,51.325301204819276,59.75903614457832
34755_terrestrial,375,289,198,217,664,52.800000000000004,57.86666666666667
34756_terrestrial,306,254,140,197,560,45.751633986928105,64.37908496732027
34757_terrestrial,312,258,149,204,570,47.756410256410255,65.38461538461539
34758_terrestrial,333,275,170,203,608,51.051051051051054,60.96096096096096
34759_terrestrial,333,280,168,201,613,50.45045045045045,60.36036036036037
34760_terrestrial,345,295,165,213,640,47.82608695652174,61.73913043478261
34761_terrestrial,443,359,237,252,802,53.49887133182845,56.884875846501124
34762_terrestrial,467,391,263,261,858,56.3169164882227,55.88865096359743
34763_terrestrial,434,375,234,253,809,53.91705069124424,58.294930875576036
34764_terrestrial,412,343,205,255,755,49.75728155339806,61.89320388349514
34765_terrestrial,354,313,163,235,667,46.04519774011299,66.38418079096046
34766_terrestrial,327,293,152,216,620,46.48318042813456,66.05504587155964
34767_terrestrial,421,322,231,248,743,54.86935866983374,58.90736342042755
34768_terrestrial,433,336,233,264,769,53.81062355658198,60.969976905311775
34769_terrestrial,434,353,227,277,787,52.30414746543779,63.824884792626726
34770_terrestrial,516,649,249,324,1165,48.25581395348838,62.7906976744186
34771_terrestrial,517,629,252,321,1146,48.74274661508704,62.0889748549323
34772_terrestrial,484,377,229,309,861,47.31404958677686,63.84297520661158
34773_terrestrial,445,331,215,280,776,48.31460674157304,62.92134831460674
34774_terrestrial,465,329,224,296,794,48.17204301075269,63.655913978494624
34775_terrestrial,508,347,234,327,855,46.06299212598425,64.37007874015748
34776_terrestrial,539,389,231,364,928,42.857142857142854,67.53246753246754
34777_terrestrial,602,511,236,425,1113,39.202657807308974,70.59800664451828
34778_terrestrial,637,617,251,448,1254,39.403453689167975,70.32967032967034
34779_terrestrial,1268,728,725,755,1996,57.17665615141956,59.54258675078864
34780_terrestrial,1242,678,742,714,1920,59.74235104669887,57.48792270531401
34846_terrestrial,1407,683,881,851,2090,62.61549395877755,60.483297796730625
34847_terrestrial,1518,774,938,924,2292,61.79183135704874,60.86956521739131
34848_terrestrial,1412,714,873,872,2126,61.827195467422094,61.756373937677054
34849_terrestrial,1360,667,835,842,2027,61.39705882352941,61.911764705882355
34850_terrestrial,1304,598,818,798,1902,62.73006134969326,61.19631901840491
34851_terrestrial,1293,591,813,785,1884,62.87703016241299,60.71152358855375
34852_terrestrial,1263,580,809,755,1843,64.05384006334126,59.77830562153602
34853_terrestrial,1276,588,817,764,1864,64.0282131661442,59.87460815047022
34854_terrestrial,1149,481,742,682,1630,64.57789382071365,59.35596170583116
34855_terrestrial,266,167,175,187,433,65.78947368421053,70.30075187969925
34856_terrestrial,1137,455,708,680,1592,62.26912928759894,59.80650835532102
34861_terrestrial,1128,452,686,688,1580,60.815602836879435,60.99290780141844
34875_terrestrial,1036,520,644,621,1556,62.16216216216216,59.94208494208494
34879_terrestrial,601,407,391,314,1008,65.05823627287853,52.24625623960066
34880_terrestrial,594,408,379,317,1002,63.804713804713806,53.36700336700336
34881_terrestrial,229,272,95,183,501,41.48471615720524,79.91266375545851
34882_terrestrial,256,291,113,189,547,44.140625,73.828125
34883_terrestrial,339,474,171,221,813,50.442477876106196,65.19174041297934
34884_terrestrial,341,501,184,208,842,53.95894428152492,60.997067448680355
34885_terrestrial,345,507,188,212,852,54.492753623188406,61.44927536231884
34886_terrestrial,366,525,196,229,891,53.551912568306015,62.568306010928964
34887_terrestrial,1295,881,761,780,2176,58.76447876447877,60.231660231660236
34888_terrestrial,1251,805,727,767,2056,58.113509192645886,61.310951239008794
34889_terrestrial,1068,506,638,661,1574,59.737827715355806,61.89138576779026
34890_terrestrial,1075,529,643,664,1604,59.81395348837209,61.76744186046511
34891_terrestrial,1075,518,643,664,1593,59.81395348837209,61.76744186046511
34892_terrestrial,1047,491,622,655,1538,59.407831900668576,62.55969436485196
34895_terrestrial,1000,490,597,631,1490,59.699999999999996,63.1
34896_terrestrial,1033,527,622,642,1560,60.21297192642788,62.14908034849952
34897_terrestrial,975,442,583,610,1417,59.794871794871796,62.56410256410256
34898_terrestrial,973,436,581,609,1409,59.71223021582733,62.589928057553955
35021_terrestrial,381,376,234,172,757,61.417322834645674,45.14435695538058
35022_terrestrial,247,439,72,204,686,29.1497975708502,82.5910931174089
35023_terrestrial,382,839,114,314,1221,29.84293193717277,82.19895287958116
35024_terrestrial,494,1010,164,402,1504,33.198380566801625,81.37651821862349
35025_terrestrial,490,998,178,388,1488,36.3265306122449,79.18367346938776
35026_terrestrial,463,971,176,364,1434,38.01295896328294,78.61771058315334
35027_terrestrial,438,980,170,336,1418,38.81278538812785,76.71232876712328
35028_terrestrial,418,910,162,326,1328,38.75598086124402,77.99043062200957
35029_terrestrial,404,870,160,311,1274,39.603960396039604,76.98019801980197
35030_terrestrial,406,868,159,314,1274,39.16256157635468,77.33990147783251
35031_terrestrial,405,861,161,313,1266,39.75308641975309,77.28395061728395
35032_terrestrial,393,840,153,305,1233,38.93129770992366,77.60814249363868
35033_terrestrial,405,824,160,311,1229,39.50617283950617,76.79012345679013
35034_terrestrial,412,811,166,313,1223,40.29126213592233,75.97087378640776
35035_terrestrial,416,809,168,316,1225,40.38461538461539,75.96153846153845
35036_terrestrial,430,826,174,327,1256,40.46511627906977,76.04651162790698
35037_terrestrial,432,837,169,333,1269,39.120370370370374,77.08333333333334
35038_terrestrial,433,811,171,331,1244,39.4919168591224,76.44341801385681
35039_terrestrial,414,755,159,322,1169,38.405797101449274,77.77777777777779
35040_terrestrial,413,748,164,318,1161,39.70944309927361,76.99757869249395
35041_terrestrial,407,717,166,309,1124,40.78624078624078,75.92137592137593
35042_terrestrial,406,706,165,308,1112,40.64039408866995,75.86206896551724
35043_terrestrial,399,682,160,307,1081,40.100250626566414,76.94235588972431
35044_terrestrial,385,663,155,297,1048,40.25974025974026,77.14285714285715
35045_terrestrial,385,645,158,295,1030,41.03896103896104,76.62337662337663
35046_terrestrial,382,612,153,293,994,40.05235602094241,76.70157068062828
35047_terrestrial,380,587,154,292,967,40.526315789473685,76.84210526315789
35048_terrestrial,380,569,153,296,949,40.26315789473684,77.89473684210526
35049_terrestrial,383,564,149,303,947,38.90339425587467,79.11227154046998
35050_terrestrial,389,547,151,309,936,38.81748071979435,79.43444730077121
35051_terrestrial,381,512,148,303,893,38.84514435695538,79.52755905511812
35052_terrestrial,369,476,140,294,845,37.94037940379404,79.67479674796748
35053_terrestrial,348,435,138,275,783,39.6551724137931,79.02298850574712
35054_terrestrial,329,403,131,262,732,39.81762917933131,79.63525835866263
35055_terrestrial,322,397,133,255,719,41.30434782608695,79.19254658385093
35056_terrestrial,310,389,120,250,699,38.70967741935484,80.64516129032258
35057_terrestrial,301,377,121,242,678,40.19933554817276,80.39867109634552
35058_terrestrial,289,382,117,236,671,40.484429065743946,81.66089965397923
35059_terrestrial,275,400,106,229,675,38.54545454545455,83.27272727272728
35060_terrestrial,277,409,110,229,686,39.71119133574007,82.67148014440433
35061_terrestrial,278,410,114,224,688,41.007194244604314,80.57553956834532
35062_terrestrial,273,407,115,221,680,42.124542124542124,80.95238095238095
35063_terrestrial,259,407,107,214,666,41.312741312741316,82.62548262548263
35064_terrestrial,277,440,108,230,717,38.98916967509025,83.03249097472924
35065_terrestrial,311,474,120,258,785,38.58520900321543,82.95819935691318
35066_terrestrial,610,577,365,348,1187,59.83606557377049,57.049180327868854
35113_terrestrial,492,280,348,198,772,70.73170731707317,40.243902439024396
35114_terrestrial,540,319,356,239,859,65.92592592592592,44.25925925925926
35115_terrestrial,345,297,147,240,642,42.608695652173914,69.56521739130434
35116_terrestrial,350,306,146,241,656,41.714285714285715,68.85714285714286
35117_terrestrial,324,283,143,218,607,44.135802469135804,67.28395061728395
35118_terrestrial,354,275,182,210,629,51.41242937853108,59.32203389830508
35119_terrestrial,344,294,176,206,638,51.162790697674424,59.883720930232556
35120_terrestrial,400,349,214,233,749,53.5,58.25
35121_terrestrial,451,401,240,261,852,53.215077605321504,57.87139689578714
35122_terrestrial,424,397,227,246,821,53.5377358490566,58.01886792452831
35123_terrestrial,409,357,223,239,766,54.52322738386308,58.43520782396088
35124_terrestrial,392,347,204,239,739,52.04081632653062,60.96938775510205
35125_terrestrial,331,333,152,224,664,45.9214501510574,67.6737160120846
35126_terrestrial,340,323,158,231,663,46.470588235294116,67.94117647058823
35127_terrestrial,450,381,233,285,831,51.77777777777778,63.33333333333333
35128_terrestrial,467,389,244,292,856,52.24839400428265,62.526766595289075
35129_terrestrial,452,370,232,290,822,51.32743362831859,64.15929203539822
35130_terrestrial,475,623,225,316,1098,47.368421052631575,66.52631578947368
35131_terrestrial,536,673,247,347,1209,46.082089552238806,64.73880597014924
35132_terrestrial,540,466,249,352,1006,46.111111111111114,65.18518518518519
35133_terrestrial,508,396,235,331,904,46.25984251968504,65.15748031496062
35134_terrestrial,495,357,235,316,852,47.474747474747474,63.83838383838384
35135_terrestrial,536,369,233,363,905,43.47014925373134,67.72388059701493
35136_terrestrial,602,494,247,416,1096,41.029900332225914,69.10299003322258
35137_terrestrial,642,580,260,442,1222,40.49844236760124,68.84735202492212
35138_terrestrial,613,558,255,417,1171,41.598694942903755,68.02610114192495
35139_terrestrial,570,456,259,373,1026,45.438596491228076,65.43859649122807
35140_terrestrial,1205,619,720,699,1824,59.75103734439834,58.00829875518673
35207_terrestrial,1323,638,803,848,1961,60.695389266817834,64.09674981103552
35208_terrestrial,1361,659,833,873,2020,61.20499632623071,64.14401175606172
35209_terrestrial,1372,657,853,862,2029,62.17201166180758,62.82798833819242
35210_terrestrial,1349,646,833,857,1995,61.74944403261675,63.52853965900667
35211_terrestrial,1316,621,813,842,1937,61.77811550151976,63.981762917933125
35212_terrestrial,471,322,274,346,793,58.174097664543524,73.46072186836517
35213_terrestrial,1400,684,875,855,2084,62.5,61.07142857142858
35214_terrestrial,1422,690,884,865,2112,62.16596343178622,60.829817158931085
35215_terrestrial,1511,741,926,923,2252,61.283917935142284,61.085373924553274
35232_terrestrial,1047,441,636,634,1488,60.74498567335244,60.55396370582618
35238_terrestrial,580,373,380,297,953,65.51724137931035,51.206896551724135
35239_terrestrial,627,425,412,317,1052,65.70972886762361,50.558213716108455
35240_terrestrial,636,444,410,329,1080,64.46540880503144,51.729559748427675
35241_terrestrial,628,458,392,335,1086,62.42038216560509,53.34394904458599
35242_terrestrial,266,270,110,210,536,41.35338345864661,78.94736842105263
35243_terrestrial,288,321,132,216,609,45.83333333333333,75
35244_terrestrial,967,649,604,550,1616,62.46122026887281,56.87693898655636
35245_terrestrial,954,651,608,527,1605,63.731656184486376,55.24109014675053
35246_terrestrial,1027,770,649,567,1797,63.1937682570594,55.20934761441091
35247_terrestrial,1311,924,760,798,2235,57.971014492753625,60.86956521739131
35248_terrestrial,1253,844,733,763,2097,58.49960095770152,60.893854748603346
35256_terrestrial,950,416,561,607,1366,59.05263157894737,63.89473684210526
35257_terrestrial,1020,489,614,624,1509,60.19607843137255,61.1764705882353
35258_terrestrial,1022,497,617,623,1519,60.37181996086106,60.95890410958904
35259_terrestrial,980,442,587,611,1422,59.897959183673464,62.34693877551021
35260_terrestrial,974,436,581,611,1410,59.65092402464066,62.73100616016427
35381_terrestrial,327,236,216,135,563,66.05504587155964,41.284403669724774
35382_terrestrial,394,460,229,188,854,58.121827411167516,47.71573604060914
35383_terrestrial,267,628,81,214,895,30.337078651685395,80.14981273408239
35384_terrestrial,465,953,148,377,1418,31.827956989247312,81.0752688172043
35385_terrestrial,487,1049,180,383,1536,36.96098562628337,78.64476386036962
35386_terrestrial,469,1018,175,368,1487,37.3134328358209,78.46481876332622
35387_terrestrial,434,992,165,336,1426,38.0184331797235,77.41935483870968
35388_terrestrial,431,958,164,335,1389,38.05104408352668,77.7262180974478
35389_terrestrial,407,898,160,317,1305,39.31203931203931,77.88697788697789
35390_terrestrial,404,873,161,308,1277,39.851485148514854,76.23762376237624
35391_terrestrial,405,864,158,314,1269,39.01234567901234,77.53086419753087
35392_terrestrial,411,836,163,318,1247,39.65936739659367,77.37226277372264
35393_terrestrial,417,844,163,324,1261,39.08872901678657,77.6978417266187
35394_terrestrial,410,829,159,321,1239,38.78048780487805,78.29268292682927
35395_terrestrial,417,825,161,326,1242,38.60911270983213,78.17745803357315
35396_terrestrial,431,867,170,332,1298,39.443155452436194,77.03016241299304
35397_terrestrial,434,849,171,334,1283,39.40092165898618,76.95852534562212
35398_terrestrial,437,818,168,339,1255,38.443935926773456,77.57437070938215
35399_terrestrial,429,782,163,335,1211,37.995337995338,78.08857808857809
35400_terrestrial,405,754,158,317,1159,39.01234567901234,78.2716049382716
35401_terrestrial,403,723,166,307,1126,41.19106699751861,76.1786600496278
35402_terrestrial,397,701,161,302,1098,40.55415617128463,76.0705289672544
35403_terrestrial,393,678,156,304,1071,39.69465648854962,77.35368956743002
35404_terrestrial,399,667,158,308,1066,39.59899749373433,77.19298245614034
35405_terrestrial,392,647,157,303,1039,40.05102040816326,77.29591836734694
35406_terrestrial,382,587,153,296,969,40.05235602094241,77.4869109947644
35407_terrestrial,371,551,147,289,922,39.62264150943396,77.89757412398922
35408_terrestrial,361,534,143,284,895,39.612188365650965,78.67036011080333
35409_terrestrial,368,526,143,294,894,38.858695652173914,79.8913043478261
35410_terrestrial,381,510,148,303,891,38.84514435695538,79.52755905511812
35411_terrestrial,376,475,144,300,851,38.297872340425535,79.7872340425532
35412_terrestrial,355,442,134,287,797,37.74647887323944,80.84507042253522
35413_terrestrial,347,426,139,274,773,40.05763688760807,78.96253602305475
35414_terrestrial,326,405,133,257,731,40.79754601226993,78.83435582822086
35415_terrestrial,320,396,128,255,716,40,79.6875
35416_terrestrial,315,394,123,254,709,39.04761904761905,80.63492063492063
35417_terrestrial,301,391,116,247,692,38.53820598006645,82.05980066445183
35418_terrestrial,295,395,116,244,690,39.32203389830509,82.71186440677965
35419_terrestrial,281,400,113,231,681,40.213523131672595,82.20640569395017
35420_terrestrial,285,411,113,235,696,39.64912280701755,82.45614035087719
35421_terrestrial,282,412,116,230,694,41.13475177304964,81.56028368794325
35422_terrestrial,282,420,116,228,702,41.13475177304964,80.85106382978722
35423_terrestrial,282,441,117,227,723,41.48936170212766,80.49645390070921
35424_terrestrial,321,516,123,268,837,38.31775700934579,83.48909657320873
35425_terrestrial,652,662,383,385,1314,58.742331288343564,59.04907975460123
35426_terrestrial,607,577,357,355,1184,58.81383855024712,58.48434925864909
35474_terrestrial,608,376,385,287,984,63.32236842105263,47.20394736842105
35475_terrestrial,420,370,175,292,790,41.66666666666667,69.52380952380952
35476_terrestrial,403,387,161,286,790,39.950372208436725,70.96774193548387
35477_terrestrial,354,329,139,254,683,39.26553672316384,71.75141242937853
35478_terrestrial,374,332,179,238,706,47.860962566844925,63.63636363636363
35479_terrestrial,366,327,189,219,693,51.63934426229508,59.83606557377049
35480_terrestrial,378,336,198,229,714,52.38095238095239,60.58201058201058
35481_terrestrial,416,374,230,240,790,55.28846153846154,57.692307692307686
35482_terrestrial,390,364,213,228,754,54.61538461538461,58.46153846153847
35483_terrestrial,382,353,204,232,735,53.403141361256544,60.73298429319372
35484_terrestrial,391,343,197,246,734,50.38363171355499,62.9156010230179
35485_terrestrial,366,352,167,251,718,45.62841530054645,68.5792349726776
35486_terrestrial,484,418,253,301,902,52.27272727272727,62.1900826446281
35487_terrestrial,561,485,305,326,1046,54.367201426024955,58.110516934046345
35488_terrestrial,550,483,297,327,1033,54,59.45454545454546
35489_terrestrial,516,450,268,319,966,51.93798449612403,61.82170542635659
35490_terrestrial,560,485,283,347,1045,50.535714285714285,61.964285714285715
35491_terrestrial,548,703,259,355,1251,47.262773722627735,64.78102189781022
35492_terrestrial,577,736,268,376,1313,46.447140381282495,65.16464471403813
35493_terrestrial,550,471,245,369,1021,44.54545454545455,67.0909090909091
35494_terrestrial,594,499,254,410,1093,42.76094276094276,69.02356902356902
35495_terrestrial,581,481,241,401,1062,41.480206540447504,69.01893287435456
35496_terrestrial,619,556,251,428,1175,40.54927302100161,69.1437802907916
35497_terrestrial,589,551,244,404,1140,41.42614601018676,68.59083191850594
35498_terrestrial,508,382,227,334,890,44.68503937007874,65.74803149606299
35499_terrestrial,519,380,245,334,899,47.20616570327553,64.35452793834297
35500_terrestrial,1161,568,702,668,1729,60.46511627906976,57.53660637381568
35571_terrestrial,1254,574,781,802,1828,62.28070175438597,63.95534290271132
35572_terrestrial,1301,601,808,824,1902,62.106072252113755,63.3358954650269
35573_terrestrial,1326,632,820,840,1958,61.840120663650076,63.348416289592755
35574_terrestrial,1361,671,835,857,2032,61.35194709772226,62.968405584129314
35575_terrestrial,1590,831,974,967,2421,61.257861635220124,60.81761006289308
35576_terrestrial,1478,741,919,881,2219,62.1786197564276,59.60757780784844
35577_terrestrial,1299,629,813,773,1928,62.586605080831404,59.50731331793687
35578_terrestrial,1231,541,772,741,1772,62.71324126726239,60.19496344435419
35579_terrestrial,1232,551,767,748,1783,62.256493506493506,60.71428571428571
35580_terrestrial,1291,609,795,787,1900,61.58017041053447,60.96049573973664
35581_terrestrial,1255,574,756,782,1829,60.2390438247012,62.310756972111555
35582_terrestrial,1247,556,747,784,1803,59.9037690457097,62.87089013632718
35583_terrestrial,1244,562,741,785,1806,59.565916398713824,63.10289389067524
35584_terrestrial,1239,555,745,773,1794,60.129136400322835,62.38902340597255
35585_terrestrial,1267,586,760,790,1853,59.98421468034728,62.35201262825573
35586_terrestrial,1248,591,749,780,1839,60.016025641025635,62.5
35587_terrestrial,1156,545,692,725,1701,59.86159169550172,62.71626297577855
35588_terrestrial,1183,551,709,738,1734,59.93237531699071,62.383770076077774
35592_terrestrial,1036,434,635,625,1470,61.2934362934363,60.32818532818533
35598_terrestrial,583,383,383,297,966,65.69468267581475,50.943396226415096
35599_terrestrial,621,413,412,308,1034,66.34460547504025,49.59742351046699
35600_terrestrial,615,417,391,321,1032,63.577235772357724,52.19512195121951
35601_terrestrial,662,459,411,348,1121,62.08459214501511,52.567975830815705
35602_terrestrial,334,354,150,251,688,44.91017964071856,75.1497005988024
35603_terrestrial,977,619,605,564,1596,61.92425793244627,57.727737973387924
35604_terrestrial,956,591,592,553,1547,61.92468619246861,57.845188284518834
35606_terrestrial,890,522,550,515,1412,61.79775280898876,57.865168539325836
35607_terrestrial,1089,788,673,621,1877,61.799816345270884,57.02479338842975
35608_terrestrial,1305,917,751,803,2222,57.547892720306514,61.53256704980843
35609_terrestrial,1241,743,730,756,1984,58.82352941176471,60.91861402095085
35612_terrestrial,997,448,602,598,1445,60.38114343029088,59.97993981945837
35613_terrestrial,980,426,586,593,1406,59.795918367346935,60.51020408163266
35617_terrestrial,964,417,573,609,1381,59.439834024896264,63.17427385892116
35618_terrestrial,1006,452,608,618,1458,60.437375745526836,61.431411530815105
35619_terrestrial,997,461,599,613,1458,60.0802407221665,61.48445336008024
35620_terrestrial,1002,459,602,616,1461,60.079840319361274,61.477045908183634
35621_terrestrial,969,432,581,607,1401,59.958720330237355,62.641898864809086
35622_terrestrial,958,423,571,606,1381,59.603340292275576,63.25678496868476
35742_terrestrial,350,313,222,152,663,63.42857142857142,43.42857142857143
35743_terrestrial,211,375,68,174,586,32.22748815165877,82.46445497630332
35744_terrestrial,388,874,118,311,1262,30.412371134020617,80.15463917525774
35745_terrestrial,528,1144,176,422,1672,33.33333333333333,79.92424242424242
35746_terrestrial,482,1064,181,371,1546,37.551867219917014,76.97095435684648
35747_terrestrial,432,978,164,339,1410,37.96296296296296,78.47222222222221
35748_terrestrial,436,976,167,338,1412,38.30275229357798,77.52293577981652
35749_terrestrial,417,919,160,323,1336,38.36930455635492,77.45803357314148
35750_terrestrial,419,902,165,322,1321,39.37947494033413,76.84964200477327
35751_terrestrial,408,859,162,316,1267,39.705882352941174,77.45098039215686
35752_terrestrial,410,852,162,318,1262,39.51219512195122,77.5609756097561
35753_terrestrial,419,847,161,327,1266,38.424821002386636,78.04295942720763
35754_terrestrial,420,842,159,330,1262,37.857142857142854,78.57142857142857
35755_terrestrial,436,868,167,337,1304,38.30275229357798,77.29357798165137
35756_terrestrial,437,856,168,338,1293,38.443935926773456,77.34553775743707
35757_terrestrial,417,811,155,330,1228,37.170263788968825,79.13669064748201
35758_terrestrial,416,762,156,330,1178,37.5,79.32692307692307
35759_terrestrial,416,759,158,329,1175,37.980769230769226,79.08653846153845
35760_terrestrial,401,736,154,316,1137,38.403990024937656,78.80299251870323
35761_terrestrial,397,698,155,312,1095,39.042821158690174,78.58942065491183
35762_terrestrial,395,696,157,304,1091,39.74683544303797,76.9620253164557
35763_terrestrial,395,681,154,308,1076,38.9873417721519,77.9746835443038
35764_terrestrial,404,683,158,314,1087,39.10891089108911,77.72277227722772
35765_terrestrial,407,658,163,315,1065,40.04914004914005,77.39557739557739
35766_terrestrial,383,581,152,301,964,39.686684073107045,78.59007832898173
35767_terrestrial,362,522,146,281,884,40.331491712707184,77.62430939226519
35768_terrestrial,358,506,144,280,864,40.22346368715084,78.2122905027933
35769_terrestrial,377,507,151,296,884,40.05305039787798,78.51458885941645
35770_terrestrial,396,502,155,315,898,39.141414141414145,79.54545454545455
35771_terrestrial,377,472,142,302,849,37.6657824933687,80.10610079575596
35772_terrestrial,349,436,132,285,785,37.82234957020057,81.66189111747852
35773_terrestrial,340,424,137,269,764,40.294117647058826,79.11764705882352
35774_terrestrial,327,401,133,259,728,40.67278287461774,79.20489296636084
35775_terrestrial,327,408,133,263,735,40.67278287461774,80.42813455657493
35776_terrestrial,321,400,130,255,721,40.49844236760124,79.43925233644859
35777_terrestrial,306,409,122,249,715,39.869281045751634,81.37254901960785
35778_terrestrial,306,409,126,249,715,41.17647058823529,81.37254901960785
35779_terrestrial,287,406,118,237,693,41.11498257839721,82.57839721254355
35780_terrestrial,293,420,122,237,713,41.63822525597269,80.88737201365188
35781_terrestrial,289,423,117,233,712,40.484429065743946,80.62283737024222
35782_terrestrial,286,441,120,230,727,41.95804195804196,80.41958041958041
35783_terrestrial,308,514,130,251,822,42.2077922077922,81.4935064935065
35784_terrestrial,655,699,381,395,1354,58.16793893129771,60.30534351145038
35785_terrestrial,648,674,381,383,1322,58.79629629629629,59.10493827160494
35833_terrestrial,518,264,352,228,782,67.95366795366795,44.01544401544402
35834_terrestrial,618,355,401,284,973,64.88673139158576,45.9546925566343
35835_terrestrial,448,397,200,307,845,44.642857142857146,68.52678571428571
35836_terrestrial,419,396,178,286,815,42.482100238663485,68.25775656324582
35837_terrestrial,384,350,164,264,734,42.70833333333333,68.75
35838_terrestrial,385,357,187,246,742,48.57142857142857,63.896103896103895
35839_terrestrial,360,348,184,227,708,51.11111111111111,63.05555555555556
35840_terrestrial,363,344,194,223,707,53.4435261707989,61.43250688705234
35841_terrestrial,388,355,212,228,743,54.63917525773196,58.76288659793815
35842_terrestrial,380,360,204,229,740,53.68421052631579,60.26315789473684
35843_terrestrial,427,375,224,266,802,52.459016393442624,62.295081967213115
35844_terrestrial,439,387,216,284,826,49.202733485193626,64.69248291571755
35845_terrestrial,438,411,213,290,849,48.63013698630137,66.21004566210046
35846_terrestrial,543,473,291,329,1016,53.591160220994475,60.58931860036832
35847_terrestrial,571,498,312,335,1069,54.64098073555166,58.66900175131349
35848_terrestrial,552,482,301,327,1034,54.528985507246375,59.2391304347826
35849_terrestrial,546,469,282,341,1015,51.64835164835166,62.45421245421245
35850_terrestrial,546,460,279,345,1006,51.098901098901095,63.18681318681318
35851_terrestrial,529,455,265,344,984,50.0945179584121,65.02835538752363
35852_terrestrial,532,488,261,350,1020,49.06015037593985,65.78947368421053
35853_terrestrial,551,500,262,360,1051,47.54990925589836,65.33575317604355
35854_terrestrial,669,666,284,469,1335,42.45142002989537,70.10463378176382
35855_terrestrial,655,622,271,463,1277,41.37404580152671,70.68702290076337
35856_terrestrial,524,432,222,366,956,42.36641221374045,69.8473282442748
35857_terrestrial,470,358,207,319,828,44.04255319148936,67.87234042553192
35858_terrestrial,450,332,209,298,782,46.44444444444444,66.22222222222223
35859_terrestrial,453,320,209,303,773,46.13686534216336,66.88741721854305
35860_terrestrial,1124,532,680,655,1656,60.4982206405694,58.27402135231316
35937_terrestrial,1146,489,707,718,1635,61.69284467713787,62.652705061082024
35938_terrestrial,1150,497,710,718,1647,61.73913043478261,62.43478260869565
35939_terrestrial,214,142,138,152,356,64.48598130841121,71.02803738317756
35940_terrestrial,1156,501,706,726,1657,61.0726643598616,62.80276816608996
35941_terrestrial,1146,487,695,723,1633,60.645724258289704,63.089005235602095
35944_terrestrial,1150,517,689,721,1667,59.913043478260875,62.69565217391304
35945_terrestrial,1166,547,700,733,1713,60.03430531732419,62.86449399656947
35946_terrestrial,1145,528,692,718,1673,60.43668122270742,62.70742358078603
35947_terrestrial,1116,515,668,706,1631,59.85663082437276,63.261648745519715
35961_terrestrial,652,439,407,342,1091,62.42331288343558,52.45398773006135
35962_terrestrial,801,512,500,427,1313,62.421972534332085,53.308364544319595
35963_terrestrial,966,569,599,557,1535,62.00828157349897,57.66045548654244
35964_terrestrial,934,545,581,542,1479,62.20556745182013,58.02997858672377
35967_terrestrial,1075,629,662,630,1704,61.58139534883721,58.6046511627907
35968_terrestrial,1295,902,777,763,2197,60,58.91891891891892
35969_terrestrial,1283,855,738,788,2138,57.521434138737334,61.418550272798136
35970_terrestrial,1287,844,749,783,2131,58.1973581973582,60.83916083916085
35971_terrestrial,1239,789,734,747,2028,59.241323648103304,60.290556900726386
35972_terrestrial,1044,499,617,634,1543,59.099616858237546,60.727969348659
35973_terrestrial,981,426,586,593,1407,59.73496432212029,60.44852191641182
35980_terrestrial,997,481,599,619,1478,60.0802407221665,62.08625877632898
35981_terrestrial,1023,517,618,622,1540,60.410557184750736,60.80156402737048
35982_terrestrial,967,433,579,609,1400,59.87590486039297,62.978283350568766
36102_terrestrial,318,233,212,127,551,66.66666666666666,39.937106918238996
36103_terrestrial,383,377,231,182,760,60.313315926892955,47.51958224543081
36104_terrestrial,271,588,88,214,859,32.47232472324723,78.96678966789668
36105_terrestrial,471,1101,154,377,1572,32.696390658174096,80.04246284501062
36106_terrestrial,479,1041,170,377,1520,35.49060542797495,78.70563674321504
36107_terrestrial,442,1012,172,340,1454,38.91402714932127,76.92307692307693
36108_terrestrial,424,952,161,328,1376,37.971698113207545,77.35849056603774
36109_terrestrial,426,913,159,334,1339,37.32394366197183,78.40375586854461
36110_terrestrial,417,919,157,325,1336,37.64988009592326,77.93764988009593
36111_terrestrial,413,888,159,323,1301,38.49878934624697,78.20823244552058
36112_terrestrial,418,868,163,325,1286,38.995215311004785,77.75119617224881
36113_terrestrial,425,827,168,331,1252,39.52941176470588,77.88235294117646
36114_terrestrial,437,811,171,340,1248,39.130434782608695,77.80320366132723
36115_terrestrial,444,839,170,346,1283,38.288288288288285,77.92792792792793
36116_terrestrial,429,788,158,340,1217,36.82983682983683,79.25407925407926
36117_terrestrial,416,753,160,327,1169,38.46153846153847,78.60576923076923
36118_terrestrial,415,737,156,327,1152,37.59036144578313,78.79518072289157
36119_terrestrial,415,715,158,325,1130,38.0722891566265,78.3132530120482
36120_terrestrial,401,695,152,319,1096,37.905236907730675,79.55112219451371
36121_terrestrial,399,659,153,313,1058,38.34586466165413,78.44611528822055
36122_terrestrial,392,654,151,304,1046,38.52040816326531,77.55102040816327
36123_terrestrial,373,635,145,296,1008,38.8739946380697,79.35656836461126
36124_terrestrial,378,622,145,298,1000,38.35978835978836,78.83597883597884
36125_terrestrial,383,595,156,299,978,40.73107049608355,78.06788511749347
36126_terrestrial,369,536,150,291,905,40.65040650406504,78.86178861788618
36127_terrestrial,355,516,145,277,871,40.845070422535215,78.0281690140845
36128_terrestrial,359,491,148,279,850,41.22562674094708,77.71587743732591
36129_terrestrial,384,497,151,308,881,39.32291666666667,80.20833333333334
36130_terrestrial,384,489,145,308,873,37.76041666666667,80.20833333333334
36131_terrestrial,361,460,138,291,821,38.227146814404435,80.60941828254848
36132_terrestrial,341,437,130,277,778,38.12316715542522,81.23167155425219
36133_terrestrial,336,424,133,266,760,39.58333333333333,79.16666666666666
36134_terrestrial,334,411,133,265,745,39.82035928143712,79.34131736526946
36135_terrestrial,329,405,136,261,734,41.33738601823708,79.33130699088146
36136_terrestrial,322,399,131,256,721,40.683229813664596,79.5031055900621
36137_terrestrial,316,417,126,253,733,39.87341772151899,80.0632911392405
36138_terrestrial,306,405,125,247,711,40.849673202614376,80.71895424836602
36139_terrestrial,288,418,114,239,706,39.58333333333333,82.98611111111111
36140_terrestrial,289,432,119,233,721,41.17647058823529,80.62283737024222
36141_terrestrial,288,447,116,232,735,40.27777777777778,80.55555555555556
36142_terrestrial,301,493,122,245,794,40.53156146179402,81.3953488372093
36143_terrestrial,637,669,380,370,1306,59.65463108320252,58.08477237048666
36144_terrestrial,637,663,377,376,1300,59.183673469387756,59.02668759811617
36194_terrestrial,559,327,369,256,886,66.01073345259391,45.796064400715565
36195_terrestrial,406,368,178,293,774,43.84236453201971,72.16748768472905
36196_terrestrial,368,338,151,266,706,41.03260869565217,72.28260869565217
36197_terrestrial,376,343,170,254,719,45.21276595744681,67.5531914893617
36198_terrestrial,359,346,168,237,705,46.796657381615596,66.01671309192201
36199_terrestrial,342,328,170,225,670,49.707602339181285,65.78947368421053
36200_terrestrial,397,358,228,226,755,57.43073047858942,56.92695214105793
36201_terrestrial,396,366,216,234,762,54.54545454545454,59.09090909090909
36202_terrestrial,391,371,191,250,762,48.84910485933504,63.9386189258312
36203_terrestrial,450,403,226,287,853,50.22222222222222,63.77777777777778
36204_terrestrial,463,438,222,310,901,47.94816414686825,66.95464362850973
36205_terrestrial,498,482,245,323,980,49.19678714859438,64.85943775100401
36206_terrestrial,470,458,226,307,928,48.08510638297872,65.31914893617021
36207_terrestrial,483,446,236,315,929,48.86128364389234,65.21739130434783
36208_terrestrial,512,459,265,323,971,51.7578125,63.0859375
36209_terrestrial,538,448,284,334,986,52.78810408921933,62.0817843866171
36210_terrestrial,526,433,273,336,959,51.90114068441065,63.87832699619772
36211_terrestrial,505,431,256,329,936,50.693069306930695,65.14851485148515
36212_terrestrial,502,444,239,337,946,47.60956175298805,67.13147410358566
36213_terrestrial,501,457,227,337,958,45.309381237524946,67.26546906187625
36214_terrestrial,629,608,272,436,1237,43.24324324324324,69.31637519872814
36215_terrestrial,652,602,276,460,1254,42.331288343558285,70.5521472392638
36216_terrestrial,482,349,217,331,831,45.02074688796681,68.67219917012449
36217_terrestrial,444,301,209,294,745,47.072072072072075,66.21621621621621
36218_terrestrial,424,299,209,276,723,49.29245283018868,65.09433962264151
36219_terrestrial,439,297,216,284,736,49.202733485193626,64.69248291571755
36220_terrestrial,1127,522,681,655,1649,60.42590949423248,58.118899733806565
36221_terrestrial,1116,505,687,639,1621,61.55913978494624,57.25806451612904
36300_terrestrial,1105,453,674,697,1558,60.995475113122176,63.07692307692307
36301_terrestrial,1125,474,682,711,1599,60.62222222222222,63.2
36304_terrestrial,1157,544,701,717,1701,60.58772687986171,61.97061365600691
36305_terrestrial,1138,506,686,712,1644,60.28119507908612,62.56590509666081
36323_terrestrial,1142,691,664,684,1833,58.14360770577933,59.89492119089317
36328_terrestrial,1152,616,686,700,1768,59.548611111111114,60.763888888888886
36329_terrestrial,1193,690,719,713,1883,60.26823134953898,59.7652975691534
36330_terrestrial,1317,854,774,791,2171,58.76993166287016,60.060744115413826
36331_terrestrial,1292,837,758,778,2129,58.6687306501548,60.216718266253864
36332_terrestrial,1052,513,623,636,1565,59.22053231939164,60.45627376425855
36342_terrestrial,952,424,569,598,1376,59.76890756302521,62.81512605042017
36343_terrestrial,951,422,568,598,1373,59.726603575184015,62.88117770767613
36463_terrestrial,353,305,227,156,658,64.30594900849859,44.19263456090651
36464_terrestrial,230,356,77,189,586,33.47826086956522,82.17391304347827
36465_terrestrial,320,779,95,257,1099,29.6875,80.3125
36466_terrestrial,443,983,136,365,1426,30.699774266365687,82.39277652370203
36467_terrestrial,451,1062,163,351,1513,36.14190687361419,77.8270509977827
36468_terrestrial,449,1065,168,343,1514,37.41648106904232,76.39198218262806
36469_terrestrial,446,1012,167,345,1458,37.44394618834081,77.3542600896861
36470_terrestrial,425,954,162,331,1379,38.11764705882353,77.88235294117646
36471_terrestrial,419,934,157,329,1353,37.47016706443914,78.52028639618138
36472_terrestrial,437,884,170,340,1321,38.901601830663616,77.80320366132723
36473_terrestrial,435,813,163,346,1248,37.47126436781609,79.54022988505747
36474_terrestrial,428,780,165,339,1208,38.55140186915888,79.2056074766355
36475_terrestrial,442,806,171,345,1248,38.68778280542987,78.05429864253394
36476_terrestrial,436,755,168,338,1191,38.53211009174312,77.52293577981652
36477_terrestrial,421,725,165,324,1146,39.19239904988123,76.95961995249407
36478_terrestrial,415,718,159,321,1133,38.31325301204819,77.34939759036145
36479_terrestrial,416,692,161,322,1108,38.70192307692308,77.40384615384616
36480_terrestrial,406,668,152,317,1074,37.4384236453202,78.07881773399015
36481_terrestrial,399,653,155,309,1052,38.847117794486216,77.44360902255639
36482_terrestrial,386,633,150,300,1019,38.860103626943,77.720207253886
36483_terrestrial,372,593,139,295,965,37.365591397849464,79.3010752688172
36484_terrestrial,363,561,138,290,924,38.01652892561984,79.88980716253444
36485_terrestrial,366,544,145,290,910,39.61748633879781,79.23497267759562
36486_terrestrial,361,515,144,285,876,39.88919667590028,78.94736842105263
36487_terrestrial,358,501,144,283,859,40.22346368715084,79.05027932960894
36488_terrestrial,373,494,148,295,867,39.67828418230563,79.08847184986595
36489_terrestrial,391,491,149,317,882,38.107416879795394,81.07416879795396
36490_terrestrial,377,478,142,305,855,37.6657824933687,80.90185676392572
36491_terrestrial,363,459,138,292,822,38.01652892561984,80.44077134986226
36492_terrestrial,337,432,131,269,769,38.87240356083086,79.82195845697329
36493_terrestrial,332,422,131,267,754,39.45783132530121,80.42168674698796
36494_terrestrial,333,410,133,262,743,39.93993993993994,78.67867867867868
36495_terrestrial,325,409,132,258,734,40.61538461538461,79.38461538461539
36496_terrestrial,314,411,122,257,725,38.853503184713375,81.84713375796179
36497_terrestrial,311,406,125,249,717,40.19292604501607,80.06430868167203
36498_terrestrial,301,420,121,244,721,40.19933554817276,81.06312292358804
36499_terrestrial,303,454,117,246,757,38.613861386138616,81.1881188118812
36500_terrestrial,295,455,118,239,750,40,81.01694915254237
36501_terrestrial,310,498,123,252,808,39.67741935483871,81.29032258064515
36502_terrestrial,330,533,130,266,863,39.39393939393939,80.60606060606061
36503_terrestrial,613,647,367,354,1260,59.8694942903752,57.74877650897226
36554_terrestrial,562,343,370,257,905,65.83629893238434,45.729537366548044
36555_terrestrial,408,388,172,300,796,42.15686274509804,73.52941176470588
36556_terrestrial,361,380,152,259,741,42.10526315789473,71.74515235457064
36557_terrestrial,356,370,151,252,726,42.41573033707865,70.78651685393258
36558_terrestrial,357,369,169,234,726,47.33893557422969,65.54621848739495
36559_terrestrial,342,329,177,218,671,51.75438596491229,63.74269005847953
36560_terrestrial,370,350,211,216,720,57.027027027027025,58.37837837837838
36561_terrestrial,362,354,189,225,716,52.20994475138122,62.15469613259669
36562_terrestrial,409,375,207,259,784,50.61124694376527,63.325183374083124
36563_terrestrial,443,398,221,287,841,49.887133182844245,64.78555304740406
36564_terrestrial,467,437,224,308,904,47.96573875802998,65.95289079229121
36565_terrestrial,481,502,228,316,983,47.4012474012474,65.6964656964657
36566_terrestrial,484,483,237,316,967,48.96694214876033,65.28925619834712
36567_terrestrial,485,468,241,316,953,49.69072164948454,65.15463917525773
36568_terrestrial,521,463,272,326,984,52.207293666026864,62.571976967370446
36569_terrestrial,525,449,271,333,974,51.61904761904762,63.42857142857142
36570_terrestrial,521,434,263,337,955,50.479846449136275,64.68330134357005
36571_terrestrial,524,444,257,341,968,49.04580152671756,65.07633587786259
36572_terrestrial,518,455,251,340,973,48.455598455598455,65.63706563706563
36573_terrestrial,501,448,225,342,949,44.91017964071856,68.26347305389223
36574_terrestrial,556,493,257,370,1049,46.223021582733814,66.54676258992805
36575_terrestrial,655,601,276,462,1256,42.13740458015267,70.53435114503816
36576_terrestrial,476,330,222,314,806,46.63865546218487,65.96638655462185
36577_terrestrial,426,267,206,276,693,48.35680751173709,64.7887323943662
36578_terrestrial,406,250,210,254,656,51.724137931034484,62.5615763546798
36579_terrestrial,405,245,205,258,650,50.617283950617285,63.70370370370371
36580_terrestrial,428,246,216,275,674,50.467289719626166,64.25233644859813
36581_terrestrial,1062,450,656,612,1512,61.77024482109228,57.6271186440678
36672_terrestrial,690,570,417,361,1260,60.43478260869565,52.31884057971015
36673_terrestrial,679,571,406,370,1250,59.79381443298969,54.49189985272459
36674_terrestrial,657,564,389,361,1221,59.208523592085236,54.946727549467276
36675_terrestrial,625,506,373,331,1131,59.68,52.959999999999994
36676_terrestrial,608,481,368,309,1089,60.526315789473685,50.82236842105263
36677_terrestrial,627,504,378,322,1131,60.28708133971292,51.355661881977674
36682_terrestrial,628,495,369,335,1123,58.75796178343949,53.34394904458599
36683_terrestrial,1202,712,696,750,1914,57.90349417637272,62.39600665557404
36684_terrestrial,1152,660,651,737,1812,56.510416666666664,63.97569444444444
36694_terrestrial,981,430,574,607,1411,58.51172273190621,61.87563710499491
36695_terrestrial,957,406,572,585,1363,59.77011494252874,61.12852664576802
36823_terrestrial,313,246,204,132,559,65.17571884984025,42.17252396166134
36824_terrestrial,379,360,229,186,739,60.4221635883905,49.07651715039577
36825_terrestrial,213,395,64,175,608,30.046948356807512,82.15962441314554
36826_terrestrial,301,720,75,252,1021,24.916943521594686,83.72093023255815
36827_terrestrial,438,999,135,357,1437,30.82191780821918,81.5068493150685
36828_terrestrial,518,1158,170,412,1676,32.818532818532816,79.53667953667953
36829_terrestrial,533,1295,178,420,1828,33.39587242026266,78.79924953095684
36830_terrestrial,465,1110,166,361,1575,35.6989247311828,77.63440860215054
36831_terrestrial,460,1007,169,361,1467,36.73913043478261,78.47826086956522
36832_terrestrial,450,933,172,352,1383,38.22222222222222,78.22222222222223
36833_terrestrial,436,811,165,344,1247,37.84403669724771,78.89908256880734
36834_terrestrial,442,733,171,353,1175,38.68778280542987,79.86425339366517
36835_terrestrial,441,714,170,350,1155,38.54875283446712,79.36507936507937
36836_terrestrial,455,723,180,353,1178,39.56043956043956,77.58241758241759
36837_terrestrial,447,714,181,342,1161,40.49217002237137,76.51006711409396
36838_terrestrial,442,701,179,339,1143,40.497737556561084,76.696832579185525
36839_terrestrial,433,705,167,339,1138,38.56812933025404,78.29099307159353
36840_terrestrial,433,695,163,338,1128,37.644341801385686,78.06004618937644
36841_terrestrial,404,660,154,318,1064,38.11881188118812,78.71287128712872
36842_terrestrial,384,620,149,299,1004,38.80208333333333,77.86458333333334
36843_terrestrial,377,576,145,299,953,38.46153846153847,79.3103448275862
36844_terrestrial,373,548,143,296,921,38.337801608579085,79.35656836461126
36845_terrestrial,367,530,145,289,897,39.509536784741144,78.7465940054496
36846_terrestrial,363,495,144,285,858,39.66942148760331,78.51239669421489
36847_terrestrial,370,504,139,295,874,37.567567567567565,79.72972972972973
36848_terrestrial,385,498,150,306,883,38.961038961038966,79.48051948051949
36849_terrestrial,387,501,145,314,888,37.46770025839793,81.13695090439276
36850_terrestrial,374,501,139,304,875,37.16577540106952,81.28342245989305
36851_terrestrial,350,456,133,283,806,38,80.85714285714286
36852_terrestrial,334,452,126,272,786,37.72455089820359,81.437125748502993
36853_terrestrial,333,443,127,273,776,38.13813813813814,81.98198198198197
36854_terrestrial,325,430,129,261,755,39.69230769230769,80.3076923076923
36855_terrestrial,319,414,128,257,733,40.12539184952978,80.56426332288402
36856_terrestrial,317,415,126,255,732,39.74763406940063,80.4416403785489
36857_terrestrial,309,435,122,249,744,39.482200647249186,80.58252427184466
36858_terrestrial,300,441,116,243,741,38.666666666666664,81
36859_terrestrial,315,505,118,258,820,37.46031746031746,81.9047619047619
36860_terrestrial,330,511,123,268,841,37.27272727272727,81.21212121212122
36861_terrestrial,356,578,133,293,934,37.359550561797754,82.30337078651685
36862_terrestrial,650,713,383,375,1363,58.92307692307692,57.692307692307686
36863_terrestrial,597,590,360,340,1187,60.30150753768844,56.951423785594635
36913_terrestrial,487,251,329,220,738,67.5564681724846,45.17453798767967
36914_terrestrial,586,409,376,275,995,64.16382252559727,46.92832764505119
36915_terrestrial,417,410,176,299,827,42.20623501199041,71.70263788968825
36916_terrestrial,391,399,167,272,790,42.710997442455245,69.56521739130434
36917_terrestrial,383,387,173,258,770,45.16971279373368,67.36292428198433
36918_terrestrial,339,344,156,226,683,46.017699115044245,66.66666666666666
36919_terrestrial,325,299,159,215,624,48.92307692307693,66.15384615384615
36920_terrestrial,314,292,159,207,606,50.63694267515923,65.92356687898089
36921_terrestrial,332,307,163,223,639,49.096385542168676,67.16867469879519
36922_terrestrial,368,331,169,254,699,45.92391304347826,69.02173913043478
36923_terrestrial,413,384,185,288,797,44.794188861985475,69.73365617433413
36924_terrestrial,445,424,198,311,869,44.49438202247191,69.88764044943821
36925_terrestrial,467,472,214,320,939,45.82441113490364,68.52248394004282
36926_terrestrial,476,445,229,319,921,48.109243697478995,67.01680672268907
36927_terrestrial,484,437,240,316,921,49.586776859504134,65.28925619834712
36928_terrestrial,509,456,257,330,965,50.491159135559926,64.83300589390963
36929_terrestrial,519,456,267,334,975,51.445086705202314,64.35452793834297
36930_terrestrial,522,434,261,340,956,50,65.13409961685824
36931_terrestrial,539,450,271,346,989,50.278293135435995,64.19294990723562
36932_terrestrial,519,451,241,349,970,46.4354527938343,67.2447013487476
36933_terrestrial,513,438,233,347,951,45.419103313840154,67.64132553606238
36934_terrestrial,543,480,256,360,1023,47.14548802946593,66.29834254143645
36935_terrestrial,651,566,271,460,1217,41.62826420890937,70.6605222734255
36936_terrestrial,419,285,202,273,704,48.21002386634845,65.15513126491646
36937_terrestrial,384,244,191,249,628,49.73958333333333,64.84375
36938_terrestrial,373,221,191,239,594,51.206434316353885,64.07506702412869
36939_terrestrial,366,221,181,239,587,49.45355191256831,65.30054644808743
36940_terrestrial,372,223,181,253,595,48.655913978494624,68.01075268817203
36941_terrestrial,1035,465,648,593,1500,62.60869565217392,57.294685990338166
36949_terrestrial,871,411,600,465,1282,68.88633754305397,53.38691159586681
36950_terrestrial,908,623,613,489,1531,67.51101321585902,53.85462555066079
37031_terrestrial,731,577,428,410,1308,58.5499316005472,56.0875512995896
37032_terrestrial,720,613,431,397,1333,59.86111111111111,55.13888888888889
37033_terrestrial,697,630,412,392,1327,59.11047345767575,56.241032998565274
37034_terrestrial,281,330,106,232,611,37.72241992882562,82.56227758007117
37035_terrestrial,655,542,389,356,1197,59.38931297709924,54.351145038167935
37036_terrestrial,660,526,396,349,1186,60,52.87878787878788
37037_terrestrial,644,522,385,338,1166,59.78260869565217,52.484472049689444
37042_terrestrial,653,532,384,356,1185,58.80551301684533,54.517611026033684
37043_terrestrial,691,577,401,381,1268,58.03183791606368,55.137481910274964
37044_terrestrial,1201,706,682,766,1907,56.78601165695254,63.78018318068276
37184_terrestrial,308,265,204,129,573,66.23376623376623,41.883116883116884
37185_terrestrial,173,223,64,141,396,36.99421965317919,81.5028901734104
37186_terrestrial,178,316,53,149,494,29.775280898876407,83.70786516853933
37187_terrestrial,243,567,70,199,810,28.80658436213992,81.89300411522635
37188_terrestrial,281,673,92,224,954,32.74021352313167,79.7153024911032
37189_terrestrial,451,1058,146,364,1509,32.37250554323725,80.70953436807096
37190_terrestrial,531,1194,176,426,1725,33.14500941619586,80.22598870056498
37191_terrestrial,538,1218,174,430,1756,32.342007434944236,79.92565055762083
37192_terrestrial,493,1017,178,384,1510,36.105476673427994,77.89046653144015
37193_terrestrial,456,831,170,365,1287,37.280701754385966,80.04385964912281
37194_terrestrial,452,745,177,360,1197,39.15929203539823,79.64601769911505
37195_terrestrial,441,694,170,353,1135,38.54875283446712,80.04535147392289
37196_terrestrial,436,675,173,347,1111,39.678899082568805,79.58715596330275
37197_terrestrial,433,664,172,341,1097,39.722863741339495,78.75288683602771
37198_terrestrial,444,688,178,343,1132,40.090090090090094,77.25225225225225
37199_terrestrial,476,754,182,370,1230,38.23529411764706,77.73109243697479
37200_terrestrial,491,751,182,388,1242,37.06720977596741,79.0224032586558
37201_terrestrial,456,689,166,367,1145,36.40350877192983,80.48245614035088
37202_terrestrial,427,619,155,348,1046,36.29976580796253,81.49882903981265
37203_terrestrial,402,580,148,329,982,36.81592039800995,81.8407960199005
37204_terrestrial,385,547,141,314,932,36.62337662337662,81.55844155844156
37205_terrestrial,372,541,140,304,913,37.634408602150536,81.72043010752688
37206_terrestrial,369,511,142,299,880,38.482384823848236,81.02981029810297
37207_terrestrial,377,507,144,305,884,38.196286472148536,80.90185676392572
37208_terrestrial,382,499,147,310,881,38.481675392670155,81.15183246073299
37209_terrestrial,384,506,140,318,890,36.45833333333333,82.8125
37210_terrestrial,365,484,135,300,849,36.986301369863014,82.1917808219178
37211_terrestrial,351,469,129,289,820,36.75213675213676,82.33618233618233
37212_terrestrial,349,487,134,286,836,38.39541547277937,81.9484240687679
37213_terrestrial,348,487,133,283,835,38.2183908045977,81.32183908045977
37214_terrestrial,334,449,132,266,783,39.52095808383233,79.64071856287424
37215_terrestrial,330,434,131,266,764,39.696969696969695,80.60606060606061
37216_terrestrial,322,438,127,256,760,39.44099378881988,79.5031055900621
37217_terrestrial,316,451,124,256,767,39.24050632911392,81.0126582278481
37218_terrestrial,310,465,124,248,775,40,80
37219_terrestrial,337,517,132,266,854,39.16913946587537,78.93175074183976
37220_terrestrial,347,582,127,281,929,36.59942363112392,80.97982708933718
37221_terrestrial,675,784,387,403,1459,57.333333333333336,59.7037037037037
37222_terrestrial,632,647,376,365,1279,59.49367088607595,57.75316455696202
37273_terrestrial,496,285,330,226,781,66.53225806451613,45.564516129032256
37274_terrestrial,374,329,156,270,703,41.711229946524064,72.19251336898395
37275_terrestrial,393,381,159,282,774,40.458015267175576,71.7557251908397
37276_terrestrial,402,380,182,272,782,45.27363184079602,67.66169154228857
37277_terrestrial,366,360,177,240,726,48.36065573770492,65.57377049180327
37278_terrestrial,325,308,158,216,633,48.61538461538461,66.46153846153847
37279_terrestrial,303,274,149,204,577,49.17491749174918,67.32673267326733
37280_terrestrial,287,256,143,196,543,49.825783972125436,68.29268292682927
37281_terrestrial,299,262,149,204,561,49.83277591973244,68.22742474916387
37282_terrestrial,377,313,171,267,690,45.35809018567639,70.82228116710876
37283_terrestrial,453,379,204,320,832,45.033112582781456,70.6401766004415
37284_terrestrial,475,417,220,326,892,46.31578947368421,68.63157894736842
37285_terrestrial,483,438,230,325,921,47.61904761904761,67.28778467908903
37286_terrestrial,481,432,230,321,913,47.81704781704782,66.73596673596674
37287_terrestrial,482,426,231,321,908,47.9253112033195,66.59751037344398
37288_terrestrial,492,430,236,328,922,47.96747967479675,66.66666666666666
37289_terrestrial,509,455,250,340,964,49.115913555992144,66.7976424361493
37290_terrestrial,520,439,258,340,959,49.61538461538461,65.38461538461539
37291_terrestrial,532,450,260,345,982,48.87218045112782,64.84962406015038
37292_terrestrial,498,441,228,339,939,45.78313253012048,68.07228915662651
37293_terrestrial,515,432,234,350,947,45.43689320388349,67.96116504854369
37294_terrestrial,531,458,247,354,989,46.516007532956685,66.66666666666666
37295_terrestrial,686,601,282,489,1287,41.10787172011662,71.28279883381924
37296_terrestrial,554,443,248,378,997,44.765342960288805,68.23104693140795
37297_terrestrial,375,258,178,255,633,47.46666666666667,68
37298_terrestrial,353,221,173,240,574,49.008498583569406,67.98866855524079
37299_terrestrial,348,221,165,239,569,47.41379310344828,68.67816091954023
37300_terrestrial,368,234,176,252,602,47.82608695652174,68.47826086956522
37301_terrestrial,1036,463,644,598,1499,62.16216216216216,57.72200772200772
37308_terrestrial,850,378,584,458,1228,68.70588235294117,53.88235294117647
37309_terrestrial,943,665,634,513,1608,67.2322375397667,54.40084835630965
37310_terrestrial,905,654,606,493,1559,66.96132596685082,54.47513812154696
37311_terrestrial,798,327,533,447,1125,66.79197994987469,56.015037593984964
37387_terrestrial,751,497,452,424,1248,60.18641810918774,56.45805592543276
37388_terrestrial,704,470,424,389,1174,60.22727272727273,55.25568181818182
37390_terrestrial,684,517,405,381,1201,59.210526315789465,55.70175438596491
37391_terrestrial,715,563,420,402,1278,58.74125874125874,56.22377622377622
37392_terrestrial,276,329,96,236,605,34.78260869565217,85.5072463768116
37393_terrestrial,276,333,96,236,609,34.78260869565217,85.5072463768116
37394_terrestrial,245,283,73,216,528,29.795918367346943,88.16326530612245
37395_terrestrial,241,248,77,207,489,31.950207468879665,85.89211618257261
37396_terrestrial,602,507,351,320,1109,58.30564784053156,53.156146179402
37397_terrestrial,608,525,362,314,1133,59.539473684210535,51.64473684210527
37402_terrestrial,648,504,380,355,1152,58.64197530864198,54.78395061728395
37403_terrestrial,303,314,114,243,617,37.62376237623762,80.19801980198021
37404_terrestrial,1220,731,690,778,1951,56.557377049180324,63.77049180327868
37545_terrestrial,321,281,206,142,602,64.17445482866043,44.23676012461059
37546_terrestrial,155,195,58,126,350,37.41935483870968,81.29032258064515
37547_terrestrial,123,211,46,99,334,37.39837398373984,80.48780487804879
37548_terrestrial,131,234,49,103,365,37.404580152671755,78.62595419847328
37549_terrestrial,150,315,59,113,465,39.33333333333333,75.33333333333333
37550_terrestrial,237,537,84,186,774,35.44303797468354,78.48101265822784
37551_terrestrial,443,914,139,363,1357,31.376975169300223,81.941309255079
37552_terrestrial,538,1097,181,435,1635,33.64312267657992,80.85501858736059
37553_terrestrial,482,927,177,384,1409,36.72199170124482,79.66804979253112
37554_terrestrial,454,803,171,367,1257,37.66519823788546,80.83700440528634
37555_terrestrial,443,734,167,359,1177,37.69751693002257,81.03837471783297
37556_terrestrial,428,669,164,344,1097,38.31775700934579,80.37383177570094
37557_terrestrial,425,626,169,336,1051,39.76470588235294,79.05882352941175
37558_terrestrial,425,618,168,337,1043,39.52941176470588,79.29411764705883
37559_terrestrial,472,725,176,376,1197,37.28813559322034,79.66101694915254
37560_terrestrial,485,727,175,391,1212,36.08247422680412,80.61855670103093
37561_terrestrial,459,666,161,375,1125,35.07625272331155,81.69934640522875
37562_terrestrial,440,633,154,363,1073,35,82.5
37563_terrestrial,434,600,154,362,1034,35.483870967741936,83.41013824884793
37564_terrestrial,434,596,152,367,1030,35.02304147465438,84.56221198156682
37565_terrestrial,417,561,149,350,978,35.73141486810552,83.93285371702638
37566_terrestrial,394,520,143,330,914,36.29441624365482,83.75634517766497
37567_terrestrial,380,493,140,315,873,36.84210526315789,82.89473684210526
37568_terrestrial,381,479,140,315,860,36.74540682414698,82.67716535433071
37569_terrestrial,372,496,137,306,868,36.82795698924731,82.25806451612904
37570_terrestrial,367,497,138,302,864,37.60217983651226,82.28882833787466
37571_terrestrial,367,490,137,303,857,37.32970027247956,82.56130790190736
37572_terrestrial,362,495,138,297,857,38.12154696132597,82.04419889502762
37573_terrestrial,359,515,136,293,874,37.88300835654596,81.61559888579387
37574_terrestrial,344,480,142,271,824,41.27906976744186,78.77906976744185
37575_terrestrial,339,461,140,265,800,41.29793510324484,78.17109144542773
37576_terrestrial,328,471,131,261,799,39.9390243902439,79.57317073170732
37577_terrestrial,319,468,126,258,787,39.49843260188088,80.87774294670847
37578_terrestrial,309,470,122,249,779,39.482200647249186,80.58252427184466
37579_terrestrial,318,496,122,257,814,38.36477987421384,80.81761006289308
37580_terrestrial,366,606,130,304,972,35.51912568306011,83.06010928961749
37581_terrestrial,696,806,395,416,1502,56.75287356321839,59.77011494252874
37582_terrestrial,631,620,378,361,1251,59.90491283676703,57.2107765451664
37633_terrestrial,512,319,329,236,831,64.2578125,46.09375
37634_terrestrial,397,342,165,284,739,41.56171284634761,71.53652392947103
37635_terrestrial,411,353,179,282,764,43.552311435523116,68.61313868613139
37636_terrestrial,384,344,179,252,728,46.61458333333333,65.625
37637_terrestrial,368,309,178,242,677,48.369565217391305,65.76086956521739
37638_terrestrial,324,269,160,216,593,49.382716049382715,66.66666666666666
37639_terrestrial,303,248,153,204,551,50.495049504950494,67.32673267326733
37640_terrestrial,288,236,143,199,524,49.65277777777778,69.09722222222221
37641_terrestrial,307,245,155,211,552,50.4885993485342,68.72964169381108
37642_terrestrial,378,285,180,265,663,47.61904761904761,70.1058201058201
37643_terrestrial,461,362,216,322,823,46.85466377440347,69.84815618221259
37644_terrestrial,486,396,232,334,882,47.73662551440329,68.72427983539094
37645_terrestrial,479,396,229,325,875,47.80793319415449,67.84968684759917
37646_terrestrial,476,401,233,318,877,48.94957983193277,66.80672268907563
37647_terrestrial,481,413,225,327,894,46.77754677754678,67.98336798336798
37648_terrestrial,498,419,240,335,917,48.19277108433735,67.26907630522089
37649_terrestrial,491,425,224,339,916,45.621181262729124,69.04276985743381
37650_terrestrial,502,431,228,348,933,45.41832669322709,69.32270916334662
37651_terrestrial,500,426,231,340,926,46.2,68
37652_terrestrial,495,418,231,332,913,46.666666666666664,67.07070707070707
37653_terrestrial,472,421,202,335,893,42.79661016949153,70.97457627118644
37654_terrestrial,508,442,226,352,950,44.48818897637795,69.29133858267717
37655_terrestrial,655,610,275,468,1265,41.98473282442748,71.45038167938931
37656_terrestrial,658,568,283,457,1226,43.00911854103344,69.45288753799392
37657_terrestrial,427,299,195,297,726,45.66744730679157,69.55503512880561
37658_terrestrial,365,255,165,260,620,45.20547945205479,71.23287671232876
37659_terrestrial,349,235,162,247,584,46.41833810888252,70.77363896848138
37660_terrestrial,371,245,180,255,616,48.517520215633425,68.73315363881402
37661_terrestrial,1033,465,643,593,1498,62.24588576960309,57.405614714424004
37668_terrestrial,866,426,597,467,1292,68.93764434180139,53.92609699769053
37669_terrestrial,937,644,635,500,1581,67.76947705442903,53.36179295624333
37670_terrestrial,292,566,171,170,858,58.56164383561644,58.21917808219178
37671_terrestrial,880,501,578,481,1381,65.68181818181819,54.659090909090914
37746_terrestrial,753,544,447,433,1297,59.36254980079681,57.50332005312085
37747_terrestrial,752,548,447,434,1300,59.441489361702125,57.71276595744681
37748_terrestrial,706,517,417,399,1223,59.06515580736544,56.51558073654391
37749_terrestrial,702,521,417,396,1223,59.401709401709404,56.41025641025641
37750_terrestrial,720,558,424,413,1278,58.88888888888889,57.36111111111111
37751_terrestrial,285,313,104,237,598,36.49122807017544,83.15789473684211
37752_terrestrial,250,270,74,226,520,29.599999999999998,90.4
37753_terrestrial,239,253,71,212,492,29.707112970711297,88.70292887029288
37754_terrestrial,229,251,61,204,480,26.637554585152838,89.08296943231441
37755_terrestrial,584,504,328,326,1088,56.16438356164384,55.821917808219176
37756_terrestrial,608,514,356,325,1122,58.55263157894737,53.45394736842105
37762_terrestrial,631,480,370,346,1111,58.63708399366085,54.83359746434231
37763_terrestrial,283,274,100,235,557,35.3356890459364,83.03886925795054
37764_terrestrial,1206,722,674,780,1928,55.88723051409619,64.6766169154229
37765_terrestrial,1227,736,685,790,1963,55.827220863895676,64.38467807660962
37766_terrestrial,1214,705,675,784,1919,55.601317957166394,64.57990115321252
37905_terrestrial,284,210,194,108,494,68.30985915492957,38.028169014084504
37906_terrestrial,320,261,206,139,581,64.375,43.4375
37907_terrestrial,150,179,55,121,329,36.666666666666664,80.66666666666666
37908_terrestrial,138,183,51,112,321,36.95652173913043,81.15942028985508
37909_terrestrial,117,206,49,90,323,41.88034188034188,76.92307692307693
37910_terrestrial,115,235,51,82,350,44.34782608695652,71.30434782608695
37911_terrestrial,189,425,70,142,614,37.03703703703704,75.13227513227513
37912_terrestrial,419,863,132,342,1282,31.5035799522673,81.62291169451073
37913_terrestrial,515,1022,168,424,1537,32.62135922330097,82.33009708737865
37914_terrestrial,486,927,170,397,1413,34.97942386831276,81.6872427983539
37915_terrestrial,449,753,165,368,1202,36.74832962138085,81.9599109131403
37916_terrestrial,432,711,164,353,1143,37.96296296296296,81.71296296296296
37917_terrestrial,411,633,163,332,1044,39.65936739659367,80.7785888077859
37918_terrestrial,408,611,166,326,1019,40.68627450980392,79.90196078431373
37919_terrestrial,432,594,168,342,1026,38.88888888888889,79.16666666666666
37920_terrestrial,458,645,170,366,1103,37.117903930131,79.91266375545851
37921_terrestrial,451,615,164,370,1066,36.36363636363637,82.039911308204
37922_terrestrial,445,612,161,364,1057,36.17977528089887,81.79775280898876
37923_terrestrial,436,609,160,360,1045,36.69724770642202,82.56880733944955
37924_terrestrial,428,586,155,355,1014,36.21495327102804,82.94392523364486
37925_terrestrial,403,550,148,336,953,36.72456575682382,83.37468982630273
37926_terrestrial,385,498,144,321,883,37.4025974025974,83.37662337662337
37927_terrestrial,372,476,139,312,848,37.365591397849464,83.87096774193549
37928_terrestrial,371,476,138,308,847,37.19676549865229,83.01886792452831
37929_terrestrial,373,502,139,308,875,37.26541554959786,82.57372654155496
37930_terrestrial,374,510,138,308,884,36.898395721925134,82.35294117647058
37931_terrestrial,373,499,137,308,872,36.72922252010724,82.57372654155496
37932_terrestrial,364,535,137,300,899,37.637362637362635,82.41758241758241
37933_terrestrial,349,526,133,286,875,38.108882521489974,81.9484240687679
37934_terrestrial,351,506,142,278,857,40.45584045584046,79.2022792022792
37935_terrestrial,346,478,144,272,824,41.61849710982659,78.61271676300578
37936_terrestrial,338,491,136,271,829,40.23668639053255,80.1775147928994
37937_terrestrial,317,482,121,260,799,38.170347003154575,82.01892744479495
37938_terrestrial,311,474,119,251,785,38.263665594855304,80.70739549839229
37939_terrestrial,314,501,118,256,815,37.57961783439491,81.52866242038218
37940_terrestrial,358,616,125,300,974,34.91620111731844,83.79888268156425
37941_terrestrial,692,808,391,419,1500,56.5028901734104,60.54913294797688
37942_terrestrial,655,666,387,381,1321,59.083969465648856,58.16793893129771
37992_terrestrial,406,210,289,170,616,71.18226600985221,41.87192118226601
37993_terrestrial,527,333,333,250,860,63.18785578747628,47.43833017077799
37994_terrestrial,380,333,151,272,713,39.73684210526316,71.57894736842105
37995_terrestrial,402,324,178,275,726,44.27860696517413,68.40796019900498
37996_terrestrial,387,293,179,261,680,46.253229974160206,67.44186046511628
37997_terrestrial,362,278,176,242,640,48.61878453038674,66.85082872928176
37998_terrestrial,354,254,177,234,608,50,66.10169491525424
37999_terrestrial,305,221,148,217,526,48.52459016393443,71.14754098360656
38000_terrestrial,293,232,145,207,525,49.48805460750853,70.64846416382252
38001_terrestrial,304,232,151,213,536,49.67105263157895,70.06578947368422
38002_terrestrial,389,266,194,271,655,49.87146529562982,69.66580976863753
38003_terrestrial,465,346,226,320,811,48.60215053763441,68.81720430107528
38004_terrestrial,486,365,238,332,851,48.971193415637856,68.3127572016461
38005_terrestrial,472,357,227,328,829,48.09322033898305,69.49152542372882
38006_terrestrial,482,388,233,330,870,48.3402489626556,68.46473029045643
38007_terrestrial,507,403,241,345,910,47.53451676528599,68.04733727810651
38008_terrestrial,531,415,260,355,946,48.96421845574388,66.85499058380414
38009_terrestrial,543,439,261,359,982,48.06629834254144,66.11418047882137
38010_terrestrial,520,430,244,350,950,46.92307692307692,67.3076923076923
38011_terrestrial,495,420,227,337,915,45.85858585858586,68.08080808080808
38012_terrestrial,462,394,215,318,856,46.53679653679654,68.83116883116884
38013_terrestrial,465,389,220,312,854,47.31182795698925,67.0967741935484
38014_terrestrial,480,417,223,326,897,46.458333333333336,67.91666666666667
38015_terrestrial,568,479,257,385,1047,45.24647887323944,67.78169014084507
38016_terrestrial,575,500,270,382,1075,46.95652173913044,66.43478260869566
38017_terrestrial,451,332,205,320,783,45.45454545454545,70.95343680709534
38018_terrestrial,397,286,186,277,683,46.85138539042821,69.77329974811083
38019_terrestrial,365,237,174,254,602,47.671232876712324,69.58904109589041
38020_terrestrial,372,224,185,256,596,49.73118279569893,68.81720430107528
38021_terrestrial,1035,460,649,592,1495,62.70531400966184,57.19806763285025
38026_terrestrial,850,373,584,460,1223,68.70588235294117,54.11764705882353
38027_terrestrial,878,386,606,463,1264,69.02050113895216,52.73348519362187
38028_terrestrial,884,410,608,467,1294,68.77828054298642,52.828054298642535
38029_terrestrial,230,269,142,134,499,61.73913043478261,58.26086956521739
38030_terrestrial,904,647,590,490,1551,65.2654867256637,54.20353982300885
38031_terrestrial,878,541,579,474,1419,65.94533029612755,53.98633257403189
38105_terrestrial,771,534,454,448,1305,58.884565499351496,58.10635538261998
38106_terrestrial,777,574,455,456,1351,58.55855855855856,58.68725868725869
38107_terrestrial,246,298,77,216,544,31.300813008130078,87.8048780487805
38108_terrestrial,674,531,389,396,1205,57.71513353115727,58.753709198813056
38109_terrestrial,703,564,412,403,1267,58.60597439544808,57.32574679943101
38110_terrestrial,718,562,421,412,1280,58.63509749303621,57.381615598885794
38111_terrestrial,269,312,91,229,581,33.82899628252788,85.13011152416357
38112_terrestrial,229,254,65,205,483,28.38427947598253,89.51965065502183
38113_terrestrial,219,219,61,194,438,27.85388127853881,88.58447488584474
38114_terrestrial,214,223,56,188,437,26.168224299065418,87.85046728971963
38115_terrestrial,245,270,82,204,515,33.46938775510204,83.26530612244898
38116_terrestrial,596,514,344,323,1110,57.71812080536913,54.194630872483216
38117_terrestrial,610,516,357,327,1126,58.524590163934434,53.60655737704918
38118_terrestrial,590,485,348,314,1075,58.98305084745763,53.22033898305085
38122_terrestrial,619,452,364,338,1071,58.80452342487884,54.60420032310178
38123_terrestrial,272,223,96,225,495,35.294117647058826,82.72058823529412
38124_terrestrial,282,267,88,247,549,31.20567375886525,87.58865248226951
38125_terrestrial,350,376,127,284,726,36.285714285714285,81.14285714285714
38126_terrestrial,1267,809,697,819,2076,55.011838989739545,64.64088397790056
38267_terrestrial,280,206,190,108,486,67.85714285714286,38.57142857142858
38268_terrestrial,324,283,205,146,607,63.27160493827161,45.06172839506173
38269_terrestrial,157,196,58,131,353,36.94267515923567,83.43949044585987
38270_terrestrial,133,206,58,104,339,43.609022556390975,78.19548872180451
38271_terrestrial,117,209,51,80,326,43.58974358974359,68.37606837606837
38272_terrestrial,206,481,69,155,687,33.49514563106796,75.24271844660194
38273_terrestrial,381,829,113,317,1210,29.658792650918635,83.2020997375328
38274_terrestrial,513,1002,169,422,1515,32.94346978557505,82.26120857699804
38275_terrestrial,548,1031,184,451,1579,33.57664233576642,82.2992700729927
38276_terrestrial,465,808,170,384,1273,36.55913978494624,82.58064516129032
38277_terrestrial,434,678,166,360,1112,38.24884792626728,82.94930875576037
38278_terrestrial,411,611,167,327,1022,40.632603406326034,79.56204379562044
38279_terrestrial,402,558,161,316,960,40.049751243781095,78.60696517412936
38280_terrestrial,406,529,159,326,935,39.16256157635468,80.29556650246306
38281_terrestrial,398,527,157,320,925,39.44723618090452,80.40201005025126
38282_terrestrial,401,551,158,321,952,39.40149625935162,80.0498753117207
38283_terrestrial,402,538,155,328,940,38.55721393034826,81.59203980099502
38284_terrestrial,410,520,158,334,930,38.53658536585366,81.46341463414633
38285_terrestrial,386,505,144,320,891,37.30569948186528,82.90155440414507
38286_terrestrial,366,488,139,305,854,37.97814207650273,83.33333333333334
38287_terrestrial,365,478,134,308,843,36.71232876712329,84.38356164383562
38288_terrestrial,358,479,133,300,837,37.150837988826815,83.79888268156425
38289_terrestrial,360,480,137,296,840,38.05555555555556,82.22222222222221
38290_terrestrial,363,494,135,302,857,37.1900826446281,83.19559228650138
38291_terrestrial,363,508,135,302,871,37.1900826446281,83.19559228650138
38292_terrestrial,358,535,134,297,893,37.43016759776536,82.9608938547486
38293_terrestrial,344,514,136,278,858,39.53488372093023,80.81395348837209
38294_terrestrial,343,496,133,279,839,38.775510204081634,81.34110787172013
38295_terrestrial,344,492,136,278,836,39.53488372093023,80.81395348837209
38296_terrestrial,332,489,130,271,821,39.1566265060241,81.62650602409639
38297_terrestrial,328,476,127,267,804,38.71951219512195,81.40243902439023
38298_terrestrial,325,492,121,265,817,37.230769230769226,81.53846153846153
38299_terrestrial,325,529,117,269,854,36,82.76923076923077
38300_terrestrial,377,622,134,310,999,35.54376657824933,82.22811671087533
38301_terrestrial,699,794,402,414,1493,57.5107296137339,59.227467811158796
38302_terrestrial,651,662,386,375,1313,59.29339477726574,57.6036866359447
38352_terrestrial,409,215,286,179,624,69.92665036674816,43.76528117359413
38353_terrestrial,322,234,153,219,556,47.51552795031056,68.01242236024845
38354_terrestrial,391,290,178,261,681,45.52429667519181,66.75191815856778
38355_terrestrial,390,298,183,262,688,46.92307692307692,67.17948717948717
38356_terrestrial,381,270,181,255,651,47.506561679790025,66.92913385826772
38357_terrestrial,342,239,153,238,581,44.73684210526316,69.5906432748538
38358_terrestrial,376,253,184,259,629,48.93617021276596,68.88297872340425
38359_terrestrial,375,248,191,257,623,50.93333333333333,68.53333333333333
38360_terrestrial,353,242,189,241,595,53.54107648725213,68.27195467422096
38361_terrestrial,323,229,159,231,552,49.22600619195047,71.51702786377709
38362_terrestrial,391,263,196,273,654,50.127877237851656,69.82097186700767
38363_terrestrial,453,299,215,323,752,47.46136865342163,71.30242825607064
38364_terrestrial,482,335,232,331,817,48.13278008298755,68.67219917012449
38365_terrestrial,496,341,237,345,837,47.78225806451613,69.55645161290323
38366_terrestrial,499,373,233,347,872,46.6933867735471,69.53907815631263
38367_terrestrial,530,401,258,359,931,48.679245283018865,67.73584905660377
38368_terrestrial,550,405,267,362,955,48.54545454545455,65.81818181818181
38369_terrestrial,537,419,255,358,956,47.486033519553075,66.66666666666666
38370_terrestrial,502,403,232,348,905,46.21513944223107,69.32270916334662
38371_terrestrial,494,402,229,338,896,46.35627530364373,68.42105263157895
38372_terrestrial,485,411,223,337,896,45.97938144329897,69.48453608247422
38373_terrestrial,482,401,218,339,883,45.22821576763486,70.33195020746888
38374_terrestrial,479,406,221,329,885,46.13778705636743,68.6847599164927
38375_terrestrial,555,478,254,375,1033,45.765765765765764,67.56756756756756
38376_terrestrial,567,514,261,387,1081,46.03174603174603,68.25396825396825
38377_terrestrial,450,340,204,318,790,45.33333333333333,70.66666666666667
38378_terrestrial,415,265,197,290,680,47.46987951807229,69.87951807228916
38379_terrestrial,408,228,207,271,636,50.73529411764706,66.42156862745098
38380_terrestrial,1031,437,651,587,1468,63.14258001939864,56.93501454898156
38381_terrestrial,995,419,628,574,1414,63.11557788944724,57.68844221105528
38385_terrestrial,845,381,580,452,1226,68.63905325443787,53.49112426035503
38386_terrestrial,864,406,590,465,1270,68.28703703703704,53.81944444444444
38387_terrestrial,266,235,173,155,501,65.0375939849624,58.27067669172933
38388_terrestrial,195,202,115,126,397,58.97435897435898,64.61538461538461
38389_terrestrial,257,343,159,140,600,61.86770428015564,54.474708171206224
38390_terrestrial,909,588,598,487,1497,65.78657865786579,53.575357535753575
38391_terrestrial,699,296,480,360,995,68.6695278969957,51.50214592274678
38463_terrestrial,755,433,460,438,1188,60.9271523178808,58.01324503311258
38464_terrestrial,784,524,468,461,1308,59.693877551020414,58.80102040816326
38465_terrestrial,783,562,458,466,1345,58.49297573435505,59.514687100893994
38466_terrestrial,267,324,92,224,591,34.45692883895131,83.89513108614233
38467_terrestrial,222,262,59,199,484,26.576576576576578,89.63963963963964
38468_terrestrial,243,259,74,217,502,30.45267489711934,89.30041152263375
38469_terrestrial,262,293,86,228,555,32.82442748091603,87.02290076335878
38470_terrestrial,253,283,79,224,536,31.225296442687743,88.53754940711462
38471_terrestrial,229,255,65,206,484,28.38427947598253,89.95633187772926
38472_terrestrial,208,220,54,190,428,25.961538461538463,91.34615384615384
38473_terrestrial,194,208,52,175,402,26.804123711340207,90.20618556701031
38474_terrestrial,193,198,52,173,391,26.94300518134715,89.63730569948186
38475_terrestrial,209,228,55,189,437,26.31578947368421,90.43062200956938
38476_terrestrial,246,257,80,210,503,32.52032520325203,85.36585365853658
38477_terrestrial,259,278,92,213,537,35.521235521235525,82.23938223938224
38478_terrestrial,590,505,338,323,1095,57.28813559322033,54.74576271186441
38479_terrestrial,597,485,340,329,1082,56.951423785594635,55.10887772194305
38480_terrestrial,602,448,349,324,1050,57.9734219269103,53.820598006644516
38481_terrestrial,553,399,325,297,952,58.77034358047016,53.70705244122965
38482_terrestrial,613,454,357,338,1067,58.23817292006525,55.13866231647635
38483_terrestrial,253,205,89,211,458,35.177865612648226,83.399209486166
38484_terrestrial,248,228,69,219,476,27.82258064516129,88.30645161290323
38485_terrestrial,368,423,133,299,791,36.141304347826086,81.25
38486_terrestrial,1268,881,701,816,2149,55.283911671924294,64.35331230283911
38628_terrestrial,269,184,181,106,453,67.28624535315984,39.405204460966544
38629_terrestrial,295,231,189,128,526,64.0677966101695,43.389830508474574
38630_terrestrial,313,287,197,144,600,62.939297124600635,46.00638977635783
38631_terrestrial,135,191,55,102,326,40.74074074074074,75.55555555555556
38632_terrestrial,105,180,42,74,285,40,70.47619047619048
38633_terrestrial,169,331,60,129,500,35.50295857988166,76.33136094674556
38634_terrestrial,282,625,91,221,907,32.269503546099294,78.36879432624113
38635_terrestrial,463,978,153,376,1441,33.04535637149028,81.20950323974083
38636_terrestrial,513,1030,168,427,1543,32.748538011695906,83.23586744639377
38637_terrestrial,477,802,177,394,1279,37.10691823899371,82.59958071278825
38638_terrestrial,404,581,158,330,985,39.10891089108911,81.68316831683168
38639_terrestrial,382,488,148,307,870,38.7434554973822,80.36649214659685
38640_terrestrial,377,459,145,303,836,38.46153846153847,80.37135278514589
38641_terrestrial,366,461,139,293,827,37.97814207650273,80.05464480874316
38642_terrestrial,386,476,153,306,862,39.637305699481864,79.27461139896373
38643_terrestrial,401,492,154,321,893,38.403990024937656,80.0498753117207
38644_terrestrial,389,482,150,319,871,38.56041131105398,82.0051413881748
38645_terrestrial,376,474,143,308,850,38.03191489361702,81.91489361702128
38646_terrestrial,369,467,138,306,836,37.39837398373984,82.92682926829268
38647_terrestrial,363,472,137,299,835,37.74104683195592,82.36914600550963
38648_terrestrial,361,467,136,296,828,37.67313019390582,81.99445983379502
38649_terrestrial,352,461,132,293,813,37.5,83.23863636363636
38650_terrestrial,350,474,134,289,824,38.285714285714285,82.57142857142857
38651_terrestrial,345,494,128,290,839,37.10144927536232,84.05797101449275
38652_terrestrial,341,513,128,285,854,37.5366568914956,83.57771260997067
38653_terrestrial,343,511,134,281,854,39.067055393586,81.92419825072886
38654_terrestrial,345,506,131,285,851,37.971014492753625,82.6086956521739
38655_terrestrial,341,512,129,281,853,37.82991202346041,82.40469208211144
38656_terrestrial,343,532,129,282,875,37.60932944606414,82.21574344023324
38657_terrestrial,350,546,137,282,896,39.14285714285714,80.57142857142857
38658_terrestrial,342,529,123,280,871,35.96491228070175,81.87134502923976
38659_terrestrial,345,552,121,287,897,35.07246376811594,83.18840579710145
38660_terrestrial,376,618,131,311,994,34.840425531914896,82.7127659574468
38661_terrestrial,688,750,397,401,1438,57.70348837209303,58.28488372093024
38712_terrestrial,399,203,270,176,602,67.66917293233082,44.11027568922306
38713_terrestrial,319,212,156,205,531,48.90282131661442,64.26332288401254
38714_terrestrial,379,264,179,251,643,47.229551451187334,66.2269129287599
38715_terrestrial,402,283,186,272,685,46.26865671641791,67.66169154228857
38716_terrestrial,394,258,172,279,652,43.65482233502538,70.81218274111674
38717_terrestrial,391,247,172,278,638,43.98976982097187,71.0997442455243
38718_terrestrial,413,257,192,289,670,46.48910411622276,69.97578692493947
38719_terrestrial,415,259,201,286,674,48.433734939759034,68.9156626506024
38720_terrestrial,434,271,205,303,705,47.235023041474655,69.81566820276498
38721_terrestrial,444,297,209,313,741,47.072072072072075,70.4954954954955
38722_terrestrial,479,318,226,329,797,47.18162839248434,68.6847599164927
38723_terrestrial,486,321,231,334,807,47.53086419753087,68.72427983539094
38724_terrestrial,511,354,241,348,865,47.162426614481404,68.10176125244618
38725_terrestrial,542,383,259,363,925,47.7859778597786,66.97416974169742
38726_terrestrial,570,424,275,372,994,48.24561403508772,65.26315789473685
38727_terrestrial,547,410,261,370,957,47.714808043875685,67.64168190127971
38728_terrestrial,522,408,238,357,930,45.593869731800766,68.39080459770115
38729_terrestrial,487,368,223,336,855,45.790554414784395,68.99383983572895
38730_terrestrial,463,370,202,334,833,43.628509719222464,72.13822894168467
38731_terrestrial,476,393,216,337,869,45.378151260504204,70.7983193277311
38732_terrestrial,484,411,223,337,895,46.074380165289256,69.62809917355372
38733_terrestrial,494,462,215,353,956,43.522267206477736,71.45748987854252
38734_terrestrial,516,442,238,355,958,46.12403100775194,68.7984496124031
38735_terrestrial,502,407,240,337,909,47.808764940239044,67.13147410358566
38736_terrestrial,528,389,256,354,917,48.484848484848484,67.04545454545455
38737_terrestrial,1089,505,660,651,1594,60.60606060606061,59.77961432506888
38738_terrestrial,1067,469,661,622,1536,61.9493908153702,58.29428303655108
38739_terrestrial,1038,432,653,599,1470,62.90944123314065,57.70712909441234
38744_terrestrial,815,340,559,442,1155,68.58895705521473,54.233128834355824
38745_terrestrial,833,373,575,445,1206,69.02761104441777,53.421368547418965
38746_terrestrial,181,168,118,111,349,65.19337016574586,61.32596685082873
38747_terrestrial,145,149,92,91,294,63.44827586206897,62.758620689655174
38748_terrestrial,158,202,105,86,360,66.45569620253164,54.43037974683544
38749_terrestrial,293,394,160,175,687,54.60750853242321,59.72696245733788
38750_terrestrial,918,607,602,490,1525,65.57734204793029,53.37690631808278
38823_terrestrial,788,461,481,455,1249,61.04060913705583,57.74111675126904
38824_terrestrial,794,530,473,467,1324,59.57178841309824,58.816120906801004
38825_terrestrial,281,303,96,240,584,34.16370106761566,85.40925266903915
38826_terrestrial,237,265,69,210,502,29.11392405063291,88.60759493670885
38827_terrestrial,216,233,56,194,449,25.925925925925924,89.81481481481481
38828_terrestrial,224,228,63,199,452,28.125,88.83928571428571
38829_terrestrial,223,235,67,198,458,30.04484304932735,88.78923766816143
38830_terrestrial,210,214,63,189,424,30,90
38831_terrestrial,187,197,46,171,384,24.598930481283425,91.44385026737967
38832_terrestrial,186,183,44,172,369,23.655913978494624,92.47311827956989
38833_terrestrial,186,167,49,170,353,26.344086021505376,91.39784946236558
38834_terrestrial,183,173,48,167,356,26.229508196721312,91.2568306010929
38835_terrestrial,184,179,49,168,363,26.6304347826087,91.30434782608695
38836_terrestrial,198,205,48,184,403,24.242424242424242,92.92929292929293
38837_terrestrial,226,255,59,204,481,26.10619469026549,90.2654867256637
38838_terrestrial,246,278,77,213,524,31.300813008130078,86.58536585365853
38839_terrestrial,271,262,93,226,533,34.31734317343174,83.39483394833948
38840_terrestrial,637,489,362,357,1126,56.828885400313965,56.043956043956044
38841_terrestrial,641,475,370,360,1116,57.72230889235569,56.16224648985959
38842_terrestrial,278,218,108,228,496,38.84892086330935,82.01438848920863
38843_terrestrial,261,203,87,221,464,33.33333333333333,84.67432950191571
38844_terrestrial,251,212,72,223,463,28.68525896414343,88.84462151394422
38845_terrestrial,331,322,102,289,653,30.815709969788518,87.31117824773413
38846_terrestrial,1258,862,696,811,2120,55.325914149443555,64.46740858505564
38847_terrestrial,1233,775,694,787,2008,56.285482562854824,63.82806163828062
38990_terrestrial,278,244,184,117,522,66.18705035971223,42.086330935251794
38991_terrestrial,145,186,56,113,331,38.62068965517241,77.93103448275862
38992_terrestrial,96,140,42,70,236,43.75,72.91666666666666
38993_terrestrial,104,158,48,77,262,46.15384615384615,74.03846153846155
38994_terrestrial,139,240,55,106,379,39.568345323741006,76.2589928057554
38995_terrestrial,180,393,57,139,573,31.666666666666664,77.22222222222223
38996_terrestrial,303,609,100,246,912,33.003300330033,81.1881188118812
38997_terrestrial,400,638,151,323,1038,37.75,80.75
38998_terrestrial,371,490,149,294,861,40.16172506738545,79.24528301886792
38999_terrestrial,363,429,137,289,792,37.74104683195592,79.61432506887053
39000_terrestrial,367,417,136,294,784,37.05722070844686,80.10899182561307
39001_terrestrial,361,415,136,288,776,37.67313019390582,79.77839335180056
39002_terrestrial,372,435,143,296,807,38.44086021505376,79.56989247311827
39003_terrestrial,393,484,150,312,877,38.16793893129771,79.38931297709924
39004_terrestrial,391,479,153,315,870,39.130434782608695,80.56265984654732
39005_terrestrial,383,464,151,313,847,39.425587467362924,81.72323759791122
39006_terrestrial,366,460,139,302,826,37.97814207650273,82.5136612021858
39007_terrestrial,353,450,134,289,803,37.960339943342774,81.86968838526913
39008_terrestrial,358,454,136,292,812,37.988826815642454,81.56424581005587
39009_terrestrial,349,453,134,288,802,38.39541547277937,82.52148997134671
39010_terrestrial,345,473,131,288,818,37.971014492753625,83.47826086956522
39011_terrestrial,344,488,129,288,832,37.5,83.72093023255815
39012_terrestrial,345,515,131,285,860,37.971014492753625,82.6086956521739
39013_terrestrial,355,511,136,291,866,38.309859154929576,81.97183098591549
39014_terrestrial,351,517,134,289,868,38.17663817663818,82.33618233618233
39015_terrestrial,352,513,135,290,865,38.35227272727273,82.38636363636364
39016_terrestrial,366,555,135,300,921,36.885245901639344,81.9672131147541
39017_terrestrial,374,613,137,303,987,36.63101604278075,81.01604278074866
39018_terrestrial,367,610,133,301,977,36.23978201634878,82.01634877384197
39019_terrestrial,374,582,130,312,956,34.75935828877005,83.42245989304813
39020_terrestrial,398,638,144,323,1036,36.18090452261307,81.15577889447236
39021_terrestrial,677,737,393,389,1414,58.050221565731164,57.459379615952734
39072_terrestrial,308,138,212,142,446,68.83116883116884,46.103896103896105
39073_terrestrial,391,231,250,186,622,63.9386189258312,47.570332480818415
39074_terrestrial,319,207,150,220,526,47.02194357366771,68.96551724137932
39075_terrestrial,332,224,144,238,556,43.373493975903614,71.6867469879518
39076_terrestrial,380,241,174,261,621,45.78947368421053,68.6842105263158
39077_terrestrial,382,230,169,275,612,44.24083769633508,71.98952879581152
39078_terrestrial,384,242,173,274,626,45.05208333333333,71.35416666666666
39079_terrestrial,394,256,195,275,650,49.49238578680203,69.79695431472082
39080_terrestrial,420,274,212,285,694,50.476190476190474,67.85714285714286
39081_terrestrial,451,317,214,309,768,47.45011086474501,68.51441241685144
39082_terrestrial,481,349,233,326,830,48.44074844074844,67.77546777546777
39083_terrestrial,492,351,234,334,843,47.5609756097561,67.88617886178862
39084_terrestrial,499,345,239,341,844,47.89579158316633,68.33667334669339
39085_terrestrial,512,355,243,348,867,47.4609375,67.96875
39086_terrestrial,536,387,255,358,923,47.57462686567165,66.7910447761194
39087_terrestrial,529,403,249,356,932,47.06994328922495,67.29678638941398
39088_terrestrial,495,372,221,343,867,44.64646464646464,69.2929292929293
39089_terrestrial,467,352,205,330,819,43.897216274089935,70.66381156316916
39090_terrestrial,455,360,199,327,815,43.73626373626374,71.86813186813187
39091_terrestrial,470,392,206,334,862,43.829787234042556,71.06382978723404
39092_terrestrial,481,415,212,347,896,44.07484407484408,72.14137214137214
39093_terrestrial,534,500,236,380,1034,44.19475655430712,71.16104868913857
39094_terrestrial,535,464,245,368,999,45.794392523364486,68.78504672897196
39095_terrestrial,530,407,255,353,937,48.113207547169814,66.60377358490565
39096_terrestrial,1166,553,713,679,1719,61.1492281303602,58.23327615780446
39097_terrestrial,1128,511,703,648,1639,62.322695035460995,57.446808510638306
39105_terrestrial,852,428,583,457,1280,68.42723004694837,53.63849765258216
39106_terrestrial,166,177,100,111,343,60.24096385542169,66.86746987951807
39107_terrestrial,120,106,75,77,226,62.5,64.16666666666667
39108_terrestrial,196,336,109,118,532,55.61224489795919,60.204081632653065
39109_terrestrial,291,516,149,183,807,51.20274914089347,62.88659793814433
39110_terrestrial,888,560,587,474,1448,66.1036036036036,53.37837837837838
39182_terrestrial,723,420,447,414,1143,61.82572614107884,57.26141078838174
39183_terrestrial,785,471,471,463,1256,60,58.98089171974522
39184_terrestrial,254,236,80,226,490,31.496062992125985,88.9763779527559
39185_terrestrial,244,224,75,216,468,30.737704918032787,88.52459016393442
39186_terrestrial,213,207,58,191,420,27.230046948356808,89.67136150234741
39187_terrestrial,204,194,59,181,398,28.921568627450984,88.72549019607843
39188_terrestrial,199,186,57,177,385,28.643216080402013,88.94472361809045
39189_terrestrial,202,191,58,181,393,28.71287128712871,89.60396039603961
39190_terrestrial,183,175,47,167,358,25.683060109289617,91.2568306010929
39191_terrestrial,170,159,46,154,329,27.058823529411764,90.58823529411765
39192_terrestrial,154,155,40,140,309,25.97402597402597,90.9090909090909
39193_terrestrial,163,156,41,148,319,25.153374233128833,90.79754601226993
39194_terrestrial,173,168,44,157,341,25.43352601156069,90.7514450867052
39195_terrestrial,178,171,47,162,349,26.40449438202247,91.01123595505618
39196_terrestrial,178,171,48,163,349,26.96629213483146,91.57303370786516
39197_terrestrial,190,195,48,176,385,25.263157894736842,92.63157894736842
39198_terrestrial,225,225,57,208,450,25.333333333333336,92.44444444444444
39199_terrestrial,243,248,69,222,491,28.39506172839506,91.35802469135803
39200_terrestrial,257,248,72,232,505,28.01556420233463,90.27237354085604
39201_terrestrial,272,242,92,234,514,33.82352941176471,86.02941176470588
39202_terrestrial,238,198,73,215,436,30.672268907563026,90.33613445378151
39203_terrestrial,234,174,67,212,408,28.63247863247863,90.5982905982906
39204_terrestrial,242,203,69,216,445,28.512396694214875,89.25619834710744
39205_terrestrial,305,295,85,272,600,27.86885245901639,89.18032786885246
39206_terrestrial,383,477,128,318,860,33.420365535248045,83.02872062663185
39207_terrestrial,1241,824,694,797,2065,55.922643029814665,64.22240128928284
39351_terrestrial,119,129,47,98,248,39.49579831932773,82.35294117647058
39352_terrestrial,89,117,37,67,206,41.57303370786517,75.28089887640449
39353_terrestrial,83,114,37,62,197,44.57831325301205,74.69879518072288
39354_terrestrial,117,165,50,88,282,42.73504273504273,75.21367521367522
39355_terrestrial,144,254,51,113,398,35.41666666666667,78.47222222222221
39356_terrestrial,246,453,80,197,699,32.52032520325203,80.08130081300813
39357_terrestrial,325,481,119,262,806,36.61538461538461,80.61538461538461
39358_terrestrial,311,387,122,246,698,39.228295819935695,79.09967845659163
39359_terrestrial,323,364,124,252,687,38.39009287925697,78.0185758513932
39360_terrestrial,321,355,123,249,676,38.31775700934579,77.57009345794393
39361_terrestrial,334,373,128,262,707,38.32335329341318,78.44311377245509
39362_terrestrial,375,452,145,295,827,38.666666666666664,78.66666666666666
39363_terrestrial,391,479,150,309,870,38.36317135549872,79.02813299232737
39364_terrestrial,382,474,151,306,856,39.52879581151832,80.10471204188482
39365_terrestrial,383,461,152,308,844,39.686684073107045,80.4177545691906
39366_terrestrial,360,455,135,297,815,37.5,82.5
39367_terrestrial,345,435,130,286,780,37.68115942028986,82.89855072463767
39368_terrestrial,353,433,135,290,786,38.243626062322946,82.15297450424929
39369_terrestrial,355,464,132,294,819,37.183098591549296,82.8169014084507
39370_terrestrial,352,487,135,293,839,38.35227272727273,83.23863636363636
39371_terrestrial,355,480,135,297,835,38.028169014084504,83.66197183098592
39372_terrestrial,356,506,134,294,862,37.640449438202246,82.58426966292134
39373_terrestrial,366,543,136,302,909,37.15846994535519,82.5136612021858
39374_terrestrial,365,539,136,300,904,37.26027397260274,82.1917808219178
39375_terrestrial,379,555,144,309,934,37.994722955145114,81.53034300791556
39376_terrestrial,380,623,139,309,1003,36.578947368421055,81.3157894736842
39377_terrestrial,389,727,140,316,1116,35.98971722365039,81.23393316195373
39378_terrestrial,387,682,140,319,1069,36.17571059431525,82.42894056847545
39379_terrestrial,391,701,139,327,1092,35.54987212276215,83.63171355498721
39380_terrestrial,720,901,407,427,1621,56.52777777777778,59.30555555555556
39381_terrestrial,682,722,400,394,1404,58.65102639296188,57.77126099706745
39433_terrestrial,345,188,226,164,533,65.5072463768116,47.53623188405797
39434_terrestrial,405,259,249,206,664,61.48148148148148,50.864197530864196
39435_terrestrial,317,206,141,221,523,44.479495268138805,69.71608832807571
39436_terrestrial,336,228,145,237,564,43.154761904761905,70.53571428571429
39437_terrestrial,358,229,152,257,587,42.45810055865922,71.7877094972067
39438_terrestrial,357,229,148,260,586,41.45658263305322,72.82913165266106
39439_terrestrial,342,212,149,251,554,43.567251461988306,73.39181286549707
39440_terrestrial,339,199,163,241,538,48.08259587020649,71.09144542772862
39441_terrestrial,364,230,170,259,594,46.7032967032967,71.15384615384616
39442_terrestrial,422,287,189,303,709,44.78672985781991,71.80094786729858
39443_terrestrial,480,333,232,324,813,48.333333333333336,67.5
39444_terrestrial,483,335,235,325,818,48.65424430641822,67.28778467908903
39445_terrestrial,469,322,233,312,791,49.68017057569296,66.52452025586354
39446_terrestrial,460,312,226,312,772,49.130434782608695,67.82608695652173
39447_terrestrial,455,327,207,314,782,45.494505494505496,69.01098901098901
39448_terrestrial,481,347,218,327,828,45.32224532224532,67.98336798336798
39449_terrestrial,473,364,210,328,837,44.397463002114165,69.3446088794926
39450_terrestrial,465,377,210,326,842,45.16129032258064,70.10752688172043
39451_terrestrial,467,377,205,335,844,43.897216274089935,71.73447537473233
39452_terrestrial,483,415,213,346,898,44.099378881987576,71.635610766045545
39453_terrestrial,548,500,240,386,1048,43.79562043795621,70.43795620437956
39454_terrestrial,534,486,252,364,1020,47.19101123595505,68.16479400749064
39455_terrestrial,1182,626,726,683,1808,61.42131979695431,57.7834179357022
39456_terrestrial,1151,538,710,667,1689,61.68549087749783,57.949609035621194
39465_terrestrial,862,458,594,458,1320,68.90951276102089,53.1322505800464
39466_terrestrial,182,163,119,113,345,65.38461538461539,62.08791208791209
39467_terrestrial,131,128,78,87,259,59.541984732824424,66.41221374045801
39468_terrestrial,244,402,133,152,646,54.50819672131148,62.295081967213115
39469_terrestrial,911,668,597,486,1579,65.5323819978046,53.34796926454446
39470_terrestrial,780,339,525,425,1119,67.3076923076923,54.48717948717948
39478_terrestrial,667,237,431,376,904,64.61769115442279,56.37181409295352
39540_terrestrial,793,418,498,463,1211,62.79949558638083,58.38587641866331
39541_terrestrial,778,412,490,453,1190,62.98200514138818,58.22622107969152
39542_terrestrial,789,447,500,457,1236,63.37135614702155,57.92141951837769
39543_terrestrial,213,175,76,184,388,35.68075117370892,86.3849765258216
39544_terrestrial,174,157,51,158,331,29.310344827586203,90.80459770114942
39545_terrestrial,173,150,48,158,323,27.74566473988439,91.32947976878613
39546_terrestrial,182,144,54,165,326,29.67032967032967,90.65934065934066
39547_terrestrial,186,151,51,171,337,27.419354838709676,91.93548387096774
39548_terrestrial,190,157,51,176,347,26.842105263157894,92.63157894736842
39549_terrestrial,185,163,48,172,348,25.945945945945947,92.97297297297298
39550_terrestrial,175,163,44,163,338,25.142857142857146,93.14285714285714
39551_terrestrial,160,160,42,148,320,26.25,92.5
39552_terrestrial,147,152,38,137,299,25.850340136054424,93.19727891156462
39553_terrestrial,148,146,37,135,294,25,91.21621621621621
39554_terrestrial,162,157,43,148,319,26.543209876543212,91.35802469135803
39555_terrestrial,172,164,46,158,336,26.744186046511626,91.86046511627907
39556_terrestrial,165,159,42,152,324,25.454545454545453,92.12121212121212
39557_terrestrial,170,158,41,158,328,24.11764705882353,92.94117647058823
39558_terrestrial,197,203,47,185,400,23.85786802030457,93.90862944162437
39559_terrestrial,228,216,55,213,444,24.12280701754386,93.42105263157895
39560_terrestrial,242,203,63,225,445,26.033057851239672,92.97520661157024
39561_terrestrial,228,194,61,211,422,26.75438596491228,92.54385964912281
39562_terrestrial,210,173,54,193,383,25.71428571428571,91.9047619047619
39563_terrestrial,208,170,57,186,378,27.403846153846157,89.42307692307693
39564_terrestrial,235,202,64,211,437,27.23404255319149,89.7872340425532
39565_terrestrial,267,255,70,242,522,26.217228464419474,90.63670411985018
39566_terrestrial,341,361,102,300,702,29.91202346041056,87.97653958944281
39567_terrestrial,1195,795,660,779,1990,55.23012552301255,65.18828451882845
39568_terrestrial,1163,705,651,753,1868,55.97592433361995,64.7463456577816
39569_terrestrial,1123,622,635,726,1745,56.54496883348175,64.64826357969724
39711_terrestrial,90,112,35,77,202,38.88888888888889,85.55555555555556
39712_terrestrial,78,112,32,62,190,41.02564102564102,79.48717948717949
39713_terrestrial,75,99,31,59,174,41.333333333333336,78.66666666666666
39714_terrestrial,98,142,42,76,240,42.857142857142854,77.55102040816327
39715_terrestrial,129,227,47,103,356,36.434108527131784,79.84496124031007
39716_terrestrial,271,453,87,222,724,32.10332103321033,81.91881918819189
39717_terrestrial,314,431,121,250,745,38.53503184713376,79.61783439490446
39718_terrestrial,300,353,117,235,653,39,78.33333333333333
39719_terrestrial,290,318,114,223,608,39.310344827586206,76.89655172413794
39720_terrestrial,301,311,118,235,612,39.202657807308974,78.07308970099668
39721_terrestrial,310,328,119,244,638,38.387096774193544,78.70967741935485
39722_terrestrial,364,390,144,285,754,39.56043956043956,78.2967032967033
39723_terrestrial,370,450,150,292,820,40.54054054054054,78.91891891891892
39724_terrestrial,374,456,150,298,830,40.106951871657756,79.67914438502673
39725_terrestrial,369,460,143,298,829,38.75338753387534,80.75880758807588
39726_terrestrial,358,444,138,295,802,38.547486033519554,82.40223463687151
39727_terrestrial,349,438,134,286,787,38.39541547277937,81.9484240687679
39728_terrestrial,362,451,139,298,813,38.39779005524862,82.32044198895028
39729_terrestrial,368,487,139,306,855,37.77173913043478,83.15217391304348
39730_terrestrial,364,497,137,301,861,37.637362637362635,82.6923076923077
39731_terrestrial,367,500,140,304,867,38.14713896457766,82.83378746594006
39732_terrestrial,372,524,137,312,896,36.82795698924731,83.87096774193549
39733_terrestrial,382,562,140,316,944,36.64921465968586,82.72251308900523
39734_terrestrial,380,598,142,309,978,37.368421052631575,81.3157894736842
39735_terrestrial,386,606,145,315,992,37.56476683937824,81.60621761658031
39736_terrestrial,383,647,138,317,1030,36.0313315926893,82.76762402088774
39737_terrestrial,392,746,138,323,1138,35.204081632653065,82.39795918367348
39738_terrestrial,387,716,138,324,1103,35.65891472868217,83.72093023255815
39739_terrestrial,416,759,152,341,1175,36.53846153846153,81.97115384615384
39740_terrestrial,708,862,404,414,1570,57.06214689265536,58.47457627118644
39794_terrestrial,363,219,230,170,582,63.36088154269972,46.83195592286501
39795_terrestrial,291,197,133,202,488,45.70446735395189,69.41580756013745
39796_terrestrial,315,213,136,222,528,43.17460317460318,70.47619047619048
39797_terrestrial,336,221,140,243,557,41.66666666666667,72.32142857142857
39798_terrestrial,345,216,145,250,561,42.028985507246375,72.46376811594203
39799_terrestrial,311,190,140,226,501,45.01607717041801,72.66881028938906
39800_terrestrial,291,163,133,214,454,45.70446735395189,73.53951890034365
39801_terrestrial,307,173,140,221,480,45.60260586319218,71.9869706840391
39802_terrestrial,340,196,161,236,536,47.35294117647059,69.41176470588235
39803_terrestrial,444,265,218,291,709,49.0990990990991,65.54054054054053
39804_terrestrial,456,287,232,300,743,50.877192982456144,65.78947368421053
39805_terrestrial,427,260,212,291,687,49.64871194379391,68.14988290398126
39806_terrestrial,400,237,189,276,637,47.25,69
39807_terrestrial,412,262,190,292,674,46.116504854368934,70.87378640776699
39808_terrestrial,458,328,201,323,786,43.88646288209607,70.52401746724891
39809_terrestrial,471,353,207,330,824,43.94904458598726,70.06369426751591
39810_terrestrial,476,366,210,332,842,44.11764705882353,69.74789915966386
39811_terrestrial,473,381,208,332,854,43.97463002114165,70.19027484143763
39812_terrestrial,526,416,235,357,942,44.67680608365019,67.87072243346007
39813_terrestrial,576,489,263,387,1065,45.65972222222222,67.1875
39814_terrestrial,517,441,243,353,958,47.00193423597679,68.27852998065764
39815_terrestrial,1150,585,712,664,1735,61.91304347826087,57.7391304347826
39816_terrestrial,1034,467,640,607,1501,61.89555125725339,58.70406189555126
39824_terrestrial,819,372,562,440,1191,68.62026862026862,53.724053724053725
39825_terrestrial,851,416,587,452,1267,68.97767332549941,53.11398354876615
39826_terrestrial,183,160,114,111,343,62.295081967213115,60.65573770491803
39827_terrestrial,139,146,74,96,285,53.23741007194245,69.06474820143885
39828_terrestrial,258,457,140,159,715,54.263565891472865,61.627906976744185
39829_terrestrial,822,512,554,439,1334,67.39659367396594,53.406326034063255
39836_terrestrial,647,205,428,360,852,66.15146831530139,55.641421947449764
39838_terrestrial,682,244,444,384,926,65.10263929618768,56.30498533724341
39900_terrestrial,810,467,506,477,1277,62.46913580246913,58.88888888888889
39901_terrestrial,227,208,75,194,435,33.03964757709251,85.46255506607929
39902_terrestrial,209,173,66,185,382,31.57894736842105,88.51674641148325
39903_terrestrial,159,144,51,142,303,32.075471698113205,89.30817610062893
39904_terrestrial,131,121,38,121,252,29.00763358778626,92.36641221374046
39905_terrestrial,130,115,38,121,245,29.230769230769234,93.07692307692308
39906_terrestrial,147,116,40,136,263,27.2108843537415,92.51700680272108
39907_terrestrial,159,120,46,145,279,28.930817610062892,91.19496855345912
39908_terrestrial,163,132,45,149,295,27.607361963190186,91.41104294478528
39909_terrestrial,170,146,47,156,316,27.647058823529413,91.76470588235294
39910_terrestrial,163,158,42,150,321,25.766871165644172,92.02453987730061
39911_terrestrial,160,153,42,147,313,26.25,91.875
39912_terrestrial,148,146,38,137,294,25.675675675675674,92.56756756756756
39913_terrestrial,150,146,34,137,296,22.666666666666664,91.33333333333333
39914_terrestrial,149,152,32,138,301,21.476510067114095,92.61744966442953
39915_terrestrial,163,161,42,151,324,25.766871165644172,92.63803680981594
39916_terrestrial,166,156,42,154,322,25.301204819277107,92.7710843373494
39917_terrestrial,167,152,40,154,319,23.952095808383234,92.21556886227546
39918_terrestrial,184,160,43,171,344,23.369565217391305,92.93478260869566
39919_terrestrial,216,191,57,201,407,26.38888888888889,93.05555555555556
39920_terrestrial,228,195,61,212,423,26.75438596491228,92.98245614035088
39921_terrestrial,231,181,62,215,412,26.83982683982684,93.07359307359307
39922_terrestrial,207,164,52,190,371,25.120772946859905,91.78743961352657
39923_terrestrial,192,161,47,173,353,24.479166666666664,90.10416666666666
39924_terrestrial,218,190,56,196,408,25.688073394495415,89.90825688073394
39925_terrestrial,249,241,64,226,490,25.702811244979916,90.76305220883533
39926_terrestrial,272,267,68,245,539,25,90.07352941176471
39927_terrestrial,316,310,96,279,626,30.37974683544304,88.29113924050634
39928_terrestrial,341,329,114,293,670,33.43108504398827,85.92375366568915
39929_terrestrial,1170,716,655,754,1886,55.98290598290598,64.44444444444444
39930_terrestrial,1125,652,637,727,1777,56.62222222222222,64.62222222222222
40072_terrestrial,77,115,36,58,192,46.75324675324675,75.32467532467533
40073_terrestrial,79,101,36,60,180,45.56962025316456,75.9493670886076
40074_terrestrial,104,141,43,79,245,41.34615384615385,75.96153846153845
40075_terrestrial,150,252,56,116,402,37.333333333333336,77.33333333333333
40076_terrestrial,299,470,104,241,769,34.78260869565217,80.60200668896321
40077_terrestrial,316,424,124,251,740,39.24050632911392,79.43037974683544
40078_terrestrial,293,348,117,226,641,39.93174061433447,77.13310580204778
40079_terrestrial,278,307,112,215,585,40.28776978417266,77.33812949640287
40080_terrestrial,299,319,121,233,618,40.468227424749166,77.92642140468227
40081_terrestrial,316,332,125,250,648,39.55696202531646,79.11392405063292
40082_terrestrial,356,372,145,280,728,40.73033707865169,78.65168539325843
40083_terrestrial,372,424,151,294,796,40.59139784946236,79.03225806451613
40084_terrestrial,376,438,150,301,814,39.8936170212766,80.0531914893617
40085_terrestrial,365,455,142,298,820,38.9041095890411,81.64383561643835
40086_terrestrial,356,441,134,294,797,37.640449438202246,82.58426966292134
40087_terrestrial,360,451,138,297,811,38.333333333333336,82.5
40088_terrestrial,378,491,150,308,869,39.682539682539684,81.48148148148148
40089_terrestrial,373,501,144,307,874,38.605898123324394,82.30563002680965
40090_terrestrial,367,510,133,305,877,36.23978201634878,83.10626702997274
40091_terrestrial,372,532,137,306,904,36.82795698924731,82.25806451612904
40092_terrestrial,370,564,131,308,934,35.4054054054054,83.24324324324324
40093_terrestrial,372,605,133,306,977,35.752688172043015,82.25806451612904
40094_terrestrial,385,647,137,315,1032,35.58441558441559,81.81818181818183
40095_terrestrial,387,664,141,315,1051,36.434108527131784,81.3953488372093
40096_terrestrial,387,732,137,322,1119,35.400516795865634,83.20413436692506
40097_terrestrial,399,785,144,332,1184,36.09022556390977,83.20802005012531
40098_terrestrial,406,794,147,337,1200,36.206896551724135,83.00492610837439
40099_terrestrial,735,945,423,428,1680,57.55102040816327,58.23129251700681
40100_terrestrial,690,754,405,392,1444,58.69565217391305,56.811594202898554
40154_terrestrial,320,174,212,147,494,66.25,45.9375
40155_terrestrial,377,253,234,182,630,62.06896551724138,48.275862068965516
40156_terrestrial,295,201,133,209,496,45.08474576271186,70.84745762711864
40157_terrestrial,317,209,136,229,526,42.90220820189275,72.2397476340694
40158_terrestrial,313,200,136,226,513,43.45047923322684,72.20447284345049
40159_terrestrial,290,180,132,212,470,45.51724137931035,73.10344827586206
40160_terrestrial,272,152,126,198,424,46.32352941176471,72.79411764705883
40161_terrestrial,249,141,116,177,390,46.58634538152611,71.08433734939759
40162_terrestrial,264,139,120,187,403,45.45454545454545,70.83333333333334
40163_terrestrial,272,163,117,193,435,43.01470588235294,70.95588235294117
40164_terrestrial,289,173,129,208,462,44.636678200692046,71.97231833910035
40165_terrestrial,326,201,157,230,527,48.15950920245399,70.5521472392638
40166_terrestrial,343,211,159,253,554,46.35568513119534,73.76093294460642
40167_terrestrial,391,246,181,286,637,46.29156010230179,73.1457800511509
40168_terrestrial,414,279,178,304,693,42.99516908212561,73.42995169082126
40169_terrestrial,461,326,207,323,787,44.90238611713666,70.06507592190889
40170_terrestrial,481,362,216,330,843,44.90644490644491,68.60706860706861
40171_terrestrial,495,377,226,341,872,45.656565656565654,68.88888888888889
40172_terrestrial,526,399,244,350,925,46.38783269961977,66.53992395437263
40173_terrestrial,522,392,246,341,914,47.12643678160919,65.32567049808429
40174_terrestrial,442,322,208,300,764,47.05882352941176,67.87330316742081
40175_terrestrial,1086,504,659,641,1590,60.68139963167587,59.02394106813996
40176_terrestrial,1071,495,661,625,1566,61.718020541549954,58.35667600373483
40184_terrestrial,861,406,592,457,1267,68.75725900116144,53.07781649245064
40185_terrestrial,199,193,129,115,392,64.82412060301507,57.78894472361809
40186_terrestrial,150,143,94,89,293,62.66666666666667,59.333333333333336
40187_terrestrial,157,256,93,97,413,59.23566878980891,61.78343949044586
40188_terrestrial,273,522,152,165,795,55.67765567765568,60.43956043956044
40189_terrestrial,792,386,535,428,1178,67.55050505050505,54.04040404040404
40196_terrestrial,642,205,423,360,847,65.88785046728972,56.074766355140184
40269_terrestrial,145,128,40,132,273,27.586206896551722,91.0344827586207
40270_terrestrial,154,147,41,141,301,26.623376623376622,91.55844155844156
40271_terrestrial,157,157,41,144,314,26.11464968152866,91.71974522292994
40272_terrestrial,158,162,38,146,320,24.050632911392405,92.40506329113924
40273_terrestrial,162,164,36,148,326,22.22222222222222,91.35802469135803
40274_terrestrial,158,161,34,147,319,21.518987341772153,93.0379746835443
40275_terrestrial,165,154,37,152,319,22.424242424242426,92.12121212121212
40276_terrestrial,162,150,37,149,312,22.839506172839506,91.9753086419753
40277_terrestrial,164,146,37,153,310,22.5609756097561,93.29268292682927
40278_terrestrial,171,150,41,160,321,23.976608187134502,93.56725146198829
40279_terrestrial,198,160,49,184,358,24.747474747474747,92.92929292929293
40280_terrestrial,216,180,60,198,396,27.77777777777778,91.66666666666666
40281_terrestrial,221,177,60,203,398,27.149321266968325,91.8552036199095
40282_terrestrial,200,155,46,184,355,23,92
40283_terrestrial,196,158,46,176,354,23.46938775510204,89.79591836734694
40284_terrestrial,203,172,47,183,375,23.15270935960591,90.14778325123153
40285_terrestrial,224,207,57,203,431,25.44642857142857,90.625
40286_terrestrial,237,237,57,214,474,24.050632911392405,90.29535864978902
40287_terrestrial,248,245,61,221,493,24.596774193548388,89.11290322580645
40288_terrestrial,283,292,78,251,575,27.56183745583039,88.69257950530034
40289_terrestrial,340,350,115,289,690,33.82352941176471,85
40290_terrestrial,1129,672,629,741,1801,55.713020372010625,65.63330380868024
40432_terrestrial,75,106,34,58,181,45.33333333333333,77.33333333333333
40433_terrestrial,83,111,39,64,194,46.98795180722892,77.10843373493977
40434_terrestrial,108,143,45,83,251,41.66666666666667,76.85185185185185
40435_terrestrial,168,329,60,135,497,35.714285714285715,80.35714285714286
40436_terrestrial,342,515,121,271,857,35.38011695906433,79.23976608187134
40437_terrestrial,327,416,127,255,743,38.837920489296636,77.98165137614679
40438_terrestrial,290,345,118,215,635,40.689655172413794,74.13793103448276
40439_terrestrial,285,308,119,214,593,41.75438596491228,75.08771929824562
40440_terrestrial,304,316,120,238,620,39.473684210526315,78.28947368421053
40441_terrestrial,319,345,124,254,664,38.87147335423197,79.62382445141067
40442_terrestrial,359,377,143,286,736,39.83286908077994,79.66573816155989
40443_terrestrial,382,438,155,299,820,40.575916230366495,78.27225130890052
40444_terrestrial,395,455,155,315,850,39.24050632911392,79.74683544303798
40445_terrestrial,377,461,145,305,838,38.46153846153847,80.90185676392572
40446_terrestrial,369,451,140,302,820,37.94037940379404,81.84281842818429
40447_terrestrial,378,490,148,306,868,39.15343915343915,80.95238095238095
40448_terrestrial,380,508,148,309,888,38.94736842105263,81.3157894736842
40449_terrestrial,369,502,140,302,871,37.94037940379404,81.84281842818429
40450_terrestrial,362,537,133,299,899,36.74033149171271,82.59668508287292
40451_terrestrial,371,566,132,307,937,35.57951482479784,82.74932614555256
40452_terrestrial,382,635,134,316,1017,35.07853403141361,82.72251308900523
40453_terrestrial,395,679,137,327,1074,34.68354430379747,82.78481012658227
40454_terrestrial,408,794,142,339,1202,34.80392156862745,83.08823529411765
40455_terrestrial,426,862,151,354,1288,35.44600938967136,83.09859154929578
40456_terrestrial,737,1123,408,444,1860,55.359565807327,60.24423337856174
40457_terrestrial,751,1122,420,448,1873,55.9254327563249,59.6537949400799
40458_terrestrial,748,1055,432,436,1803,57.75401069518716,58.288770053475936
40459_terrestrial,707,875,409,410,1582,57.85007072135785,57.991513437057996
40515_terrestrial,357,243,228,170,600,63.86554621848739,47.61904761904761
40516_terrestrial,287,191,134,204,478,46.68989547038328,71.0801393728223
40517_terrestrial,303,193,135,216,496,44.554455445544555,71.28712871287128
40518_terrestrial,303,193,137,218,496,45.21452145214521,71.94719471947195
40519_terrestrial,289,168,131,208,457,45.32871972318339,71.97231833910035
40520_terrestrial,254,136,116,184,390,45.66929133858268,72.44094488188976
40521_terrestrial,233,126,103,164,359,44.20600858369099,70.3862660944206
40522_terrestrial,223,122,96,154,345,43.04932735426009,69.05829596412556
40523_terrestrial,219,125,99,149,344,45.20547945205479,68.0365296803653
40524_terrestrial,225,140,101,158,365,44.888888888888886,70.22222222222221
40525_terrestrial,259,149,125,180,408,48.26254826254826,69.4980694980695
40526_terrestrial,308,188,145,219,496,47.07792207792208,71.1038961038961
40527_terrestrial,377,229,175,272,606,46.41909814323608,72.14854111405835
40528_terrestrial,425,266,192,298,691,45.1764705882353,70.11764705882354
40529_terrestrial,476,339,218,326,815,45.79831932773109,68.4873949579832
40530_terrestrial,533,435,236,371,968,44.27767354596623,69.60600375234522
40531_terrestrial,553,464,248,377,1017,44.846292947558766,68.1735985533454
40532_terrestrial,522,435,239,351,957,45.785440613026815,67.24137931034483
40533_terrestrial,451,310,213,306,761,47.22838137472284,67.84922394678492
40534_terrestrial,405,252,184,279,657,45.4320987654321,68.88888888888889
40535_terrestrial,407,255,190,283,662,46.68304668304668,69.53316953316954
40536_terrestrial,1064,499,657,619,1563,61.74812030075187,58.1766917293233
40544_terrestrial,859,417,586,460,1276,68.21885913853319,53.55064027939464
40545_terrestrial,190,206,119,116,396,62.63157894736842,61.05263157894737
40546_terrestrial,154,174,89,99,328,57.7922077922078,64.28571428571429
40547_terrestrial,222,404,128,132,626,57.65765765765766,59.45945945945946
40548_terrestrial,904,638,603,475,1542,66.70353982300885,52.54424778761062
40549_terrestrial,781,315,530,422,1096,67.8617157490397,54.03329065300896
40630_terrestrial,138,145,30,128,283,21.73913043478261,92.7536231884058
40631_terrestrial,155,155,36,143,310,23.225806451612904,92.25806451612904
40632_terrestrial,165,172,37,153,337,22.424242424242426,92.72727272727272
40633_terrestrial,183,176,45,169,359,24.59016393442623,92.34972677595628
40634_terrestrial,193,181,53,173,374,27.461139896373055,89.63730569948186
40635_terrestrial,183,174,49,164,357,26.775956284153008,89.61748633879782
40636_terrestrial,176,164,41,162,340,23.295454545454543,92.04545454545455
40637_terrestrial,167,141,39,155,308,23.353293413173652,92.81437125748504
40638_terrestrial,167,142,38,156,309,22.75449101796407,93.41317365269461
40639_terrestrial,185,140,46,171,325,24.864864864864867,92.43243243243244
40640_terrestrial,200,154,51,186,354,25.5,93
40641_terrestrial,198,156,49,183,354,24.747474747474747,92.42424242424242
40642_terrestrial,193,160,43,177,353,22.279792746113987,91.70984455958549
40643_terrestrial,198,161,46,179,359,23.232323232323232,90.40404040404042
40644_terrestrial,209,169,50,187,378,23.923444976076556,89.47368421052632
40645_terrestrial,218,183,53,195,401,24.31192660550459,89.44954128440367
40646_terrestrial,228,216,52,207,444,22.807017543859647,90.78947368421053
40647_terrestrial,238,231,59,211,469,24.789915966386555,88.65546218487394
40648_terrestrial,268,269,67,236,537,25,88.05970149253731
40649_terrestrial,312,318,92,276,630,29.48717948717949,88.46153846153845
40650_terrestrial,1132,685,619,744,1817,54.68197879858657,65.7243816254417
40651_terrestrial,1139,668,632,739,1807,55.48726953467954,64.88147497805092
40793_terrestrial,84,96,41,63,180,48.80952380952381,75
40794_terrestrial,114,155,45,87,269,39.473684210526315,76.31578947368422
40795_terrestrial,222,389,84,171,611,37.83783783783784,77.02702702702703
40796_terrestrial,338,513,116,277,851,34.319526627218934,81.95266272189349
40797_terrestrial,305,372,121,241,677,39.67213114754099,79.01639344262294
40798_terrestrial,284,307,123,216,591,43.309859154929576,76.05633802816901
40799_terrestrial,287,298,122,217,585,42.508710801393725,75.60975609756098
40800_terrestrial,307,316,124,238,623,40.390879478827365,77.52442996742671
40801_terrestrial,319,339,126,255,658,39.49843260188088,79.9373040752351
40802_terrestrial,340,364,132,271,704,38.82352941176471,79.70588235294119
40803_terrestrial,371,442,149,292,813,40.16172506738545,78.70619946091644
40804_terrestrial,386,479,150,306,865,38.860103626943,79.27461139896373
40805_terrestrial,401,492,148,329,893,36.907730673316706,82.04488778054862
40806_terrestrial,398,507,150,322,905,37.68844221105528,80.90452261306532
40807_terrestrial,390,501,148,317,891,37.94871794871795,81.28205128205128
40808_terrestrial,368,483,135,303,851,36.684782608695656,82.33695652173914
40809_terrestrial,356,502,132,291,858,37.07865168539326,81.74157303370787
40810_terrestrial,367,548,132,300,915,35.967302452316076,81.74386920980926
40811_terrestrial,378,626,131,313,1004,34.65608465608466,82.8042328042328
40812_terrestrial,405,744,143,331,1149,35.30864197530864,81.72839506172839
40813_terrestrial,437,812,157,356,1249,35.92677345537758,81.46453089244852
40814_terrestrial,710,1043,395,424,1753,55.633802816901415,59.71830985915493
40815_terrestrial,723,1052,409,430,1775,56.56984785615491,59.47441217150761
40816_terrestrial,700,994,405,411,1694,57.85714285714286,58.71428571428572
40817_terrestrial,692,835,402,406,1527,58.092485549132945,58.67052023121387
40875_terrestrial,323,212,213,154,535,65.94427244582043,47.6780185758514
40876_terrestrial,266,174,122,187,440,45.86466165413533,70.30075187969925
40877_terrestrial,282,177,125,204,459,44.32624113475177,72.3404255319149
40878_terrestrial,289,180,127,205,469,43.944636678200695,70.93425605536332
40879_terrestrial,271,146,123,193,417,45.38745387453875,71.21771217712177
40880_terrestrial,239,127,109,172,366,45.60669456066946,71.96652719665272
40881_terrestrial,210,122,90,144,332,42.857142857142854,68.57142857142857
40882_terrestrial,195,115,80,135,310,41.02564102564102,69.23076923076923
40883_terrestrial,206,118,87,141,324,42.23300970873786,68.44660194174757
40884_terrestrial,225,132,99,157,357,44,69.77777777777779
40885_terrestrial,273,154,120,202,427,43.956043956043956,73.992673992674
40886_terrestrial,331,199,142,246,530,42.90030211480362,74.32024169184291
40887_terrestrial,412,249,189,287,661,45.87378640776699,69.66019417475728
40888_terrestrial,462,315,212,316,777,45.887445887445885,68.3982683982684
40889_terrestrial,490,366,226,338,856,46.12244897959184,68.9795918367347
40890_terrestrial,527,445,232,373,972,44.022770398481974,70.77798861480076
40891_terrestrial,545,484,246,376,1029,45.137614678899084,68.9908256880734
40892_terrestrial,513,408,239,341,921,46.588693957115005,66.47173489278752
40893_terrestrial,474,318,223,322,792,47.04641350210971,67.9324894514768
40894_terrestrial,409,240,177,291,649,43.27628361858191,71.14914425427872
40895_terrestrial,418,260,196,294,678,46.889952153110045,70.33492822966507
40896_terrestrial,1070,517,664,624,1587,62.05607476635514,58.3177570093458
40904_terrestrial,866,426,588,457,1292,67.89838337182448,52.771362586605086
40905_terrestrial,190,209,109,123,399,57.36842105263158,64.73684210526316
40906_terrestrial,138,128,79,92,266,57.2463768115942,66.66666666666666
40907_terrestrial,218,379,129,133,597,59.174311926605505,61.00917431192661
40908_terrestrial,857,570,584,448,1427,68.14469078179697,52.275379229871646
40992_terrestrial,172,184,36,160,356,20.930232558139537,93.02325581395348
40993_terrestrial,198,195,53,178,393,26.767676767676768,89.8989898989899
40994_terrestrial,199,192,53,179,391,26.633165829145728,89.9497487437186
40995_terrestrial,197,191,51,177,388,25.888324873096447,89.84771573604061
40996_terrestrial,173,178,38,159,351,21.965317919075144,91.90751445086705
40997_terrestrial,167,149,39,155,316,23.353293413173652,92.81437125748504
40998_terrestrial,166,138,36,155,304,21.686746987951807,93.37349397590361
40999_terrestrial,178,150,40,167,328,22.47191011235955,93.82022471910112
41000_terrestrial,190,155,45,177,345,23.684210526315788,93.15789473684211
41001_terrestrial,189,161,43,177,350,22.75132275132275,93.65079365079364
41002_terrestrial,190,164,40,176,354,21.052631578947366,92.63157894736842
41003_terrestrial,197,162,40,179,359,20.304568527918782,90.86294416243655
41004_terrestrial,211,174,50,189,385,23.696682464454977,89.57345971563981
41005_terrestrial,216,182,52,194,398,24.074074074074073,89.81481481481481
41006_terrestrial,217,206,50,196,423,23.04147465437788,90.32258064516128
41007_terrestrial,243,212,58,218,455,23.868312757201647,89.7119341563786
41008_terrestrial,255,251,63,225,506,24.705882352941178,88.23529411764706
41009_terrestrial,283,293,72,251,576,25.4416961130742,88.69257950530034
41010_terrestrial,319,325,93,279,644,29.153605015673982,87.46081504702194
41011_terrestrial,1118,679,606,742,1797,54.203935599284435,66.3685152057245
41012_terrestrial,1103,648,602,717,1751,54.57842248413418,65.00453309156845
41152_terrestrial,61,79,31,51,140,50.81967213114754,83.60655737704919
41153_terrestrial,83,99,40,64,182,48.19277108433735,77.10843373493977
41154_terrestrial,124,182,51,95,306,41.12903225806452,76.61290322580645
41155_terrestrial,241,417,92,190,658,38.17427385892116,78.83817427385893
41156_terrestrial,321,458,122,253,779,38.006230529595015,78.81619937694704
41157_terrestrial,278,337,115,223,615,41.36690647482014,80.2158273381295
41158_terrestrial,268,278,115,205,546,42.91044776119403,76.49253731343283
41159_terrestrial,271,273,115,211,544,42.435424354243544,77.85977859778598
41160_terrestrial,293,310,122,226,603,41.63822525597269,77.13310580204778
41161_terrestrial,310,336,127,242,646,40.96774193548387,78.06451612903226
41162_terrestrial,335,372,129,271,707,38.50746268656716,80.8955223880597
41163_terrestrial,382,456,150,305,838,39.26701570680628,79.84293193717278
41164_terrestrial,390,507,149,317,897,38.205128205128204,81.28205128205128
41165_terrestrial,402,491,146,330,893,36.318407960199,82.08955223880598
41166_terrestrial,416,514,157,340,930,37.74038461538461,81.73076923076923
41167_terrestrial,376,483,139,308,859,36.96808510638298,81.91489361702128
41168_terrestrial,354,476,128,294,830,36.15819209039548,83.05084745762711
41169_terrestrial,350,499,124,294,849,35.42857142857142,84
41170_terrestrial,355,550,128,295,905,36.056338028169016,83.09859154929578
41171_terrestrial,383,674,140,311,1057,36.55352480417754,81.20104438642298
41172_terrestrial,425,772,161,335,1197,37.88235294117647,78.82352941176471
41173_terrestrial,661,963,373,384,1624,56.429652042360054,58.09379727685325
41174_terrestrial,650,876,378,376,1526,58.15384615384615,57.84615384615385
41235_terrestrial,274,178,194,118,452,70.8029197080292,43.06569343065693
41236_terrestrial,235,147,112,163,382,47.65957446808511,69.36170212765957
41237_terrestrial,252,172,116,176,424,46.03174603174603,69.84126984126983
41238_terrestrial,270,168,119,188,438,44.074074074074076,69.62962962962963
41239_terrestrial,246,147,111,173,393,45.1219512195122,70.32520325203252
41240_terrestrial,231,129,104,162,360,45.02164502164502,70.12987012987013
41241_terrestrial,218,124,93,147,342,42.6605504587156,67.43119266055045
41242_terrestrial,204,116,84,142,320,41.17647058823529,69.6078431372549
41243_terrestrial,216,124,92,151,340,42.592592592592595,69.9074074074074
41244_terrestrial,254,146,114,182,400,44.881889763779526,71.65354330708661
41245_terrestrial,303,180,133,225,483,43.89438943894389,74.25742574257426
41246_terrestrial,394,251,175,282,645,44.41624365482234,71.57360406091371
41247_terrestrial,435,277,198,301,712,45.51724137931035,69.19540229885057
41248_terrestrial,464,348,218,317,812,46.98275862068966,68.31896551724138
41249_terrestrial,478,368,223,328,846,46.65271966527197,68.6192468619247
41250_terrestrial,507,428,225,361,935,44.37869822485207,71.20315581854044
41251_terrestrial,539,502,240,381,1041,44.526901669758814,70.68645640074212
41252_terrestrial,540,467,246,370,1007,45.55555555555556,68.51851851851852
41253_terrestrial,507,363,241,346,870,47.53451676528599,68.24457593688363
41254_terrestrial,482,308,231,332,790,47.9253112033195,68.87966804979253
41255_terrestrial,1097,532,668,647,1629,60.89334548769371,58.979033728350046
41256_terrestrial,413,262,208,279,675,50.363196125908,67.55447941888619
41264_terrestrial,820,379,564,434,1199,68.78048780487805,52.926829268292686
41265_terrestrial,813,384,553,440,1197,68.01968019680197,54.12054120541205
41266_terrestrial,170,169,105,105,339,61.76470588235294,61.76470588235294
41267_terrestrial,275,504,163,161,779,59.27272727272728,58.54545454545455
41268_terrestrial,866,584,578,465,1450,66.74364896073904,53.695150115473446
41353_terrestrial,184,193,40,170,377,21.73913043478261,92.3913043478261
41354_terrestrial,194,199,48,177,393,24.742268041237114,91.23711340206185
41355_terrestrial,186,193,45,172,379,24.193548387096776,92.47311827956989
41356_terrestrial,169,176,36,158,345,21.301775147928996,93.49112426035504
41357_terrestrial,159,148,36,148,307,22.641509433962266,93.08176100628931
41358_terrestrial,158,136,35,147,294,22.151898734177212,93.0379746835443
41359_terrestrial,180,155,43,169,335,23.88888888888889,93.88888888888889
41360_terrestrial,194,162,48,181,356,24.742268041237114,93.29896907216495
41361_terrestrial,199,168,48,185,367,24.120603015075375,92.96482412060301
41362_terrestrial,201,166,46,184,367,22.885572139303484,91.54228855721394
41363_terrestrial,197,160,42,180,357,21.31979695431472,91.37055837563452
41364_terrestrial,205,165,46,187,370,22.439024390243905,91.21951219512195
41365_terrestrial,215,177,51,193,392,23.72093023255814,89.76744186046511
41366_terrestrial,215,182,48,194,397,22.325581395348838,90.23255813953487
41367_terrestrial,233,210,53,210,443,22.746781115879827,90.12875536480686
41368_terrestrial,256,247,60,227,503,23.4375,88.671875
41369_terrestrial,267,262,67,237,529,25.0936329588015,88.76404494382022
41370_terrestrial,286,303,73,254,589,25.524475524475527,88.81118881118881
41371_terrestrial,344,346,108,296,690,31.3953488372093,86.04651162790698
41372_terrestrial,1094,665,586,721,1759,53.56489945155393,65.90493601462522
41373_terrestrial,1005,626,531,659,1631,52.83582089552239,65.57213930348259
41512_terrestrial,57,64,29,49,121,50.877192982456144,85.96491228070175
41513_terrestrial,86,106,40,69,192,46.51162790697674,80.23255813953489
41514_terrestrial,138,237,60,109,375,43.47826086956522,78.98550724637681
41515_terrestrial,276,435,106,226,711,38.405797101449274,81.88405797101449
41516_terrestrial,293,401,115,235,694,39.249146757679185,80.2047781569966
41517_terrestrial,260,298,112,205,558,43.07692307692308,78.84615384615384
41518_terrestrial,254,264,109,199,518,42.91338582677165,78.34645669291339
41519_terrestrial,268,272,115,208,540,42.91044776119403,77.61194029850746
41520_terrestrial,283,292,119,222,575,42.04946996466431,78.4452296819788
41521_terrestrial,297,342,123,238,639,41.41414141414141,80.13468013468014
41522_terrestrial,339,398,132,273,737,38.93805309734513,80.53097345132744
41523_terrestrial,386,474,152,308,860,39.37823834196891,79.79274611398964
41524_terrestrial,375,491,143,308,866,38.13333333333333,82.13333333333334
41525_terrestrial,388,477,144,321,865,37.11340206185567,82.73195876288659
41526_terrestrial,394,541,149,319,935,37.81725888324873,80.96446700507614
41527_terrestrial,372,520,140,300,892,37.634408602150536,80.64516129032258
41528_terrestrial,345,488,128,286,833,37.10144927536232,82.89855072463767
41529_terrestrial,343,505,125,284,848,36.44314868804665,82.79883381924198
41530_terrestrial,342,549,124,282,891,36.25730994152047,82.45614035087719
41531_terrestrial,390,700,152,310,1090,38.97435897435898,79.48717948717949
41532_terrestrial,647,912,375,368,1559,57.95981452859351,56.87789799072643
41533_terrestrial,609,757,359,344,1366,58.94909688013136,56.48604269293924
41595_terrestrial,256,162,188,99,418,73.4375,38.671875
41596_terrestrial,185,118,92,126,303,49.72972972972973,68.10810810810811
41597_terrestrial,222,152,100,156,374,45.04504504504504,70.27027027027027
41598_terrestrial,223,151,100,157,374,44.843049327354265,70.4035874439462
41599_terrestrial,213,138,98,153,351,46.009389671361504,71.83098591549296
41600_terrestrial,232,121,102,160,353,43.96551724137931,68.96551724137932
41601_terrestrial,224,129,96,153,353,42.857142857142854,68.30357142857143
41602_terrestrial,214,128,91,150,342,42.523364485981304,70.09345794392523
41603_terrestrial,236,144,102,165,380,43.22033898305085,69.91525423728814
41604_terrestrial,281,162,124,201,443,44.128113879003564,71.53024911032028
41605_terrestrial,325,196,140,241,521,43.07692307692308,74.15384615384616
41606_terrestrial,407,273,184,288,680,45.20884520884521,70.76167076167076
41607_terrestrial,446,299,207,309,745,46.41255605381166,69.28251121076234
41608_terrestrial,452,346,209,308,798,46.23893805309734,68.14159292035397
41609_terrestrial,456,351,214,315,807,46.92982456140351,69.07894736842105
41610_terrestrial,467,383,214,332,850,45.82441113490364,71.09207708779444
41611_terrestrial,531,469,239,376,1000,45.00941619585687,70.80979284369114
41612_terrestrial,558,517,249,387,1075,44.623655913978496,69.35483870967742
41613_terrestrial,1231,689,742,709,1920,60.2761982128351,57.59545085296507
41614_terrestrial,1109,570,681,648,1679,61.40667267808837,58.431018935978365
41615_terrestrial,396,254,202,272,650,51.010101010101,68.68686868686868
41625_terrestrial,796,351,548,422,1147,68.84422110552764,53.015075376884425
41626_terrestrial,785,331,538,415,1116,68.53503184713375,52.86624203821656
41627_terrestrial,864,600,585,457,1464,67.70833333333334,52.893518518518526
41628_terrestrial,781,370,531,421,1151,67.98975672215109,53.90524967989757
41714_terrestrial,165,180,31,155,345,18.787878787878785,93.93939393939394
41715_terrestrial,165,186,32,155,351,19.393939393939394,93.93939393939394
41716_terrestrial,161,176,32,151,337,19.875776397515526,93.7888198757764
41717_terrestrial,153,157,31,143,310,20.26143790849673,93.4640522875817
41718_terrestrial,159,152,35,149,311,22.0125786163522,93.71069182389937
41719_terrestrial,180,160,44,169,340,24.444444444444443,93.88888888888889
41720_terrestrial,197,165,48,184,362,24.36548223350254,93.4010152284264
41721_terrestrial,196,171,46,183,367,23.46938775510204,93.36734693877551
41722_terrestrial,204,177,46,190,381,22.54901960784314,93.13725490196079
41723_terrestrial,209,159,47,191,368,22.48803827751196,91.38755980861244
41724_terrestrial,206,167,46,189,373,22.330097087378643,91.74757281553399
41725_terrestrial,211,177,45,192,388,21.32701421800948,90.99526066350711
41726_terrestrial,216,183,49,195,399,22.685185185185187,90.27777777777779
41727_terrestrial,233,199,54,212,432,23.17596566523605,90.98712446351931
41728_terrestrial,258,242,60,230,500,23.25581395348837,89.14728682170544
41729_terrestrial,267,252,69,235,519,25.842696629213485,88.01498127340824
41730_terrestrial,274,270,70,244,544,25.547445255474454,89.05109489051095
41731_terrestrial,299,315,76,267,614,25.418060200668897,89.29765886287625
41732_terrestrial,336,344,95,296,680,28.273809523809522,88.09523809523809
41733_terrestrial,989,710,533,628,1699,53.892821031344795,63.49848331648129
41734_terrestrial,963,661,525,605,1624,54.51713395638629,62.824506749740394
41872_terrestrial,67,69,34,56,136,50.74626865671642,83.5820895522388
41873_terrestrial,99,126,40,78,225,40.4040404040404,78.78787878787878
41874_terrestrial,152,272,64,117,424,42.10526315789473,76.97368421052632
41875_terrestrial,305,483,114,253,788,37.37704918032787,82.95081967213115
41876_terrestrial,269,384,107,219,653,39.77695167286245,81.41263940520446
41877_terrestrial,245,269,105,195,514,42.857142857142854,79.59183673469387
41878_terrestrial,245,246,107,192,491,43.673469387755105,78.36734693877551
41879_terrestrial,258,260,109,202,518,42.248062015503876,78.29457364341084
41880_terrestrial,273,293,115,218,566,42.124542124542124,79.85347985347985
41881_terrestrial,310,372,123,250,682,39.67741935483871,80.64516129032258
41882_terrestrial,339,405,131,272,744,38.64306784660767,80.23598820058997
41883_terrestrial,356,443,135,297,799,37.92134831460674,83.42696629213484
41884_terrestrial,364,481,139,300,845,38.18681318681318,82.41758241758241
41885_terrestrial,384,490,151,310,874,39.32291666666667,80.72916666666666
41886_terrestrial,384,529,151,312,913,39.32291666666667,81.25
41887_terrestrial,367,534,142,299,901,38.69209809264305,81.47138964577657
41888_terrestrial,340,499,129,279,839,37.94117647058823,82.05882352941177
41889_terrestrial,340,499,130,276,839,38.23529411764706,81.17647058823529
41890_terrestrial,338,527,126,276,865,37.278106508875744,81.65680473372781
41891_terrestrial,380,652,145,305,1032,38.15789473684211,80.26315789473685
41892_terrestrial,608,777,356,343,1385,58.55263157894737,56.414473684210535
41955_terrestrial,252,162,186,96,414,73.80952380952381,38.095238095238095
41956_terrestrial,298,224,209,124,522,70.13422818791946,41.61073825503356
41957_terrestrial,200,138,101,141,338,50.5,70.5
41958_terrestrial,209,142,96,153,351,45.933014354066984,73.20574162679426
41959_terrestrial,209,133,95,152,342,45.45454545454545,72.72727272727273
41960_terrestrial,224,131,100,162,355,44.642857142857146,72.32142857142857
41961_terrestrial,237,125,106,166,362,44.72573839662447,70.042194092827
41962_terrestrial,225,136,98,157,361,43.55555555555555,69.77777777777779
41963_terrestrial,250,160,112,173,410,44.800000000000004,69.19999999999999
41964_terrestrial,284,165,131,205,449,46.12676056338028,72.1830985915493
41965_terrestrial,326,194,147,239,520,45.0920245398773,73.31288343558282
41966_terrestrial,367,228,159,272,595,43.32425068119891,74.11444141689373
41967_terrestrial,385,254,171,279,639,44.41558441558441,72.46753246753246
41968_terrestrial,405,301,183,285,706,45.18518518518518,70.37037037037037
41969_terrestrial,387,308,179,274,695,46.253229974160206,70.80103359173127
41970_terrestrial,386,315,179,276,701,46.373056994818654,71.50259067357513
41971_terrestrial,478,401,222,332,879,46.44351464435147,69.4560669456067
41972_terrestrial,538,475,246,370,1013,45.72490706319702,68.77323420074349
41973_terrestrial,1215,735,728,705,1950,59.91769547325103,58.0246913580247
42076_terrestrial,165,173,31,155,338,18.787878787878785,93.93939393939394
42077_terrestrial,160,157,33,152,317,20.625,95
42078_terrestrial,159,150,34,152,309,21.38364779874214,95.59748427672956
42079_terrestrial,170,158,40,160,328,23.52941176470588,94.11764705882352
42080_terrestrial,178,160,42,168,338,23.595505617977526,94.3820224719101
42081_terrestrial,185,163,44,173,348,23.783783783783786,93.51351351351352
42082_terrestrial,195,162,45,181,357,23.076923076923077,92.82051282051282
42083_terrestrial,203,154,46,189,357,22.660098522167488,93.10344827586206
42084_terrestrial,212,164,48,195,376,22.641509433962266,91.98113207547169
42085_terrestrial,216,171,50,197,387,23.14814814814815,91.20370370370371
42086_terrestrial,221,183,53,200,404,23.981900452488688,90.49773755656109
42087_terrestrial,232,185,56,210,417,24.137931034482758,90.51724137931035
42088_terrestrial,239,203,60,216,442,25.10460251046025,90.3765690376569
42089_terrestrial,262,234,63,234,496,24.045801526717558,89.31297709923665
42090_terrestrial,269,241,68,237,510,25.27881040892193,88.10408921933085
42091_terrestrial,286,279,74,254,565,25.874125874125873,88.81118881118881
42092_terrestrial,325,335,87,290,660,26.769230769230766,89.23076923076924
42093_terrestrial,361,391,118,308,752,32.686980609418285,85.3185595567867
42094_terrestrial,973,664,518,621,1637,53.23741007194245,63.82322713257965
42231_terrestrial,79,82,31,66,161,39.24050632911392,83.54430379746836
42232_terrestrial,71,94,31,59,165,43.66197183098591,83.09859154929578
42233_terrestrial,107,174,42,81,281,39.25233644859813,75.70093457943925
42234_terrestrial,160,312,61,124,472,38.125,77.5
42235_terrestrial,303,449,114,251,752,37.62376237623762,82.83828382838284
42236_terrestrial,249,307,102,203,556,40.963855421686745,81.52610441767068
42237_terrestrial,237,255,99,190,492,41.77215189873418,80.16877637130801
42238_terrestrial,245,242,107,191,487,43.673469387755105,77.9591836734694
42239_terrestrial,253,251,106,201,504,41.89723320158103,79.44664031620553
42240_terrestrial,269,291,105,220,560,39.03345724907063,81.78438661710037
42241_terrestrial,306,374,115,252,680,37.58169934640523,82.35294117647058
42242_terrestrial,323,416,118,266,739,36.53250773993808,82.35294117647058
42243_terrestrial,334,432,127,273,766,38.02395209580838,81.73652694610777
42244_terrestrial,358,482,134,291,840,37.43016759776536,81.28491620111731
42245_terrestrial,362,514,141,290,876,38.950276243093924,80.11049723756905
42246_terrestrial,366,501,144,292,867,39.34426229508197,79.78142076502732
42247_terrestrial,348,495,137,280,843,39.36781609195402,80.45977011494253
42248_terrestrial,332,461,131,271,793,39.45783132530121,81.62650602409639
42249_terrestrial,329,462,127,270,791,38.60182370820669,82.06686930091185
42250_terrestrial,340,498,128,274,838,37.64705882352941,80.58823529411765
42251_terrestrial,361,587,140,291,948,38.78116343490305,80.60941828254848
42252_terrestrial,592,735,356,329,1327,60.13513513513513,55.57432432432432
42316_terrestrial,296,222,215,118,518,72.63513513513513,39.86486486486486
42317_terrestrial,220,153,114,147,373,51.81818181818182,66.81818181818183
42318_terrestrial,224,164,108,154,388,48.214285714285715,68.75
42319_terrestrial,202,134,94,144,336,46.53465346534654,71.28712871287128
42320_terrestrial,215,134,103,154,349,47.906976744186046,71.62790697674419
42321_terrestrial,228,142,110,163,370,48.24561403508772,71.49122807017544
42322_terrestrial,239,140,108,173,379,45.18828451882845,72.38493723849372
42323_terrestrial,267,164,119,185,431,44.569288389513105,69.28838951310861
42324_terrestrial,286,178,131,205,464,45.8041958041958,71.67832167832168
42325_terrestrial,321,193,148,232,514,46.10591900311526,72.27414330218068
42326_terrestrial,335,210,151,249,545,45.07462686567164,74.32835820895522
42327_terrestrial,343,214,151,255,557,44.02332361516035,74.34402332361516
42328_terrestrial,337,233,150,247,570,44.510385756676556,73.29376854599407
42329_terrestrial,344,244,161,246,588,46.80232558139535,71.51162790697676
42330_terrestrial,377,319,175,265,696,46.41909814323608,70.29177718832891
42331_terrestrial,450,400,212,315,850,47.11111111111111,70
42332_terrestrial,542,490,248,379,1032,45.75645756457565,69.92619926199262
42333_terrestrial,1193,738,726,678,1931,60.85498742665549,56.83151718357083
42437_terrestrial,164,146,37,153,310,22.5609756097561,93.29268292682927
42438_terrestrial,163,144,39,153,307,23.92638036809816,93.86503067484662
42439_terrestrial,171,146,43,161,317,25.146198830409354,94.15204678362574
42440_terrestrial,178,148,42,168,326,23.595505617977526,94.3820224719101
42441_terrestrial,182,153,45,168,335,24.725274725274726,92.3076923076923
42442_terrestrial,195,163,47,181,358,24.102564102564102,92.82051282051282
42443_terrestrial,201,151,45,187,352,22.388059701492537,93.03482587064677
42444_terrestrial,222,163,52,201,385,23.423423423423422,90.54054054054053
42445_terrestrial,221,169,53,198,390,23.981900452488688,89.59276018099548
42446_terrestrial,229,173,58,205,402,25.327510917030565,89.51965065502183
42447_terrestrial,228,167,53,205,395,23.24561403508772,89.91228070175438
42448_terrestrial,236,181,58,212,417,24.576271186440678,89.83050847457628
42449_terrestrial,247,215,61,220,462,24.696356275303643,89.06882591093117
42450_terrestrial,262,234,69,231,496,26.33587786259542,88.16793893129771
42451_terrestrial,286,272,71,251,558,24.825174825174827,87.76223776223776
42452_terrestrial,322,343,84,289,665,26.08695652173913,89.75155279503106
42453_terrestrial,362,407,115,310,769,31.767955801104975,85.6353591160221
42454_terrestrial,971,709,517,607,1680,53.244078269824925,62.512873326467556
42591_terrestrial,77,84,30,65,161,38.961038961038966,84.4155844155844
42592_terrestrial,83,114,31,65,197,37.34939759036144,78.3132530120482
42593_terrestrial,117,189,47,90,306,40.17094017094017,76.92307692307693
42594_terrestrial,162,298,57,129,460,35.18518518518518,79.62962962962963
42595_terrestrial,236,357,92,195,593,38.983050847457626,82.62711864406779
42596_terrestrial,222,271,88,182,493,39.63963963963964,81.98198198198197
42597_terrestrial,233,248,98,184,481,42.06008583690987,78.96995708154506
42598_terrestrial,241,236,109,187,477,45.22821576763486,77.59336099585063
42599_terrestrial,253,242,108,196,495,42.68774703557312,77.4703557312253
42600_terrestrial,273,289,102,222,562,37.362637362637365,81.31868131868131
42601_terrestrial,295,358,110,244,653,37.28813559322034,82.71186440677965
42602_terrestrial,294,377,106,247,671,36.054421768707485,84.01360544217688
42603_terrestrial,286,381,103,242,667,36.01398601398601,84.61538461538461
42604_terrestrial,308,420,115,250,728,37.33766233766234,81.16883116883116
42605_terrestrial,306,434,117,244,740,38.23529411764706,79.73856209150327
42606_terrestrial,305,409,116,249,714,38.0327868852459,81.63934426229508
42607_terrestrial,301,406,115,246,707,38.205980066445186,81.72757475083057
42608_terrestrial,310,413,121,254,723,39.03225806451613,81.93548387096774
42609_terrestrial,319,452,125,258,771,39.18495297805642,80.87774294670847
42610_terrestrial,342,515,135,277,857,39.473684210526315,80.99415204678363
42611_terrestrial,572,742,339,321,1314,59.265734265734274,56.11888111888111
42612_terrestrial,568,648,347,302,1216,61.09154929577465,53.16901408450704
42676_terrestrial,150,79,85,103,229,56.666666666666664,68.66666666666667
42677_terrestrial,368,314,244,168,682,66.30434782608695,45.65217391304348
42678_terrestrial,252,213,123,172,465,48.80952380952381,68.25396825396825
42679_terrestrial,236,179,113,165,415,47.88135593220339,69.91525423728814
42680_terrestrial,240,180,114,167,420,47.5,69.58333333333333
42681_terrestrial,238,173,115,168,411,48.319327731092436,70.58823529411765
42682_terrestrial,240,164,115,173,404,47.91666666666667,72.08333333333333
42683_terrestrial,254,172,118,182,426,46.45669291338583,71.65354330708661
42684_terrestrial,276,169,130,194,445,47.10144927536232,70.28985507246377
42685_terrestrial,296,189,141,209,485,47.63513513513514,70.6081081081081
42686_terrestrial,316,207,144,231,523,45.56962025316456,73.10126582278481
42687_terrestrial,329,212,153,235,541,46.504559270516715,71.42857142857143
42688_terrestrial,322,236,150,232,558,46.58385093167702,72.04968944099379
42689_terrestrial,360,295,162,260,655,45,72.22222222222221
42690_terrestrial,402,362,174,291,764,43.28358208955223,72.38805970149254
42691_terrestrial,468,439,222,329,907,47.43589743589743,70.2991452991453
42692_terrestrial,1121,692,668,643,1813,59.58965209634255,57.35950044603033
42693_terrestrial,1142,705,704,636,1847,61.646234676007005,55.69176882661997
42798_terrestrial,177,142,44,163,319,24.858757062146893,92.09039548022598
42799_terrestrial,175,142,46,162,317,26.285714285714285,92.57142857142857
42800_terrestrial,182,140,46,170,322,25.274725274725274,93.4065934065934
42801_terrestrial,180,145,45,167,325,25,92.77777777777779
42802_terrestrial,191,156,48,176,347,25.13089005235602,92.14659685863874
42803_terrestrial,201,151,48,184,352,23.88059701492537,91.54228855721394
42804_terrestrial,215,161,51,195,376,23.72093023255814,90.69767441860465
42805_terrestrial,219,165,54,196,384,24.65753424657534,89.49771689497716
42806_terrestrial,226,171,58,201,397,25.663716814159294,88.93805309734513
42807_terrestrial,230,168,54,207,398,23.47826086956522,90
42808_terrestrial,234,176,59,209,410,25.213675213675213,89.31623931623932
42809_terrestrial,250,200,64,223,450,25.6,89.2
42810_terrestrial,256,231,65,229,487,25.390625,89.453125
42811_terrestrial,272,266,65,243,538,23.897058823529413,89.33823529411765
42812_terrestrial,303,352,76,270,655,25.082508250825082,89.10891089108911
42813_terrestrial,340,417,97,298,757,28.52941176470588,87.6470588235294
42814_terrestrial,948,691,493,609,1639,52.004219409282705,64.24050632911393
42950_terrestrial,107,124,41,94,231,38.31775700934579,87.85046728971963
42951_terrestrial,78,92,31,66,170,39.743589743589745,84.61538461538461
42952_terrestrial,98,146,39,72,244,39.795918367346935,73.46938775510205
42953_terrestrial,131,218,55,96,349,41.98473282442748,73.2824427480916
42954_terrestrial,181,255,66,142,436,36.46408839779006,78.45303867403315
42955_terrestrial,218,286,81,175,504,37.15596330275229,80.27522935779817
42956_terrestrial,214,291,83,174,505,38.78504672897196,81.30841121495327
42957_terrestrial,233,269,95,184,502,40.772532188841204,78.96995708154506
42958_terrestrial,239,241,101,184,480,42.25941422594142,76.98744769874477
42959_terrestrial,238,243,99,185,481,41.596638655462186,77.73109243697479
42960_terrestrial,264,300,99,214,564,37.5,81.06060606060606
42961_terrestrial,277,345,103,226,622,37.18411552346571,81.58844765342961
42962_terrestrial,269,341,98,224,610,36.43122676579926,83.27137546468401
42963_terrestrial,268,361,99,221,629,36.940298507462686,82.46268656716418
42964_terrestrial,265,370,100,214,635,37.735849056603776,80.75471698113208
42965_terrestrial,259,358,104,205,617,40.15444015444015,79.15057915057915
42966_terrestrial,278,369,109,221,647,39.20863309352518,79.49640287769785
42967_terrestrial,289,391,111,233,680,38.4083044982699,80.62283737024222
42968_terrestrial,315,399,122,250,714,38.730158730158735,79.36507936507937
42969_terrestrial,349,472,138,274,821,39.541547277936964,78.51002865329512
42970_terrestrial,575,695,335,319,1270,58.26086956521739,55.47826086956522
42971_terrestrial,562,695,337,304,1257,59.9644128113879,54.092526690391466
43037_terrestrial,327,287,226,147,614,69.1131498470948,44.95412844036697
43038_terrestrial,372,336,248,177,708,66.66666666666666,47.58064516129033
43039_terrestrial,235,205,114,168,440,48.51063829787234,71.48936170212767
43040_terrestrial,227,177,113,162,404,49.77973568281938,71.36563876651982
43041_terrestrial,214,158,107,156,372,50,72.89719626168224
43042_terrestrial,219,166,109,160,385,49.77168949771689,73.0593607305936
43043_terrestrial,235,174,111,169,409,47.23404255319149,71.91489361702128
43044_terrestrial,258,179,120,185,437,46.51162790697674,71.70542635658916
43045_terrestrial,284,192,132,200,476,46.478873239436616,70.4225352112676
43046_terrestrial,307,202,143,217,509,46.579804560260584,70.68403908794788
43047_terrestrial,319,220,149,231,539,46.70846394984326,72.41379310344827
43048_terrestrial,309,228,147,221,537,47.57281553398058,71.52103559870551
43049_terrestrial,261,233,123,194,494,47.12643678160919,74.32950191570882
43050_terrestrial,415,401,179,305,816,43.132530120481924,73.49397590361446
43051_terrestrial,985,641,598,542,1626,60.71065989847716,55.0253807106599
43052_terrestrial,1053,655,645,594,1708,61.25356125356125,56.41025641025641
43159_terrestrial,186,159,47,173,345,25.268817204301076,93.01075268817203
43160_terrestrial,187,166,44,176,353,23.52941176470588,94.11764705882352
43161_terrestrial,189,151,48,173,340,25.396825396825395,91.53439153439153
43162_terrestrial,188,146,48,171,334,25.53191489361702,90.95744680851064
43163_terrestrial,197,154,47,180,351,23.85786802030457,91.37055837563452
43164_terrestrial,210,152,51,191,362,24.285714285714285,90.95238095238095
43165_terrestrial,221,159,57,198,380,25.791855203619914,89.59276018099548
43166_terrestrial,230,164,57,203,394,24.782608695652176,88.26086956521739
43167_terrestrial,232,167,59,207,399,25.43103448275862,89.22413793103449
43168_terrestrial,237,175,62,212,412,26.160337552742618,89.45147679324894
43169_terrestrial,248,190,64,221,438,25.806451612903224,89.11290322580645
43170_terrestrial,264,220,66,236,484,25,89.39393939393939
43171_terrestrial,275,265,67,246,540,24.363636363636363,89.45454545454545
43172_terrestrial,303,346,76,271,649,25.082508250825082,89.43894389438944
43173_terrestrial,345,386,107,294,731,31.01449275362319,85.21739130434783
43174_terrestrial,887,618,460,568,1505,51.86020293122886,64.03607666290868
43309_terrestrial,208,243,130,103,451,62.5,49.519230769230774
43310_terrestrial,115,136,49,99,251,42.608695652173914,86.08695652173914
43311_terrestrial,85,93,34,71,178,40,83.52941176470588
43312_terrestrial,111,150,45,82,261,40.54054054054054,73.87387387387388
43313_terrestrial,140,203,56,106,343,40,75.71428571428571
43314_terrestrial,171,231,65,132,402,38.01169590643275,77.19298245614034
43315_terrestrial,203,292,71,162,495,34.97536945812808,79.80295566502463
43316_terrestrial,224,314,83,182,538,37.05357142857143,81.25
43317_terrestrial,232,276,97,182,508,41.810344827586206,78.44827586206897
43318_terrestrial,230,232,94,180,462,40.869565217391305,78.26086956521739
43319_terrestrial,230,250,95,182,480,41.30434782608695,79.13043478260869
43320_terrestrial,248,295,95,203,543,38.306451612903224,81.85483870967742
43321_terrestrial,254,330,94,208,584,37.00787401574803,81.88976377952756
43322_terrestrial,249,327,93,205,576,37.34939759036144,82.32931726907631
43323_terrestrial,252,336,97,206,588,38.492063492063494,81.74603174603175
43324_terrestrial,242,302,95,192,544,39.25619834710744,79.33884297520662
43325_terrestrial,238,305,96,187,543,40.33613445378151,78.57142857142857
43326_terrestrial,248,309,100,195,557,40.32258064516129,78.62903225806451
43327_terrestrial,256,334,107,199,590,41.796875,77.734375
43328_terrestrial,290,363,117,230,653,40.3448275862069,79.3103448275862
43329_terrestrial,513,556,307,274,1069,59.84405458089669,53.41130604288499
43330_terrestrial,532,582,324,276,1114,60.902255639097746,51.8796992481203
43398_terrestrial,367,339,252,165,706,68.66485013623979,44.95912806539509
43399_terrestrial,218,199,111,157,417,50.917431192660544,72.01834862385321
43400_terrestrial,205,170,103,153,375,50.24390243902439,74.63414634146342
43401_terrestrial,189,145,97,141,334,51.32275132275132,74.60317460317461
43402_terrestrial,198,149,97,149,347,48.98989898989899,75.25252525252525
43403_terrestrial,226,167,112,163,393,49.557522123893804,72.12389380530973
43404_terrestrial,244,177,118,175,421,48.36065573770492,71.72131147540983
43405_terrestrial,278,195,134,195,473,48.201438848920866,70.14388489208633
43406_terrestrial,294,213,143,203,507,48.63945578231292,69.04761904761905
43407_terrestrial,304,227,146,212,531,48.026315789473685,69.73684210526315
43408_terrestrial,316,250,147,225,566,46.51898734177215,71.20253164556962
43409_terrestrial,325,284,152,232,609,46.76923076923077,71.38461538461539
43410_terrestrial,413,382,184,301,795,44.55205811138014,72.88135593220339
43411_terrestrial,924,593,579,486,1517,62.66233766233766,52.5974025974026
43520_terrestrial,189,180,44,177,369,23.28042328042328,93.65079365079364
43521_terrestrial,186,147,46,170,333,24.731182795698924,91.39784946236558
43522_terrestrial,196,140,51,180,336,26.02040816326531,91.83673469387756
43523_terrestrial,202,146,52,186,348,25.742574257425744,92.07920792079209
43524_terrestrial,205,150,52,188,355,25.365853658536587,91.70731707317074
43525_terrestrial,217,151,55,195,368,25.34562211981567,89.86175115207374
43526_terrestrial,229,166,56,205,395,24.45414847161572,89.51965065502183
43527_terrestrial,238,174,60,213,412,25.210084033613445,89.49579831932773
43528_terrestrial,240,176,62,217,416,25.833333333333336,90.41666666666667
43529_terrestrial,257,209,67,228,466,26.07003891050584,88.715953307393
43530_terrestrial,262,240,61,236,502,23.282442748091604,90.07633587786259
43531_terrestrial,273,266,68,244,539,24.90842490842491,89.37728937728939
43532_terrestrial,316,351,87,283,667,27.531645569620256,89.55696202531645
43533_terrestrial,883,653,452,571,1536,51.18912797281994,64.66591166477916
43534_terrestrial,879,614,462,554,1493,52.55972696245734,63.026166097838455
43669_terrestrial,205,246,129,104,451,62.926829268292686,50.73170731707317
43670_terrestrial,112,150,45,96,262,40.17857142857143,85.71428571428571
43671_terrestrial,90,109,37,72,199,41.11111111111111,80
43672_terrestrial,124,184,51,95,308,41.12903225806452,76.61290322580645
43673_terrestrial,142,210,55,104,352,38.732394366197184,73.23943661971832
43674_terrestrial,169,219,65,130,388,38.46153846153847,76.92307692307693
43675_terrestrial,199,266,71,159,465,35.678391959798994,79.89949748743719
43676_terrestrial,222,295,86,182,517,38.73873873873874,81.98198198198197
43677_terrestrial,221,261,92,175,482,41.6289592760181,79.18552036199095
43678_terrestrial,221,236,95,171,457,42.98642533936652,77.37556561085974
43679_terrestrial,227,261,93,179,488,40.969162995594715,78.8546255506608
43680_terrestrial,241,300,91,198,541,37.75933609958506,82.15767634854771
43681_terrestrial,249,318,96,200,567,38.55421686746988,80.32128514056225
43682_terrestrial,250,315,99,201,565,39.6,80.4
43683_terrestrial,243,299,98,194,542,40.32921810699588,79.83539094650206
43684_terrestrial,237,276,96,188,513,40.50632911392405,79.32489451476793
43685_terrestrial,230,285,93,182,515,40.43478260869565,79.13043478260869
43686_terrestrial,235,295,98,180,530,41.702127659574465,76.59574468085107
43687_terrestrial,256,318,107,200,574,41.796875,78.125
43688_terrestrial,482,490,310,239,972,64.31535269709543,49.5850622406639
43689_terrestrial,480,505,309,237,985,64.375,49.375
43690_terrestrial,444,444,292,217,888,65.76576576576578,48.873873873873876
43758_terrestrial,351,294,243,159,645,69.23076923076923,45.2991452991453
43759_terrestrial,404,418,267,194,822,66.0891089108911,48.01980198019802
43760_terrestrial,233,238,115,170,471,49.35622317596567,72.96137339055794
43761_terrestrial,209,165,104,153,374,49.760765550239235,73.20574162679426
43762_terrestrial,211,146,106,154,357,50.23696682464455,72.98578199052133
43763_terrestrial,233,179,120,164,412,51.50214592274678,70.3862660944206
43764_terrestrial,250,184,123,181,434,49.2,72.39999999999999
43765_terrestrial,274,203,133,194,477,48.54014598540146,70.8029197080292
43766_terrestrial,297,234,145,206,531,48.821548821548824,69.36026936026936
43767_terrestrial,324,266,154,233,590,47.53086419753087,71.91358024691358
43768_terrestrial,347,294,159,250,641,45.821325648414984,72.04610951008645
43769_terrestrial,374,323,179,259,697,47.860962566844925,69.25133689839572
43770_terrestrial,773,538,501,382,1311,64.8124191461837,49.417852522639066
43771_terrestrial,351,307,164,254,658,46.72364672364672,72.36467236467237
43881_terrestrial,195,149,49,178,344,25.128205128205128,91.28205128205128
43882_terrestrial,199,148,52,180,347,26.13065326633166,90.45226130653266
43883_terrestrial,200,155,51,180,355,25.5,90
43884_terrestrial,216,145,57,193,361,26.38888888888889,89.35185185185185
43885_terrestrial,216,157,57,196,373,26.38888888888889,90.74074074074075
43886_terrestrial,227,156,54,207,383,23.788546255506606,91.18942731277532
43887_terrestrial,228,165,53,209,393,23.24561403508772,91.66666666666666
43888_terrestrial,235,185,58,213,420,24.680851063829788,90.63829787234042
43889_terrestrial,259,223,60,229,482,23.166023166023166,88.41698841698842
43890_terrestrial,271,263,64,243,534,23.616236162361623,89.66789667896678
43891_terrestrial,288,298,73,258,586,25.34722222222222,89.58333333333334
43892_terrestrial,324,354,98,283,678,30.246913580246915,87.34567901234568
43893_terrestrial,875,644,461,548,1519,52.68571428571428,62.62857142857143
43894_terrestrial,830,554,440,521,1384,53.01204819277109,62.77108433734939
44029_terrestrial,222,262,140,115,484,63.06306306306306,51.80180180180181
44030_terrestrial,120,174,48,104,294,40,86.66666666666667
44031_terrestrial,103,143,39,84,246,37.86407766990291,81.55339805825243
44032_terrestrial,132,188,53,101,320,40.15151515151515,76.51515151515152
44033_terrestrial,141,197,56,101,338,39.71631205673759,71.63120567375887
44034_terrestrial,161,222,60,125,383,37.267080745341616,77.63975155279503
44035_terrestrial,195,249,71,155,444,36.41025641025641,79.48717948717949
44036_terrestrial,216,269,82,172,485,37.96296296296296,79.62962962962963
44037_terrestrial,204,241,87,161,445,42.64705882352941,78.92156862745098
44038_terrestrial,201,218,83,158,419,41.29353233830846,78.60696517412936
44039_terrestrial,211,251,85,168,462,40.28436018957346,79.62085308056872
44040_terrestrial,229,295,88,188,524,38.427947598253276,82.09606986899564
44041_terrestrial,227,284,94,181,511,41.409691629955944,79.73568281938326
44042_terrestrial,374,397,218,211,771,58.288770053475936,56.417112299465245
44043_terrestrial,222,270,93,178,492,41.891891891891895,80.18018018018019
44044_terrestrial,216,254,89,175,470,41.2037037037037,81.01851851851852
44045_terrestrial,215,263,89,175,478,41.3953488372093,81.3953488372093
44046_terrestrial,230,273,96,183,503,41.73913043478261,79.56521739130434
44047_terrestrial,263,299,113,203,562,42.96577946768061,77.18631178707224
44048_terrestrial,484,496,317,233,980,65.49586776859503,48.14049586776859
44049_terrestrial,448,401,298,215,849,66.51785714285714,47.99107142857143
44118_terrestrial,390,362,270,179,752,69.23076923076923,45.8974358974359
44119_terrestrial,423,442,282,202,865,66.66666666666666,47.75413711583924
44120_terrestrial,268,281,134,191,549,50,71.26865671641791
44121_terrestrial,246,211,126,173,457,51.21951219512195,70.32520325203252
44122_terrestrial,252,198,129,175,450,51.19047619047619,69.44444444444444
44123_terrestrial,263,212,131,187,475,49.80988593155893,71.10266159695817
44124_terrestrial,289,226,142,204,515,49.13494809688581,70.58823529411765
44125_terrestrial,319,246,154,225,565,48.275862068965516,70.53291536050156
44126_terrestrial,344,300,160,245,644,46.51162790697674,71.22093023255815
44127_terrestrial,391,362,187,270,753,47.82608695652174,69.0537084398977
44128_terrestrial,694,503,444,344,1197,63.976945244956774,49.56772334293948
44129_terrestrial,709,510,465,342,1219,65.58533145275035,48.23695345557123
44130_terrestrial,311,260,148,222,571,47.58842443729904,71.38263665594855
44238_terrestrial,440,473,205,269,913,46.590909090909086,61.13636363636363
44239_terrestrial,256,191,74,225,447,28.90625,87.890625
44240_terrestrial,219,175,50,201,394,22.831050228310502,91.78082191780823
44244_terrestrial,215,149,56,192,364,26.046511627906977,89.30232558139535
44245_terrestrial,219,145,56,198,364,25.570776255707763,90.41095890410958
44246_terrestrial,231,166,56,210,397,24.242424242424242,90.9090909090909
44247_terrestrial,236,176,57,213,412,24.152542372881356,90.2542372881356
44248_terrestrial,248,184,62,222,432,25,89.51612903225806
44249_terrestrial,268,226,69,235,494,25.74626865671642,87.68656716417911
44250_terrestrial,285,265,75,253,550,26.31578947368421,88.7719298245614
44251_terrestrial,316,326,95,276,642,30.063291139240505,87.34177215189874
44252_terrestrial,844,643,438,529,1487,51.8957345971564,62.67772511848341
44253_terrestrial,854,610,451,528,1464,52.81030444964871,61.82669789227167
44389_terrestrial,231,277,142,126,508,61.471861471861466,54.54545454545454
44390_terrestrial,129,179,52,110,308,40.310077519379846,85.27131782945736
44391_terrestrial,118,167,44,90,285,37.28813559322034,76.27118644067797
44392_terrestrial,129,176,49,94,305,37.98449612403101,72.86821705426357
44393_terrestrial,133,186,52,99,319,39.097744360902254,74.43609022556392
44394_terrestrial,151,200,58,118,351,38.41059602649007,78.1456953642384
44395_terrestrial,176,217,65,137,393,36.93181818181818,77.8409090909091
44396_terrestrial,182,225,71,142,407,39.010989010989015,78.02197802197803
44397_terrestrial,174,211,77,135,385,44.252873563218394,77.58620689655173
44398_terrestrial,180,200,77,138,380,42.77777777777778,76.66666666666667
44399_terrestrial,186,218,78,148,404,41.935483870967744,79.56989247311827
44400_terrestrial,211,277,84,171,488,39.81042654028436,81.04265402843602
44401_terrestrial,226,303,97,178,529,42.92035398230089,78.76106194690266
44402_terrestrial,385,440,239,207,825,62.077922077922075,53.76623376623376
44403_terrestrial,211,278,93,166,489,44.07582938388626,78.67298578199052
44404_terrestrial,206,257,89,163,463,43.203883495145625,79.12621359223301
44405_terrestrial,212,262,93,167,474,43.86792452830189,78.77358490566037
44406_terrestrial,234,266,105,185,500,44.871794871794876,79.05982905982906
44407_terrestrial,432,431,284,212,863,65.74074074074075,49.074074074074076
44408_terrestrial,249,257,122,180,506,48.99598393574297,72.28915662650603
44478_terrestrial,391,359,271,179,750,69.30946291560103,45.78005115089514
44479_terrestrial,458,481,305,219,939,66.5938864628821,47.81659388646288
44480_terrestrial,300,319,145,218,619,48.333333333333336,72.66666666666667
44481_terrestrial,305,316,151,222,621,49.50819672131148,72.78688524590164
44482_terrestrial,324,312,163,229,636,50.308641975308646,70.67901234567901
44483_terrestrial,547,490,355,267,1037,64.89945155393053,48.81170018281536
44484_terrestrial,586,519,371,294,1105,63.310580204778155,50.170648464163826
44485_terrestrial,616,518,396,301,1134,64.28571428571429,48.86363636363637
44486_terrestrial,686,553,443,335,1239,64.57725947521867,48.8338192419825
44487_terrestrial,701,548,452,342,1249,64.4793152639087,48.787446504992865
44488_terrestrial,675,481,448,325,1156,66.37037037037037,48.148148148148145
44598_terrestrial,433,446,205,263,879,47.34411085450346,60.739030023094685
44599_terrestrial,445,441,210,271,886,47.19101123595505,60.89887640449439
44600_terrestrial,252,195,64,228,447,25.396825396825395,90.47619047619048
44601_terrestrial,239,200,60,213,439,25.10460251046025,89.1213389121339
44602_terrestrial,232,207,59,207,439,25.43103448275862,89.22413793103449
44606_terrestrial,244,182,66,219,426,27.049180327868854,89.75409836065575
44607_terrestrial,247,189,68,220,436,27.530364372469634,89.06882591093117
44608_terrestrial,255,200,72,224,455,28.235294117647058,87.84313725490196
44609_terrestrial,269,240,72,236,509,26.765799256505574,87.73234200743495
44610_terrestrial,298,280,80,266,578,26.845637583892618,89.26174496644296
44611_terrestrial,790,591,399,495,1381,50.50632911392405,62.65822784810127
44612_terrestrial,847,619,439,525,1466,51.82998819362455,61.98347107438017
44748_terrestrial,208,245,132,108,453,63.46153846153846,51.92307692307693
44749_terrestrial,226,282,139,121,508,61.504424778761056,53.53982300884957
44750_terrestrial,109,188,45,93,297,41.284403669724774,85.3211009174312
44751_terrestrial,117,189,44,87,306,37.60683760683761,74.35897435897436
44752_terrestrial,126,179,49,92,305,38.88888888888889,73.01587301587301
44753_terrestrial,128,178,50,96,306,39.0625,75
44754_terrestrial,141,178,57,106,319,40.42553191489361,75.177304964539
44755_terrestrial,147,179,60,112,326,40.816326530612244,76.19047619047619
44756_terrestrial,155,189,62,121,344,40,78.06451612903226
44757_terrestrial,161,192,69,126,353,42.857142857142854,78.26086956521739
44758_terrestrial,154,188,65,119,342,42.2077922077922,77.27272727272727
44759_terrestrial,160,182,69,126,342,43.125,78.75
44760_terrestrial,184,228,80,145,412,43.47826086956522,78.80434782608695
44761_terrestrial,206,276,89,164,482,43.203883495145625,79.6116504854369
44762_terrestrial,371,455,235,194,826,63.342318059299195,52.2911051212938
44763_terrestrial,366,464,235,185,830,64.20765027322405,50.54644808743169
44764_terrestrial,354,418,229,176,772,64.68926553672316,49.717514124293785
44765_terrestrial,369,436,245,178,805,66.39566395663957,48.23848238482385
44766_terrestrial,397,424,264,193,821,66.49874055415617,48.614609571788414
44767_terrestrial,386,381,261,182,767,67.61658031088082,47.15025906735752
44839_terrestrial,483,499,333,221,982,68.94409937888199,45.75569358178054
44840_terrestrial,491,502,334,229,993,68.0244399185336,46.63951120162933
44841_terrestrial,504,438,347,233,942,68.84920634920636,46.230158730158735
44842_terrestrial,523,459,361,240,982,69.02485659655831,45.88910133843212
44843_terrestrial,535,463,363,248,998,67.85046728971963,46.35514018691589
44844_terrestrial,550,483,365,263,1033,66.36363636363637,47.81818181818182
44845_terrestrial,567,476,373,277,1043,65.78483245149911,48.85361552028218
44846_terrestrial,332,277,166,236,609,50,71.08433734939759
44957_terrestrial,414,395,205,241,809,49.51690821256038,58.212560386473434
44958_terrestrial,416,397,205,243,813,49.27884615384615,58.41346153846154
44959_terrestrial,464,453,220,283,917,47.41379310344828,60.991379310344826
44960_terrestrial,275,224,80,238,499,29.09090909090909,86.54545454545455
44961_terrestrial,252,205,66,224,457,26.190476190476193,88.88888888888889
44962_terrestrial,240,200,63,215,440,26.25,89.58333333333334
44963_terrestrial,246,203,67,219,449,27.235772357723576,89.02439024390245
44964_terrestrial,246,190,67,217,436,27.235772357723576,88.21138211382113
44965_terrestrial,241,179,65,213,420,26.970954356846473,88.38174273858921
44966_terrestrial,248,188,71,220,436,28.62903225806452,88.70967741935483
44967_terrestrial,249,186,71,215,435,28.514056224899598,86.34538152610442
44968_terrestrial,259,201,74,223,460,28.57142857142857,86.10038610038609
44969_terrestrial,263,229,72,230,492,27.376425855513308,87.45247148288973
44970_terrestrial,305,280,88,268,585,28.852459016393446,87.8688524590164
44971_terrestrial,697,567,347,429,1264,49.78479196556672,61.54949784791965
44972_terrestrial,707,526,358,430,1233,50.636492220650645,60.82036775106082
44993_terrestrial,285,227,222,109,512,77.89473684210526,38.24561403508772
44994_terrestrial,289,240,226,110,529,78.20069204152249,38.062283737024224
45108_terrestrial,216,270,135,110,486,62.5,50.92592592592593
45109_terrestrial,122,175,52,105,297,42.62295081967213,86.0655737704918
45110_terrestrial,97,182,42,78,279,43.29896907216495,80.41237113402062
45111_terrestrial,113,178,47,81,291,41.5929203539823,71.68141592920354
45112_terrestrial,124,170,50,90,294,40.32258064516129,72.58064516129032
45113_terrestrial,127,175,50,93,302,39.37007874015748,73.22834645669292
45114_terrestrial,141,171,57,106,312,40.42553191489361,75.177304964539
45115_terrestrial,145,175,59,110,320,40.689655172413794,75.86206896551724
45116_terrestrial,152,185,61,118,337,40.131578947368425,77.63157894736842
45117_terrestrial,153,176,66,120,329,43.13725490196079,78.43137254901961
45118_terrestrial,149,175,63,117,324,42.281879194630875,78.52348993288591
45119_terrestrial,143,165,58,115,308,40.55944055944056,80.41958041958041
45120_terrestrial,153,176,68,117,329,44.44444444444444,76.47058823529412
45121_terrestrial,172,199,80,130,371,46.51162790697674,75.5813953488372
45122_terrestrial,195,232,91,152,427,46.666666666666664,77.94871794871796
45123_terrestrial,335,375,220,161,710,65.67164179104478,48.059701492537314
45317_terrestrial,409,414,200,232,823,48.899755501222494,56.723716381418086
45318_terrestrial,426,412,211,244,838,49.53051643192488,57.27699530516433
45319_terrestrial,468,456,226,279,924,48.29059829059829,59.61538461538461
45320_terrestrial,455,442,218,271,897,47.91208791208791,59.56043956043956
45321_terrestrial,256,179,72,228,435,28.125,89.0625
45322_terrestrial,231,179,60,210,410,25.97402597402597,90.9090909090909
45323_terrestrial,249,185,68,223,434,27.309236947791167,89.5582329317269
45324_terrestrial,258,186,71,231,444,27.51937984496124,89.53488372093024
45325_terrestrial,254,196,70,222,450,27.559055118110237,87.4015748031496
45326_terrestrial,253,195,70,222,448,27.66798418972332,87.74703557312253
45327_terrestrial,257,209,73,223,466,28.404669260700388,86.7704280155642
45328_terrestrial,261,240,74,227,501,28.35249042145594,86.97318007662835
45329_terrestrial,261,252,72,229,513,27.586206896551722,87.73946360153256
45330_terrestrial,295,273,93,250,568,31.52542372881356,84.7457627118644
45331_terrestrial,629,528,325,369,1157,51.669316375198726,58.66454689984102
45354_terrestrial,287,242,216,112,529,75.26132404181185,39.02439024390244
45355_terrestrial,305,248,235,120,553,77.04918032786885,39.34426229508197
45467_terrestrial,186,251,117,98,437,62.903225806451616,52.68817204301075
45468_terrestrial,200,281,127,104,481,63.5,52
45469_terrestrial,121,172,54,98,293,44.62809917355372,80.99173553719008
45470_terrestrial,96,179,43,72,275,44.79166666666667,75
45471_terrestrial,113,183,49,83,296,43.36283185840708,73.45132743362832
45472_terrestrial,124,162,51,89,286,41.12903225806452,71.7741935483871
45473_terrestrial,130,162,52,96,292,40,73.84615384615385
45474_terrestrial,137,166,53,104,303,38.68613138686132,75.91240875912408
45475_terrestrial,144,176,56,111,320,38.88888888888889,77.08333333333334
45476_terrestrial,153,185,61,120,338,39.869281045751634,78.43137254901961
45477_terrestrial,155,179,66,120,334,42.58064516129032,77.41935483870968
45478_terrestrial,141,166,59,111,307,41.843971631205676,78.72340425531915
45479_terrestrial,136,157,56,109,293,41.17647058823529,80.14705882352942
45480_terrestrial,137,151,56,109,288,40.87591240875913,79.56204379562044
45481_terrestrial,141,156,62,113,297,43.97163120567376,80.1418439716312
45482_terrestrial,150,157,68,115,307,45.33333333333333,76.66666666666667
45483_terrestrial,288,275,190,139,563,65.97222222222221,48.26388888888889
45484_terrestrial,289,319,190,138,608,65.7439446366782,47.75086505190311
45680_terrestrial,435,425,213,256,860,48.96551724137931,58.85057471264368
45681_terrestrial,268,201,76,233,469,28.35820895522388,86.94029850746269
45682_terrestrial,253,198,63,225,451,24.90118577075099,88.93280632411067
45683_terrestrial,253,210,65,225,463,25.691699604743086,88.93280632411067
45684_terrestrial,263,195,73,231,458,27.756653992395435,87.83269961977186
45685_terrestrial,268,211,74,238,479,27.611940298507463,88.80597014925374
45686_terrestrial,270,232,74,241,502,27.40740740740741,89.25925925925927
45687_terrestrial,263,252,74,235,515,28.13688212927757,89.35361216730038
45688_terrestrial,269,256,75,235,525,27.881040892193308,87.36059479553904
45689_terrestrial,257,254,78,220,511,30.35019455252918,85.60311284046692
45690_terrestrial,526,506,275,296,1032,52.28136882129277,56.27376425855514
45691_terrestrial,536,474,284,300,1010,52.98507462686567,55.970149253731336
45714_terrestrial,251,219,201,87,470,80.0796812749004,34.66135458167331
45715_terrestrial,303,260,235,120,563,77.55775577557755,39.603960396039604
45716_terrestrial,293,263,227,115,556,77.47440273037543,39.249146757679185
45827_terrestrial,201,269,126,110,470,62.68656716417911,54.72636815920397
45828_terrestrial,112,169,46,98,281,41.07142857142857,87.5
45829_terrestrial,112,184,47,88,296,41.964285714285715,78.57142857142857
45830_terrestrial,98,171,45,74,269,45.91836734693878,75.51020408163265
45831_terrestrial,114,171,51,83,285,44.73684210526316,72.80701754385966
45832_terrestrial,121,166,50,86,287,41.32231404958678,71.07438016528926
45833_terrestrial,128,154,51,98,282,39.84375,76.5625
45834_terrestrial,142,156,58,107,298,40.845070422535215,75.35211267605634
45835_terrestrial,143,173,57,110,316,39.86013986013986,76.92307692307693
45836_terrestrial,151,185,61,118,336,40.397350993377486,78.1456953642384
45837_terrestrial,153,187,67,119,340,43.790849673202615,77.77777777777779
45838_terrestrial,156,181,64,122,337,41.02564102564102,78.2051282051282
45839_terrestrial,143,167,58,117,310,40.55944055944056,81.81818181818183
45840_terrestrial,134,147,54,108,281,40.298507462686565,80.59701492537313
45841_terrestrial,132,141,56,106,273,42.42424242424242,80.3030303030303
45842_terrestrial,143,152,64,115,295,44.75524475524475,80.41958041958041
45843_terrestrial,272,315,181,130,587,66.54411764705883,47.794117647058826
45844_terrestrial,264,262,174,127,526,65.9090909090909,48.10606060606061
46040_terrestrial,416,417,207,237,833,49.75961538461539,56.97115384615385
46041_terrestrial,432,459,213,251,891,49.30555555555556,58.10185185185185
46042_terrestrial,260,219,80,221,479,30.76923076923077,85
46043_terrestrial,258,222,79,221,480,30.620155038759687,85.65891472868216
46044_terrestrial,262,211,77,232,473,29.389312977099237,88.54961832061069
46045_terrestrial,471,494,235,277,965,49.89384288747346,58.81104033970276
46046_terrestrial,473,509,234,279,982,49.471458773784356,58.985200845665965
46047_terrestrial,266,257,83,231,523,31.203007518796994,86.8421052631579
46048_terrestrial,471,502,243,262,973,51.59235668789809,55.62632696390658
46049_terrestrial,466,494,250,255,960,53.648068669527895,54.72103004291845
46050_terrestrial,505,511,275,268,1016,54.45544554455446,53.069306930693074
46075_terrestrial,260,209,209,96,469,80.38461538461539,36.92307692307693
46076_terrestrial,291,264,227,111,555,78.00687285223368,38.144329896907216
46077_terrestrial,273,246,215,100,519,78.75457875457876,36.63003663003663
46078_terrestrial,262,238,202,96,500,77.09923664122137,36.6412213740458
46079_terrestrial,250,241,193,90,491,77.2,36
46187_terrestrial,194,258,121,102,452,62.371134020618555,52.57731958762887
46188_terrestrial,111,159,44,94,270,39.63963963963964,84.68468468468468
46189_terrestrial,111,191,48,86,302,43.24324324324324,77.47747747747748
46190_terrestrial,107,211,47,82,318,43.925233644859816,76.63551401869158
46191_terrestrial,107,162,46,79,269,42.99065420560748,73.83177570093457
46192_terrestrial,122,157,50,87,279,40.98360655737705,71.31147540983606
46193_terrestrial,126,153,49,94,279,38.88888888888889,74.60317460317461
46194_terrestrial,138,153,56,106,291,40.57971014492754,76.81159420289855
46195_terrestrial,142,172,57,111,314,40.140845070422536,78.16901408450704
46196_terrestrial,152,179,62,119,331,40.78947368421053,78.28947368421053
46197_terrestrial,158,189,71,122,347,44.936708860759495,77.21518987341773
46198_terrestrial,267,330,160,140,597,59.925093632958806,52.43445692883895
46199_terrestrial,249,295,148,132,544,59.43775100401606,53.01204819277109
46200_terrestrial,244,277,148,127,521,60.65573770491803,52.04918032786885
46201_terrestrial,236,288,147,120,524,62.28813559322034,50.847457627118644
46202_terrestrial,238,265,149,121,503,62.60504201680672,50.84033613445378
46203_terrestrial,243,254,159,115,497,65.4320987654321,47.325102880658434
46401_terrestrial,411,423,210,227,834,51.09489051094891,55.23114355231144
46402_terrestrial,430,438,221,236,868,51.3953488372093,54.88372093023256
46403_terrestrial,434,442,224,237,876,51.61290322580645,54.60829493087558
46404_terrestrial,443,449,226,245,892,51.0158013544018,55.30474040632054
46405_terrestrial,457,460,236,257,917,51.64113785557986,56.236323851203494
46406_terrestrial,477,466,247,269,943,51.78197064989518,56.39412997903563
46407_terrestrial,469,478,253,258,947,53.94456289978679,55.010660980810236
46408_terrestrial,450,454,241,244,904,53.55555555555556,54.22222222222223
46435_terrestrial,247,230,195,90,477,78.94736842105263,36.43724696356275
46436_terrestrial,95,43,54,73,138,56.84210526315789,76.84210526315789
46437_terrestrial,103,37,61,78,140,59.22330097087378,75.72815533980582
46438_terrestrial,268,248,206,100,516,76.86567164179104,37.3134328358209
46439_terrestrial,247,236,194,89,483,78.54251012145748,36.032388663967616
46547_terrestrial,190,263,116,102,453,61.05263157894737,53.68421052631579
46548_terrestrial,112,174,44,94,286,39.285714285714285,83.92857142857143
46549_terrestrial,108,201,47,83,309,43.51851851851852,76.85185185185185
46550_terrestrial,104,194,42,80,298,40.38461538461539,76.92307692307693
46551_terrestrial,95,148,38,68,243,40,71.57894736842105
46552_terrestrial,113,143,49,83,256,43.36283185840708,73.45132743362832
46553_terrestrial,118,147,47,86,265,39.83050847457627,72.88135593220339
46554_terrestrial,130,141,54,98,271,41.53846153846154,75.38461538461539
46555_terrestrial,132,150,53,104,282,40.15151515151515,78.78787878787878
46556_terrestrial,139,155,56,108,294,40.28776978417266,77.6978417266187
46557_terrestrial,148,165,65,114,313,43.91891891891892,77.02702702702703
46558_terrestrial,258,292,158,134,550,61.240310077519375,51.93798449612403
46764_terrestrial,318,306,197,134,624,61.94968553459119,42.138364779874216
46765_terrestrial,325,313,200,139,638,61.53846153846154,42.769230769230774
46767_terrestrial,424,427,229,223,851,54.009433962264154,52.594339622641506
46768_terrestrial,327,320,203,146,647,62.079510703363916,44.64831804281346
46769_terrestrial,333,320,207,150,653,62.16216216216216,45.04504504504504
46794_terrestrial,227,224,181,77,451,79.73568281938326,33.92070484581498
46795_terrestrial,250,230,193,94,480,77.2,37.6
46796_terrestrial,241,221,186,89,462,77.17842323651453,36.92946058091287
46797_terrestrial,251,247,196,94,498,78.08764940239044,37.45019920318725
46798_terrestrial,246,242,192,90,488,78.04878048780488,36.58536585365854
46907_terrestrial,177,252,105,99,429,59.32203389830508,55.932203389830505
46908_terrestrial,113,172,48,91,285,42.47787610619469,80.53097345132744
46909_terrestrial,104,203,46,79,307,44.230769230769226,75.96153846153845
46910_terrestrial,107,180,43,81,287,40.18691588785047,75.70093457943925
46911_terrestrial,95,148,40,67,243,42.10526315789473,70.52631578947368
46912_terrestrial,98,151,41,72,249,41.83673469387755,73.46938775510205
46913_terrestrial,108,156,45,83,264,41.66666666666667,76.85185185185185
46914_terrestrial,118,151,47,93,269,39.83050847457627,78.8135593220339
46915_terrestrial,228,265,130,119,493,57.01754385964912,52.19298245614035
46916_terrestrial,227,293,132,118,520,58.14977973568281,51.98237885462555
46917_terrestrial,137,142,59,109,279,43.06569343065693,79.56204379562044
46918_terrestrial,232,249,137,123,481,59.05172413793104,53.01724137931034
47124_terrestrial,302,294,183,129,596,60.59602649006622,42.71523178807947
47125_terrestrial,358,375,212,158,733,59.217877094972074,44.134078212290504
47126_terrestrial,330,349,195,150,679,59.09090909090909,45.45454545454545
47127_terrestrial,337,346,199,154,683,59.05044510385756,45.6973293768546
47128_terrestrial,374,396,225,173,770,60.16042780748663,46.25668449197861
47129_terrestrial,382,396,231,173,778,60.47120418848168,45.287958115183244
47153_terrestrial,234,225,180,91,459,76.92307692307693,38.88888888888889
47154_terrestrial,232,229,175,86,461,75.43103448275862,37.06896551724138
47155_terrestrial,239,232,181,92,471,75.73221757322176,38.49372384937239
47156_terrestrial,253,235,194,97,488,76.6798418972332,38.3399209486166
47157_terrestrial,242,232,188,85,474,77.68595041322314,35.12396694214876
47267_terrestrial,178,234,106,99,412,59.55056179775281,55.61797752808989
47268_terrestrial,189,250,114,101,439,60.317460317460316,53.43915343915344
47269_terrestrial,103,200,47,76,303,45.63106796116505,73.7864077669903
47270_terrestrial,103,161,42,79,264,40.77669902912621,76.69902912621359
47271_terrestrial,92,141,39,68,233,42.391304347826086,73.91304347826086
47272_terrestrial,94,141,39,69,235,41.48936170212766,73.40425531914893
47273_terrestrial,97,150,40,72,247,41.23711340206185,74.22680412371135
47274_terrestrial,106,147,43,81,253,40.56603773584906,76.41509433962264
47275_terrestrial,206,241,122,102,447,59.22330097087378,49.51456310679612
47276_terrestrial,197,213,109,110,410,55.32994923857868,55.83756345177665
47277_terrestrial,134,151,59,101,285,44.02985074626866,75.3731343283582
47278_terrestrial,213,231,123,116,444,57.74647887323944,54.460093896713616
47485_terrestrial,314,327,188,147,641,59.87261146496815,46.81528662420382
47486_terrestrial,330,357,195,149,687,59.09090909090909,45.151515151515156
47487_terrestrial,353,365,212,164,718,60.05665722379604,46.45892351274787
47488_terrestrial,354,367,212,165,721,59.887005649717516,46.61016949152542
47489_terrestrial,350,342,210,163,692,60,46.57142857142857
47512_terrestrial,85,50,49,61,135,57.647058823529406,71.76470588235294
47513_terrestrial,230,236,175,90,466,76.08695652173914,39.130434782608695
47514_terrestrial,253,235,191,103,488,75.49407114624506,40.71146245059288
47515_terrestrial,249,273,190,97,522,76.30522088353415,38.95582329317269
47516_terrestrial,247,260,188,95,507,76.11336032388664,38.46153846153847
47517_terrestrial,224,218,175,77,442,78.125,34.375
47628_terrestrial,170,229,98,82,399,57.647058823529406,48.23529411764706
47629_terrestrial,96,173,43,71,269,44.79166666666667,73.95833333333334
47630_terrestrial,102,149,42,78,251,41.17647058823529,76.47058823529412
47631_terrestrial,90,127,39,66,217,43.333333333333336,73.33333333333333
47632_terrestrial,90,125,38,67,215,42.22222222222222,74.44444444444444
47633_terrestrial,91,126,38,66,217,41.75824175824176,72.52747252747253
47634_terrestrial,100,127,39,74,227,39,74
47635_terrestrial,201,206,120,98,407,59.70149253731343,48.756218905472636
47636_terrestrial,199,245,123,98,444,61.80904522613066,49.246231155778894
47846_terrestrial,300,289,177,140,589,59,46.666666666666664
47847_terrestrial,157,134,63,123,291,40.12738853503185,78.343949044586
47848_terrestrial,347,342,208,166,689,59.94236311239193,47.83861671469741
47849_terrestrial,348,338,211,163,686,60.63218390804598,46.839080459770116
47871_terrestrial,196,204,151,69,400,77.04081632653062,35.204081632653065
47872_terrestrial,212,216,161,82,428,75.94339622641509,38.67924528301887
47873_terrestrial,93,42,53,72,135,56.98924731182796,77.41935483870968
47874_terrestrial,231,269,176,87,500,76.19047619047619,37.66233766233766
47875_terrestrial,203,228,154,75,431,75.86206896551724,36.94581280788177
47988_terrestrial,161,227,97,79,388,60.24844720496895,49.06832298136646
47989_terrestrial,93,159,40,70,252,43.01075268817204,75.26881720430107
47990_terrestrial,98,133,40,77,231,40.816326530612244,78.57142857142857
47991_terrestrial,88,129,38,67,217,43.18181818181818,76.13636363636364
47992_terrestrial,83,118,35,64,201,42.168674698795186,77.10843373493977
47993_terrestrial,83,107,36,64,190,43.373493975903614,77.10843373493977
47994_terrestrial,91,108,39,71,199,42.857142857142854,78.02197802197803
47995_terrestrial,190,238,113,97,428,59.473684210526315,51.05263157894737
47996_terrestrial,187,213,113,96,400,60.42780748663101,51.33689839572193
48206_terrestrial,283,272,170,131,555,60.07067137809188,46.28975265017668
48207_terrestrial,308,318,184,144,626,59.74025974025974,46.75324675324675
48208_terrestrial,334,335,199,160,669,59.58083832335329,47.90419161676647
48229_terrestrial,192,201,147,69,393,76.5625,35.9375
48230_terrestrial,82,44,47,62,126,57.3170731707317,75.60975609756098
48231_terrestrial,209,221,159,81,430,76.07655502392345,38.75598086124402
48232_terrestrial,211,237,159,86,448,75.35545023696683,40.758293838862556
48233_terrestrial,231,260,175,95,491,75.75757575757575,41.125541125541126
48234_terrestrial,218,257,166,87,475,76.14678899082568,39.908256880733944
48349_terrestrial,90,150,40,67,240,44.44444444444444,74.44444444444444
48350_terrestrial,94,135,41,73,229,43.61702127659575,77.6595744680851
48351_terrestrial,81,116,36,62,197,44.44444444444444,76.5432098765432
48352_terrestrial,80,109,35,62,189,43.75,77.5
48353_terrestrial,88,105,39,68,193,44.31818181818182,77.27272727272727
48354_terrestrial,104,102,50,78,206,48.07692307692308,75
48588_terrestrial,198,208,153,73,406,77.27272727272727,36.868686868686865
48589_terrestrial,204,208,157,82,412,76.9607843137255,40.19607843137255
48590_terrestrial,83,44,48,67,127,57.831325301204814,80.72289156626506
48591_terrestrial,89,44,52,69,133,58.42696629213483,77.52808988764045
48592_terrestrial,215,248,165,84,463,76.74418604651163,39.06976744186046
48709_terrestrial,89,149,42,68,238,47.19101123595505,76.40449438202246
48710_terrestrial,92,136,39,71,228,42.391304347826086,77.17391304347827
48711_terrestrial,81,114,37,62,195,45.67901234567901,76.5432098765432
48947_terrestrial,197,215,152,70,412,77.15736040609137,35.53299492385787
48948_terrestrial,208,220,158,78,428,75.96153846153845,37.5
48949_terrestrial,82,35,47,65,117,57.3170731707317,79.26829268292683
48950_terrestrial,86,35,50,65,121,58.139534883720934,75.5813953488372
48951_terrestrial,216,252,162,89,468,75,41.2037037037037
48952_terrestrial,195,211,147,75,406,75.38461538461539,38.46153846153847
49307_terrestrial,186,203,147,69,389,79.03225806451613,37.096774193548384
49308_terrestrial,207,237,157,85,444,75.84541062801932,41.06280193236715
49309_terrestrial,208,231,157,87,439,75.48076923076923,41.82692307692308
49310_terrestrial,203,238,154,81,441,75.86206896551724,39.90147783251231
49311_terrestrial,199,231,151,75,430,75.87939698492463,37.68844221105528
49668_terrestrial,181,214,139,72,395,76.79558011049724,39.77900552486188
49669_terrestrial,175,209,136,69,384,77.71428571428571,39.42857142857143
6688_marine,152,75,109,88,227,71.71052631578947,57.89473684210527
6689_marine,152,73,111,86,225,73.02631578947368,56.57894736842105
7042_marine,194,87,139,116,281,71.64948453608247,59.79381443298969
7043_marine,169,87,121,100,256,71.59763313609467,59.171597633136095
7044_marine,190,84,133,117,274,70,61.578947368421055
7045_marine,194,80,139,122,274,71.64948453608247,62.88659793814433
7046_marine,196,84,140,122,280,71.42857142857143,62.244897959183675
7047_marine,179,82,128,110,261,71.50837988826815,61.452513966480446
7048_marine,166,79,119,99,245,71.6867469879518,59.63855421686747
7049_marine,186,80,132,116,266,70.96774193548387,62.365591397849464
7050_marine,191,83,136,116,274,71.20418848167539,60.73298429319372
7051_marine,165,75,120,99,240,72.72727272727273,60
7052_marine,155,68,111,92,223,71.61290322580646,59.354838709677416
7151_marine,84,43,57,42,127,67.85714285714286,50
7398_marine,206,97,144,128,303,69.90291262135922,62.13592233009708
7399_marine,212,86,150,133,298,70.75471698113208,62.735849056603776
7400_marine,199,85,141,126,284,70.85427135678391,63.31658291457286
7401_marine,197,89,140,121,286,71.06598984771574,61.42131979695431
7402_marine,187,80,133,115,267,71.12299465240642,61.49732620320856
7404_marine,172,74,118,104,246,68.6046511627907,60.46511627906976
7410_marine,179,77,123,109,256,68.71508379888269,60.893854748603346
7411_marine,182,78,127,113,260,69.78021978021978,62.08791208791209
7413_marine,152,69,106,88,221,69.73684210526315,57.89473684210527
7414_marine,155,71,106,92,226,68.38709677419355,59.354838709677416
7416_marine,144,63,98,86,207,68.05555555555556,59.72222222222222
7417_marine,141,63,96,82,204,68.08510638297872,58.156028368794324
7756_marine,219,104,155,130,323,70.77625570776256,59.3607305936073
7757_marine,221,100,156,130,321,70.58823529411765,58.82352941176471
7758_marine,207,93,144,127,300,69.56521739130434,61.35265700483091
8114_marine,224,95,157,136,319,70.08928571428571,60.71428571428571
8115_marine,237,101,167,146,338,70.46413502109705,61.60337552742617
8116_marine,227,95,159,141,322,70.04405286343612,62.11453744493392
8117_marine,194,87,138,114,281,71.1340206185567,58.76288659793815
8132_marine,159,61,101,115,220,63.52201257861635,72.32704402515722
8133_marine,196,75,133,132,271,67.85714285714286,67.3469387755102
8148_marine,115,55,71,63,170,61.73913043478261,54.78260869565217
8473_marine,240,98,170,139,338,70.83333333333334,57.91666666666667
8474_marine,251,97,178,154,348,70.91633466135458,61.354581673306775
8493_marine,200,80,133,133,280,66.5,66.5
8494_marine,211,81,136,137,292,64.45497630331754,64.92890995260665
8495_marine,213,78,136,136,291,63.84976525821596,63.84976525821596
8506_marine,112,54,73,59,166,65.17857142857143,52.67857142857143
8507_marine,122,59,78,67,181,63.934426229508205,54.91803278688525
8508_marine,119,58,76,64,177,63.86554621848739,53.78151260504202
8530_marine,119,64,75,69,183,63.02521008403361,57.98319327731093
8531_marine,119,59,77,71,178,64.70588235294117,59.66386554621849
8532_marine,114,57,72,71,171,63.1578947368421,62.28070175438597
8533_marine,99,53,59,56,152,59.59595959595959,56.56565656565656
8832_marine,248,97,175,141,345,70.56451612903226,56.85483870967742
8833_marine,253,96,178,152,349,70.35573122529645,60.079051383399204
8834_marine,150,49,97,112,199,64.66666666666666,74.66666666666667
8842_marine,203,75,136,140,278,66.99507389162561,68.96551724137932
8843_marine,203,74,137,139,277,67.48768472906403,68.4729064039409
8844_marine,193,77,130,133,270,67.35751295336787,68.9119170984456
8845_marine,227,85,150,156,312,66.07929515418502,68.72246696035242
8846_marine,233,85,147,163,318,63.0901287553648,69.95708154506438
8855_marine,210,79,135,140,289,64.28571428571429,66.66666666666666
9191_marine,253,108,178,144,361,70.35573122529645,56.916996047430835
9192_marine,266,113,186,158,379,69.92481203007519,59.3984962406015
9201_marine,198,71,133,139,269,67.17171717171718,70.2020202020202
9202_marine,204,75,134,145,279,65.68627450980392,71.07843137254902
9204_marine,226,86,146,156,312,64.60176991150442,69.02654867256636
9205_marine,231,82,148,161,313,64.06926406926407,69.6969696969697
9206_marine,227,77,147,159,304,64.75770925110133,70.04405286343612
9215_marine,214,79,135,142,293,63.084112149532714,66.35514018691589
9217_marine,215,80,135,142,295,62.7906976744186,66.04651162790698
9218_marine,203,75,130,136,278,64.03940886699507,66.99507389162561
9219_marine,201,73,129,134,274,64.17910447761194,66.66666666666666
9548_marine,263,120,185,148,383,70.34220532319392,56.27376425855514
9549_marine,269,123,186,153,392,69.14498141263941,56.877323420074354
9550_marine,281,120,195,162,401,69.3950177935943,57.65124555160143
9551_marine,272,113,189,159,385,69.48529411764706,58.45588235294118
9552_marine,264,111,182,153,375,68.93939393939394,57.95454545454546
9559_marine,197,80,129,135,277,65.48223350253807,68.52791878172589
9560_marine,203,78,134,141,281,66.00985221674877,69.45812807881774
9561_marine,224,80,146,156,304,65.17857142857143,69.64285714285714
9562_marine,240,96,153,168,336,63.74999999999999,70
9563_marine,231,92,149,160,323,64.5021645021645,69.26406926406926
9564_marine,229,82,148,158,311,64.62882096069869,68.99563318777294
9578_marine,205,78,129,135,283,62.926829268292686,65.85365853658537
9906_marine,288,125,205,163,413,71.18055555555556,56.59722222222222
9907_marine,279,118,197,161,397,70.60931899641577,57.70609318996416
9908_marine,275,119,195,159,394,70.9090909090909,57.81818181818181
9909_marine,266,115,188,151,381,70.67669172932331,56.766917293233085
9918_marine,205,84,135,140,289,65.85365853658537,68.29268292682927
9919_marine,201,80,131,138,281,65.17412935323384,68.65671641791045
9922_marine,242,97,152,167,339,62.8099173553719,69.00826446280992
10110_marine,207,133,102,124,340,49.275362318840585,59.90338164251207
10111_marine,207,129,104,122,336,50.24154589371981,58.93719806763285
10112_marine,206,131,108,117,337,52.42718446601942,56.79611650485437
10113_marine,214,132,114,125,346,53.271028037383175,58.41121495327103
10114_marine,211,128,107,122,339,50.71090047393365,57.81990521327014
10265_marine,287,130,203,154,417,70.73170731707317,53.65853658536586
10266_marine,298,132,213,166,430,71.47651006711409,55.70469798657718
10267_marine,276,129,202,146,405,73.18840579710145,52.89855072463768
10268_marine,257,117,185,129,374,71.98443579766537,50.19455252918288
10278_marine,219,91,145,149,310,66.21004566210046,68.0365296803653
10282_marine,253,107,162,173,360,64.03162055335969,68.37944664031622
10471_marine,234,138,119,138,372,50.85470085470085,58.97435897435898
10472_marine,223,132,118,132,355,52.91479820627802,59.19282511210763
10473_marine,225,131,123,133,356,54.666666666666664,59.111111111111114
10474_marine,219,131,116,130,350,52.96803652968036,59.3607305936073
10475_marine,220,133,115,131,353,52.27272727272727,59.54545454545455
10476_marine,218,135,112,128,353,51.37614678899083,58.71559633027523
10477_marine,214,124,115,120,338,53.73831775700935,56.074766355140184
10478_marine,207,123,111,115,330,53.62318840579711,55.55555555555556
10479_marine,211,122,113,118,333,53.55450236966824,55.92417061611374
10481_marine,205,119,105,115,324,51.21951219512195,56.09756097560976
10625_marine,282,133,204,147,415,72.3404255319149,52.12765957446809
10626_marine,293,128,212,160,421,72.35494880546075,54.60750853242321
10627_marine,273,132,199,140,405,72.89377289377289,51.28205128205128
10628_marine,238,108,173,117,346,72.68907563025209,49.159663865546214
10638_marine,243,98,166,163,341,68.3127572016461,67.07818930041152
10639_marine,250,96,168,166,346,67.2,66.4
10640_marine,198,63,135,152,261,68.18181818181817,76.76767676767676
10641_marine,215,73,150,161,288,69.76744186046511,74.88372093023256
10642_marine,270,110,176,179,380,65.18518518518519,66.2962962962963
10643_marine,266,110,173,179,376,65.0375939849624,67.29323308270678
10644_marine,251,109,164,166,360,65.33864541832669,66.13545816733067
10645_marine,254,113,164,168,367,64.56692913385827,66.14173228346458
10646_marine,258,113,167,170,371,64.72868217054264,65.89147286821705
10647_marine,259,114,167,170,373,64.47876447876449,65.63706563706563
10648_marine,282,115,178,189,397,63.12056737588653,67.02127659574468
10649_marine,278,121,173,190,399,62.23021582733813,68.34532374100719
10650_marine,277,113,175,189,390,63.1768953068592,68.23104693140795
10651_marine,256,108,162,172,364,63.28125,67.1875
10837_marine,221,127,123,121,348,55.65610859728507,54.75113122171946
10839_marine,224,124,125,123,348,55.80357142857143,54.91071428571429
10840_marine,222,126,123,123,348,55.4054054054054,55.4054054054054
10841_marine,228,134,122,134,362,53.50877192982456,58.77192982456141
10842_marine,222,131,119,132,353,53.6036036036036,59.45945945945946
10844_marine,219,134,117,128,353,53.42465753424658,58.44748858447488
10845_marine,246,150,124,151,396,50.40650406504065,61.382113821138205
10977_marine,252,101,204,114,353,80.95238095238095,45.23809523809524
10978_marine,252,95,203,114,347,80.55555555555556,45.23809523809524
10986_marine,335,140,246,190,475,73.43283582089552,56.71641791044776
10987_marine,274,131,199,140,405,72.62773722627736,51.09489051094891
10990_marine,309,130,228,167,439,73.7864077669903,54.0453074433657
10991_marine,350,136,258,192,486,73.71428571428571,54.85714285714286
10992_marine,320,130,233,175,450,72.8125,54.6875
10998_marine,217,85,142,151,302,65.43778801843318,69.5852534562212
10999_marine,262,104,180,171,366,68.70229007633588,65.2671755725191
11000_marine,244,99,168,156,343,68.85245901639344,63.934426229508205
11001_marine,210,66,147,150,276,70,71.42857142857143
11002_marine,203,67,145,145,270,71.42857142857143,71.42857142857143
11003_marine,299,116,195,203,415,65.21739130434783,67.89297658862876
11004_marine,316,133,205,216,449,64.87341772151899,68.35443037974683
11005_marine,307,131,198,213,438,64.49511400651465,69.38110749185668
11006_marine,292,121,190,199,413,65.06849315068493,68.15068493150685
11007_marine,288,119,187,196,407,64.93055555555556,68.05555555555556
11008_marine,274,114,174,185,388,63.503649635036496,67.51824817518248
11009_marine,280,112,176,187,392,62.857142857142854,66.78571428571428
11010_marine,274,110,175,187,384,63.868613138686136,68.24817518248175
11123_marine,179,87,110,113,266,61.452513966480446,63.128491620111724
11124_marine,180,90,111,114,270,61.66666666666667,63.33333333333333
11125_marine,178,85,108,114,263,60.67415730337079,64.04494382022472
11126_marine,170,84,104,109,254,61.1764705882353,64.11764705882354
11127_marine,173,85,106,109,258,61.27167630057804,63.005780346820806
11128_marine,173,90,108,111,263,62.42774566473989,64.16184971098265
11129_marine,174,92,109,112,266,62.643678160919535,64.36781609195403
11130_marine,180,92,115,116,272,63.888888888888886,64.44444444444444
11131_marine,182,93,119,118,275,65.38461538461539,64.83516483516483
11132_marine,175,95,112,111,270,64,63.42857142857142
11133_marine,169,89,106,107,258,62.721893491124256,63.31360946745562
11134_marine,167,87,105,106,254,62.874251497005986,63.47305389221557
11135_marine,171,98,109,108,269,63.74269005847953,63.1578947368421
11202_marine,224,128,123,125,352,54.91071428571429,55.80357142857143
11203_marine,231,137,126,129,368,54.54545454545454,55.84415584415584
11204_marine,254,153,136,145,407,53.54330708661418,57.08661417322835
11205_marine,247,153,127,144,400,51.417004048582996,58.2995951417004
11206_marine,249,159,128,146,408,51.40562248995983,58.63453815261044
11207_marine,233,153,117,138,386,50.21459227467812,59.227467811158796
11335_marine,299,134,226,137,433,75.58528428093646,45.819397993311036
11336_marine,301,132,224,142,433,74.4186046511628,47.176079734219265
11337_marine,352,133,267,188,485,75.85227272727273,53.40909090909091
11338_marine,255,95,206,116,350,80.7843137254902,45.490196078431374
11346_marine,349,147,259,197,496,74.21203438395415,56.446991404011456
11347_marine,360,152,262,204,512,72.77777777777777,56.666666666666664
11348_marine,321,138,235,162,459,73.20872274143302,50.467289719626166
11349_marine,305,139,223,158,444,73.11475409836066,51.80327868852459
11350_marine,319,146,230,172,465,72.10031347962382,53.91849529780565
11351_marine,339,149,249,183,488,73.45132743362832,53.98230088495575
11352_marine,329,138,234,179,467,71.12462006079028,54.40729483282675
11357_marine,263,104,181,170,367,68.8212927756654,64.63878326996198
11358_marine,258,103,180,168,361,69.76744186046511,65.11627906976744
11359_marine,242,96,168,157,338,69.42148760330579,64.87603305785123
11360_marine,145,44,110,89,189,75.86206896551724,61.37931034482759
11362_marine,254,78,176,184,332,69.29133858267717,72.44094488188976
11363_marine,264,80,180,192,344,68.18181818181817,72.72727272727273
11364_marine,306,130,197,206,436,64.37908496732027,67.3202614379085
11365_marine,287,132,188,196,419,65.50522648083623,68.29268292682927
11481_marine,180,78,114,114,258,63.33333333333333,63.33333333333333
11482_marine,184,83,114,118,267,61.95652173913043,64.13043478260869
11483_marine,182,85,112,115,267,61.53846153846154,63.18681318681318
11492_marine,171,90,109,106,261,63.74269005847953,61.98830409356725
11493_marine,173,84,110,108,257,63.58381502890174,62.42774566473989
11567_marine,244,155,123,141,399,50.409836065573764,57.786885245901644
11568_marine,221,135,112,124,356,50.678733031674206,56.10859728506787
11694_marine,298,128,235,146,426,78.85906040268456,48.99328859060403
11695_marine,327,141,247,165,468,75.53516819571865,50.45871559633027
11696_marine,319,136,236,168,455,73.98119122257053,52.66457680250783
11697_marine,340,135,253,187,475,74.41176470588235,55.00000000000001
11698_marine,340,138,257,176,478,75.58823529411765,51.76470588235295
11699_marine,313,138,241,157,451,76.99680511182109,50.159744408945684
11708_marine,321,144,234,162,465,72.89719626168224,50.467289719626166
11709_marine,343,156,251,178,499,73.17784256559767,51.89504373177842
11710_marine,340,150,248,181,490,72.94117647058823,53.23529411764706
11711_marine,335,151,249,181,486,74.32835820895522,54.02985074626866
11712_marine,343,136,249,193,479,72.59475218658892,56.268221574344025
11713_marine,308,124,220,168,432,71.42857142857143,54.54545454545454
11717_marine,280,124,191,182,404,68.21428571428572,65
11718_marine,226,87,160,159,313,70.79646017699115,70.35398230088495
11719_marine,211,75,152,142,286,72.03791469194313,67.29857819905213
11720_marine,206,74,148,138,280,71.84466019417476,66.99029126213593
11722_marine,297,124,195,194,421,65.65656565656566,65.31986531986533
11723_marine,321,132,210,217,453,65.42056074766354,67.601246105919
11724_marine,298,132,195,203,430,65.43624161073825,68.12080536912751
11725_marine,299,134,194,203,433,64.88294314381271,67.89297658862876
11839_marine,190,89,123,126,279,64.73684210526316,66.3157894736842
11840_marine,193,85,123,127,278,63.730569948186535,65.80310880829016
11841_marine,190,81,119,123,271,62.63157894736842,64.73684210526316
11928_marine,251,146,125,134,397,49.800796812749006,53.38645418326693
11929_marine,226,150,125,133,376,55.309734513274336,58.849557522123895
11973_marine,126,78,47,87,204,37.301587301587304,69.04761904761905
12054_marine,329,155,253,163,484,76.89969604863222,49.544072948328264
12055_marine,354,152,267,189,506,75.42372881355932,53.38983050847458
12056_marine,304,138,229,152,442,75.32894736842105,50
12057_marine,348,137,261,187,485,75,53.735632183908045
12058_marine,368,150,278,201,518,75.54347826086956,54.61956521739131
12069_marine,367,143,270,204,510,73.56948228882834,55.5858310626703
12070_marine,222,83,149,159,305,67.11711711711712,71.62162162162163
12071_marine,328,140,236,188,468,71.95121951219512,57.3170731707317
12072_marine,293,109,215,172,402,73.37883959044369,58.703071672354945
12073_marine,344,153,244,200,497,70.93023255813954,58.139534883720934
12075_marine,261,120,180,164,381,68.96551724137932,62.83524904214559
12076_marine,261,115,180,164,376,68.96551724137932,62.83524904214559
12077_marine,286,129,198,185,415,69.23076923076923,64.6853146853147
12079_marine,200,72,144,134,272,72,67
12081_marine,283,130,191,181,413,67.49116607773851,63.957597173144876
12082_marine,288,131,193,183,419,67.01388888888889,63.541666666666664
12198_marine,198,96,128,130,294,64.64646464646465,65.65656565656566
12199_marine,201,98,129,133,299,64.17910447761194,66.16915422885572
12288_marine,232,137,128,128,369,55.172413793103445,55.172413793103445
12289_marine,241,155,131,142,396,54.356846473029044,58.921161825726145
12290_marine,251,170,131,154,421,52.191235059760956,61.354581673306775
12291_marine,246,162,129,149,408,52.4390243902439,60.56910569105691
12335_marine,125,80,47,86,205,37.6,68.8
12337_marine,119,78,46,84,197,38.655462184873954,70.58823529411765
12338_marine,119,77,46,84,196,38.655462184873954,70.58823529411765
12412_marine,305,137,236,138,442,77.37704918032787,45.24590163934426
12413_marine,329,135,257,162,464,78.11550151975683,49.24012158054711
12414_marine,358,145,275,181,503,76.81564245810057,50.5586592178771
12415_marine,392,168,290,203,560,73.9795918367347,51.78571428571429
12416_marine,357,151,268,190,508,75.07002801120449,53.221288515406165
12417_marine,321,131,245,167,452,76.32398753894081,52.024922118380054
12418_marine,333,138,249,176,471,74.77477477477478,52.85285285285285
12419_marine,363,145,275,194,508,75.75757575757575,53.4435261707989
12429_marine,377,151,283,206,528,75.06631299734748,54.64190981432361
12430_marine,326,144,238,190,470,73.00613496932516,58.282208588957054
12431_marine,325,148,235,190,473,72.3076923076923,58.46153846153847
12432_marine,299,113,216,188,412,72.24080267558529,62.87625418060201
12433_marine,346,154,249,213,500,71.96531791907515,61.5606936416185
12434_marine,271,124,189,165,395,69.74169741697416,60.88560885608856
12435_marine,308,148,202,195,456,65.5844155844156,63.31168831168831
12436_marine,220,98,149,138,318,67.72727272727272,62.727272727272734
12441_marine,291,131,198,189,422,68.04123711340206,64.94845360824742
12442_marine,307,139,207,199,446,67.42671009771986,64.82084690553745
12556_marine,213,99,137,144,312,64.31924882629107,67.6056338028169
12557_marine,218,101,144,148,319,66.05504587155964,67.88990825688074
12558_marine,231,98,151,160,329,65.36796536796537,69.26406926406926
12559_marine,172,61,120,133,233,69.76744186046511,77.32558139534885
12647_marine,227,107,137,132,334,60.352422907488986,58.14977973568281
12648_marine,226,113,132,131,339,58.4070796460177,57.9646017699115
12649_marine,251,161,141,140,412,56.17529880478087,55.77689243027888
12650_marine,248,176,137,146,424,55.24193548387096,58.87096774193549
12651_marine,227,160,129,125,387,56.82819383259912,55.06607929515418
12698_marine,122,77,45,87,199,36.885245901639344,71.31147540983606
12722_marine,159,86,89,87,245,55.9748427672956,54.71698113207547
12723_marine,173,98,99,96,271,57.22543352601156,55.49132947976878
12770_marine,315,158,246,133,473,78.0952380952381,42.22222222222222
12771_marine,336,132,260,158,468,77.38095238095238,47.023809523809526
12772_marine,337,128,263,165,465,78.04154302670622,48.96142433234421
12773_marine,280,118,222,126,398,79.28571428571428,45
12774_marine,290,119,231,135,409,79.65517241379311,46.55172413793103
12775_marine,371,168,284,191,539,76.54986522911051,51.482479784366575
12776_marine,360,153,277,191,513,76.94444444444444,53.05555555555556
12777_marine,382,156,291,206,538,76.17801047120419,53.92670157068062
12778_marine,340,148,260,181,488,76.47058823529412,53.23529411764706
12779_marine,351,147,267,185,498,76.06837606837607,52.70655270655271
12780_marine,353,150,273,189,503,77.33711048158641,53.54107648725213
12789_marine,383,157,282,201,540,73.62924281984334,52.48041775456919
12790_marine,324,137,234,188,461,72.22222222222221,58.0246913580247
12791_marine,353,155,258,215,508,73.08781869688386,60.90651558073654
12792_marine,366,164,263,232,530,71.85792349726776,63.387978142076506
12793_marine,344,163,244,228,507,70.93023255813954,66.27906976744185
12794_marine,324,150,220,210,474,67.90123456790124,64.81481481481481
12795_marine,344,175,227,221,519,65.98837209302324,64.24418604651163
12796_marine,321,170,208,204,491,64.797507788162,63.55140186915887
12797_marine,274,144,183,173,418,66.78832116788321,63.138686131386855
12798_marine,285,141,187,181,426,65.6140350877193,63.50877192982456
12799_marine,294,152,200,188,446,68.02721088435374,63.94557823129252
12800_marine,294,135,202,192,429,68.70748299319727,65.3061224489796
12801_marine,295,134,204,190,429,69.15254237288136,64.40677966101694
12916_marine,222,107,144,152,329,64.86486486486487,68.46846846846847
12917_marine,226,107,148,158,333,65.48672566371681,69.91150442477876
12918_marine,229,107,149,159,336,65.06550218340611,69.43231441048034
12919_marine,235,106,155,162,341,65.95744680851064,68.93617021276596
12920_marine,228,111,149,157,339,65.35087719298247,68.85964912280701
12921_marine,226,111,146,154,337,64.60176991150442,68.14159292035397
12923_marine,221,111,141,152,332,63.80090497737556,68.77828054298642
13007_marine,188,95,115,99,283,61.170212765957444,52.659574468085104
13008_marine,192,100,116,99,292,60.416666666666664,51.5625
13009_marine,183,95,110,100,278,60.10928961748634,54.644808743169406
13010_marine,238,159,140,134,397,58.82352941176471,56.30252100840336
13011_marine,244,166,142,137,410,58.19672131147541,56.14754098360656
13012_marine,244,166,138,140,410,56.557377049180324,57.377049180327866
13013_marine,225,145,128,126,370,56.888888888888886,56.00000000000001
13058_marine,139,88,51,100,227,36.69064748201439,71.94244604316546
13062_marine,115,82,45,78,197,39.130434782608695,67.82608695652173
13080_marine,162,83,89,86,245,54.93827160493827,53.086419753086425
13081_marine,159,86,88,85,245,55.34591194968554,53.459119496855344
13082_marine,150,83,83,80,233,55.333333333333336,53.333333333333336
13130_marine,326,131,254,143,457,77.91411042944786,43.86503067484663
13131_marine,356,125,279,175,481,78.37078651685393,49.157303370786515
13132_marine,301,119,239,135,420,79.40199335548172,44.85049833887043
13134_marine,332,127,263,165,459,79.21686746987952,49.6987951807229
13136_marine,370,159,284,189,529,76.75675675675676,51.08108108108108
13137_marine,389,167,297,213,556,76.34961439588689,54.75578406169666
13138_marine,367,160,284,197,527,77.3841961852861,53.67847411444142
13140_marine,338,148,265,176,486,78.40236686390533,52.071005917159766
13141_marine,345,154,270,181,499,78.26086956521739,52.46376811594203
13145_marine,313,112,246,158,425,78.59424920127796,50.47923322683706
13146_marine,372,157,284,190,529,76.34408602150538,51.075268817204304
13147_marine,367,158,280,186,525,76.29427792915531,50.68119891008175
13148_marine,376,166,283,195,542,75.2659574468085,51.86170212765957
13149_marine,399,175,292,217,574,73.1829573934837,54.385964912280706
13150_marine,377,174,274,208,551,72.67904509283821,55.172413793103445
13152_marine,301,150,206,189,451,68.43853820598007,62.7906976744186
13154_marine,288,146,195,183,434,67.70833333333334,63.541666666666664
13155_marine,314,152,212,203,466,67.51592356687898,64.64968152866241
13277_marine,215,103,140,147,318,65.11627906976744,68.37209302325581
13278_marine,220,107,144,152,327,65.45454545454545,69.0909090909091
13279_marine,224,107,147,154,331,65.625,68.75
13281_marine,256,118,170,173,374,66.40625,67.578125
13282_marine,283,143,182,184,426,64.31095406360424,65.01766784452296
13283_marine,219,114,140,150,333,63.926940639269404,68.4931506849315
13372_marine,246,161,140,139,407,56.91056910569105,56.50406504065041
13373_marine,261,173,142,151,434,54.406130268199234,57.8544061302682
13374_marine,245,160,131,141,405,53.46938775510204,57.55102040816327
13418_marine,137,88,47,97,225,34.306569343065696,70.8029197080292
13419_marine,149,102,50,110,251,33.557046979865774,73.8255033557047
13420_marine,145,101,49,106,246,33.793103448275865,73.10344827586206
13422_marine,130,92,51,93,222,39.23076923076923,71.53846153846153
13490_marine,326,136,260,136,462,79.75460122699386,41.717791411042946
13491_marine,356,133,284,161,489,79.7752808988764,45.2247191011236
13492_marine,306,128,245,133,434,80.06535947712419,43.4640522875817
13493_marine,327,129,262,147,456,80.1223241590214,44.95412844036697
13494_marine,358,135,289,171,493,80.72625698324022,47.76536312849162
13495_marine,314,162,246,139,476,78.343949044586,44.26751592356688
13496_marine,379,167,292,189,546,77.04485488126649,49.86807387862797
13497_marine,313,155,244,147,468,77.95527156549521,46.96485623003195
13501_marine,365,157,283,194,522,77.53424657534246,53.15068493150685
13502_marine,387,160,302,204,547,78.0361757105943,52.71317829457365
13505_marine,392,167,296,206,559,75.51020408163265,52.55102040816326
13642_marine,292,145,187,189,437,64.04109589041096,64.72602739726028
13644_marine,230,123,151,151,353,65.65217391304347,65.65217391304347
13733_marine,257,173,141,149,430,54.86381322957199,57.97665369649806
13734_marine,244,160,130,138,404,53.278688524590166,56.557377049180324
13779_marine,136,87,45,99,223,33.088235294117645,72.79411764705883
13780_marine,163,113,56,124,276,34.355828220858896,76.07361963190185
13781_marine,165,112,58,123,277,35.15151515151515,74.54545454545455
13782_marine,154,110,53,113,264,34.41558441558442,73.37662337662337
13850_marine,331,152,265,136,483,80.06042296072508,41.08761329305136
13851_marine,348,139,276,151,487,79.3103448275862,43.39080459770115
13852_marine,339,136,270,149,475,79.64601769911505,43.95280235988201
13853_marine,328,131,264,143,459,80.48780487804879,43.59756097560975
13855_marine,347,163,276,153,510,79.53890489913545,44.09221902017291
13856_marine,390,174,309,191,564,79.23076923076923,48.97435897435897
13857_marine,392,177,303,198,569,77.29591836734694,50.51020408163265
13858_marine,376,175,298,186,551,79.25531914893617,49.46808510638298
13861_marine,381,162,299,194,543,78.4776902887139,50.91863517060368
13862_marine,420,174,333,215,594,79.28571428571428,51.19047619047619
13863_marine,380,189,278,196,569,73.15789473684211,51.578947368421055
13864_marine,416,185,309,224,601,74.27884615384616,53.84615384615385
13865_marine,415,177,304,228,592,73.25301204819277,54.93975903614457
14001_marine,262,123,176,171,385,67.17557251908397,65.2671755725191
14002_marine,298,150,191,191,448,64.09395973154362,64.09395973154362
14003_marine,231,124,148,155,355,64.06926406926407,67.09956709956711
14004_marine,230,128,150,152,358,65.21739130434783,66.08695652173913
14092_marine,236,141,136,133,377,57.6271186440678,56.355932203389834
14093_marine,278,196,149,155,474,53.597122302158276,55.75539568345324
14094_marine,274,192,144,156,466,52.55474452554745,56.934306569343065
14095_marine,287,204,147,167,491,51.21951219512195,58.18815331010453
14096_marine,272,183,141,165,455,51.83823529411765,60.66176470588235
14097_marine,265,183,133,161,448,50.18867924528302,60.75471698113207
14141_marine,151,97,48,115,248,31.788079470198678,76.15894039735099
14154_marine,206,152,91,138,358,44.1747572815534,66.99029126213593
14155_marine,194,141,88,126,335,45.36082474226804,64.94845360824742
14156_marine,217,145,110,132,362,50.69124423963134,60.82949308755761
14157_marine,209,139,109,124,348,52.15311004784689,59.33014354066985
14158_marine,199,131,108,114,330,54.2713567839196,57.286432160804026
14159_marine,192,125,105,110,317,54.6875,57.291666666666664
14215_marine,355,185,285,154,540,80.28169014084507,43.38028169014084
14216_marine,384,183,303,175,567,78.90625,45.57291666666667
14217_marine,395,184,313,187,579,79.24050632911393,47.34177215189874
14218_marine,414,186,329,204,600,79.46859903381642,49.275362318840585
14219_marine,418,196,330,205,614,78.94736842105263,49.04306220095694
14220_marine,392,170,306,190,562,78.06122448979592,48.46938775510204
14221_marine,386,164,306,190,550,79.27461139896373,49.22279792746114
14222_marine,453,209,342,235,662,75.49668874172185,51.87637969094923
14361_marine,265,121,176,173,386,66.41509433962264,65.28301886792453
14363_marine,246,131,158,163,377,64.22764227642277,66.26016260162602
14364_marine,238,133,156,156,371,65.54621848739495,65.54621848739495
14453_marine,231,144,134,127,375,58.00865800865801,54.97835497835498
14454_marine,243,153,142,138,396,58.43621399176955,56.79012345679012
14455_marine,269,165,150,169,434,55.762081784386616,62.825278810408925
14456_marine,339,229,172,208,568,50.737463126843664,61.35693215339233
14457_marine,353,258,174,222,611,49.29178470254957,62.889518413597735
14458_marine,308,225,155,193,533,50.324675324675326,62.66233766233766
14512_marine,218,151,93,150,369,42.6605504587156,68.80733944954129
14513_marine,225,159,98,154,384,43.55555555555555,68.44444444444444
14514_marine,237,180,103,161,417,43.459915611814345,67.9324894514768
14516_marine,194,92,107,125,286,55.154639175257735,64.43298969072166
14517_marine,189,82,106,123,271,56.08465608465608,65.07936507936508
14518_marine,188,82,105,122,270,55.85106382978723,64.8936170212766
14519_marine,188,80,106,121,268,56.38297872340425,64.36170212765957
14522_marine,206,85,123,122,291,59.70873786407766,59.22330097087378
14523_marine,192,78,115,111,270,59.895833333333336,57.8125
14575_marine,345,189,277,141,534,80.28985507246377,40.869565217391305
14578_marine,330,137,274,141,467,83.03030303030303,42.72727272727273
14579_marine,423,217,314,203,640,74.23167848699764,47.99054373522459
14580_marine,386,200,288,184,586,74.61139896373057,47.66839378238342
14581_marine,426,207,322,216,633,75.5868544600939,50.70422535211267
14721_marine,270,126,183,169,396,67.77777777777779,62.59259259259259
14723_marine,269,141,177,172,410,65.79925650557621,63.94052044609665
14724_marine,243,131,161,156,374,66.2551440329218,64.19753086419753
14725_marine,232,125,156,149,357,67.24137931034483,64.22413793103449
14815_marine,276,162,158,167,438,57.2463768115942,60.507246376811594
14816_marine,339,255,175,204,594,51.62241887905604,60.17699115044248
14817_marine,350,269,179,219,619,51.142857142857146,62.57142857142857
14818_marine,330,264,165,216,594,50,65.45454545454545
14869_marine,158,106,43,127,264,27.21518987341772,80.37974683544303
14870_marine,172,122,49,140,294,28.488372093023255,81.3953488372093
14871_marine,247,193,101,173,440,40.89068825910931,70.04048582995951
14872_marine,247,188,101,173,435,40.89068825910931,70.04048582995951
14874_marine,244,169,110,155,413,45.08196721311475,63.52459016393443
14875_marine,244,168,114,155,412,46.72131147540984,63.52459016393443
14876_marine,264,181,125,169,445,47.34848484848485,64.01515151515152
14936_marine,434,218,330,201,652,76.036866359447,46.31336405529954
14937_marine,411,204,307,190,615,74.69586374695864,46.228710462287104
14938_marine,422,211,313,201,633,74.17061611374407,47.6303317535545
14939_marine,434,219,324,214,653,74.65437788018433,49.30875576036866
15080_marine,273,119,186,171,392,68.13186813186813,62.637362637362635
15081_marine,281,129,191,177,410,67.97153024911033,62.989323843416365
15082_marine,261,124,166,171,385,63.601532567049816,65.51724137931035
15083_marine,272,139,179,172,411,65.80882352941177,63.23529411764706
15085_marine,248,129,164,161,377,66.12903225806451,64.91935483870968
15176_marine,318,230,171,189,548,53.77358490566038,59.43396226415094
15177_marine,264,202,133,168,466,50.378787878787875,63.63636363636363
15178_marine,294,219,146,190,513,49.65986394557823,64.62585034013605
15230_marine,254,208,104,175,462,40.94488188976378,68.89763779527559
15231_marine,242,193,98,168,435,40.49586776859504,69.42148760330579
15235_marine,269,180,125,173,449,46.468401486988846,64.31226765799256
15236_marine,288,198,135,186,486,46.875,64.58333333333334
15237_marine,220,109,119,146,329,54.090909090909086,66.36363636363637
15240_marine,244,129,133,155,373,54.50819672131148,63.52459016393443
15296_marine,436,224,333,194,660,76.37614678899082,44.4954128440367
15297_marine,450,225,338,206,675,75.1111111111111,45.77777777777778
15298_marine,482,233,364,229,715,75.51867219917013,47.5103734439834
15299_marine,406,200,304,200,606,74.8768472906404,49.26108374384236
15332_marine,268,145,181,185,413,67.53731343283582,69.02985074626866
15338_marine,279,151,201,180,430,72.04301075268818,64.51612903225806
15339_marine,293,167,213,182,460,72.6962457337884,62.116040955631405
15340_marine,300,171,214,190,471,71.33333333333334,63.33333333333333
15351_marine,203,100,144,128,303,70.93596059113301,63.05418719211823
15352_marine,221,124,160,139,345,72.39819004524887,62.89592760180995
15439_marine,285,136,192,182,421,67.36842105263158,63.859649122807014
15440_marine,283,129,194,181,412,68.55123674911661,63.957597173144876
15442_marine,264,132,175,172,396,66.28787878787878,65.15151515151516
15443_marine,274,140,183,174,414,66.78832116788321,63.503649635036496
15444_marine,259,135,172,168,394,66.40926640926641,64.86486486486487
15536_marine,330,249,174,203,579,52.72727272727272,61.51515151515151
15537_marine,333,259,171,212,592,51.35135135135135,63.66366366366366
15587_marine,238,223,84,177,461,35.294117647058826,74.36974789915966
15588_marine,248,229,87,185,477,35.08064516129033,74.59677419354838
15589_marine,253,217,93,184,470,36.75889328063241,72.72727272727273
15590_marine,245,193,93,174,438,37.95918367346939,71.0204081632653
15596_marine,297,213,142,188,510,47.81144781144781,63.2996632996633
15597_marine,288,204,141,181,492,48.95833333333333,62.84722222222222
15598_marine,238,113,131,155,351,55.04201680672269,65.12605042016807
15599_marine,256,126,136,166,382,53.125,64.84375
15600_marine,252,128,137,156,380,54.36507936507936,61.904761904761905
15601_marine,249,139,136,159,388,54.61847389558233,63.85542168674698
15658_marine,457,236,348,202,693,76.14879649890591,44.201312910284464
15659_marine,479,241,368,214,720,76.82672233820459,44.676409185803756
15691_marine,346,199,244,206,545,70.52023121387283,59.53757225433526
15692_marine,362,211,257,222,573,70.99447513812154,61.32596685082873
15693_marine,353,212,253,218,565,71.671388101983,61.756373937677054
15694_marine,320,181,234,204,501,73.125,63.74999999999999
15695_marine,275,149,199,174,424,72.36363636363636,63.272727272727266
15696_marine,288,160,207,183,448,71.875,63.541666666666664
15697_marine,280,152,203,176,432,72.5,62.857142857142854
15698_marine,316,166,228,203,482,72.15189873417721,64.24050632911393
15699_marine,310,160,223,198,470,71.93548387096774,63.87096774193548
15700_marine,264,142,190,171,406,71.96969696969697,64.77272727272727
15709_marine,238,125,165,155,363,69.32773109243698,65.12605042016807
15710_marine,259,135,182,170,394,70.27027027027027,65.63706563706563
15711_marine,229,120,162,151,349,70.74235807860262,65.93886462882097
15712_marine,228,131,164,146,359,71.9298245614035,64.03508771929825
15713_marine,226,128,163,143,354,72.12389380530973,63.27433628318584
15714_marine,190,124,132,119,314,69.47368421052632,62.63157894736842
15798_marine,281,134,189,187,415,67.25978647686833,66.54804270462633
15799_marine,295,138,201,188,433,68.13559322033899,63.72881355932203
15802_marine,283,142,189,183,425,66.78445229681978,64.66431095406361
15803_marine,274,142,184,175,416,67.15328467153284,63.868613138686136
15804_marine,274,149,186,174,423,67.88321167883211,63.503649635036496
15896_marine,325,240,176,194,565,54.15384615384615,59.692307692307686
15897_marine,320,238,168,197,558,52.5,61.5625
15946_marine,267,247,94,204,514,35.2059925093633,76.40449438202246
15947_marine,264,258,88,203,522,33.33333333333333,76.89393939393939
15953_marine,329,236,169,196,565,51.3677811550152,59.57446808510638
15954_marine,337,235,178,199,572,52.818991097922854,59.05044510385756
15955_marine,330,219,176,199,549,53.333333333333336,60.303030303030305
15956_marine,322,218,168,191,540,52.17391304347826,59.3167701863354
15957_marine,310,204,163,181,514,52.58064516129032,58.387096774193544
15958_marine,306,204,156,189,510,50.98039215686274,61.76470588235294
15959_marine,309,210,160,182,519,51.7799352750809,58.89967637540453
15960_marine,302,208,156,177,510,51.65562913907284,58.609271523178805
15961_marine,256,131,143,157,387,55.859375,61.328125
16019_marine,481,261,369,215,742,76.71517671517671,44.6985446985447
16020_marine,457,249,352,195,706,77.02407002188184,42.669584245076585
16033_marine,491,292,372,230,783,75.76374745417516,46.84317718940937
16034_marine,547,314,395,270,861,72.21206581352834,49.36014625228519
16035_marine,487,299,345,216,786,70.84188911704312,44.35318275154005
16050_marine,398,226,284,245,624,71.35678391959799,61.55778894472361
16051_marine,368,203,257,222,571,69.83695652173914,60.32608695652174
16053_marine,293,166,213,186,459,72.6962457337884,63.48122866894198
16054_marine,326,187,239,205,513,73.31288343558282,62.88343558282209
16055_marine,264,133,193,172,397,73.10606060606061,65.15151515151516
16056_marine,322,179,235,200,501,72.98136645962732,62.11180124223602
16057_marine,361,201,261,223,562,72.29916897506925,61.772853185595565
16058_marine,333,181,236,202,514,70.87087087087087,60.66066066066066
16059_marine,274,141,198,173,415,72.26277372262774,63.138686131386855
16068_marine,253,134,176,170,387,69.56521739130434,67.19367588932806
16069_marine,248,128,175,166,376,70.56451612903226,66.93548387096774
16073_marine,177,109,121,107,286,68.36158192090396,60.451977401129945
16074_marine,163,91,110,100,254,67.48466257668711,61.34969325153374
16157_marine,289,139,196,192,428,67.82006920415225,66.43598615916954
16158_marine,297,141,202,193,438,68.01346801346801,64.98316498316498
16162_marine,380,227,259,242,607,68.15789473684211,63.68421052631579
16163_marine,381,206,259,238,587,67.97900262467192,62.46719160104986
16256_marine,328,240,179,195,568,54.57317073170732,59.45121951219512
16311_marine,337,235,175,200,572,51.92878338278932,59.34718100890207
16312_marine,353,250,183,209,603,51.84135977337111,59.20679886685553
16313_marine,346,251,180,206,597,52.02312138728323,59.53757225433526
16314_marine,354,267,185,216,621,52.259887005649716,61.016949152542374
16315_marine,311,193,167,180,504,53.69774919614147,57.87781350482315
16316_marine,322,204,172,191,526,53.41614906832298,59.3167701863354
16317_marine,313,206,171,181,519,54.632587859424916,57.82747603833865
16318_marine,314,200,173,175,514,55.095541401273884,55.73248407643312
16319_marine,299,197,164,170,496,54.84949832775919,56.85618729096989
16379_marine,466,272,363,194,738,77.8969957081545,41.63090128755365
16389_marine,430,276,330,160,706,76.74418604651163,37.2093023255814
16390_marine,451,286,342,177,737,75.83148558758315,39.24611973392461
16393_marine,481,286,374,221,767,77.75467775467776,45.94594594594595
16394_marine,430,259,315,177,689,73.25581395348837,41.16279069767442
16395_marine,497,315,347,228,812,69.81891348088531,45.87525150905433
16396_marine,470,294,338,219,764,71.91489361702128,46.59574468085106
16409_marine,407,232,282,243,639,69.28746928746928,59.7051597051597
16410_marine,383,228,281,225,611,73.36814621409921,58.7467362924282
16414_marine,312,183,218,189,495,69.87179487179486,60.57692307692307
16415_marine,313,176,218,190,489,69.6485623003195,60.70287539936102
16416_marine,314,180,225,195,494,71.656050955414,62.101910828025474
16418_marine,314,169,216,198,483,68.78980891719745,63.05732484076433
16419_marine,319,173,214,201,492,67.0846394984326,63.00940438871473
16427_marine,238,131,168,158,369,70.58823529411765,66.38655462184873
16428_marine,264,151,190,184,415,71.96969696969697,69.6969696969697
16516_marine,310,150,214,205,460,69.03225806451613,66.12903225806451
16517_marine,307,145,213,202,452,69.38110749185668,65.79804560260585
16616_marine,337,250,183,196,587,54.3026706231454,58.160237388724035
16670_marine,400,279,205,246,679,51.24999999999999,61.5
16671_marine,369,270,196,222,639,53.116531165311656,60.16260162601627
16674_marine,316,211,173,181,527,54.74683544303798,57.27848101265823
16675_marine,326,211,180,185,537,55.21472392638037,56.74846625766872
16676_marine,323,210,179,181,533,55.417956656346746,56.03715170278638
16731_marine,421,284,339,148,705,80.52256532066508,35.15439429928741
16732_marine,439,280,350,172,719,79.72665148063781,39.17995444191344
16733_marine,438,260,345,169,698,78.76712328767124,38.58447488584475
16735_marine,406,282,318,143,688,78.32512315270937,35.221674876847295
16737_marine,436,294,329,174,730,75.45871559633028,39.908256880733944
16738_marine,426,296,326,165,722,76.52582159624414,38.732394366197184
16739_marine,464,287,360,193,751,77.58620689655173,41.5948275862069
16744_marine,491,279,382,201,770,77.80040733197556,40.936863543788185
16745_marine,523,287,412,219,810,78.77629063097514,41.87380497131931
16746_marine,528,282,406,221,810,76.89393939393939,41.85606060606061
16747_marine,493,279,383,204,772,77.68762677484787,41.37931034482759
16748_marine,497,287,375,204,784,75.45271629778671,41.04627766599598
16749_marine,411,263,322,143,674,78.34549878345499,34.79318734793188
16750_marine,403,256,327,132,659,81.14143920595534,32.754342431761785
16751_marine,500,297,380,218,797,76,43.6
16753_marine,372,245,288,138,617,77.41935483870968,37.096774193548384
16754_marine,391,262,302,148,653,77.23785166240408,37.851662404092075
16756_marine,463,294,343,208,757,74.08207343412528,44.9244060475162
16757_marine,480,294,352,220,774,73.33333333333333,45.83333333333333
16758_marine,476,288,350,225,764,73.52941176470588,47.26890756302521
16768_marine,363,222,256,204,585,70.52341597796143,56.19834710743802
16769_marine,419,234,291,247,653,69.4510739856802,58.94988066825776
16780_marine,310,185,205,187,495,66.12903225806451,60.322580645161295
16781_marine,316,191,208,192,507,65.82278481012658,60.75949367088608
16788_marine,271,172,192,193,443,70.84870848708486,71.21771217712177
16872_marine,375,171,265,245,546,70.66666666666667,65.33333333333333
16873_marine,347,170,245,218,517,70.60518731988472,62.824207492795395
16875_marine,318,163,224,209,481,70.44025157232704,65.72327044025157
16876_marine,324,157,226,213,481,69.75308641975309,65.74074074074075
16976_marine,345,269,186,197,614,53.91304347826087,57.10144927536231
17029_marine,375,260,190,233,635,50.66666666666667,62.133333333333326
17030_marine,463,293,242,292,756,52.26781857451404,63.06695464362851
17091_marine,453,284,366,165,737,80.79470198675497,36.423841059602644
17092_marine,462,261,366,173,723,79.22077922077922,37.44588744588744
17104_marine,519,298,397,219,817,76.49325626204238,42.19653179190752
17109_marine,394,226,315,141,620,79.94923857868021,35.786802030456855
17110_marine,414,237,334,154,651,80.67632850241546,37.19806763285024
17111_marine,483,290,375,205,773,77.63975155279503,42.44306418219462
17112_marine,475,288,365,194,763,76.84210526315789,40.8421052631579
17114_marine,371,245,292,132,616,78.70619946091644,35.57951482479784
17115_marine,422,254,333,168,676,78.90995260663507,39.81042654028436
17117_marine,385,215,300,148,600,77.92207792207793,38.44155844155844
17118_marine,486,285,357,231,771,73.4567901234568,47.53086419753087
17119_marine,501,298,369,242,799,73.65269461077844,48.30339321357285
17120_marine,457,279,343,206,736,75.054704595186,45.076586433260395
17128_marine,429,246,297,252,675,69.23076923076923,58.74125874125874
17129_marine,353,223,246,192,576,69.68838526912181,54.39093484419264
17134_marine,265,152,185,144,417,69.81132075471697,54.339622641509436
17135_marine,254,160,177,138,414,69.68503937007874,54.330708661417326
17136_marine,250,162,171,139,412,68.4,55.60000000000001
17141_marine,307,180,201,186,487,65.47231270358306,60.586319218241044
17142_marine,337,196,224,211,533,66.46884272997032,62.61127596439169
17148_marine,272,163,191,191,435,70.22058823529412,70.22058823529412
17149_marine,240,138,168,163,378,70,67.91666666666667
17231_marine,388,183,281,254,571,72.42268041237114,65.4639175257732
17232_marine,382,176,272,255,558,71.20418848167539,66.75392670157068
17233_marine,345,175,244,221,520,70.72463768115942,64.05797101449275
17234_marine,339,168,241,213,507,71.09144542772862,62.83185840707964
17235_marine,321,163,228,204,484,71.02803738317756,63.55140186915887
17241_marine,357,190,265,198,547,74.2296918767507,55.46218487394958
17336_marine,361,287,203,200,648,56.232686980609415,55.4016620498615
17387_marine,469,345,257,269,814,54.79744136460555,57.356076759061835
17388_marine,470,337,258,275,807,54.8936170212766,58.51063829787234
17389_marine,480,325,267,280,805,55.625,58.333333333333336
17390_marine,454,294,255,258,748,56.167400881057276,56.82819383259912
17391_marine,437,291,246,249,728,56.2929061784897,56.97940503432495
17452_marine,488,280,381,182,768,78.07377049180327,37.295081967213115
17462_marine,491,255,374,206,746,76.17107942973523,41.955193482688394
17463_marine,497,276,376,209,773,75.65392354124748,42.052313883299796
17464_marine,470,267,365,185,737,77.6595744680851,39.361702127659576
17469_marine,440,264,351,161,704,79.77272727272727,36.59090909090909
17470_marine,448,264,356,173,712,79.46428571428571,38.61607142857143
17473_marine,465,293,363,190,758,78.06451612903226,40.86021505376344
17474_marine,458,294,354,185,752,77.29257641921397,40.39301310043668
17476_marine,477,256,366,206,733,76.72955974842768,43.18658280922432
17477_marine,494,274,378,217,768,76.51821862348179,43.92712550607287
17478_marine,374,237,296,130,611,79.14438502673798,34.75935828877005
17480_marine,513,314,380,246,827,74.07407407407408,47.953216374269005
17488_marine,425,256,310,206,681,72.94117647058823,48.470588235294116
17489_marine,485,271,349,249,756,71.95876288659794,51.340206185567006
17490_marine,415,252,305,198,667,73.49397590361446,47.71084337349398
17491_marine,315,202,220,165,517,69.84126984126983,52.38095238095239
17492_marine,300,181,211,157,481,70.33333333333334,52.33333333333333
17493_marine,282,170,194,151,452,68.79432624113475,53.54609929078015
17494_marine,274,157,190,149,431,69.34306569343066,54.379562043795616
17495_marine,270,158,186,151,428,68.88888888888889,55.925925925925924
17496_marine,301,173,203,183,474,67.44186046511628,60.797342192691026
17497_marine,316,175,215,198,491,68.0379746835443,62.65822784810127
17498_marine,278,168,184,165,446,66.18705035971223,59.352517985611506
17499_marine,251,160,164,143,411,65.33864541832669,56.97211155378486
17500_marine,268,174,175,153,442,65.29850746268657,57.08955223880597
17501_marine,270,177,176,151,447,65.18518518518519,55.925925925925924
17502_marine,340,205,226,206,545,66.47058823529412,60.588235294117645
17509_marine,285,154,198,200,439,69.47368421052632,70.17543859649122
17510_marine,254,146,175,175,400,68.89763779527559,68.89763779527559
17590_marine,357,166,259,218,523,72.54901960784314,61.06442577030813
17591_marine,341,161,252,205,502,73.90029325513197,60.117302052785924
17601_marine,438,284,326,232,722,74.42922374429224,52.96803652968036
17602_marine,439,297,330,227,736,75.17084282460137,51.70842824601367
17696_marine,364,282,203,201,646,55.769230769230774,55.219780219780226
17746_marine,482,373,266,279,855,55.18672199170125,57.8838174273859
17747_marine,497,399,276,288,896,55.53319919517102,57.947686116700204
17748_marine,409,247,249,235,656,60.880195599022,57.457212713936435
17812_marine,475,279,376,171,754,79.15789473684211,36
17821_marine,537,265,414,236,802,77.09497206703911,43.947858472998135
17829_marine,411,204,329,176,615,80.04866180048663,42.82238442822384
17834_marine,424,275,334,154,699,78.77358490566037,36.32075471698113
17835_marine,448,283,340,172,731,75.89285714285714,38.392857142857146
17836_marine,425,263,327,151,688,76.94117647058823,35.529411764705884
17837_marine,428,264,333,156,692,77.80373831775701,36.44859813084112
17838_marine,434,253,342,166,687,78.80184331797236,38.24884792626728
17839_marine,405,239,325,151,644,80.24691358024691,37.28395061728395
17840_marine,511,283,379,242,794,74.16829745596868,47.35812133072407
17843_marine,514,294,380,253,808,73.92996108949417,49.221789883268485
17844_marine,479,285,354,219,764,73.90396659707724,45.72025052192067
17845_marine,535,300,392,268,835,73.27102803738318,50.09345794392524
17846_marine,541,302,407,276,843,75.23105360443623,51.01663585951941
17847_marine,544,299,405,264,843,74.44852941176471,48.529411764705884
17848_marine,468,261,343,235,729,73.29059829059828,50.21367521367522
17849_marine,487,271,356,256,758,73.1006160164271,52.56673511293635
17850_marine,420,238,305,205,658,72.61904761904762,48.80952380952381
17859_marine,255,158,163,145,413,63.921568627450974,56.86274509803921
17860_marine,262,172,169,149,434,64.50381679389314,56.87022900763359
17861_marine,265,175,172,148,440,64.90566037735849,55.84905660377358
17870_marine,303,161,209,212,464,68.97689768976898,69.96699669966998
17871_marine,277,149,190,190,426,68.59205776173285,68.59205776173285
17940_marine,372,144,284,212,516,76.34408602150538,56.98924731182796
17941_marine,401,161,303,230,562,75.56109725685786,57.356608478803
17942_marine,426,177,322,253,603,75.5868544600939,59.38967136150235
17943_marine,394,159,300,227,553,76.14213197969542,57.61421319796954
17945_marine,250,109,173,192,359,69.19999999999999,76.8
17949_marine,353,160,253,212,513,71.671388101983,60.05665722379604
17950_marine,347,163,251,206,510,72.3342939481268,59.36599423631124
17960_marine,381,205,290,205,586,76.11548556430446,53.805774278215225
17961_marine,375,210,283,195,585,75.46666666666667,52
17962_marine,401,241,310,203,642,77.3067331670823,50.62344139650873
18056_marine,356,262,202,193,618,56.74157303370787,54.21348314606742
18057_marine,361,277,203,199,638,56.232686980609415,55.124653739612185
18104_marine,490,362,276,274,852,56.326530612244895,55.91836734693878
18105_marine,519,373,290,300,892,55.8766859344894,57.80346820809249
18106_marine,490,337,274,279,827,55.91836734693878,56.93877551020409
18171_marine,456,307,367,153,763,80.48245614035088,33.55263157894737
18172_marine,489,296,390,192,785,79.75460122699386,39.263803680981596
18180_marine,502,255,392,214,757,78.08764940239044,42.62948207171315
18181_marine,458,249,361,177,707,78.82096069868996,38.646288209606986
18182_marine,374,175,318,121,549,85.02673796791443,32.35294117647059
18183_marine,405,196,326,157,601,80.49382716049382,38.76543209876544
18184_marine,415,213,336,159,628,80.96385542168674,38.31325301204819
18189_marine,436,207,345,193,643,79.12844036697247,44.26605504587156
18190_marine,436,204,344,195,640,78.89908256880734,44.72477064220183
18196_marine,441,276,339,154,717,76.87074829931973,34.92063492063492
18197_marine,475,275,359,188,750,75.57894736842105,39.578947368421055
18198_marine,439,268,341,167,707,77.67653758542141,38.041002277904326
18199_marine,387,230,314,137,617,81.13695090439276,35.400516795865634
18200_marine,500,284,374,234,784,74.8,46.800000000000004
18201_marine,515,299,386,244,814,74.9514563106796,47.37864077669903
18202_marine,458,272,350,199,730,76.41921397379913,43.44978165938865
18203_marine,473,272,352,224,745,74.4186046511628,47.35729386892177
18204_marine,488,291,367,234,779,75.20491803278688,47.950819672131146
18205_marine,453,269,343,195,722,75.71743929359823,43.04635761589404
18206_marine,426,195,333,191,621,78.16901408450704,44.835680751173705
18207_marine,486,270,365,223,756,75.1028806584362,45.884773662551446
18229_marine,308,157,216,213,465,70.12987012987013,69.15584415584416
18230_marine,359,181,257,258,540,71.58774373259052,71.86629526462396
18234_marine,207,132,139,131,339,67.14975845410628,63.28502415458937
18298_marine,390,153,301,218,543,77.17948717948718,55.8974358974359
18299_marine,410,157,315,236,567,76.82926829268293,57.56097560975609
18300_marine,421,162,325,243,583,77.19714964370546,57.71971496437055
18302_marine,402,159,308,230,561,76.61691542288557,57.2139303482587
18303_marine,395,155,301,223,550,76.20253164556962,56.45569620253165
18304_marine,400,160,302,226,560,75.5,56.49999999999999
18305_marine,442,170,330,251,612,74.6606334841629,56.78733031674208
18306_marine,412,165,308,229,577,74.75728155339806,55.582524271844655
18308_marine,384,164,277,231,548,72.13541666666666,60.15625
18320_marine,405,213,309,213,618,76.29629629629629,52.59259259259259
18321_marine,362,192,279,191,554,77.07182320441989,52.762430939226526
18322_marine,404,236,318,205,640,78.71287128712872,50.742574257425744
18323_marine,403,242,317,201,645,78.66004962779157,49.87593052109181
18417_marine,393,312,223,221,705,56.74300254452926,56.234096692111954
18418_marine,422,317,224,245,739,53.08056872037915,58.0568720379147
18419_marine,239,200,86,188,439,35.98326359832636,78.66108786610879
18463_marine,462,382,263,254,844,56.926406926406926,54.97835497835498
18464_marine,495,396,272,279,891,54.94949494949495,56.36363636363636
18465_marine,501,353,279,286,854,55.688622754491014,57.08582834331337
18466_marine,476,318,274,259,794,57.56302521008403,54.41176470588235
18531_marine,499,318,399,185,817,79.95991983967936,37.07414829659319
18532_marine,508,311,405,198,819,79.7244094488189,38.976377952755904
18540_marine,520,265,409,215,785,78.65384615384615,41.34615384615385
18541_marine,454,252,361,162,706,79.51541850220264,35.68281938325991
18542_marine,371,167,316,123,538,85.17520215633422,33.153638814016176
18549_marine,435,221,351,167,656,80.6896551724138,38.39080459770115
18550_marine,427,230,351,150,657,82.20140515222482,35.1288056206089
18553_marine,419,219,339,152,638,80.90692124105013,36.27684964200477
18554_marine,424,221,338,159,645,79.71698113207547,37.5
18555_marine,421,229,334,155,650,79.33491686460808,36.81710213776722
18556_marine,479,301,362,178,780,75.5741127348643,37.160751565762006
18557_marine,470,271,360,180,741,76.59574468085107,38.297872340425535
18558_marine,412,254,324,142,666,78.64077669902912,34.46601941747573
18561_marine,496,298,378,228,794,76.20967741935483,45.96774193548387
18562_marine,503,304,379,234,807,75.3479125248509,46.52087475149106
18563_marine,510,298,380,243,808,74.50980392156863,47.647058823529406
18564_marine,495,283,375,232,778,75.75757575757575,46.86868686868687
18565_marine,462,266,347,207,728,75.10822510822511,44.8051948051948
18566_marine,373,170,299,139,543,80.16085790884718,37.26541554959786
18567_marine,503,280,373,239,783,74.15506958250498,47.514910536779325
18568_marine,452,249,336,201,701,74.33628318584071,44.469026548672566
18589_marine,379,194,260,268,573,68.60158311345647,70.71240105540898
18590_marine,322,161,229,224,483,71.11801242236024,69.56521739130434
18658_marine,401,162,310,227,563,77.3067331670823,56.60847880299252
18659_marine,391,160,307,218,551,78.51662404092072,55.754475703324815
18662_marine,390,162,296,213,552,75.8974358974359,54.61538461538461
18665_marine,399,162,303,213,561,75.93984962406014,53.383458646616546
18666_marine,405,165,307,218,570,75.80246913580247,53.827160493827165
18668_marine,338,137,257,196,475,76.03550295857988,57.98816568047337
18669_marine,383,158,288,207,541,75.19582245430809,54.04699738903395
18679_marine,344,169,266,158,513,77.32558139534885,45.93023255813954
18680_marine,410,225,315,210,635,76.82926829268293,51.21951219512195
18681_marine,366,184,288,179,550,78.68852459016394,48.90710382513661
18682_marine,420,257,331,204,677,78.80952380952381,48.57142857142857
18777_marine,390,284,228,203,674,58.46153846153847,52.05128205128206
18778_marine,448,339,246,252,787,54.91071428571429,56.25
18823_marine,240,267,75,202,507,31.25,84.16666666666667
18824_marine,516,444,284,297,960,55.03875968992248,57.55813953488372
18825_marine,510,334,286,289,844,56.07843137254902,56.666666666666664
18892_marine,538,311,421,218,849,78.25278810408922,40.520446096654275
18893_marine,549,298,429,228,847,78.14207650273224,41.53005464480874
18894_marine,530,285,418,213,815,78.8679245283019,40.18867924528302
18899_marine,461,257,370,162,718,80.26030368763557,35.140997830802604
18900_marine,522,254,412,201,776,78.9272030651341,38.50574712643678
18907_marine,480,241,376,182,721,78.33333333333333,37.916666666666664
18908_marine,480,239,377,183,719,78.54166666666667,38.125
18909_marine,493,239,387,193,732,78.49898580121703,39.148073022312374
18910_marine,528,242,412,217,770,78.03030303030303,41.09848484848485
18913_marine,446,227,358,161,673,80.26905829596413,36.09865470852018
18914_marine,433,221,344,169,654,79.44572748267899,39.03002309468822
18915_marine,394,191,319,137,585,80.96446700507614,34.77157360406091
18916_marine,529,305,400,229,834,75.61436672967864,43.28922495274102
18917_marine,418,250,330,141,668,78.94736842105263,33.73205741626794
18921_marine,366,173,300,126,539,81.9672131147541,34.42622950819672
18922_marine,450,270,348,190,720,77.33333333333333,42.22222222222222
18923_marine,439,270,340,180,709,77.44874715261959,41.00227790432802
18924_marine,436,265,333,180,701,76.37614678899082,41.284403669724774
18925_marine,440,266,334,181,706,75.9090909090909,41.13636363636364
18926_marine,371,183,299,131,554,80.59299191374663,35.309973045822105
18927_marine,405,199,314,168,604,77.53086419753087,41.48148148148148
18928_marine,515,272,385,252,787,74.75728155339806,48.932038834951456
18929_marine,442,243,343,194,685,77.60180995475113,43.89140271493213
18949_marine,236,145,155,155,381,65.67796610169492,65.67796610169492
18950_marine,241,138,160,154,379,66.39004149377593,63.90041493775933
18951_marine,237,141,154,150,378,64.9789029535865,63.29113924050633
18954_marine,284,158,187,189,442,65.84507042253522,66.54929577464789
19019_marine,375,154,294,207,529,78.4,55.2
19020_marine,392,157,307,214,549,78.31632653061224,54.59183673469388
19021_marine,376,158,293,197,534,77.92553191489363,52.3936170212766
19022_marine,387,160,303,208,547,78.29457364341084,53.746770025839794
19023_marine,391,166,307,199,557,78.51662404092072,50.89514066496164
19025_marine,408,173,314,210,581,76.9607843137255,51.470588235294116
19026_marine,436,178,336,225,614,77.06422018348624,51.60550458715596
19027_marine,460,181,350,254,641,76.08695652173914,55.21739130434783
19030_marine,397,160,302,208,557,76.0705289672544,52.39294710327456
19037_marine,433,220,344,211,653,79.44572748267899,48.72979214780601
19038_marine,439,231,339,224,670,77.22095671981776,51.025056947608206
19039_marine,434,247,334,214,681,76.95852534562212,49.30875576036866
19040_marine,392,207,301,202,599,76.78571428571429,51.53061224489795
19041_marine,410,226,321,205,636,78.29268292682927,50
19042_marine,425,251,336,204,676,79.05882352941175,48
19138_marine,422,314,255,216,736,60.426540284360186,51.18483412322274
19139_marine,428,332,254,223,760,59.345794392523366,52.10280373831776
19184_marine,495,448,279,272,943,56.36363636363636,54.94949494949495
19185_marine,504,437,288,277,941,57.14285714285714,54.96031746031746
19252_marine,457,302,367,148,759,80.30634573304157,32.38512035010941
19253_marine,505,308,403,194,813,79.8019801980198,38.415841584158414
19254_marine,577,318,452,238,895,78.33622183708839,41.24783362218371
19255_marine,569,324,443,227,893,77.85588752196837,39.894551845342704
19256_marine,508,276,394,197,784,77.55905511811024,38.77952755905512
19257_marine,504,266,394,192,770,78.17460317460318,38.095238095238095
19258_marine,517,261,407,195,778,78.72340425531915,37.71760154738878
19259_marine,455,242,369,146,697,81.0989010989011,32.08791208791209
19261_marine,485,252,384,181,737,79.17525773195877,37.31958762886598
19262_marine,485,249,383,179,734,78.96907216494846,36.907216494845365
19263_marine,480,248,381,180,728,79.375,37.5
19264_marine,485,253,379,187,738,78.14432989690722,38.55670103092784
19265_marine,483,248,376,187,731,77.84679089026915,38.71635610766045
19266_marine,484,250,375,188,734,77.47933884297521,38.84297520661157
19267_marine,484,244,377,190,728,77.89256198347107,39.25619834710744
19268_marine,479,234,378,185,713,78.91440501043841,38.62212943632568
19269_marine,501,232,392,202,733,78.2435129740519,40.31936127744511
19275_marine,448,226,356,175,674,79.46428571428571,39.0625
19276_marine,432,216,346,168,648,80.0925925925926,38.88888888888889
19282_marine,423,251,331,166,674,78.25059101654847,39.2434988179669
19283_marine,439,255,339,173,694,77.22095671981776,39.40774487471526
19284_marine,421,252,328,159,673,77.90973871733968,37.76722090261283
19285_marine,342,162,280,106,504,81.87134502923976,30.994152046783626
19286_marine,328,178,268,107,506,81.70731707317073,32.6219512195122
19287_marine,359,176,291,125,535,81.05849582172702,34.81894150417828
19288_marine,484,306,369,221,790,76.2396694214876,45.66115702479338
19289_marine,486,299,368,218,785,75.7201646090535,44.8559670781893
19290_marine,449,240,344,194,689,76.61469933184856,43.207126948775056
19291_marine,465,247,345,202,712,74.19354838709677,43.44086021505376
19292_marine,456,247,344,197,703,75.43859649122807,43.20175438596491
19293_marine,433,236,328,186,669,75.75057736720554,42.956120092378754
19294_marine,475,245,364,218,720,76.63157894736841,45.89473684210526
19295_marine,498,262,377,238,760,75.70281124497991,47.791164658634536
19296_marine,502,275,379,240,777,75.4980079681275,47.808764940239044
19312_marine,238,135,156,150,373,65.54621848739495,63.02521008403361
19313_marine,256,143,168,164,399,65.625,64.0625
19314_marine,286,158,183,183,444,63.98601398601399,63.98601398601399
19315_marine,261,144,173,166,405,66.28352490421456,63.601532567049816
19381_marine,408,176,323,208,584,79.16666666666666,50.98039215686274
19382_marine,400,173,317,201,573,79.25,50.24999999999999
19383_marine,397,170,315,196,567,79.34508816120906,49.37027707808564
19387_marine,436,183,339,235,619,77.75229357798165,53.899082568807344
19390_marine,447,181,339,231,628,75.83892617449665,51.67785234899329
19393_marine,300,146,262,85,446,87.33333333333333,28.333333333333332
19394_marine,359,183,295,142,542,82.17270194986072,39.55431754874652
19396_marine,448,217,358,212,665,79.91071428571429,47.32142857142857
19397_marine,457,219,361,221,676,78.99343544857767,48.35886214442014
19398_marine,430,224,331,219,654,76.9767441860465,50.93023255813953
19401_marine,473,250,363,230,723,76.74418604651163,48.625792811839325
19499_marine,421,291,253,212,712,60.09501187648456,50.3562945368171
19500_marine,412,290,247,206,702,59.95145631067961,50
19543_marine,255,293,82,214,548,32.15686274509804,83.92156862745098
19544_marine,539,450,310,292,989,57.5139146567718,54.17439703153989
19545_marine,543,433,321,285,976,59.11602209944752,52.48618784530387
19614_marine,528,275,422,203,803,79.92424242424242,38.446969696969695
19615_marine,597,312,462,234,909,77.38693467336684,39.19597989949749
19616_marine,527,254,407,210,781,77.22960151802657,39.84819734345351
19619_marine,520,264,405,203,784,77.88461538461539,39.03846153846154
19621_marine,470,234,372,174,704,79.14893617021276,37.02127659574468
19635_marine,315,141,268,86,456,85.07936507936508,27.3015873015873
19644_marine,390,224,312,137,614,80,35.128205128205124
19645_marine,376,210,295,141,586,78.45744680851064,37.5
19646_marine,372,206,294,138,578,79.03225806451613,37.096774193548384
19647_marine,372,212,299,132,584,80.3763440860215,35.483870967741936
19648_marine,369,210,298,134,579,80.75880758807588,36.31436314363143
19653_marine,391,187,311,151,578,79.53964194373401,38.61892583120204
19654_marine,407,189,322,169,596,79.11547911547912,41.52334152334152
19655_marine,405,184,322,165,589,79.50617283950618,40.74074074074074
19656_marine,429,250,321,175,679,74.82517482517483,40.79254079254079
19740_marine,407,179,321,208,586,78.86977886977887,51.105651105651106
19741_marine,391,173,312,194,564,79.79539641943734,49.61636828644501
19747_marine,457,193,360,232,650,78.7746170678337,50.76586433260394
19748_marine,475,180,378,230,655,79.57894736842105,48.421052631578945
19749_marine,522,209,415,253,731,79.50191570881226,48.46743295019157
19750_marine,540,235,424,246,775,78.51851851851852,45.55555555555556
19753_marine,494,236,398,225,730,80.5668016194332,45.546558704453446
19754_marine,468,242,375,221,710,80.12820512820514,47.22222222222222
19755_marine,461,225,369,219,686,80.04338394793926,47.50542299349241
19756_marine,477,235,382,230,712,80.083857442348,48.21802935010482
19757_marine,775,399,541,401,1174,69.80645161290323,51.74193548387097
19759_marine,770,400,520,422,1170,67.53246753246754,54.8051948051948
19760_marine,793,415,534,439,1208,67.33921815889029,55.359394703656996
19761_marine,774,379,529,415,1153,68.34625322997417,53.617571059431526
19860_marine,469,343,285,233,812,60.76759061833689,49.68017057569296
19861_marine,459,351,286,224,810,62.309368191721134,48.80174291938998
19862_marine,447,320,276,217,767,61.74496644295302,48.54586129753915
19903_marine,556,441,324,302,997,58.27338129496403,54.31654676258992
19904_marine,549,459,327,288,1008,59.56284153005464,52.459016393442624
20005_marine,338,178,269,124,516,79.58579881656804,36.68639053254438
20006_marine,334,177,264,123,511,79.04191616766467,36.82634730538922
20013_marine,389,154,303,169,543,77.89203084832906,43.44473007712082
20014_marine,393,153,308,174,546,78.37150127226464,44.274809160305345
20015_marine,396,183,316,160,579,79.7979797979798,40.4040404040404
20016_marine,410,253,308,160,663,75.1219512195122,39.02439024390244
20100_marine,410,176,324,215,586,79.02439024390245,52.4390243902439
20101_marine,396,175,315,195,571,79.54545454545455,49.24242424242424
20107_marine,540,220,421,265,760,77.96296296296296,49.074074074074076
20108_marine,560,214,438,269,774,78.21428571428571,48.035714285714285
20109_marine,575,223,448,270,798,77.91304347826087,46.95652173913044
20110_marine,499,229,395,192,728,79.15831663326654,38.476953907815634
20111_marine,647,295,501,299,942,77.43431221020093,46.21329211746523
20112_marine,667,321,518,302,988,77.66116941529235,45.27736131934033
20113_marine,740,377,555,346,1117,75,46.75675675675676
20114_marine,722,373,535,338,1095,74.09972299168976,46.81440443213297
20115_marine,869,458,611,449,1327,70.31070195627159,51.66858457997699
20116_marine,839,411,582,447,1250,69.36829558998808,53.2777115613826
20117_marine,853,450,593,461,1303,69.51934349355217,54.04454865181712
20118_marine,792,417,551,412,1209,69.57070707070707,52.02020202020202
20119_marine,832,443,560,457,1275,67.3076923076923,54.92788461538461
20120_marine,839,470,554,471,1309,66.03098927294398,56.13825983313468
20220_marine,343,201,243,148,544,70.8454810495627,43.14868804664723
20221_marine,362,223,250,162,585,69.06077348066299,44.751381215469614
20222_marine,482,358,295,241,840,61.20331950207469,50
20223_marine,472,346,293,230,818,62.07627118644068,48.728813559322035
20261_marine,556,489,327,301,1045,58.81294964028777,54.13669064748201
20262_marine,553,464,327,300,1017,59.13200723327306,54.249547920434
20263_marine,548,480,325,288,1028,59.306569343065696,52.55474452554745
20376_marine,461,272,349,195,733,75.70498915401302,42.299349240780906
20461_marine,413,174,334,200,587,80.87167070217917,48.426150121065376
20467_marine,454,191,363,194,645,79.95594713656388,42.731277533039645
20470_marine,684,333,522,311,1017,76.31578947368422,45.46783625730994
20471_marine,740,371,561,335,1111,75.8108108108108,45.27027027027027
20472_marine,878,424,629,437,1302,71.64009111617312,49.772209567198175
20473_marine,944,470,647,480,1414,68.53813559322035,50.847457627118644
20474_marine,990,467,689,535,1457,69.5959595959596,54.04040404040404
20475_marine,955,463,661,512,1418,69.21465968586388,53.612565445026185
20476_marine,925,455,649,483,1380,70.16216216216216,52.21621621621622
20477_marine,864,433,607,451,1297,70.25462962962963,52.19907407407407
20583_marine,510,370,309,260,880,60.588235294117645,50.98039215686274
20584_marine,438,333,272,212,771,62.10045662100456,48.401826484018265
20620_marine,568,475,336,308,1043,59.154929577464785,54.22535211267606
20621_marine,570,488,338,307,1058,59.29824561403508,53.85964912280702
20683_marine,253,126,224,50,379,88.53754940711462,19.76284584980237
20684_marine,258,127,229,50,385,88.75968992248062,19.379844961240313
20735_marine,504,263,387,223,767,76.78571428571429,44.24603174603175
20736_marine,461,237,353,197,698,76.57266811279827,42.73318872017354
20821_marine,563,216,466,288,779,82.7708703374778,51.15452930728242
20822_marine,503,189,417,239,692,82.90258449304176,47.514910536779325
20829_marine,604,289,453,252,893,75,41.72185430463576
20830_marine,742,364,536,358,1106,72.23719676549865,48.24797843665768
20831_marine,729,355,525,367,1084,72.0164609053498,50.34293552812071
20832_marine,1039,461,712,572,1500,68.5274302213667,55.05293551491819
20833_marine,1069,508,727,578,1577,68.00748362956034,54.06922357343311
20834_marine,995,455,689,537,1450,69.24623115577889,53.96984924623116
20944_marine,465,369,292,229,834,62.795698924731184,49.24731182795699
20946_marine,469,395,283,244,864,60.3411513859275,52.02558635394456
20947_marine,446,381,275,227,827,61.65919282511211,50.89686098654709
20979_marine,582,438,346,317,1020,59.450171821305844,54.46735395189003
20980_marine,572,417,345,304,989,60.31468531468531,53.14685314685315
21051_marine,493,238,398,177,731,80.73022312373224,35.902636916835704
21089_marine,371,153,292,118,524,78.70619946091644,31.805929919137466
21090_marine,465,191,357,185,656,76.77419354838709,39.784946236559136
21091_marine,509,187,392,209,696,77.01375245579568,41.06090373280943
21092_marine,503,177,393,211,680,78.13121272365805,41.94831013916501
21093_marine,548,186,419,248,734,76.45985401459853,45.25547445255474
21094_marine,418,175,332,160,593,79.42583732057416,38.27751196172249
21181_marine,556,217,460,285,773,82.73381294964028,51.2589928057554
21182_marine,585,234,483,295,819,82.564102564102555,50.427350427350426
21190_marine,891,364,603,473,1255,67.67676767676768,53.086419753086425
21191_marine,1038,451,698,593,1489,67.2447013487476,57.129094412331405
21192_marine,1072,459,728,598,1531,67.91044776119402,55.78358208955224
21304_marine,454,363,287,220,817,63.21585903083701,48.458149779735685
21305_marine,436,350,276,209,786,63.30275229357798,47.935779816513765
21307_marine,446,401,277,217,847,62.10762331838565,48.654708520179376
21308_marine,440,380,276,216,820,62.727272727272734,49.09090909090909
21330_marine,533,474,295,301,1007,55.34709193245778,56.47279549718574
21331_marine,577,559,310,332,1136,53.7261698440208,57.538994800693246
21332_marine,589,536,324,333,1125,55.00848896434635,56.536502546689306
21333_marine,583,525,325,321,1108,55.74614065180102,55.06003430531733
21334_marine,571,505,320,317,1076,56.042031523642734,55.51663747810858
21335_marine,572,462,320,320,1034,55.94405594405595,55.94405594405595
21336_marine,580,458,331,323,1038,57.068965517241374,55.68965517241379
21337_marine,557,430,326,300,987,58.52782764811491,53.85996409335727
21339_marine,588,454,352,316,1042,59.863945578231295,53.74149659863946
21411_marine,520,253,411,197,773,79.03846153846153,37.88461538461539
21449_marine,366,150,288,116,516,78.68852459016394,31.693989071038253
21469_marine,504,241,359,255,745,71.23015873015873,50.595238095238095
21470_marine,457,220,329,214,677,71.99124726477024,46.82713347921225
21471_marine,425,207,309,193,632,72.70588235294117,45.41176470588235
21541_marine,634,287,522,318,921,82.33438485804416,50.1577287066246
21542_marine,662,275,546,332,937,82.4773413897281,50.15105740181269
21543_marine,530,201,443,241,731,83.58490566037736,45.47169811320755
21551_marine,1103,544,745,612,1647,67.54306436990028,55.48504079782411
21552_marine,952,421,647,510,1373,67.96218487394958,53.57142857142857
21665_marine,449,338,283,224,787,63.02895322939867,49.88864142538976
21666_marine,495,458,326,226,953,65.85858585858585,45.656565656565654
21668_marine,499,477,305,241,976,61.12224448897795,48.296593186372746
21685_marine,577,420,303,346,997,52.512998266897746,59.96533795493934
21686_marine,589,448,312,349,1037,52.97113752122241,59.25297113752123
21687_marine,579,455,311,346,1034,53.71329879101899,59.758203799654574
21688_marine,563,381,310,330,944,55.06216696269982,58.614564831261106
21689_marine,556,391,305,327,947,54.85611510791367,58.81294964028777
21690_marine,555,366,310,316,921,55.85585585585585,56.93693693693693
21691_marine,556,386,310,319,942,55.75539568345324,57.37410071942446
21692_marine,562,436,323,313,998,57.47330960854092,55.693950177935946
21695_marine,587,519,335,326,1106,57.06984667802385,55.5366269165247
21696_marine,594,501,340,331,1095,57.23905723905723,55.72390572390572
21697_marine,605,465,346,338,1070,57.190082644628106,55.867768595041326
21698_marine,574,431,335,317,1005,58.36236933797909,55.22648083623694
21699_marine,568,399,343,302,967,60.387323943661976,53.16901408450704
21700_marine,582,447,350,307,1029,60.13745704467354,52.749140893470795
21770_marine,469,233,376,165,702,80.17057569296375,35.18123667377399
21771_marine,500,215,393,186,715,78.60000000000001,37.2
21829_marine,517,238,368,260,755,71.1798839458414,50.29013539651837
21830_marine,381,177,281,158,558,73.75328083989501,41.46981627296588
21831_marine,440,221,317,199,661,72.04545454545455,45.22727272727273
21902_marine,698,289,581,338,987,83.2378223495702,48.42406876790831
21903_marine,690,290,572,320,980,82.89855072463767,46.3768115942029
22026_marine,438,339,276,216,777,63.013698630136986,49.31506849315068
22028_marine,530,565,318,260,1095,60,49.056603773584904
22029_marine,507,498,308,243,1005,60.74950690335306,47.928994082840234
22043_marine,557,381,297,318,938,53.3213644524237,57.09156193895871
22044_marine,615,427,328,355,1042,53.333333333333336,57.72357723577236
22045_marine,580,425,313,338,1005,53.96551724137931,58.27586206896552
22051_marine,528,429,299,294,957,56.628787878787875,55.68181818181818
22058_marine,595,447,345,332,1042,57.98319327731093,55.79831932773109
22060_marine,641,432,381,344,1073,59.4383775351014,53.66614664586583
22122_marine,334,150,296,79,484,88.62275449101796,23.652694610778443
22123_marine,352,168,310,86,520,88.06818181818183,24.431818181818183
22124_marine,370,176,324,100,546,87.56756756756758,27.027027027027028
22125_marine,358,169,316,95,527,88.26815642458101,26.536312849162012
22130_marine,455,203,363,156,658,79.78021978021978,34.285714285714285
22191_marine,430,214,314,186,644,73.0232558139535,43.25581395348837
22192_marine,422,210,308,185,632,72.98578199052133,43.838862559241704
22261_marine,713,302,586,341,1015,82.18793828892007,47.82608695652174
22262_marine,746,318,609,365,1064,81.63538873994638,48.92761394101876
22270_marine,1117,532,698,662,1649,62.48880931065354,59.26589077887198
22271_marine,997,419,612,585,1416,61.384152457372124,58.67602808425276
22388_marine,479,445,298,217,924,62.21294363256785,45.3027139874739
22389_marine,560,562,337,274,1122,60.17857142857142,48.92857142857142
22390_marine,544,525,328,269,1069,60.29411764705882,49.44852941176471
22391_marine,516,431,316,252,947,61.240310077519375,48.837209302325576
22403_marine,605,440,314,354,1045,51.90082644628099,58.51239669421487
22418_marine,612,425,363,336,1037,59.31372549019608,54.90196078431373
22420_marine,636,454,379,339,1090,59.59119496855346,53.301886792452834
22484_marine,359,169,316,97,528,88.02228412256268,27.019498607242337
22485_marine,368,170,326,95,538,88.58695652173914,25.815217391304344
22552_marine,429,213,313,185,642,72.96037296037296,43.12354312354312
22553_marine,429,202,316,187,631,73.65967365967366,43.58974358974359
22554_marine,415,198,309,175,613,74.4578313253012,42.168674698795186
22556_marine,433,214,326,182,647,75.28868360277137,42.032332563510394
22557_marine,494,262,375,203,756,75.91093117408907,41.093117408906885
22621_marine,831,352,678,389,1183,81.58844765342961,46.81107099879663
22622_marine,570,252,473,218,822,82.98245614035088,38.24561403508772
22628_marine,1061,475,659,618,1536,62.11121583411876,58.24693685202639
22629_marine,1124,544,703,663,1668,62.54448398576512,58.98576512455516
22630_marine,1081,489,676,640,1570,62.534690101757626,59.204440333024976
22749_marine,504,472,318,229,976,63.095238095238095,45.43650793650794
22751_marine,560,507,336,280,1067,60,50
22763_marine,587,417,311,341,1004,52.98126064735945,58.09199318568995
22778_marine,608,407,365,331,1015,60.0328947368421,54.44078947368421
22779_marine,604,375,355,330,979,58.774834437086085,54.63576158940398
22780_marine,658,461,382,356,1119,58.05471124620061,54.1033434650456
22782_marine,470,345,285,265,815,60.63829787234043,56.38297872340425
22783_marine,465,332,276,270,797,59.354838709677416,58.06451612903226
22784_marine,464,321,274,266,785,59.05172413793104,57.327586206896555
22910_marine,390,180,278,171,570,71.28205128205128,43.84615384615385
22911_marine,436,211,312,197,647,71.55963302752293,45.18348623853211
22914_marine,420,212,315,180,632,75,42.857142857142854
22915_marine,441,218,330,190,659,74.82993197278913,43.08390022675737
22916_marine,463,246,354,192,709,76.45788336933045,41.46868250539957
22917_marine,586,340,445,248,926,75.93856655290102,42.32081911262799
22918_marine,526,269,404,212,795,76.80608365019012,40.3041825095057
22980_marine,972,412,767,461,1384,78.90946502057614,47.42798353909465
22981_marine,970,403,772,447,1373,79.58762886597938,46.08247422680412
22987_marine,1057,464,655,616,1521,61.9678334910123,58.27814569536424
22988_marine,1164,652,711,690,1816,61.08247422680413,59.27835051546392
22989_marine,1127,534,703,669,1661,62.37799467613132,59.36113575865129
23109_marine,505,451,320,231,956,63.366336633663366,45.742574257425744
23111_marine,578,557,357,283,1135,61.76470588235294,48.96193771626297
23112_marine,489,457,309,240,946,63.190184049079754,49.079754601226995
23123_marine,570,395,309,332,965,54.21052631578947,58.245614035087726
23139_marine,673,452,389,366,1125,57.80089153046062,54.38335809806835
23140_marine,689,528,398,378,1217,57.76487663280116,54.862119013062404
23142_marine,482,341,296,268,823,61.41078838174274,55.601659751037346
23143_marine,481,360,286,279,841,59.45945945945946,58.004158004158
23144_marine,463,320,276,261,783,59.611231101511876,56.371490280777536
23271_marine,436,215,311,194,651,71.3302752293578,44.4954128440367
23278_marine,553,284,423,224,837,76.49186256781194,40.50632911392405
23279_marine,540,278,415,211,818,76.85185185185185,39.07407407407407
23280_marine,505,258,390,191,763,77.22772277227723,37.82178217821782
23281_marine,491,253,383,184,744,78.00407331975559,37.4745417515275
23282_marine,527,270,409,185,797,77.60910815939279,35.10436432637571
23283_marine,510,253,402,180,763,78.82352941176471,35.294117647058826
23284_marine,505,269,402,181,774,79.60396039603961,35.84158415841584
23285_marine,506,267,401,180,773,79.2490118577075,35.573122529644266
23286_marine,533,264,418,209,797,78.42401500938087,39.21200750469043
23287_marine,611,284,474,262,895,77.57774140752865,42.88052373158756
23339_marine,997,378,786,494,1375,78.83650952858575,49.54864593781344
23340_marine,1187,470,934,575,1657,78.68576242628475,48.44144903117102
23342_marine,1471,624,1043,773,2095,70.90414683888511,52.54928619986404
23343_marine,1445,639,1011,778,2084,69.96539792387543,53.840830449826996
23352_marine,373,77,260,194,450,69.70509383378017,52.01072386058981
23472_marine,578,538,355,282,1116,61.418685121107266,48.78892733564014
23473_marine,503,465,312,242,968,62.02783300198808,48.111332007952285
23500_marine,666,542,394,350,1208,59.15915915915916,52.552552552552555
23502_marine,505,331,316,271,836,62.57425742574257,53.663366336633665
23503_marine,478,346,287,274,824,60.04184100418411,57.32217573221757
23504_marine,467,318,280,267,785,59.95717344753747,57.17344753747323
23505_marine,455,303,271,256,758,59.56043956043956,56.26373626373626
23506_marine,454,292,278,247,746,61.23348017621145,54.40528634361234
23647_marine,606,296,475,246,902,78.38283828382838,40.5940594059406
23648_marine,655,295,511,293,950,78.01526717557252,44.732824427480914
23698_marine,1018,399,789,528,1417,77.5049115913556,51.8664047151277
23699_marine,1106,445,860,552,1551,77.75768535262206,49.90958408679928
23700_marine,1438,558,1048,760,1996,72.87899860917942,52.85118219749653
23701_marine,1375,563,1002,709,1938,72.87272727272727,51.56363636363637
23702_marine,1479,656,1037,792,2135,70.11494252873564,53.54969574036511
23703_marine,1229,561,843,624,1790,68.59235150528885,50.772986167615954
23704_marine,1158,534,776,641,1692,67.01208981001727,55.35405872193437
23705_marine,1082,493,703,626,1575,64.97227356746765,57.85582255083179
23706_marine,1052,446,673,623,1498,63.973384030418245,59.22053231939164
23830_marine,501,408,327,230,909,65.26946107784431,45.90818363273453
23831_marine,539,485,350,245,1024,64.93506493506493,45.45454545454545
23833_marine,559,523,342,272,1082,61.18067978533095,48.658318425760285
23834_marine,587,576,348,293,1163,59.28449744463373,49.91482112436116
23843_marine,521,405,271,308,926,52.01535508637236,59.11708253358925
23857_marine,599,409,388,294,1008,64.77462437395658,49.08180300500835
23858_marine,603,413,391,297,1016,64.8424543946932,49.25373134328358
23859_marine,595,427,386,297,1022,64.87394957983193,49.91596638655462
23860_marine,584,436,374,299,1020,64.04109589041096,51.1986301369863
23863_marine,503,331,313,270,834,62.22664015904572,53.677932405566594
23864_marine,460,300,283,255,760,61.52173913043478,55.434782608695656
23865_marine,464,310,282,263,774,60.775862068965516,56.68103448275862
23866_marine,459,305,278,257,764,60.56644880174292,55.99128540305011
24008_marine,642,299,501,283,941,78.03738317757009,44.0809968847352
24009_marine,697,307,537,326,1004,77.0444763271162,46.77187948350072
24011_marine,664,264,507,320,928,76.35542168674698,48.19277108433735
24031_marine,680,257,502,353,937,73.82352941176471,51.911764705882355
24054_marine,987,397,748,540,1384,75.78520770010132,54.7112462006079
24057_marine,986,415,764,517,1401,77.48478701825557,52.43407707910751
24058_marine,1022,431,799,524,1453,78.18003913894324,51.2720156555773
24061_marine,1423,589,1016,749,2012,71.3984539704849,52.63527758257203
24062_marine,1410,645,976,774,2055,69.21985815602837,54.8936170212766
24141_marine,434,188,301,253,622,69.35483870967742,58.294930875576036
24190_marine,529,428,339,246,957,64.08317580340265,46.502835538752365
24191_marine,527,472,339,244,999,64.32637571157495,46.29981024667932
24194_marine,589,595,350,293,1184,59.42275042444821,49.745331069609506
24195_marine,586,606,340,302,1192,58.02047781569966,51.5358361774744
24203_marine,592,457,314,345,1049,53.04054054054054,58.27702702702703
24216_marine,561,389,354,295,950,63.101604278074866,52.584670231729056
24217_marine,549,394,344,294,943,62.659380692167574,53.551912568306015
24218_marine,525,336,325,285,861,61.904761904761905,54.285714285714285
24219_marine,528,346,325,287,874,61.5530303030303,54.35606060606061
24220_marine,557,377,349,295,934,62.65709156193896,52.96229802513464
24221_marine,542,375,339,288,917,62.54612546125461,53.13653136531366
24222_marine,542,416,337,288,958,62.17712177121771,53.13653136531366
24223_marine,537,414,337,284,951,62.75605214152699,52.886405959031656
24226_marine,457,303,276,257,760,60.393873085339166,56.236323851203494
24227_marine,439,281,268,246,720,61.04783599088838,56.03644646924829
24369_marine,651,288,508,292,939,78.03379416282642,44.85407066052227
24370_marine,683,293,525,325,976,76.86676427525623,47.58418740849194
24371_marine,682,285,522,327,967,76.53958944281524,47.94721407624634
24373_marine,763,307,577,380,1070,75.62254259501967,49.803407601572744
24388_marine,419,135,300,290,554,71.59904534606206,69.21241050119332
24389_marine,759,328,570,371,1087,75.09881422924902,48.88010540184453
24390_marine,717,309,538,353,1026,75.03486750348675,49.232914923291496
24391_marine,711,294,532,354,1005,74.82419127988749,49.789029535864984
24392_marine,734,312,547,378,1046,74.52316076294278,51.49863760217984
24413_marine,442,163,321,314,605,72.62443438914026,71.04072398190046
24414_marine,1070,480,819,567,1550,76.54205607476635,52.99065420560748
24415_marine,1050,478,814,558,1528,77.52380952380953,53.142857142857146
24416_marine,1013,432,783,537,1445,77.29516288252715,53.01085883514314
24417_marine,971,415,756,493,1386,77.85787847579815,50.77239958805355
24421_marine,1476,674,1036,795,2150,70.18970189701898,53.86178861788618
24422_marine,1405,649,966,781,2054,68.75444839857651,55.587188612099645
24500_marine,407,176,286,224,583,70.27027027027027,55.03685503685504
24501_marine,444,193,303,261,637,68.24324324324324,58.78378378378378
24502_marine,479,204,324,287,683,67.64091858037578,59.91649269311065
24503_marine,486,204,328,294,690,67.48971193415639,60.49382716049383
24504_marine,447,190,308,258,637,68.90380313199105,57.71812080536913
24555_marine,617,653,356,325,1270,57.69854132901134,52.6742301458671
24563_marine,606,461,333,351,1067,54.95049504950495,57.920792079207914
24572_marine,625,414,364,336,1039,58.24,53.76
24573_marine,642,458,372,346,1100,57.943925233644855,53.89408099688473
24574_marine,699,545,400,382,1244,57.224606580829764,54.64949928469242
24576_marine,553,364,349,290,917,63.11030741410488,52.44122965641953
24577_marine,545,355,341,289,900,62.56880733944954,53.027522935779814
24578_marine,517,303,322,275,820,62.28239845261122,53.191489361702125
24580_marine,527,347,329,281,874,62.428842504743834,53.32068311195446
24581_marine,525,345,326,284,870,62.095238095238095,54.095238095238095
24582_marine,540,348,336,287,888,62.22222222222222,53.148148148148145
24583_marine,532,365,330,284,897,62.03007518796993,53.383458646616546
24584_marine,522,380,326,276,902,62.45210727969349,52.87356321839081
24585_marine,527,407,330,277,934,62.61859582542695,52.56166982922201
24587_marine,450,285,271,251,735,60.22222222222222,55.77777777777778
24588_marine,442,264,268,250,706,60.633484162895925,56.56108597285068
24589_marine,434,249,262,243,683,60.36866359447005,55.99078341013824
24730_marine,675,291,517,315,966,76.5925925925926,46.666666666666664
24731_marine,659,282,505,306,941,76.63125948406677,46.4339908952959
24732_marine,687,280,524,325,967,76.27365356622998,47.30713245997089
24733_marine,794,326,592,404,1120,74.55919395465995,50.88161209068011
24734_marine,716,292,536,367,1008,74.86033519553072,51.25698324022346
24747_marine,717,308,537,355,1025,74.89539748953975,49.5118549511855
24748_marine,776,332,580,395,1108,74.74226804123711,50.9020618556701
24749_marine,757,330,571,369,1087,75.42932628797885,48.74504623513871
24750_marine,730,335,550,359,1065,75.34246575342466,49.17808219178082
24751_marine,652,280,492,316,932,75.4601226993865,48.466257668711656
24752_marine,691,303,521,351,994,75.39797395079594,50.7959479015919
24753_marine,689,303,516,359,992,74.89114658925979,52.1044992743106
24768_marine,969,434,721,524,1403,74.40660474716202,54.076367389060884
24769_marine,986,429,744,529,1415,75.45638945233266,53.65111561866126
24770_marine,900,381,680,480,1281,75.55555555555556,53.333333333333336
24771_marine,893,375,676,480,1268,75.69988801791713,53.75139977603583
24772_marine,924,394,703,499,1318,76.08225108225109,54.004329004329
24773_marine,978,414,740,533,1392,75.66462167689161,54.49897750511248
24774_marine,1005,421,769,525,1426,76.51741293532338,52.23880597014925
24781_marine,1445,662,995,794,2107,68.85813148788927,54.94809688581314
24863_marine,428,193,294,243,621,68.69158878504673,56.77570093457944
24864_marine,447,184,304,261,631,68.0089485458613,58.38926174496645
24865_marine,468,185,319,282,653,68.16239316239316,60.256410256410255
24915_marine,615,652,354,324,1267,57.56097560975609,52.6829268292683
24923_marine,544,403,309,302,947,56.80147058823529,55.51470588235294
24924_marine,597,466,341,330,1063,57.11892797319933,55.27638190954774
24930_marine,628,420,360,323,1048,57.324840764331206,51.433121019108285
24933_marine,681,570,372,393,1251,54.62555066079295,57.70925110132159
24934_marine,696,568,386,394,1264,55.45977011494253,56.60919540229885
24942_marine,530,332,332,280,862,62.64150943396226,52.83018867924528
24943_marine,523,332,325,280,855,62.1414913957935,53.53728489483748
24945_marine,529,361,329,284,890,62.19281663516069,53.68620037807184
24946_marine,539,429,339,284,968,62.89424860853432,52.69016697588126
24947_marine,483,324,307,251,807,63.56107660455487,51.96687370600414
25091_marine,691,287,532,320,978,76.98986975397975,46.30969609261939
25092_marine,697,281,533,326,978,76.47058823529412,46.77187948350072
25093_marine,768,318,584,370,1086,76.04166666666666,48.17708333333333
25107_marine,769,334,569,386,1103,73.99219765929779,50.19505851755527
25108_marine,723,318,544,352,1041,75.2420470262794,48.686030428769016
25113_marine,798,352,582,428,1150,72.93233082706767,53.63408521303258
25114_marine,775,312,559,430,1087,72.12903225806451,55.483870967741936
25127_marine,949,442,707,506,1391,74.49947312961012,53.31928345626976
25128_marine,929,428,696,491,1357,74.91926803013995,52.85252960172229
25130_marine,959,435,710,508,1394,74.0354535974974,52.971845672575604
25131_marine,994,434,736,528,1428,74.04426559356136,53.118712273641854
25224_marine,457,184,311,274,641,68.05251641137856,59.95623632385121
25225_marine,459,185,313,275,644,68.1917211328976,59.912854030501094
25226_marine,448,179,309,266,627,68.97321428571429,59.375
25275_marine,568,589,332,287,1157,58.45070422535211,50.52816901408451
25276_marine,562,591,330,287,1153,58.718861209964416,51.06761565836299
25284_marine,628,507,348,356,1135,55.4140127388535,56.68789808917197
25285_marine,623,500,350,344,1123,56.17977528089888,55.21669341894061
25290_marine,602,419,349,315,1021,57.9734219269103,52.32558139534884
25293_marine,660,559,370,375,1219,56.060606060606055,56.81818181818182
25299_marine,427,243,267,236,670,62.52927400468384,55.26932084309133
25300_marine,411,223,266,218,634,64.72019464720195,53.04136253041363
25301_marine,455,239,298,233,694,65.49450549450549,51.208791208791204
25303_marine,525,372,326,280,897,62.095238095238095,53.333333333333336
25304_marine,523,361,325,280,884,62.1414913957935,53.53728489483748
25305_marine,522,378,325,280,900,62.26053639846744,53.63984674329502
25306_marine,522,384,326,278,906,62.45210727969349,53.25670498084292
25309_marine,467,354,301,249,821,64.45396145610277,53.319057815845824
25310_marine,467,345,300,250,812,64.23982869379014,53.53319057815846
25311_marine,478,356,308,253,834,64.43514644351464,52.928870292887034
25312_marine,474,350,307,250,824,64.76793248945147,52.742616033755276
25453_marine,780,350,596,383,1130,76.41025641025641,49.1025641025641
25454_marine,738,322,566,370,1060,76.69376693766937,50.135501355013545
25465_marine,736,339,547,367,1075,74.32065217391305,49.86413043478261
25466_marine,823,358,614,416,1181,74.60510328068044,50.546780072904006
25467_marine,752,333,565,365,1085,75.13297872340425,48.53723404255319
25473_marine,461,215,344,188,676,74.62039045553145,40.780911062906725
25474_marine,802,345,576,455,1147,71.82044887780549,56.733167082294266
25475_marine,784,318,564,438,1102,71.93877551020408,55.86734693877551
25486_marine,891,419,662,480,1310,74.29854096520762,53.87205387205387
25487_marine,857,402,637,455,1259,74.32905484247374,53.092182030338385
25489_marine,815,354,622,409,1169,76.31901840490798,50.1840490797546
25490_marine,828,350,634,409,1178,76.57004830917874,49.39613526570048
25491_marine,835,359,630,432,1194,75.44910179640718,51.73652694610779
25492_marine,837,357,637,421,1194,76.10513739545998,50.29868578255675
25585_marine,452,179,311,269,631,68.80530973451327,59.51327433628318
25636_marine,553,583,324,279,1136,58.58951175406871,50.45207956600362
25637_marine,555,603,325,283,1158,58.55855855855856,50.990990990990994
25638_marine,532,574,309,269,1106,58.08270676691729,50.56390977443609
25645_marine,678,634,360,396,1312,53.09734513274337,58.4070796460177
25646_marine,674,631,363,397,1305,53.85756676557863,58.902077151335305
25647_marine,627,499,357,352,1126,56.9377990430622,56.14035087719298
25648_marine,626,442,356,350,1068,56.86900958466453,55.91054313099042
25649_marine,673,495,374,386,1168,55.57206537890045,57.355126300148584
25652_marine,675,632,374,385,1307,55.407407407407405,57.03703703703704
25653_marine,676,603,374,383,1279,55.325443786982255,56.6568047337278
25663_marine,472,331,295,252,803,62.5,53.38983050847458
25666_marine,475,378,304,249,853,64,52.421052631578945
25668_marine,475,399,305,249,874,64.21052631578948,52.421052631578945
25669_marine,469,388,302,247,857,64.39232409381663,52.66524520255863
25671_marine,474,356,309,250,830,65.18987341772153,52.742616033755276
25672_marine,493,408,320,258,901,64.90872210953347,52.33265720081136
25673_marine,520,389,335,281,909,64.42307692307693,54.03846153846153
25674_marine,515,363,332,278,878,64.46601941747574,53.980582524271846
25675_marine,528,411,337,286,939,63.82575757575758,54.166666666666664
25676_marine,477,361,316,244,838,66.24737945492663,51.15303983228512
25677_marine,443,347,303,215,790,68.39729119638827,48.53273137697517
25678_marine,407,310,276,201,717,67.81326781326781,49.385749385749385
25813_marine,788,349,599,393,1137,76.01522842639594,49.87309644670051
25814_marine,739,328,570,361,1067,77.13125845737483,48.84979702300406
25824_marine,711,315,533,344,1026,74.9648382559775,48.38255977496484
25825_marine,742,331,550,368,1073,74.12398921832884,49.59568733153639
25834_marine,769,321,551,430,1090,71.65149544863459,55.91677503250976
25835_marine,819,358,586,460,1177,71.55067155067155,56.166056166056165
25846_marine,909,418,661,498,1327,72.71727172717272,54.78547854785478
25847_marine,920,415,667,506,1335,72.5,55.00000000000001
25849_marine,835,354,628,427,1189,75.20958083832335,51.1377245508982
25850_marine,818,345,613,426,1163,74.93887530562347,52.07823960880196
25851_marine,817,348,614,427,1165,75.1529987760098,52.264381884944925
25861_marine,1345,612,864,817,1957,64.23791821561339,60.74349442379182
25862_marine,1356,652,870,824,2008,64.15929203539822,60.766961651917406
25863_marine,1367,642,879,828,2009,64.30138990490124,60.570592538405265
25998_marine,540,586,313,275,1126,57.96296296296296,50.92592592592593
25999_marine,551,582,319,286,1133,57.89473684210527,51.90562613430127
26000_marine,529,554,307,270,1083,58.034026465028354,51.03969754253308
26012_marine,723,683,380,428,1406,52.558782849239286,59.19778699861688
26013_marine,454,364,294,201,818,64.75770925110133,44.27312775330397
26023_marine,478,335,304,251,813,63.59832635983263,52.51046025104602
26029_marine,481,386,312,254,867,64.86486486486487,52.80665280665281
26033_marine,513,371,336,268,884,65.49707602339181,52.241715399610136
26034_marine,509,374,333,266,883,65.42239685658153,52.25933202357563
26035_marine,508,369,330,265,877,64.96062992125984,52.16535433070866
26036_marine,464,350,308,230,814,66.37931034482759,49.56896551724138
26037_marine,406,320,283,180,726,69.70443349753694,44.33497536945813
26038_marine,429,340,288,222,769,67.13286713286713,51.74825174825175
26075_marine,244,98,211,55,342,86.47540983606558,22.540983606557376
26076_marine,245,97,212,55,342,86.53061224489797,22.448979591836736
26174_marine,766,336,587,379,1102,76.63185378590079,49.47780678851175
26183_marine,709,333,540,342,1042,76.16361071932299,48.23695345557123
26184_marine,748,334,561,355,1082,75,47.45989304812834
26195_marine,850,355,607,481,1205,71.41176470588235,56.58823529411765
26197_marine,887,384,642,488,1271,72.37880496054116,55.01691093573844
26198_marine,891,386,645,485,1277,72.39057239057239,54.43322109988776
26207_marine,980,427,703,552,1407,71.73469387755102,56.326530612244895
26208_marine,940,396,660,531,1336,70.2127659574468,56.48936170212766
26221_marine,1332,594,849,816,1926,63.738738738738746,61.261261261261254
26223_marine,1369,632,873,835,2001,63.76917457998539,60.99342585829073
26360_marine,523,525,305,265,1048,58.31739961759082,50.66921606118547
26361_marine,546,583,317,275,1129,58.058608058608066,50.366300366300365
26362_marine,539,568,314,269,1107,58.25602968460112,49.90723562152134
26363_marine,520,552,301,265,1072,57.88461538461539,50.96153846153846
26365_marine,499,519,298,246,1018,59.719438877755515,49.298597194388776
26366_marine,537,553,312,278,1090,58.10055865921788,51.76908752327747
26367_marine,508,487,307,255,995,60.43307086614173,50.196850393700785
26372_marine,703,747,376,412,1450,53.485064011379805,58.60597439544808
26374_marine,683,692,372,394,1375,54.465592972181554,57.68667642752562
26375_marine,668,654,360,387,1322,53.89221556886228,57.93413173652695
26398_marine,410,316,284,196,726,69.26829268292683,47.80487804878049
26435_marine,248,101,215,57,349,86.69354838709677,22.983870967741936
26436_marine,253,110,218,60,363,86.16600790513834,23.715415019762844
26438_marine,251,107,219,58,358,87.25099601593625,23.107569721115535
26534_marine,778,342,592,390,1120,76.09254498714652,50.128534704370175
26542_marine,730,334,554,347,1064,75.89041095890411,47.534246575342465
26543_marine,730,334,553,346,1064,75.75342465753425,47.397260273972606
26555_marine,838,349,595,474,1187,71.00238663484487,56.56324582338902
26556_marine,819,326,582,455,1145,71.06227106227107,55.55555555555556
26557_marine,835,359,613,452,1194,73.41317365269461,54.131736526946106
26558_marine,948,440,695,510,1388,73.31223628691983,53.79746835443038
26568_marine,987,423,697,566,1410,70.61803444782169,57.34549138804458
26569_marine,1074,431,759,620,1505,70.6703910614525,57.72811918063314
26580_marine,1336,610,849,819,1946,63.547904191616766,61.30239520958084
26581_marine,1341,617,853,822,1958,63.60924683072334,61.297539149888145
26582_marine,1354,639,855,838,1993,63.14623338257016,61.89069423929099
26583_marine,1375,652,872,845,2027,63.41818181818182,61.45454545454545
26723_marine,531,565,309,267,1096,58.19209039548022,50.282485875706215
26724_marine,532,568,310,266,1100,58.27067669172933,50
26725_marine,534,570,315,262,1104,58.98876404494382,49.063670411985015
26727_marine,532,561,315,271,1093,59.210526315789465,50.93984962406015
26728_marine,492,495,299,246,987,60.77235772357723,50
26732_marine,672,749,359,386,1421,53.422619047619044,57.44047619047619
26733_marine,652,719,349,378,1371,53.52760736196319,57.97546012269939
26734_marine,647,663,350,375,1310,54.09582689335394,57.95981452859351
26735_marine,641,635,350,366,1276,54.60218408736349,57.09828393135725
26736_marine,651,646,350,384,1297,53.76344086021505,58.986175115207374
26737_marine,664,624,362,389,1288,54.51807228915663,58.584337349397586
26759_marine,462,357,301,242,819,65.15151515151516,52.38095238095239
26796_marine,245,102,210,56,347,85.71428571428571,22.857142857142858
26797_marine,256,109,221,61,365,86.328125,23.828125
26798_marine,250,107,218,57,357,87.2,22.8
26894_marine,865,373,644,447,1238,74.45086705202311,51.676300578034684
26901_marine,774,344,586,364,1118,75.71059431524549,47.02842377260982
26902_marine,732,333,553,341,1065,75.5464480874317,46.58469945355191
26915_marine,847,353,592,478,1200,69.89374262101535,56.434474616292796
26916_marine,821,331,584,453,1152,71.13276492082827,55.176613885505475
26918_marine,959,430,673,535,1389,70.17726798748697,55.78727841501564
26929_marine,1053,419,746,621,1472,70.84520417853751,58.97435897435898
26940_marine,1335,623,845,821,1958,63.29588014981273,61.49812734082397
26942_marine,1424,712,896,879,2136,62.92134831460674,61.72752808988764
26943_marine,1304,596,808,792,1900,61.963190184049076,60.73619631901841
27088_marine,495,515,303,244,1010,61.212121212121204,49.292929292929294
27089_marine,483,487,298,235,970,61.697722567287784,48.65424430641822
27097_marine,640,591,356,366,1231,55.625,57.1875
27156_marine,251,106,216,59,357,86.05577689243027,23.50597609561753
27157_marine,252,106,217,61,358,86.11111111111111,24.206349206349206
27163_marine,766,379,521,342,1145,68.01566579634465,44.64751958224543
27164_marine,760,365,508,352,1125,66.84210526315789,46.31578947368421
27255_marine,905,382,671,471,1287,74.14364640883979,52.04419889502763
27261_marine,782,347,588,374,1129,75.1918158567775,47.82608695652174
27278_marine,1142,439,773,652,1581,67.68826619964973,57.09281961471103
27279_marine,1138,423,766,654,1561,67.31107205623901,57.46924428822495
27290_marine,1098,426,754,659,1524,68.6703096539162,60.01821493624773
27301_marine,1389,672,876,854,2061,63.06695464362851,61.48308135349172
27302_marine,1425,707,895,880,2132,62.807017543859644,61.75438596491228
27303_marine,1406,709,880,873,2115,62.58890469416786,62.09103840682788
27304_marine,1364,670,850,844,2034,62.316715542522,61.87683284457478
27305_marine,1299,612,810,776,1911,62.355658198614314,59.73826020015397
27449_marine,482,495,295,236,977,61.20331950207469,48.96265560165975
27450_marine,561,565,329,286,1126,58.64527629233511,50.98039215686274
27451_marine,560,576,334,278,1136,59.64285714285714,49.642857142857146
27452_marine,552,572,330,274,1124,59.78260869565217,49.63768115942029
27453_marine,594,605,344,312,1199,57.91245791245792,52.52525252525253
27457_marine,566,495,338,303,1061,59.717314487632514,53.53356890459364
27459_marine,376,287,269,149,663,71.54255319148936,39.62765957446808
27524_marine,889,449,583,417,1338,65.5793025871766,46.9066366704162
27525_marine,818,384,535,385,1202,65.40342298288509,47.066014669926645
27615_marine,905,371,677,481,1276,74.80662983425415,53.149171270718234
27621_marine,840,370,628,412,1210,74.76190476190476,49.047619047619044
27633_marine,703,279,464,420,982,66.00284495021337,59.74395448079659
27634_marine,726,289,486,420,1015,66.94214876033058,57.85123966942148
27639_marine,1312,519,867,783,1831,66.08231707317073,59.67987804878049
27641_marine,1111,521,825,601,1632,74.25742574257426,54.0954095409541
27650_marine,1135,435,785,675,1570,69.16299559471366,59.471365638766514
27661_marine,1434,724,909,875,2158,63.38912133891213,61.01813110181311
27662_marine,1457,742,919,891,2199,63.07481125600549,61.15305422100206
27663_marine,1418,707,892,866,2125,62.90550070521862,61.0719322990127
27664_marine,1382,684,862,855,2066,62.37337192474675,61.86685962373372
27665_marine,1398,701,878,855,2099,62.80400572246065,61.1587982832618
27685_marine,696,228,466,426,924,66.95402298850574,61.206896551724135
27813_marine,564,583,338,278,1147,59.9290780141844,49.29078014184397
27814_marine,556,565,332,277,1121,59.71223021582733,49.82014388489209
27817_marine,649,687,358,376,1336,55.1617873651772,57.93528505392912
27819_marine,398,288,276,174,686,69.34673366834171,43.71859296482412
27828_marine,643,637,377,353,1280,58.63141524105754,54.898911353032666
27829_marine,649,640,380,358,1289,58.55161787365177,55.1617873651772
27830_marine,668,693,391,370,1361,58.532934131736525,55.38922155688623
27831_marine,679,734,399,377,1413,58.76288659793815,55.52282768777614
27832_marine,461,358,323,210,819,70.06507592190889,45.5531453362256
27884_marine,848,417,575,371,1265,67.80660377358491,43.75
27975_marine,939,398,696,494,1337,74.12140575079871,52.609158679446224
27976_marine,919,393,685,487,1312,74.53754080522307,52.9923830250272
27980_marine,816,362,605,407,1178,74.1421568627451,49.877450980392155
27981_marine,841,379,628,415,1220,74.6730083234245,49.34601664684899
27993_marine,706,273,465,425,979,65.86402266288952,60.19830028328612
27994_marine,632,249,424,351,881,67.08860759493672,55.5379746835443
27998_marine,1000,316,645,599,1316,64.5,59.9
27999_marine,1308,513,870,766,1821,66.5137614678899,58.56269113149847
28000_marine,1091,484,804,579,1575,73.69385884509624,53.07057745187901
28001_marine,1146,538,834,623,1684,72.77486910994764,54.3630017452007
28002_marine,1074,489,786,575,1563,73.18435754189943,53.53817504655494
28003_marine,1131,521,827,617,1652,73.1211317418214,54.55349248452697
28010_marine,1188,453,811,709,1641,68.26599326599326,59.68013468013468
28020_marine,1281,559,799,777,1840,62.37314597970336,60.65573770491803
28021_marine,1392,682,880,843,2074,63.2183908045977,60.560344827586206
28022_marine,1395,710,882,833,2105,63.2258064516129,59.71326164874552
28023_marine,1315,625,819,787,1940,62.28136882129277,59.847908745247146
28024_marine,1407,702,884,867,2109,62.82871357498223,61.62046908315565
28025_marine,1434,770,893,896,2204,62.273361227336125,62.482566248256624
28026_marine,1326,630,818,806,1956,61.68929110105581,60.78431372549019
28174_marine,567,623,336,286,1190,59.25925925925925,50.44091710758377
28175_marine,590,642,346,300,1232,58.644067796610166,50.847457627118644
28177_marine,649,747,362,373,1396,55.77812018489985,57.473035439137135
28186_marine,739,795,413,430,1534,55.88633288227334,58.18673883626523
28187_marine,703,761,391,405,1464,55.618776671408256,57.61024182076814
28188_marine,648,640,369,365,1288,56.94444444444444,56.32716049382716
28189_marine,679,639,389,385,1318,57.2901325478645,56.70103092783505
28190_marine,649,632,378,359,1281,58.24345146379045,55.31587057010786
28191_marine,670,708,391,371,1378,58.35820895522388,55.37313432835821
28192_marine,711,742,414,394,1453,58.22784810126582,55.41490857946554
28196_marine,518,428,351,239,946,67.76061776061776,46.13899613899614
28197_marine,523,442,354,244,965,67.68642447418738,46.65391969407266
28200_marine,523,453,345,243,976,65.96558317399618,46.46271510516252
28244_marine,780,361,550,323,1141,70.51282051282051,41.410256410256416
28245_marine,812,388,562,342,1200,69.21182266009852,42.11822660098522
28336_marine,980,425,724,520,1405,73.87755102040816,53.06122448979592
28340_marine,876,389,645,438,1265,73.63013698630137,50
28353_marine,703,289,462,424,992,65.71834992887624,60.31294452347083
28354_marine,624,247,417,350,871,66.82692307692307,56.08974358974359
28359_marine,1331,506,880,767,1837,66.11570247933885,57.62584522915102
28360_marine,1139,516,829,617,1655,72.78314310798947,54.17032484635646
28363_marine,1172,524,858,648,1696,73.20819112627987,55.2901023890785
28364_marine,1121,498,816,631,1619,72.7921498661909,56.28902765388047
28369_marine,1155,460,788,687,1615,68.22510822510822,59.480519480519476
28370_marine,1190,465,811,704,1655,68.15126050420169,59.15966386554622
28376_marine,721,194,463,433,915,64.21636615811373,60.05547850208044
28380_marine,1346,621,858,810,1967,63.74442793462109,60.178306092124814
28381_marine,1310,590,821,782,1900,62.671755725190835,59.69465648854961
28382_marine,1354,676,855,806,2030,63.14623338257016,59.527326440177255
28383_marine,1337,631,834,807,1968,62.378459237097985,60.35901271503366
28384_marine,1409,756,883,846,2165,62.66855926188787,60.042583392476935
28385_marine,1451,832,914,858,2283,62.991040661612686,59.13163335630599
28386_marine,1377,695,849,833,2072,61.6557734204793,60.49382716049383
28535_marine,632,718,368,336,1350,58.22784810126582,53.16455696202531
28536_marine,599,676,348,313,1275,58.09682804674458,52.25375626043406
28537_marine,665,794,362,395,1459,54.4360902255639,59.3984962406015
28545_marine,693,750,395,398,1443,56.99855699855701,57.43145743145743
28546_marine,694,718,393,402,1412,56.62824207492796,57.925072046109506
28548_marine,399,495,200,254,894,50.125313283208015,63.65914786967418
28549_marine,714,696,405,412,1410,56.72268907563025,57.70308123249299
28552_marine,755,794,429,433,1549,56.82119205298013,57.35099337748344
28553_marine,761,837,430,436,1598,56.504599211563736,57.29303547963206
28554_marine,764,830,429,436,1594,56.15183246073299,57.06806282722513
28555_marine,746,779,432,410,1525,57.9088471849866,54.95978552278821
28556_marine,759,825,440,422,1584,57.971014492753625,55.59947299077734
28557_marine,767,803,440,431,1570,57.36636245110821,56.192959582790095
28558_marine,808,871,465,454,1679,57.54950495049505,56.188118811881196
28559_marine,824,949,466,461,1773,56.55339805825243,55.94660194174757
28560_marine,642,616,381,346,1258,59.345794392523366,53.89408099688473
28605_marine,745,362,535,291,1107,71.81208053691275,39.06040268456376
28606_marine,768,373,546,300,1141,71.09375,39.0625
28607_marine,400,211,238,222,611,59.5,55.50000000000001
28696_marine,1003,407,739,521,1410,73.678963110668,51.94416749750748
28697_marine,1008,412,738,524,1420,73.21428571428571,51.98412698412699
28700_marine,1116,463,785,593,1579,70.3405017921147,53.136200716845885
28713_marine,686,255,448,410,941,65.3061224489796,59.7667638483965
28719_marine,1393,580,925,809,1973,66.40344580043073,58.07609475951184
28720_marine,1180,544,853,640,1724,72.28813559322033,54.23728813559322
28724_marine,1142,509,826,644,1651,72.3292469352014,56.3922942206655
28725_marine,1152,516,837,656,1668,72.65625,56.94444444444444
28726_marine,1054,422,763,592,1476,72.39089184060721,56.166982922201136
28727_marine,1146,454,802,671,1600,69.9825479930192,58.551483420593364
28728_marine,1173,471,798,690,1644,68.03069053708441,58.82352941176471
28729_marine,1145,466,776,683,1611,67.77292576419214,59.65065502183406
28739_marine,1267,539,803,776,1806,63.378058405682715,61.247040252565114
28740_marine,1306,567,823,797,1873,63.01684532924961,61.0260336906585
28741_marine,1248,525,773,760,1773,61.93910256410257,60.89743589743589
28742_marine,1336,625,833,806,1961,62.3502994011976,60.32934131736527
28743_marine,1379,718,861,836,2097,62.43654822335025,60.62364031907179
28744_marine,1390,692,864,840,2082,62.15827338129496,60.431654676258994
28745_marine,1417,756,889,841,2173,62.73817925194072,59.35074100211715
28746_marine,1390,722,857,838,2112,61.6546762589928,60.28776978417266
28747_marine,1288,543,792,782,1831,61.49068322981367,60.71428571428571
28895_marine,588,650,348,301,1238,59.183673469387756,51.19047619047619
28896_marine,674,873,362,383,1547,53.70919881305638,56.82492581602374
28897_marine,939,1129,536,502,2068,57.082002129925456,53.46112886048988
28898_marine,679,859,364,406,1538,53.608247422680414,59.79381443298969
28899_marine,642,804,358,372,1446,55.7632398753894,57.943925233644855
28900_marine,662,865,354,394,1527,53.47432024169184,59.516616314199396
28901_marine,953,1233,559,504,2186,58.65687303252886,52.885624344176286
28902_marine,643,869,364,368,1512,56.60964230171073,57.23172628304821
28903_marine,631,834,366,358,1465,58.00316957210776,56.735340729001585
28904_marine,652,712,370,371,1364,56.74846625766872,56.901840490797554
28905_marine,664,685,381,379,1349,57.37951807228916,57.07831325301205
28908_marine,414,523,205,268,937,49.51690821256038,64.73429951690821
28909_marine,448,589,216,295,1037,48.214285714285715,65.84821428571429
28918_marine,735,699,450,396,1434,61.224489795918366,53.87755102040816
28919_marine,717,714,425,403,1431,59.274755927475596,56.20641562064156
28920_marine,705,698,414,396,1403,58.723404255319146,56.17021276595745
28966_marine,700,344,513,260,1044,73.28571428571429,37.142857142857146
28967_marine,797,433,566,308,1230,71.0163111668758,38.64491844416562
29057_marine,1058,432,765,560,1490,72.3062381852552,52.93005671077504
29059_marine,979,395,704,502,1374,71.91011235955057,51.27681307456589
29060_marine,1234,497,864,678,1731,70.01620745542951,54.94327390599676
29061_marine,1143,453,800,628,1596,69.9912510936133,54.94313210848644
29073_marine,660,239,432,390,899,65.45454545454545,59.09090909090909
29079_marine,1408,612,932,812,2020,66.19318181818183,57.67045454545454
29080_marine,1205,585,862,659,1790,71.53526970954357,54.68879668049793
29081_marine,940,366,673,514,1306,71.59574468085106,54.680851063829785
29085_marine,1058,444,757,598,1502,71.55009451795841,56.52173913043478
29086_marine,1135,455,807,640,1590,71.1013215859031,56.38766519823789
29087_marine,1109,429,778,636,1538,70.15329125338143,57.34896302975654
29098_marine,1260,514,799,773,1774,63.41269841269841,61.349206349206355
29099_marine,1277,545,811,780,1822,63.50822239624119,61.0806577916993
29100_marine,1280,574,808,785,1854,63.125,61.328125
29103_marine,1362,669,853,825,2031,62.62848751835536,60.57268722466961
29104_marine,1433,786,902,855,2219,62.94487090020935,59.665038381018846
29105_marine,1420,764,886,858,2184,62.394366197183096,60.4225352112676
29106_marine,1421,767,879,862,2188,61.857846586910625,60.66150598170302
29107_marine,1365,686,842,838,2051,61.684981684981686,61.391941391941394
29257_marine,668,854,362,374,1522,54.191616766467064,55.98802395209581
29258_marine,947,1167,550,497,2114,58.07814149947201,52.48152059134108
29259_marine,944,1168,552,497,2112,58.47457627118644,52.64830508474576
29260_marine,930,1158,544,489,2088,58.49462365591398,52.58064516129032
29261_marine,687,915,373,398,1602,54.29403202328966,57.933042212518195
29262_marine,682,960,380,387,1642,55.718475073313776,56.74486803519062
29263_marine,942,1250,558,492,2192,59.23566878980891,52.22929936305732
29264_marine,700,890,383,416,1590,54.714285714285715,59.42857142857143
29279_marine,699,720,397,406,1419,56.79542203147353,58.0829756795422
29280_marine,716,730,410,413,1446,57.262569832402235,57.68156424581006
29281_marine,710,766,398,404,1476,56.056338028169016,56.901408450704224
29327_marine,817,479,576,327,1296,70.50183598531213,40.024479804161565
29328_marine,769,436,548,295,1205,71.26137841352406,38.36150845253576
29417_marine,1053,447,758,563,1500,71.98480531813865,53.466286799620136
29418_marine,1061,447,755,574,1508,71.1592836946277,54.09990574929312
29419_marine,1107,458,777,599,1565,70.18970189701898,54.11020776874436
29420_marine,1159,483,803,633,1642,69.28386540120793,54.616048317515094
29421_marine,1068,379,735,612,1447,68.82022471910112,57.30337078651685
29422_marine,1116,418,773,622,1534,69.26523297491039,55.7347670250896
29434_marine,672,227,436,399,899,64.88095238095238,59.375
29439_marine,1420,649,942,806,2069,66.33802816901408,56.760563380281695
29440_marine,1103,502,790,598,1605,71.62284678150499,54.21577515865821
29441_marine,1128,543,802,611,1671,71.09929078014184,54.166666666666664
29445_marine,1064,426,748,606,1490,70.30075187969925,56.954887218045116
29446_marine,1055,439,741,603,1494,70.23696682464455,57.156398104265406
29447_marine,759,303,543,382,1062,71.54150197628458,50.329380764163375
29457_marine,1185,445,751,718,1630,63.37552742616034,60.59071729957806
29458_marine,1296,552,835,781,1848,64.42901234567901,60.26234567901234
29459_marine,1260,520,801,769,1780,63.57142857142857,61.03174603174604
29463_marine,1346,667,834,821,2013,61.96136701337296,60.99554234769688
29464_marine,1370,691,844,838,2061,61.605839416058394,61.16788321167883
29465_marine,1364,675,844,836,2039,61.87683284457478,61.29032258064516
29466_marine,1345,650,832,830,1995,61.858736059479554,61.71003717472119
29467_marine,1338,659,826,828,1997,61.733931240657704,61.88340807174888
29619_marine,636,755,364,350,1391,57.23270440251572,55.0314465408805
29620_marine,638,742,365,348,1380,57.210031347962385,54.54545454545454
29621_marine,583,674,346,298,1257,59.348198970840485,51.114922813036024
29622_marine,632,872,368,338,1504,58.22784810126582,53.48101265822785
29623_marine,626,892,358,338,1518,57.18849840255591,53.99361022364217
29641_marine,667,706,375,384,1373,56.22188905547226,57.5712143928036
29642_marine,709,813,393,417,1522,55.43018335684062,58.81523272214386
29688_marine,755,444,546,278,1199,72.31788079470198,36.82119205298014
29689_marine,714,408,517,267,1122,72.40896358543417,37.39495798319328
29780_marine,1124,456,779,619,1580,69.30604982206405,55.071174377224196
29782_marine,1109,411,763,625,1520,68.80072137060415,56.3570784490532
29794_marine,700,255,451,414,955,64.42857142857143,59.14285714285714
29799_marine,1387,640,920,784,2027,66.33020908435472,56.524873828406626
29800_marine,1345,653,890,772,1998,66.17100371747212,57.39776951672862
29801_marine,1191,598,845,652,1789,70.9487825356843,54.743912678421495
29817_marine,1494,818,934,893,2312,62.51673360107095,59.772423025435074
29818_marine,1543,838,970,916,2381,62.86454957874271,59.364873622812695
29822_marine,1325,655,822,811,1980,62.03773584905661,61.20754716981131
29823_marine,1339,667,830,819,2006,61.9865571321882,61.165048543689316
29824_marine,1342,681,830,824,2023,61.847988077496275,61.40089418777943
29825_marine,1333,655,828,821,1988,62.11552888222055,61.59039759939985
29826_marine,1336,651,825,826,1987,61.75149700598802,61.82634730538922
29827_marine,1330,649,823,824,1979,61.8796992481203,61.954887218045116
29983_marine,636,847,374,331,1483,58.80503144654088,52.04402515723271
30002_marine,734,865,400,437,1599,54.495912806539515,59.53678474114441
30003_marine,719,850,391,430,1569,54.381084840055635,59.80528511821975
30004_marine,443,595,308,169,1038,69.52595936794582,38.1489841986456
30005_marine,702,832,383,412,1534,54.55840455840456,58.68945868945868
30049_marine,769,478,543,293,1247,70.6111833550065,38.10143042912874
30050_marine,733,460,515,282,1193,70.25920873124147,38.47203274215553
30062_marine,715,389,480,303,1104,67.13286713286713,42.37762237762237
30063_marine,669,389,451,285,1058,67.41405082212258,42.600896860986545
30064_marine,765,488,506,327,1253,66.1437908496732,42.745098039215684
30065_marine,706,459,481,291,1165,68.13031161473087,41.21813031161473
30140_marine,1111,450,760,616,1561,68.4068406840684,55.44554455445545
30141_marine,1120,455,768,623,1575,68.57142857142857,55.625
30142_marine,1136,438,780,635,1574,68.66197183098592,55.897887323943664
30154_marine,674,240,435,398,914,64.54005934718101,59.05044510385756
30160_marine,1379,735,921,775,2114,66.78752719361857,56.20014503263234
30161_marine,1433,740,976,812,2173,68.10886252616888,56.66434054431263
30162_marine,1189,596,823,669,1785,69.21783010933558,56.26576955424727
30163_marine,1243,619,846,699,1862,68.06114239742558,56.23491552695092
30177_marine,1432,765,892,866,2197,62.290502793296085,60.47486033519554
30178_marine,1429,764,886,855,2193,62.00139958012596,59.83205038488454
30179_marine,1412,744,874,852,2156,61.89801699716714,60.3399433427762
30181_marine,1164,472,725,706,1636,62.2852233676976,60.65292096219931
30182_marine,1360,696,855,823,2056,62.86764705882353,60.514705882352935
30183_marine,1357,672,842,829,2029,62.04863669859986,61.09064112011791
30184_marine,1318,645,814,817,1963,61.76024279210925,61.98786039453717
30185_marine,1322,645,819,816,1967,61.95158850226928,61.72465960665659
30186_marine,1347,663,834,828,2010,61.915367483296215,61.46993318485523
30187_marine,1327,666,823,822,1993,62.01959306706858,61.944235116804826
30343_marine,620,834,361,325,1454,58.225806451612904,52.41935483870967
30363_marine,714,865,384,432,1579,53.78151260504202,60.50420168067227
30364_marine,707,837,384,423,1544,54.31400282885431,59.830268741159834
30365_marine,709,848,388,422,1557,54.724964739069115,59.52045133991537
30366_marine,722,899,393,432,1621,54.43213296398892,59.83379501385041
30367_marine,720,877,387,434,1597,53.75,60.27777777777777
30368_marine,717,876,385,431,1593,53.69595536959554,60.111576011157595
30410_marine,702,453,500,270,1155,71.22507122507122,38.46153846153847
30411_marine,719,470,515,272,1189,71.62726008344924,37.83031988873435
30415_marine,735,512,522,275,1247,71.0204081632653,37.41496598639456
30416_marine,769,541,545,291,1310,70.87126137841352,37.841352405721715
30417_marine,771,532,554,285,1303,71.85473411154345,36.964980544747085
30418_marine,696,483,499,255,1179,71.69540229885058,36.637931034482754
30419_marine,707,489,499,269,1196,70.57991513437058,38.04809052333805
30420_marine,781,515,530,314,1296,67.8617157490397,40.204865556978234
30421_marine,786,496,525,329,1282,66.79389312977099,41.85750636132315
30425_marine,642,435,441,260,1077,68.69158878504673,40.49844236760124
30426_marine,726,451,506,291,1177,69.6969696969697,40.082644628099175
30501_marine,1109,449,758,617,1558,68.34986474301172,55.635707844905326
30516_marine,1252,636,790,760,1888,63.09904153354633,60.70287539936102
30517_marine,1208,611,770,726,1819,63.741721854304636,60.099337748344375
30518_marine,1199,648,781,698,1847,65.13761467889908,58.215179316096744
30521_marine,1325,743,884,763,2068,66.71698113207547,57.58490566037736
30523_marine,1241,626,838,702,1867,67.52618855761483,56.56728444802579
30524_marine,1249,639,829,717,1888,66.37309847878302,57.405924739791836
30535_marine,1202,677,768,699,1879,63.89351081530782,58.15307820299501
30536_marine,1322,800,847,772,2122,64.0695915279879,58.3963691376702
30537_marine,1283,723,820,759,2006,63.91270459859704,59.15822291504287
30538_marine,1392,741,858,847,2133,61.63793103448276,60.84770114942529
30539_marine,1431,769,886,866,2200,61.91474493361285,60.51712089447938
30540_marine,1518,849,931,920,2367,61.33069828722003,60.60606060606061
30541_marine,1196,497,746,729,1693,62.374581939799334,60.953177257525084
30542_marine,1160,479,721,708,1639,62.1551724137931,61.03448275862069
30545_marine,1313,626,810,819,1939,61.69078446306169,62.37623762376238
30546_marine,1355,664,839,834,2019,61.91881918819189,61.54981549815498
30703_marine,613,838,367,309,1451,59.8694942903752,50.40783034257748
30728_marine,717,903,379,437,1620,52.859135285913524,60.94839609483961
30729_marine,741,934,398,438,1675,53.71120107962213,59.10931174089069
30771_marine,677,459,493,244,1136,72.82127031019202,36.04135893648449
30772_marine,689,482,497,251,1171,72.13352685050798,36.42960812772134
30773_marine,701,518,509,254,1219,72.61055634807418,36.233951497860204
30774_marine,733,520,532,268,1253,72.57844474761255,36.56207366984993
30775_marine,699,506,505,252,1205,72.24606580829757,36.05150214592275
30778_marine,706,515,506,255,1221,71.671388101983,36.11898016997167
30779_marine,703,509,503,256,1212,71.55049786628734,36.41536273115221
30786_marine,707,440,503,274,1147,71.14568599717114,38.75530410183875
30787_marine,720,447,509,285,1167,70.69444444444444,39.58333333333333
30788_marine,732,486,512,294,1218,69.94535519125684,40.16393442622951
30789_marine,788,703,528,331,1491,67.00507614213198,42.00507614213198
30790_marine,739,713,495,316,1452,66.98240866035182,42.760487144790254
30876_marine,1225,596,767,759,1821,62.61224489795918,61.95918367346939
30877_marine,1172,573,738,727,1745,62.96928327645052,62.03071672354948
30878_marine,1153,640,752,669,1793,65.22116218560278,58.022549869904594
30879_marine,1212,686,792,707,1898,65.34653465346535,58.333333333333336
30881_marine,1296,689,852,759,1985,65.74074074074075,58.56481481481482
30884_marine,1255,659,833,719,1914,66.37450199203188,57.29083665338646
30888_marine,880,386,570,486,1266,64.77272727272727,55.22727272727273
30889_marine,893,384,577,492,1277,64.61366181410975,55.09518477043673
30894_marine,1200,703,764,698,1903,63.66666666666667,58.166666666666664
30895_marine,1229,699,785,719,1928,63.87306753458096,58.50284784377543
30896_marine,1222,705,778,712,1927,63.666121112929616,58.265139116202946
30898_marine,1375,764,845,848,2139,61.45454545454545,61.672727272727265
30899_marine,1404,748,862,860,2152,61.396011396011396,61.25356125356125
30907_marine,1104,441,681,667,1545,61.684782608695656,60.416666666666664
31062_marine,333,306,258,89,639,77.47747747747748,26.726726726726728
31063_marine,604,858,362,308,1462,59.93377483443708,50.993377483443716
31089_marine,675,818,371,393,1493,54.962962962962955,58.22222222222222
31090_marine,425,540,297,163,965,69.88235294117648,38.35294117647059
31149_marine,433,364,333,132,797,76.905311778291,30.484988452655887
31150_marine,775,795,530,318,1570,68.38709677419355,41.03225806451613
31237_marine,1224,621,760,765,1845,62.091503267973856,62.5
31238_marine,1219,620,762,762,1839,62.510254306808854,62.510254306808854
31239_marine,1157,660,764,673,1817,66.03284356093346,58.1676750216076
31240_marine,1172,651,781,677,1823,66.6382252559727,57.76450511945392
31241_marine,1238,660,818,721,1898,66.07431340872375,58.23909531502424
31242_marine,1220,649,817,703,1869,66.9672131147541,57.622950819672134
31244_marine,1295,677,856,748,1972,66.1003861003861,57.76061776061776
31246_marine,881,333,578,477,1214,65.60726447219069,54.14301929625426
31247_marine,769,297,531,393,1066,69.05071521456438,51.10533159947984
31248_marine,908,388,593,491,1296,65.30837004405286,54.074889867841414
31249_marine,935,398,611,511,1333,65.3475935828877,54.652406417112296
31253_marine,1133,636,737,652,1769,65.0485436893204,57.54633715798765
31254_marine,1145,662,739,660,1807,64.5414847161572,57.64192139737992
31258_marine,1345,740,825,830,2085,61.33828996282528,61.71003717472119
31267_marine,1090,442,667,667,1532,61.19266055045871,61.19266055045871
31422_marine,581,770,355,287,1351,61.10154905335629,49.39759036144578
31423_marine,564,752,344,279,1316,60.99290780141844,49.46808510638298
31450_marine,678,818,369,397,1496,54.424778761061944,58.55457227138643
31510_marine,696,684,487,267,1380,69.97126436781609,38.362068965517246
31546_marine,848,392,521,496,1240,61.438679245283026,58.490566037735846
31596_marine,871,338,559,513,1209,64.17910447761194,58.89781859931114
31597_marine,896,357,576,529,1253,64.28571428571429,59.04017857142857
31598_marine,1236,645,779,764,1881,63.02588996763754,61.81229773462783
31599_marine,1210,611,757,750,1821,62.56198347107438,61.98347107438017
31600_marine,1129,611,751,644,1740,66.51904340124003,57.04162976085031
31601_marine,1173,647,779,671,1820,66.41091219096334,57.20375106564365
31602_marine,1372,847,928,766,2219,67.63848396501457,55.83090379008746
31603_marine,1195,627,797,684,1822,66.69456066945607,57.23849372384937
31604_marine,1256,691,824,719,1947,65.60509554140127,57.245222929936304
31605_marine,1308,749,858,737,2057,65.59633027522935,56.34556574923547
31606_marine,902,351,600,479,1253,66.51884700665188,53.10421286031042
31609_marine,905,375,605,486,1280,66.85082872928176,53.70165745856353
31610_marine,1199,688,796,662,1887,66.38865721434529,55.21267723102585
31612_marine,1151,653,752,654,1804,65.33449174630755,56.82015638575152
31618_marine,1325,679,809,822,2004,61.056603773584904,62.03773584905661
31619_marine,1318,669,802,818,1987,60.849772382397575,62.06373292867981
31628_marine,1174,569,699,720,1743,59.54003407155025,61.32879045996593
31629_marine,1182,568,711,714,1750,60.15228426395939,60.40609137055838
31781_marine,602,772,359,305,1374,59.63455149501661,50.66445182724253
31782_marine,599,794,352,307,1393,58.764607679465776,51.25208681135225
31810_marine,701,811,375,418,1512,53.49500713266762,59.62910128388017
31811_marine,684,789,373,401,1473,54.53216374269005,58.62573099415205
31870_marine,677,645,471,261,1322,69.57163958641064,38.55243722304284
31904_marine,855,369,521,503,1224,60.93567251461989,58.83040935672514
31905_marine,882,396,530,521,1278,60.090702947845806,59.070294784580504
31906_marine,854,384,522,502,1238,61.124121779859486,58.78220140515222
31958_marine,954,401,605,576,1355,63.41719077568134,60.37735849056604
31959_marine,1237,637,773,767,1874,62.48989490703315,62.0048504446241
31961_marine,1097,583,729,637,1680,66.45396536007293,58.06745670009116
31962_marine,1141,630,770,640,1771,67.48466257668711,56.09114811568799
31963_marine,1380,854,930,770,2234,67.3913043478261,55.79710144927537
31964_marine,1426,844,949,803,2270,66.54978962131838,56.311360448807854
31965_marine,1424,828,954,792,2252,66.99438202247191,55.61797752808989
31969_marine,1157,622,762,638,1779,65.8599827139153,55.142610198789974
31970_marine,1196,703,790,667,1899,66.05351170568562,55.769230769230774
31971_marine,1178,708,775,665,1886,65.78947368421053,56.451612903225815
31972_marine,1155,670,759,652,1825,65.71428571428571,56.45021645021645
31978_marine,1321,673,801,821,1994,60.635881907645725,62.149886449659355
31979_marine,1324,676,802,827,2000,60.57401812688822,62.46223564954683
31981_marine,1294,585,805,778,1879,62.21020092735703,60.123647604327665
31982_marine,1276,583,786,774,1859,61.59874608150471,60.658307210031346
31983_marine,1276,585,786,774,1861,61.59874608150471,60.658307210031346
31985_marine,1308,618,802,797,1926,61.31498470948012,60.93272171253823
31986_marine,1325,633,812,808,1958,61.28301886792453,60.9811320754717
31988_marine,1167,560,689,719,1727,59.04027420736932,61.61096829477292
31989_marine,1174,574,706,711,1748,60.13628620102215,60.56218057921635
32140_marine,592,652,360,299,1244,60.810810810810814,50.50675675675676
32141_marine,572,620,346,288,1192,60.48951048951049,50.349650349650354
32169_marine,664,794,356,392,1458,53.6144578313253,59.036144578313255
32170_marine,709,839,375,433,1548,52.89139633286318,61.0719322990127
32227_marine,285,162,232,80,447,81.40350877192982,28.07017543859649
32230_marine,671,615,468,256,1286,69.74664679582713,38.152011922503725
32231_marine,366,426,201,204,792,54.91803278688525,55.73770491803278
32263_marine,883,413,535,526,1296,60.588901472253674,59.56964892412231
32264_marine,906,427,544,541,1333,60.04415011037527,59.71302428256071
32318_marine,946,389,600,567,1335,63.424947145877375,59.936575052854124
32319_marine,1240,643,780,760,1883,62.903225806451616,61.29032258064516
32320_marine,1236,633,774,760,1869,62.62135922330098,61.48867313915858
32323_marine,1228,650,823,692,1878,67.01954397394137,56.35179153094463
32324_marine,1319,716,897,712,2035,68.00606520090979,53.980288097043214
32325_marine,1072,491,719,573,1563,67.07089552238806,53.45149253731343
32329_marine,1173,631,774,651,1804,65.98465473145781,55.49872122762148
32330_marine,1171,614,776,653,1785,66.26814688300597,55.76430401366353
32338_marine,1233,634,774,747,1867,62.77372262773723,60.58394160583942
32339_marine,1403,729,851,867,2132,60.65573770491803,61.796151104775475
32340_marine,1315,599,820,785,1914,62.3574144486692,59.6958174904943
32341_marine,1305,597,810,786,1902,62.06896551724138,60.229885057471265
32342_marine,1273,592,781,778,1865,61.35113904163394,61.11547525530243
32343_marine,1293,598,794,787,1891,61.40757927300851,60.8662026295437
32344_marine,1298,604,797,789,1902,61.40215716486903,60.78582434514638
32345_marine,1300,616,800,789,1916,61.53846153846154,60.69230769230769
32348_marine,1204,579,724,723,1783,60.13289036544851,60.04983388704319
32349_marine,1157,560,688,713,1717,59.464131374243735,61.62489196197062
32350_marine,1097,554,652,669,1651,59.43482224247949,60.984503190519604
32500_marine,568,593,354,274,1161,62.323943661971825,48.23943661971831
32529_marine,712,883,383,427,1595,53.79213483146067,59.97191011235955
32530_marine,695,806,369,421,1501,53.093525179856115,60.57553956834533
32531_marine,669,740,360,395,1409,53.81165919282511,59.04334828101644
32532_marine,720,815,389,436,1535,54.02777777777777,60.55555555555555
32533_marine,680,745,379,400,1425,55.73529411764706,58.82352941176471
32534_marine,669,699,381,383,1368,56.95067264573991,57.24962630792228
32587_marine,269,131,223,69,400,82.8996282527881,25.650557620817843
32589_marine,679,573,481,252,1252,70.83946980854198,37.11340206185567
32590_marine,638,535,451,240,1173,70.6896551724138,37.61755485893417
32622_marine,891,377,543,532,1268,60.94276094276094,59.70819304152637
32623_marine,936,439,559,561,1375,59.72222222222222,59.93589743589743
32679_marine,955,428,617,563,1383,64.60732984293193,58.95287958115183
32680_marine,1239,624,781,758,1863,63.03470540758676,61.17836965294592
32681_marine,1247,640,783,768,1887,62.7906976744186,61.587810745789895
32684_marine,1251,657,840,692,1908,67.14628297362111,55.315747402078344
32685_marine,1073,455,735,582,1528,68.4995340167754,54.24044734389562
32690_marine,1194,627,788,674,1821,65.9966499162479,56.44891122278057
32698_marine,1188,604,770,705,1792,64.81481481481481,59.34343434343434
32700_marine,1298,584,808,780,1882,62.249614791987675,60.0924499229584
32701_marine,1271,602,778,776,1873,61.21164437450825,61.05428796223447
32702_marine,1294,597,801,782,1891,61.90108191653787,60.432766615146825
32703_marine,1338,606,833,801,1944,62.25710014947683,59.865470852017935
32704_marine,1267,586,772,775,1853,60.93133385951065,61.16811365430151
32708_marine,1182,591,713,714,1773,60.32148900169205,60.40609137055838
32709_marine,1169,577,694,721,1746,59.366980325064155,61.67664670658682
32710_marine,1097,553,654,661,1650,59.61713764813127,60.255241567912485
32711_marine,1224,700,723,759,1924,59.068627450980394,62.00980392156863
32712_marine,1265,730,747,787,1995,59.05138339920949,62.21343873517786
32713_marine,1161,648,677,737,1809,58.31180017226529,63.47975882859603
32714_marine,1148,640,669,723,1788,58.275261324041814,62.97909407665505
32715_marine,1165,651,684,731,1816,58.712446351931334,62.74678111587983
32716_marine,1038,507,623,636,1545,60.01926782273603,61.27167630057804
32717_marine,1030,502,617,632,1532,59.90291262135923,61.359223300970875
32860_marine,561,548,351,267,1109,62.56684491978609,47.593582887700535
32888_marine,476,764,191,364,1240,40.12605042016807,76.47058823529412
32889_marine,462,755,183,360,1217,39.61038961038961,77.92207792207793
32890_marine,688,832,363,414,1520,52.76162790697675,60.17441860465116
32891_marine,702,846,379,418,1548,53.98860398860399,59.54415954415955
32892_marine,722,838,387,440,1560,53.601108033241,60.94182825484764
32894_marine,657,659,377,374,1316,57.3820395738204,56.925418569254184
32895_marine,664,633,389,381,1297,58.584337349397586,57.37951807228916
32896_marine,624,582,373,346,1206,59.77564102564102,55.44871794871795
32949_marine,654,538,457,249,1192,69.8776758409786,38.07339449541284
32950_marine,662,539,458,256,1201,69.18429003021149,38.670694864048336
32981_marine,1009,473,610,596,1482,60.45589692765114,59.068384539147665
32982_marine,1049,527,631,615,1576,60.15252621544328,58.627264061010486
33039_marine,914,385,587,544,1299,64.22319474835886,59.51859956236324
33040_marine,928,392,600,549,1320,64.65517241379311,59.15948275862068
33041_marine,1262,647,795,776,1909,62.99524564183835,61.489698890649755
33045_marine,1276,664,855,716,1940,67.00626959247649,56.112852664576806
33046_marine,1042,467,698,583,1509,66.98656429942419,55.950095969289826
33047_marine,1035,463,693,579,1498,66.95652173913044,55.94202898550724
33049_marine,972,383,643,535,1355,66.1522633744856,55.041152263374485
33050_marine,1162,622,767,648,1784,66.00688468158347,55.76592082616179
33057_marine,1171,605,751,691,1776,64.13321947053801,59.00939368061486
33058_marine,1170,585,755,688,1755,64.52991452991454,58.80341880341881
33060_marine,1262,566,789,750,1828,62.51980982567353,59.42947702060222
33061_marine,1262,596,775,770,1858,61.41045958795562,61.014263074484944
33062_marine,1277,592,782,783,1869,61.237274862960064,61.31558339859045
33063_marine,1290,620,793,784,1910,61.47286821705427,60.775193798449614
33064_marine,1288,627,794,779,1915,61.64596273291926,60.48136645962733
33068_marine,1144,533,678,704,1677,59.265734265734274,61.53846153846154
33069_marine,1140,545,673,711,1685,59.03508771929824,62.36842105263158
33070_marine,1183,588,693,737,1771,58.57988165680473,62.299239222316146
33071_marine,1278,720,761,788,1998,59.54616588419406,61.658841940532085
33072_marine,1236,700,728,769,1936,58.89967637540453,62.2168284789644
33073_marine,1157,626,680,720,1783,58.772687986171135,62.22990492653414
33075_marine,1166,676,684,732,1842,58.662092624356774,62.778730703259
33076_marine,1113,625,665,678,1738,59.74842767295597,60.91644204851752
33077_marine,1137,664,676,694,1801,59.4547053649956,61.03781882145998
33078_marine,1135,625,658,719,1760,57.97356828193833,63.34801762114537
33079_marine,1131,612,658,717,1743,58.17860300618921,63.395225464190986
33080_marine,1123,609,656,711,1732,58.414959928762244,63.31255565449688
33087_marine,978,416,583,602,1394,59.61145194274029,61.554192229038854
33088_marine,948,384,561,593,1332,59.17721518987342,62.552742616033754
33219_marine,504,478,332,215,982,65.87301587301587,42.65873015873016
33220_marine,542,524,344,247,1066,63.46863468634686,45.571955719557195
33221_marine,537,528,331,260,1065,61.63873370577281,48.4171322160149
33250_marine,414,658,163,315,1072,39.371980676328505,76.08695652173914
33251_marine,670,826,370,391,1496,55.223880597014926,58.35820895522388
33256_marine,637,584,375,355,1221,58.86970172684458,55.72998430141287
33257_marine,598,516,357,335,1114,59.6989966555184,56.020066889632105
33258_marine,596,519,361,333,1115,60.570469798657726,55.87248322147651
33259_marine,588,512,362,322,1100,61.564625850340136,54.761904761904766
33260_marine,572,492,361,311,1064,63.11188811188811,54.37062937062937
33261_marine,568,479,359,309,1047,63.20422535211267,54.401408450704224
33310_marine,669,549,461,265,1218,68.90881913303438,39.61136023916293
33311_marine,679,546,468,271,1225,68.92488954344624,39.91163475699558
33341_marine,1121,618,669,661,1739,59.67885816235504,58.96520963425513
33342_marine,1014,512,618,592,1526,60.946745562130175,58.38264299802761
33400_marine,924,400,602,540,1324,65.15151515151516,58.44155844155844
33401_marine,1277,682,814,781,1959,63.74314800313235,61.15896632732968
33402_marine,1230,622,771,760,1852,62.68292682926829,61.78861788617886
33405_marine,1283,656,864,719,1939,67.34216679657054,56.04053000779423
33406_marine,1337,692,898,752,2029,67.16529543754675,56.245325355273
33407_marine,1292,690,872,721,1982,67.49226006191951,55.804953560371516
33408_marine,1012,450,681,557,1462,67.29249011857708,55.03952569169961
33409_marine,1010,437,669,557,1447,66.23762376237624,55.14851485148515
33412_marine,1144,610,746,654,1754,65.20979020979021,57.16783216783217
33414_marine,1152,592,752,661,1744,65.27777777777779,57.37847222222222
33419_marine,1252,566,784,740,1818,62.61980830670927,59.105431309904155
33420_marine,1241,565,775,737,1806,62.44963738920226,59.38759065269944
33421_marine,1246,581,769,756,1827,61.71749598715891,60.67415730337079
33422_marine,1271,595,779,778,1866,61.29032258064516,61.21164437450825
33423_marine,1265,582,775,773,1847,61.26482213438735,61.10671936758894
33429_marine,1171,561,704,720,1732,60.1195559350982,61.48590947907772
33430_marine,1244,639,741,776,1883,59.565916398713824,62.37942122186495
33431_marine,1245,642,744,775,1887,59.75903614457832,62.24899598393574
33432_marine,1200,650,699,756,1850,58.25,63
33433_marine,1195,668,697,749,1863,58.32635983263599,62.67782426778242
33434_marine,1166,665,691,726,1831,59.262435677530014,62.264150943396224
33435_marine,1148,667,670,721,1815,58.36236933797909,62.80487804878049
33436_marine,1121,620,652,710,1741,58.162355040142735,63.336306868867084
33437_marine,1124,615,650,715,1739,57.82918149466192,63.612099644128115
33438_marine,1111,601,642,706,1712,57.78577857785778,63.546354635463544
33440_marine,1119,615,651,713,1734,58.17694369973191,63.71760500446828
33441_marine,1168,675,679,737,1843,58.13356164383562,63.099315068493155
33442_marine,1155,659,672,729,1814,58.18181818181818,63.116883116883116
33443_marine,1133,638,658,716,1771,58.075904677846424,63.195057369814656
33447_marine,971,424,579,600,1395,59.6292481977343,61.79196704428425
33448_marine,983,432,589,603,1415,59.91861648016277,61.34282807731435
33451_marine,1044,600,628,639,1644,60.15325670498084,61.206896551724135
33452_marine,1049,498,633,639,1547,60.343183984747384,60.91515729265967
33616_marine,604,523,362,330,1127,59.93377483443708,54.63576158940398
33621_marine,564,471,351,311,1035,62.23404255319149,55.14184397163121
33622_marine,573,490,358,316,1063,62.478184991274,55.14834205933682
33671_marine,688,556,474,273,1244,68.8953488372093,39.68023255813954
33672_marine,652,512,452,257,1164,69.32515337423312,39.41717791411043
33700_marine,1138,629,689,663,1767,60.54481546572935,58.260105448154654
33701_marine,1123,608,674,655,1731,60.01780943900267,58.325912733748886
33761_marine,904,349,584,535,1253,64.60176991150442,59.18141592920354
33762_marine,1238,618,781,761,1856,63.08562197092083,61.47011308562197
33763_marine,1225,611,773,760,1836,63.102040816326536,62.04081632653061
33766_marine,1276,679,839,735,1955,65.75235109717869,57.60188087774295
33767_marine,1338,713,893,754,2051,66.74140508221225,56.35276532137519
33768_marine,1037,460,690,578,1497,66.5380906460945,55.73770491803278
33769_marine,1028,446,676,575,1474,65.75875486381322,55.933852140077825
33772_marine,1223,625,788,711,1848,64.43172526573998,58.13573180703189
33774_marine,1212,624,786,698,1836,64.85148514851485,57.59075907590759
33775_marine,1233,630,801,715,1863,64.96350364963503,57.98864557988645
33779_marine,1261,562,783,753,1823,62.09357652656622,59.71451229183188
33780_marine,1250,567,773,753,1817,61.839999999999996,60.24
33781_marine,1261,590,774,768,1851,61.37985725614592,60.904044409199045
33782_marine,1248,575,767,759,1823,61.458333333333336,60.817307692307686
33783_marine,1274,585,781,776,1859,61.30298273155416,60.9105180533752
33784_marine,1154,461,704,714,1615,61.005199306759096,61.871750433275565
33786_marine,1132,493,677,704,1625,59.805653710247356,62.19081272084806
33787_marine,1152,522,694,711,1674,60.24305555555556,61.71875
33788_marine,1225,633,749,737,1858,61.142857142857146,60.16326530612245
33789_marine,1192,604,727,721,1796,60.98993288590604,60.486577181208055
33790_marine,1154,565,696,710,1719,60.31195840554593,61.52512998266898
33791_marine,1171,580,707,719,1751,60.37574722459437,61.400512382578995
33793_marine,1201,653,699,750,1854,58.2014987510408,62.447960033305584
33794_marine,1149,648,685,713,1797,59.61705831157529,62.05395996518712
33795_marine,1221,703,714,760,1924,58.47665847665847,62.24406224406225
33796_marine,1126,640,661,710,1766,58.703374777975135,63.05506216696269
33803_marine,1131,640,655,721,1771,57.9133510167993,63.748894783377544
33804_marine,1150,661,670,726,1811,58.26086956521739,63.13043478260869
33805_marine,1174,677,686,736,1851,58.43270868824531,62.6916524701874
33812_marine,1040,488,628,634,1528,60.38461538461538,60.96153846153847
33813_marine,1069,506,655,639,1575,61.27221702525725,59.775491113189894
33982_marine,563,479,356,308,1042,63.232682060390765,54.70692717584369
33983_marine,573,492,363,312,1065,63.35078534031413,54.45026178010471
33984_marine,559,484,358,299,1043,64.04293381037567,53.48837209302325
34032_marine,722,555,482,294,1277,66.7590027700831,40.7202216066482
34033_marine,396,332,200,239,728,50.505050505050505,60.35353535353535
34060_marine,1228,723,747,699,1951,60.83061889250815,56.92182410423453
34076_marine,670,279,458,377,949,68.35820895522387,56.26865671641791
34123_marine,1250,607,784,774,1857,62.72,61.919999999999995
34124_marine,1269,624,798,791,1893,62.88416075650118,62.33254531126872
34126_marine,1400,703,900,820,2103,64.28571428571429,58.57142857142858
34135_marine,1229,615,785,719,1844,63.87306753458096,58.50284784377543
34140_marine,1256,571,781,754,1827,62.181528662420384,60.031847133757964
34141_marine,1237,568,765,747,1805,61.843168957154404,60.38803556992725
34142_marine,1257,576,772,762,1833,61.41607000795545,60.62052505966587
34143_marine,1318,629,821,789,1947,62.29135053110774,59.86342943854325
34144_marine,1222,526,746,756,1748,61.04746317512275,61.8657937806874
34153_marine,1193,632,697,745,1825,58.4241408214585,62.447611064543175
34154_marine,1174,634,700,720,1808,59.6252129471891,61.32879045996593
34155_marine,1155,650,691,711,1805,59.82683982683983,61.55844155844156
34156_marine,1091,605,667,668,1696,61.136571952337306,61.228230980751604
34157_marine,632,462,412,323,1094,65.18987341772153,51.10759493670886
34158_marine,598,423,390,305,1021,65.21739130434783,51.00334448160535
34166_marine,1187,673,694,741,1860,58.46672283066554,62.426284751474306
34171_marine,1066,488,641,656,1554,60.131332082551594,61.53846153846154
34172_marine,1071,518,642,661,1589,59.943977591036415,61.718020541549954
34173_marine,1134,628,698,667,1762,61.552028218694886,58.81834215167549
34174_marine,1040,512,629,639,1552,60.480769230769226,61.44230769230769
34344_marine,553,475,351,301,1028,63.47197106690777,54.43037974683544
34345_marine,572,513,362,309,1085,63.286713286713294,54.02097902097902
34392_marine,642,440,430,263,1082,66.97819314641744,40.965732087227416
34393_marine,773,540,510,321,1313,65.97671410090557,41.52652005174644
34394_marine,426,330,225,246,756,52.816901408450704,57.74647887323944
34419_marine,1161,636,703,669,1797,60.55124892334195,57.622739018087856
34420_marine,1242,737,768,691,1979,61.83574879227053,55.63607085346216
34483_marine,874,318,561,515,1192,64.18764302059496,58.924485125858126
34484_marine,1292,631,811,802,1923,62.77089783281734,62.07430340557275
34485_marine,1348,684,844,833,2032,62.61127596439169,61.79525222551929
34486_marine,1648,901,1034,981,2549,62.74271844660194,59.52669902912622
34487_marine,1429,670,910,856,2099,63.680895731280614,59.902029391182644
34488_marine,1339,629,852,804,1968,63.629574309185955,60.044809559372666
34500_marine,1260,580,785,751,1840,62.301587301587304,59.6031746031746
34501_marine,1269,593,780,765,1862,61.46572104018912,60.28368794326241
34502_marine,1144,486,697,704,1630,60.92657342657343,61.53846153846154
34503_marine,1230,545,750,755,1775,60.97560975609756,61.382113821138205
34504_marine,1223,537,743,753,1760,60.752248569092394,61.5699100572363
34513_marine,1095,524,664,660,1619,60.63926940639269,60.273972602739725
34514_marine,1067,484,660,638,1551,61.855670103092784,59.79381443298969
34515_marine,1068,543,655,644,1611,61.329588014981276,60.2996254681648
34518_marine,607,432,397,311,1039,65.40362438220758,51.23558484349259
34519_marine,587,414,384,302,1001,65.41737649063032,51.4480408858603
34526_marine,1184,658,682,752,1842,57.60135135135135,63.51351351351351
34527_marine,1179,664,680,745,1843,57.67599660729432,63.189143341815104
34528_marine,1216,700,716,747,1916,58.88157894736842,61.43092105263158
34529_marine,1134,587,695,674,1721,61.28747795414462,59.43562610229277
34530_marine,1076,518,644,665,1594,59.85130111524164,61.80297397769516
34531_marine,1077,515,650,665,1592,60.35283194057567,61.745589600742804
34532_marine,1072,514,644,660,1586,60.07462686567165,61.56716417910447
34533_marine,1069,508,643,657,1577,60.14967259120674,61.45930776426567
34535_marine,1036,507,626,635,1543,60.424710424710426,61.2934362934363
34536_marine,1016,485,610,637,1501,60.03937007874016,62.696850393700785
34705_marine,572,504,359,308,1076,62.76223776223776,53.84615384615385
34706_marine,589,543,364,324,1132,61.79966044142614,55.00848896434635
34753_marine,685,459,465,273,1144,67.88321167883211,39.85401459854015
34779_marine,1162,618,691,676,1780,59.466437177280554,58.17555938037866
34780_marine,1221,668,737,697,1889,60.36036036036037,57.08435708435709
34846_marine,1453,711,920,882,2164,63.31727460426704,60.70199587061252
34847_marine,1450,678,909,875,2128,62.689655172413794,60.3448275862069
34848_marine,1333,631,849,802,1964,63.69092273068267,60.16504126031508
34849_marine,1322,618,839,792,1940,63.46444780635401,59.90922844175491
34850_marine,1319,609,841,789,1928,63.76042456406369,59.81804397270659
34851_marine,1300,605,831,772,1905,63.92307692307693,59.38461538461538
34852_marine,1290,600,831,761,1890,64.4186046511628,58.992248062015506
34853_marine,1306,614,846,772,1920,64.77794793261869,59.11179173047473
34854_marine,1166,500,755,685,1666,64.75128644939966,58.74785591766724
34855_marine,1245,530,780,750,1775,62.65060240963856,60.24096385542169
34856_marine,1156,474,724,686,1630,62.629757785467135,59.34256055363322
34861_marine,1173,482,709,717,1655,60.44330775788577,61.125319693094625
34875_marine,1046,523,648,629,1569,61.95028680688337,60.133843212237096
34879_marine,599,403,389,314,1002,64.9415692821369,52.42070116861436
34887_marine,1149,629,666,715,1778,57.96344647519582,62.22802436901653
34888_marine,1185,668,693,730,1853,58.48101265822785,61.60337552742617
34889_marine,1110,552,676,666,1662,60.9009009009009,60
34890_marine,1075,528,643,662,1603,59.81395348837209,61.58139534883721
34891_marine,1063,506,634,658,1569,59.64252116650988,61.90028222013171
34892_marine,1052,492,626,655,1544,59.50570342205324,62.262357414448665
34895_marine,1011,481,607,633,1492,60.03956478733927,62.61127596439169
34896_marine,1039,504,628,645,1543,60.44273339749759,62.07892204042348
34897_marine,1016,474,612,626,1490,60.23622047244095,61.61417322834646
34898_marine,977,444,586,608,1421,59.97952917093142,62.23132036847492
35066_marine,606,583,367,342,1189,60.561056105610554,56.43564356435643
35113_marine,491,294,352,191,785,71.69042769857434,38.90020366598778
35114_marine,488,270,341,201,758,69.87704918032787,41.18852459016394
35140_marine,1178,599,718,673,1777,60.95076400679117,57.130730050933785
35207_marine,1303,605,811,826,1908,62.24098234842671,63.39217191097467
35208_marine,1305,606,809,828,1911,61.99233716475096,63.44827586206897
35209_marine,1307,621,823,819,1928,62.96863045141545,62.66258607498087
35210_marine,1280,609,806,800,1889,62.96874999999999,62.5
35211_marine,1269,579,798,797,1848,62.88416075650118,62.8053585500394
35213_marine,1353,653,862,812,2006,63.71027346637103,60.01478196600147
35214_marine,1371,670,867,825,2041,63.23851203501094,60.17505470459519
35215_marine,1495,741,922,910,2236,61.67224080267558,60.86956521739131
35216_marine,1230,548,772,722,1778,62.764227642276424,58.69918699186992
35232_marine,1050,462,638,635,1512,60.76190476190476,60.476190476190474
35235_marine,979,424,609,590,1403,62.206332992849845,60.26557711950971
35239_marine,625,427,410,317,1052,65.60000000000001,50.72
35240_marine,619,409,404,318,1028,65.26655896607431,51.37318255250404
35241_marine,601,396,380,318,997,63.2279534109817,52.911813643926784
35244_marine,907,532,572,515,1439,63.06504961411245,56.780595369349506
35245_marine,885,544,558,501,1429,63.05084745762712,56.61016949152542
35246_marine,894,554,560,510,1448,62.639821029082775,57.04697986577181
35248_marine,1175,663,682,732,1838,58.04255319148937,62.29787234042553
35256_marine,985,428,582,616,1413,59.08629441624365,62.538071065989854
35257_marine,1034,504,626,631,1538,60.541586073500966,61.02514506769826
35258_marine,1024,496,619,623,1520,60.44921875,60.83984375
35259_marine,993,448,596,613,1441,60.02014098690835,61.73212487411883
35260_marine,988,444,593,612,1432,60.02024291497976,61.943319838056674
35425_marine,611,595,363,357,1206,59.41080196399346,58.42880523731587
35426_marine,614,587,368,350,1201,59.934853420195445,57.00325732899023
35474_marine,561,322,367,259,883,65.41889483065954,46.16755793226381
35500_marine,1136,561,695,646,1697,61.179577464788736,56.866197183098585
35571_marine,1282,588,808,800,1870,63.026521060842434,62.402496099843994
35572_marine,1289,594,810,805,1883,62.83941039565555,62.451512800620634
35573_marine,1298,610,814,810,1908,62.71186440677966,62.40369799691834
35574_marine,1353,648,842,843,2001,62.23207686622321,62.3059866962306
35575_marine,1576,806,976,948,2382,61.92893401015228,60.15228426395939
35576_marine,1473,736,920,873,2209,62.457569585879156,59.26680244399185
35577_marine,1316,633,831,778,1949,63.14589665653495,59.118541033434646
35578_marine,1238,540,779,741,1778,62.92407108239095,59.8546042003231
35579_marine,1237,552,770,749,1789,62.247372675828615,60.549717057396926
35580_marine,1303,614,801,793,1917,61.4735226400614,60.85955487336915
35581_marine,1254,564,756,781,1818,60.28708133971292,62.28070175438597
35582_marine,1249,552,747,786,1801,59.80784627702162,62.93034427542034
35583_marine,1249,564,745,787,1813,59.647718174539634,63.01040832666133
35584_marine,1260,572,761,778,1832,60.39682539682539,61.74603174603175
35585_marine,1264,574,761,785,1838,60.20569620253164,62.10443037974683
35586_marine,1260,598,757,786,1858,60.079365079365076,62.38095238095238
35587_marine,1160,540,695,725,1700,59.91379310344828,62.5
35588_marine,1197,555,721,742,1752,60.23391812865497,61.98830409356725
35592_marine,1079,505,659,650,1584,61.07506950880445,60.24096385542169
35598_marine,614,407,406,309,1021,66.12377850162866,50.3257328990228
35599_marine,632,429,418,313,1061,66.13924050632912,49.5253164556962
35600_marine,630,424,399,328,1054,63.33333333333333,52.06349206349207
35601_marine,651,437,411,337,1088,63.133640552995395,51.76651305683564
35603_marine,916,555,568,534,1471,62.00873362445415,58.29694323144105
35604_marine,959,585,596,549,1544,62.148070907195,57.247132429614176
35606_marine,920,556,566,534,1476,61.52173913043478,58.04347826086956
35607_marine,1000,595,616,584,1595,61.6,58.4
35609_marine,1167,653,676,730,1820,57.92630676949443,62.55355612682091
35610_marine,1180,643,688,730,1823,58.30508474576271,61.86440677966102
35611_marine,1018,470,617,607,1488,60.6090373280943,59.626719056974466
35612_marine,1013,462,614,604,1475,60.61204343534057,59.6248766041461
35613_marine,991,440,594,598,1431,59.93945509586277,60.34308779011099
35617_marine,987,431,587,614,1418,59.47315096251267,62.20871327254306
35618_marine,1016,455,615,617,1471,60.53149606299213,60.72834645669292
35619_marine,994,462,596,613,1456,59.95975855130785,61.670020120724345
35620_marine,1004,466,605,615,1470,60.2589641434263,61.254980079681275
35621_marine,993,458,599,610,1451,60.32225579053374,61.43001007049346
35622_marine,972,426,584,608,1398,60.08230452674898,62.55144032921811
35785_marine,638,619,381,372,1257,59.71786833855799,58.307210031347964
35833_marine,525,289,358,229,814,68.19047619047619,43.61904761904762
35834_marine,559,288,379,250,847,67.79964221824687,44.72271914132379
35860_marine,1100,538,674,636,1638,61.272727272727266,57.81818181818181
35937_marine,1188,515,736,739,1703,61.95286195286195,62.20538720538721
35938_marine,1179,507,735,730,1686,62.34096692111959,61.91687871077184
35939_marine,1169,491,723,724,1660,61.84773310521814,61.93327630453379
35940_marine,1174,514,716,738,1688,60.98807495741057,62.862010221465084
35941_marine,1161,497,704,730,1658,60.63738156761412,62.87683031869078
35944_marine,1185,539,709,742,1724,59.83122362869199,62.61603375527426
35945_marine,1168,544,700,734,1712,59.93150684931506,62.84246575342466
35946_marine,1142,532,692,710,1674,60.595446584938706,62.17162872154116
35947_marine,1135,525,685,708,1660,60.352422907488986,62.37885462555066
35961_marine,688,456,435,346,1144,63.22674418604651,50.2906976744186
35962_marine,832,548,519,443,1380,62.379807692307686,53.245192307692314
35963_marine,1077,640,647,630,1717,60.07428040854224,58.495821727019504
35964_marine,1013,631,626,584,1644,61.79664363277394,57.65054294175715
35967_marine,1132,659,683,679,1791,60.33568904593639,59.98233215547704
35968_marine,1162,664,693,705,1826,59.63855421686747,60.67125645438899
35969_marine,1156,626,670,723,1782,57.95847750865052,62.54325259515571
35970_marine,1196,681,694,746,1877,58.026755852842804,62.374581939799334
35971_marine,1244,780,739,748,2024,59.40514469453376,60.12861736334405
35972_marine,1057,521,626,638,1578,59.22421948912016,60.35950804162725
35973_marine,1013,460,610,605,1473,60.21717670286279,59.72359328726555
35974_marine,987,427,588,597,1414,59.57446808510638,60.48632218844985
35980_marine,999,474,600,618,1473,60.06006006006006,61.86186186186187
35981_marine,1021,507,618,620,1528,60.52889324191969,60.72477962781586
35982_marine,972,433,583,610,1405,59.97942386831275,62.757201646090536
36143_marine,432,474,303,193,906,70.13888888888889,44.675925925925924
36144_marine,626,616,374,367,1242,59.7444089456869,58.626198083067095
36194_marine,534,293,368,235,827,68.91385767790263,44.00749063670412
36220_marine,1076,491,663,626,1567,61.61710037174721,58.17843866171004
36221_marine,1111,525,690,631,1636,62.10621062106211,56.79567956795679
36300_marine,1128,466,694,702,1594,61.52482269503546,62.23404255319149
36301_marine,1131,478,689,710,1609,60.91954022988506,62.776304155614504
36304_marine,1167,555,711,718,1722,60.9254498714653,61.52527849185947
36305_marine,1142,517,691,711,1659,60.507880910683006,62.25919439579685
36323_marine,1215,730,713,734,1945,58.68312757201646,60.41152263374485
36328_marine,1165,627,696,702,1792,59.742489270386265,60.25751072961374
36329_marine,1173,632,703,708,1805,59.93179880647911,60.35805626598465
36330_marine,1242,723,726,763,1965,58.454106280193244,61.43317230273752
36331_marine,1269,780,747,765,2049,58.86524822695035,60.28368794326241
36332_marine,1092,585,643,666,1677,58.88278388278388,60.98901098901099
36333_marine,1005,479,599,613,1484,59.601990049751244,60.995024875621894
36342_marine,966,435,579,602,1401,59.93788819875776,62.31884057971014
36343_marine,955,428,573,599,1383,60,62.72251308900524
36503_marine,602,598,365,343,1200,60.631229235880404,56.97674418604651
36554_marine,520,309,360,224,829,69.23076923076923,43.07692307692308
36581_marine,1048,472,659,596,1520,62.88167938931297,56.87022900763359
36590_marine,833,354,568,452,1187,68.18727490996399,54.26170468187274
36672_marine,690,570,416,362,1260,60.28985507246377,52.46376811594203
36673_marine,677,560,404,369,1237,59.67503692762186,54.505169867060566
36674_marine,663,546,393,361,1209,59.276018099547514,54.44947209653092
36675_marine,649,515,393,338,1164,60.55469953775039,52.08012326656395
36676_marine,622,487,378,316,1109,60.77170418006431,50.80385852090033
36677_marine,630,518,380,325,1148,60.317460317460316,51.587301587301596
36682_marine,652,508,384,355,1160,58.895705521472394,54.44785276073619
36683_marine,1192,700,693,739,1892,58.13758389261745,61.99664429530202
36684_marine,1157,663,670,722,1820,57.908383751080386,62.4027657735523
36694_marine,1005,456,591,614,1461,58.805970149253724,61.094527363184085
36695_marine,964,406,578,586,1370,59.95850622406639,60.788381742738586
36862_marine,630,638,376,361,1268,59.682539682539684,57.3015873015873
36863_marine,605,594,372,335,1199,61.48760330578512,55.371900826446286
36913_marine,488,259,337,211,747,69.05737704918032,43.23770491803279
36914_marine,537,327,370,232,864,68.90130353817506,43.20297951582867
36941_marine,1035,484,647,592,1519,62.51207729468599,57.19806763285025
36949_marine,873,407,592,472,1280,67.81214203894616,54.06643757159221
36950_marine,855,409,578,467,1264,67.60233918128655,54.61988304093567
37031_marine,736,566,436,407,1302,59.2391304347826,55.29891304347826
37032_marine,715,575,428,394,1290,59.86013986013986,55.1048951048951
37033_marine,682,565,409,376,1247,59.970674486803524,55.13196480938416
37035_marine,646,514,392,339,1160,60.681114551083596,52.47678018575851
37036_marine,638,509,381,333,1147,59.71786833855799,52.19435736677116
37037_marine,644,518,385,338,1162,59.78260869565217,52.484472049689444
37042_marine,656,524,388,357,1180,59.14634146341463,54.420731707317074
37044_marine,1208,706,690,766,1914,57.11920529801324,63.41059602649006
37221_marine,628,632,375,360,1260,59.71337579617835,57.324840764331206
37222_marine,645,679,384,369,1324,59.53488372093023,57.20930232558139
37273_marine,466,250,317,201,716,68.02575107296137,43.13304721030043
37301_marine,1030,482,646,588,1512,62.71844660194175,57.0873786407767
37308_marine,858,387,590,462,1245,68.76456876456876,53.84615384615385
37309_marine,889,480,607,484,1369,68.27896512935882,54.443194600674914
37310_marine,802,339,537,446,1141,66.9576059850374,55.61097256857855
37311_marine,800,331,537,444,1131,67.125,55.50000000000001
37386_marine,739,443,456,403,1182,61.70500676589986,54.53315290933695
37387_marine,759,497,461,424,1256,60.73781291172595,55.86297760210803
37388_marine,706,466,430,382,1172,60.90651558073654,54.107648725212464
37390_marine,675,506,402,370,1181,59.55555555555555,54.81481481481482
37391_marine,690,519,408,384,1209,59.130434782608695,55.65217391304348
37396_marine,578,486,345,295,1064,59.688581314878896,51.03806228373703
37397_marine,608,531,361,314,1139,59.375,51.64473684210527
37402_marine,640,486,379,347,1126,59.21875,54.21875000000001
37404_marine,1212,711,683,773,1923,56.353135313531354,63.778877887788774
37581_marine,645,679,381,372,1324,59.06976744186046,57.674418604651166
37582_marine,643,646,386,365,1289,60.031104199066874,56.7651632970451
37633_marine,454,241,310,197,695,68.28193832599119,43.392070484581495
37661_marine,1028,484,642,590,1512,62.45136186770428,57.39299610894941
37668_marine,862,412,596,466,1274,69.1415313225058,54.060324825986086
37671_marine,793,327,527,444,1120,66.45649432534678,55.98991172761665
37746_marine,759,572,454,433,1331,59.81554677206851,57.04874835309618
37747_marine,743,515,444,426,1258,59.757738896366085,57.335127860026915
37748_marine,685,474,412,375,1159,60.14598540145985,54.74452554744526
37749_marine,704,515,419,394,1219,59.51704545454546,55.96590909090909
37750_marine,710,541,418,405,1251,58.87323943661972,57.04225352112676
37756_marine,591,481,349,309,1072,59.05245346869712,52.28426395939086
37762_marine,625,460,369,340,1085,59.040000000000006,54.400000000000006
37764_marine,1188,678,672,759,1866,56.56565656565656,63.888888888888886
37765_marine,1215,707,684,772,1922,56.2962962962963,63.53909465020576
37766_marine,1243,715,697,793,1958,56.074014481094125,63.79726468222044
37941_marine,634,636,377,363,1270,59.46372239747634,57.25552050473186
37942_marine,656,670,395,375,1326,60.213414634146346,57.16463414634146
37992_marine,412,218,297,164,630,72.0873786407767,39.80582524271845
37993_marine,419,219,294,177,638,70.16706443914082,42.243436754176614
38021_marine,1038,477,651,593,1515,62.71676300578035,57.129094412331405
38026_marine,859,382,593,461,1241,69.0337601862631,53.66705471478463
38027_marine,867,380,598,462,1247,68.97347174163782,53.28719723183391
38028_marine,844,358,586,446,1202,69.43127962085308,52.843601895734594
38030_marine,874,520,583,466,1394,66.70480549199085,53.31807780320366
38031_marine,861,467,574,462,1328,66.66666666666666,53.65853658536586
38105_marine,773,545,458,446,1318,59.2496765847348,57.69728331177232
38106_marine,768,523,454,447,1291,59.114583333333336,58.203125
38109_marine,690,515,409,391,1205,59.27536231884057,56.666666666666664
38110_marine,694,526,406,392,1220,58.501440922190206,56.48414985590778
38116_marine,567,455,340,290,1022,59.9647266313933,51.14638447971781
38117_marine,597,492,356,313,1089,59.631490787269684,52.428810720268004
38118_marine,575,475,347,296,1050,60.34782608695652,51.47826086956522
38122_marine,602,430,359,324,1032,59.63455149501661,53.820598006644516
38126_marine,1269,807,705,813,2076,55.55555555555556,64.0661938534279
38301_marine,659,664,389,380,1323,59.028831562974204,57.66312594840668
38302_marine,654,656,393,372,1310,60.09174311926605,56.88073394495413
38352_marine,399,226,283,162,625,70.92731829573935,40.6015037593985
38379_marine,352,191,180,238,543,51.13636363636363,67.61363636363636
38380_marine,1027,457,652,582,1484,63.4858812074002,56.66991236611489
38381_marine,1014,457,645,574,1471,63.609467455621306,56.60749506903353
38385_marine,824,375,567,443,1199,68.81067961165049,53.7621359223301
38386_marine,847,370,581,455,1217,68.59504132231406,53.71900826446281
38390_marine,843,434,564,454,1277,66.90391459074732,53.855278766310796
38391_marine,712,305,484,370,1017,67.97752808988764,51.96629213483146
38463_marine,773,443,478,441,1216,61.83699870633894,57.050452781371284
38464_marine,784,570,469,458,1354,59.82142857142857,58.41836734693877
38465_marine,770,521,452,453,1291,58.7012987012987,58.83116883116883
38478_marine,579,475,341,304,1054,58.89464594127807,52.50431778929189
38479_marine,604,481,349,325,1085,57.78145695364238,53.807947019867555
38480_marine,600,443,349,322,1043,58.166666666666664,53.666666666666664
38481_marine,567,403,340,296,970,59.9647266313933,52.20458553791887
38482_marine,602,440,355,325,1042,58.97009966777409,53.98671096345515
38486_marine,1259,820,706,804,2079,56.07625099285147,63.860206513105645
38629_marine,276,216,186,112,492,67.3913043478261,40.57971014492754
38630_marine,244,190,168,93,434,68.85245901639344,38.114754098360656
38661_marine,660,677,389,379,1337,58.93939393939394,57.42424242424242
38712_marine,380,219,265,160,599,69.73684210526315,42.10526315789473
38737_marine,1027,438,641,601,1465,62.414800389483936,58.519961051606614
38738_marine,1050,479,660,607,1529,62.857142857142854,57.80952380952381
38739_marine,1040,457,660,594,1497,63.46153846153846,57.11538461538461
38740_marine,1012,449,647,571,1461,63.93280632411067,56.422924901185766
38744_marine,817,349,563,440,1166,68.91064871481028,53.85556915544676
38745_marine,812,345,558,439,1157,68.7192118226601,54.06403940886699
38750_marine,824,404,552,444,1228,66.99029126213593,53.883495145631066
38823_marine,777,445,478,443,1222,61.518661518661524,57.01415701415702
38824_marine,772,491,465,450,1263,60.23316062176166,58.2901554404145
38840_marine,619,448,359,337,1067,57.996768982229405,54.44264943457189
38841_marine,622,450,365,342,1072,58.68167202572347,54.983922829581985
38846_marine,1206,752,680,769,1958,56.38474295190713,63.76451077943616
38847_marine,1246,796,707,785,2042,56.74157303370787,63.0016051364366
38990_marine,256,222,176,99,478,68.75,38.671875
39021_marine,661,691,395,373,1352,59.75794251134644,56.429652042360054
39072_marine,313,177,222,133,490,70.92651757188499,42.49201277955272
39073_marine,326,162,221,148,488,67.79141104294479,45.39877300613497
39096_marine,1097,482,693,625,1579,63.17228805834093,56.97356426618049
39097_marine,1122,507,705,640,1629,62.834224598930476,57.04099821746881
39098_marine,998,444,619,596,1442,62.02404809619239,59.719438877755515
39105_marine,827,355,568,447,1182,68.6819830713422,54.05078597339782
39110_marine,804,350,543,433,1154,67.53731343283582,53.85572139303483
39182_marine,749,421,470,428,1170,62.75033377837116,57.14285714285714
39183_marine,753,434,464,431,1187,61.62018592297477,57.23771580345286
39207_marine,1231,792,696,779,2023,56.53939886271324,63.28188464662876
39380_marine,662,708,391,374,1370,59.06344410876133,56.49546827794561
39381_marine,682,723,408,386,1405,59.82404692082112,56.598240469208214
39433_marine,330,180,219,150,510,66.36363636363637,45.45454545454545
39434_marine,282,145,194,131,427,68.79432624113475,46.45390070921986
39455_marine,1132,549,714,646,1681,63.074204946996474,57.06713780918727
39456_marine,1143,522,719,649,1665,62.904636920384945,56.78040244969379
39465_marine,840,373,581,446,1213,69.16666666666667,53.095238095238095
39469_marine,788,338,536,422,1126,68.02030456852792,53.55329949238579
39478_marine,683,251,446,379,934,65.30014641288433,55.4904831625183
39541_marine,780,415,496,443,1195,63.589743589743584,56.794871794871796
39542_marine,774,400,498,440,1174,64.34108527131784,56.84754521963824
39567_marine,1179,712,665,753,1891,56.40373197625106,63.8676844783715
39568_marine,1154,690,653,739,1844,56.58578856152513,64.038128249566725
39569_marine,1129,651,651,713,1780,57.66164747564216,63.15323294951284
39740_marine,691,744,405,393,1435,58.61070911722142,56.87409551374819
39794_marine,319,167,213,145,486,66.77115987460816,45.45454545454545
39815_marine,1100,530,687,632,1630,62.45454545454545,57.45454545454546
39816_marine,1088,531,685,621,1619,62.95955882352941,57.07720588235294
39824_marine,827,383,568,441,1210,68.6819830713422,53.325272067714636
39825_marine,829,380,574,439,1209,69.2400482509047,52.95536791314838
39829_marine,787,340,539,418,1127,68.48792884371029,53.1130876747141
39836_marine,649,207,429,361,856,66.10169491525424,55.62403697996918
39838_marine,682,244,443,383,926,64.95601173020528,56.158357771260995
39929_marine,1157,685,654,741,1842,56.52549697493517,64.04494382022472
39930_marine,1149,668,651,736,1817,56.6579634464752,64.05570060922543
40099_marine,680,718,399,386,1398,58.6764705882353,56.76470588235294
40100_marine,699,758,414,391,1457,59.227467811158796,55.93705293276109
40154_marine,316,183,213,139,499,67.40506329113924,43.9873417721519
40155_marine,282,155,195,124,437,69.14893617021278,43.97163120567376
40176_marine,1077,538,671,620,1615,62.302692664809655,57.567316620241414
40184_marine,852,405,585,454,1257,68.66197183098592,53.286384976525824
40189_marine,769,323,524,414,1092,68.14044213263979,53.83615084525357
40196_marine,647,207,427,361,854,65.9969088098918,55.79598145285936
40290_marine,1135,657,637,736,1792,56.12334801762115,64.84581497797357
40456_marine,677,830,393,398,1507,58.050221565731164,58.78877400295421
40457_marine,713,890,407,418,1603,57.082748948106584,58.62552594670407
40458_marine,715,834,415,413,1549,58.04195804195804,57.76223776223777
40459_marine,703,811,412,403,1514,58.60597439544808,57.32574679943101
40460_marine,678,702,406,377,1380,59.882005899705014,55.604719764011804
40515_marine,302,193,204,140,495,67.54966887417218,46.35761589403973
40536_marine,1058,533,659,613,1591,62.28733459357277,57.93950850661626
40544_marine,840,402,574,447,1242,68.33333333333333,53.214285714285715
40548_marine,791,334,540,422,1125,68.26801517067004,53.35018963337548
40650_marine,1105,645,611,722,1750,55.294117647058826,65.3393665158371
40651_marine,1121,655,624,724,1776,55.66458519179304,64.58519179304193
40814_marine,650,821,380,372,1471,58.46153846153847,57.230769230769226
40815_marine,684,862,395,399,1546,57.748538011695906,58.333333333333336
40816_marine,703,942,410,408,1645,58.32147937411095,58.03698435277382
40817_marine,715,855,415,416,1570,58.04195804195804,58.18181818181818
40875_marine,288,196,202,126,484,70.13888888888889,43.75
40896_marine,1063,547,662,618,1610,62.276575729068675,58.137347130761995
40904_marine,854,408,583,450,1262,68.26697892271663,52.69320843091335
40908_marine,798,346,546,423,1144,68.42105263157895,53.00751879699248
41011_marine,1112,649,617,722,1761,55.485611510791365,64.92805755395683
41012_marine,1141,666,633,741,1807,55.47765118317266,64.943032427695
41173_marine,628,813,363,358,1441,57.80254777070064,57.00636942675159
41174_marine,660,818,392,373,1478,59.3939393939394,56.515151515151516
41235_marine,268,181,197,108,449,73.50746268656717,40.298507462686565
41255_marine,1070,535,673,619,1605,62.89719626168224,57.85046728971963
41256_marine,1069,555,667,619,1624,62.394761459307766,57.90458372310571
41264_marine,823,376,566,435,1199,68.77278250303766,52.8554070473876
41265_marine,778,334,532,420,1112,68.38046272493573,53.98457583547558
41268_marine,838,442,574,441,1280,68.4964200477327,52.62529832935561
41372_marine,1068,618,582,690,1686,54.49438202247191,64.60674157303372
41373_marine,1076,649,599,681,1725,55.66914498141264,63.28996282527881
41532_marine,623,810,363,355,1433,58.26645264847512,56.98234349919743
41533_marine,627,769,368,352,1396,58.69218500797449,56.14035087719298
41595_marine,264,187,197,97,451,74.62121212121212,36.74242424242424
41613_marine,1145,599,706,659,1744,61.65938864628821,57.554585152838435
41614_marine,1115,610,698,637,1725,62.600896860986545,57.13004484304933
41615_marine,1061,565,674,603,1626,63.524976437323275,56.83317624882187
41625_marine,801,359,553,423,1160,69.03870162297129,52.80898876404494
41626_marine,793,343,547,416,1136,68.97856242118537,52.459016393442624
41627_marine,850,471,587,440,1321,69.05882352941177,51.76470588235295
41628_marine,803,396,552,424,1199,68.74221668742216,52.80199252801992
41733_marine,965,664,526,608,1629,54.50777202072538,63.00518134715026
41734_marine,984,692,546,605,1676,55.487804878048784,61.483739837398375
41892_marine,589,720,345,331,1309,58.57385398981324,56.196943972835314
41955_marine,272,223,203,99,495,74.63235294117648,36.39705882352941
41956_marine,267,190,193,106,457,72.28464419475655,39.70037453183521
41973_marine,1181,692,723,678,1873,61.219305673158345,57.40897544453853
42094_marine,991,695,539,616,1686,54.38950554994955,62.15943491422805
42252_marine,582,678,351,321,1260,60.30927835051546,55.154639175257735
42316_marine,294,233,218,112,527,74.14965986394559,38.095238095238095
42333_marine,1154,717,713,649,1871,61.78509532062392,56.23916811091855
42454_marine,971,695,529,593,1666,54.4799176107106,61.07106076210093
42611_marine,525,607,317,281,1132,60.38095238095238,53.52380952380953
42612_marine,573,649,355,300,1222,61.95462478184991,52.35602094240838
42676_marine,306,234,229,115,540,74.83660130718954,37.58169934640523
42677_marine,352,297,247,150,649,70.17045454545455,42.61363636363637
42692_marine,1038,622,638,588,1660,61.46435452793835,56.64739884393064
42693_marine,1144,744,719,628,1888,62.849650349650354,54.89510489510489
42814_marine,935,670,504,577,1605,53.903743315508024,61.71122994652406
42970_marine,501,537,312,256,1038,62.27544910179641,51.09780439121756
42971_marine,542,618,330,287,1160,60.88560885608856,52.952029520295206
43037_marine,329,297,235,138,626,71.42857142857143,41.94528875379939
43038_marine,321,285,227,136,606,70.7165109034268,42.36760124610592
43051_marine,904,566,573,471,1470,63.38495575221239,52.10176991150443
43052_marine,1080,692,680,590,1772,62.96296296296296,54.629629629629626
43174_marine,894,629,480,548,1523,53.691275167785236,61.297539149888145
43329_marine,491,515,305,256,1006,62.11812627291242,52.138492871690424
43330_marine,527,541,325,271,1068,61.66982922201139,51.423149905123346
43398_marine,355,329,252,149,684,70.98591549295776,41.971830985915496
43411_marine,926,626,588,478,1552,63.498920086393085,51.61987041036718
43534_marine,895,640,480,548,1535,53.63128491620112,61.22905027932961
43688_marine,466,436,307,227,902,65.87982832618026,48.712446351931334
43689_marine,471,492,307,229,963,65.18046709129511,48.61995753715499
43690_marine,465,474,310,219,939,66.66666666666666,47.096774193548384
43758_marine,363,331,254,156,694,69.9724517906336,42.97520661157025
43759_marine,357,336,247,160,693,69.187675070028,44.81792717086835
43770_marine,756,547,504,359,1303,66.66666666666666,47.48677248677249
43771_marine,778,563,519,370,1341,66.70951156812339,47.55784061696658
43893_marine,856,600,461,525,1456,53.85514018691588,61.33177570093458
43894_marine,860,622,469,512,1482,54.534883720930225,59.53488372093023
44029_marine,210,261,135,105,471,64.28571428571429,50
44042_marine,223,273,92,177,496,41.25560538116592,79.37219730941703
44048_marine,475,479,317,223,954,66.73684210526316,46.94736842105263
44049_marine,451,449,304,210,900,67.40576496674058,46.56319290465632
44118_marine,399,407,276,180,806,69.17293233082707,45.11278195488722
44119_marine,399,379,274,188,778,68.67167919799499,47.11779448621554
44128_marine,638,453,431,300,1091,67.55485893416929,47.02194357366771
44129_marine,703,526,471,329,1229,66.9985775248933,46.799431009957324
44130_marine,715,509,485,331,1224,67.83216783216784,46.29370629370629
44238_marine,412,424,197,245,836,47.81553398058252,59.46601941747572
44252_marine,799,540,426,487,1339,53.31664580725908,60.95118898623279
44253_marine,879,631,477,524,1510,54.26621160409556,59.613196814561995
44389_marine,216,254,136,113,470,62.96296296296296,52.31481481481482
44402_marine,376,410,233,198,786,61.96808510638297,52.659574468085104
44407_marine,432,435,292,195,867,67.5925925925926,45.13888888888889
44408_marine,442,437,305,198,879,69.00452488687783,44.79638009049774
44478_marine,411,422,289,185,833,70.31630170316302,45.01216545012166
44479_marine,448,430,309,210,878,68.97321428571429,46.875
44485_marine,543,412,361,262,955,66.48250460405156,48.25046040515654
44486_marine,647,512,430,316,1159,66.46058732612056,48.84080370942813
44487_marine,677,532,459,321,1209,67.79911373707533,47.41506646971935
44488_marine,688,529,470,316,1217,68.31395348837209,45.93023255813954
44598_marine,428,433,203,259,861,47.429906542056074,60.51401869158879
44612_marine,866,643,461,519,1509,53.23325635103926,59.930715935334874
44748_marine,213,250,137,110,463,64.31924882629107,51.64319248826291
44749_marine,205,226,131,105,431,63.90243902439025,51.21951219512195
44762_marine,370,453,236,193,823,63.78378378378379,52.16216216216216
44763_marine,359,444,230,179,803,64.06685236768801,49.86072423398329
44764_marine,341,407,221,164,748,64.80938416422288,48.09384164222874
44765_marine,355,412,236,169,767,66.47887323943662,47.6056338028169
44766_marine,384,424,260,179,808,67.70833333333334,46.61458333333333
44767_marine,409,426,282,181,835,68.94865525672371,44.25427872860636
44839_marine,488,533,342,220,1021,70.08196721311475,45.08196721311475
44840_marine,490,479,345,220,969,70.40816326530613,44.89795918367347
44841_marine,502,443,353,226,945,70.3187250996016,45.0199203187251
44842_marine,515,441,362,236,956,70.29126213592232,45.8252427184466
44843_marine,541,481,367,250,1022,67.8373382624769,46.21072088724584
44844_marine,557,515,371,264,1072,66.6068222621185,47.3967684021544
44845_marine,576,516,383,276,1092,66.49305555555556,47.91666666666667
44846_marine,631,530,422,302,1161,66.87797147385103,47.86053882725832
44957_marine,416,405,210,239,821,50.480769230769226,57.45192307692307
44958_marine,416,394,206,243,810,49.519230769230774,58.41346153846154
44959_marine,439,413,216,264,852,49.202733485193626,60.13667425968109
44971_marine,688,522,356,408,1210,51.74418604651163,59.30232558139535
44972_marine,763,595,401,443,1358,52.55570117955439,58.0602883355177
44993_marine,305,272,241,114,577,79.01639344262294,37.37704918032787
44994_marine,305,273,242,111,578,79.34426229508198,36.39344262295082
45108_marine,209,266,135,106,475,64.5933014354067,50.717703349282296
45123_marine,332,379,218,157,711,65.66265060240963,47.28915662650602
45317_marine,426,431,214,237,857,50.23474178403756,55.633802816901415
45318_marine,423,411,209,243,834,49.40898345153664,57.446808510638306
45319_marine,460,447,225,271,907,48.91304347826087,58.913043478260875
45320_marine,426,389,212,247,815,49.76525821596244,57.981220657277
45331_marine,651,551,348,362,1202,53.45622119815668,55.60675883256528
45354_marine,303,278,235,108,581,77.55775577557755,35.64356435643564
45355_marine,320,279,248,122,599,77.5,38.125
45467_marine,204,273,132,103,477,64.70588235294117,50.49019607843137
45468_marine,191,258,125,97,449,65.44502617801047,50.78534031413613
45483_marine,250,299,167,103,549,66.8,41.199999999999996
45484_marine,294,336,194,137,630,65.98639455782312,46.59863945578231
45680_marine,423,406,217,239,829,51.30023640661938,56.50118203309693
45690_marine,489,460,265,260,949,54.19222903885481,53.16973415132924
45691_marine,601,512,332,321,1113,55.24126455906821,53.41098169717138
45714_marine,273,258,221,90,531,80.95238095238095,32.967032967032964
45715_marine,322,286,252,126,608,78.26086956521739,39.130434782608695
45716_marine,315,299,247,121,614,78.41269841269842,38.41269841269842
45827_marine,202,273,131,106,475,64.85148514851485,52.475247524752476
45843_marine,265,299,173,124,564,65.28301886792453,46.79245283018868
45844_marine,271,319,182,122,590,67.15867158671587,45.018450184501845
46040_marine,442,441,237,234,883,53.619909502262445,52.94117647058824
46041_marine,441,433,237,233,874,53.74149659863946,52.83446712018141
46046_marine,429,409,220,240,838,51.28205128205128,55.94405594405595
46049_marine,441,452,242,228,893,54.87528344671202,51.70068027210885
46050_marine,527,520,297,265,1047,56.35673624288425,50.284629981024665
46051_marine,531,514,307,260,1045,57.81544256120527,48.96421845574388
46075_marine,282,249,231,96,531,81.91489361702128,34.04255319148936
46076_marine,275,253,217,99,528,78.9090909090909,36
46077_marine,295,277,235,102,572,79.66101694915254,34.57627118644068
46078_marine,281,264,222,97,545,79.00355871886121,34.519572953736656
46079_marine,266,261,211,87,527,79.32330827067669,32.70676691729324
46187_marine,189,265,121,98,454,64.02116402116403,51.85185185185185
46198_marine,252,303,151,131,555,59.92063492063492,51.98412698412699
46199_marine,240,299,144,123,539,60,51.24999999999999
46200_marine,234,284,145,117,518,61.965811965811966,50
46201_marine,231,278,145,115,509,62.77056277056276,49.78354978354979
46202_marine,237,292,151,114,529,63.71308016877637,48.10126582278481
46203_marine,251,310,166,114,561,66.13545816733067,45.41832669322709
46401_marine,445,431,242,228,876,54.382022471910105,51.23595505617977
46402_marine,445,445,240,229,890,53.93258426966292,51.460674157303366
46403_marine,451,446,247,230,897,54.767184035476724,50.99778270509978
46404_marine,432,428,227,230,860,52.54629629629629,53.24074074074075
46405_marine,458,444,239,255,902,52.183406113537124,55.67685589519651
46406_marine,475,450,252,262,925,53.05263157894737,55.1578947368421
46407_marine,455,447,245,245,902,53.84615384615385,53.84615384615385
46408_marine,435,427,237,230,862,54.48275862068965,52.87356321839081
46435_marine,257,243,206,90,500,80.1556420233463,35.019455252918284
46438_marine,232,227,183,77,459,78.87931034482759,33.189655172413794
46439_marine,258,257,206,85,515,79.84496124031007,32.945736434108525
46547_marine,191,269,119,99,460,62.30366492146597,51.832460732984295
46558_marine,252,306,154,130,558,61.111111111111114,51.587301587301596
46559_marine,247,303,148,127,550,59.91902834008097,51.417004048582996
46764_marine,347,349,222,137,696,63.976945244956774,39.481268011527376
46765_marine,320,320,198,132,640,61.875,41.25
46767_marine,443,435,239,234,878,53.95033860045147,52.82167042889391
46768_marine,346,352,217,152,698,62.71676300578035,43.93063583815029
46769_marine,354,365,232,142,719,65.5367231638418,40.11299435028249
46794_marine,230,229,182,72,459,79.13043478260869,31.30434782608696
46795_marine,247,228,195,85,475,78.94736842105263,34.41295546558704
46796_marine,222,213,173,74,435,77.92792792792793,33.33333333333333
46798_marine,254,263,198,88,517,77.95275590551181,34.645669291338585
46907_marine,172,229,105,93,401,61.04651162790697,54.06976744186046
46915_marine,181,249,109,80,430,60.22099447513812,44.19889502762431
46916_marine,215,270,125,110,485,58.139534883720934,51.162790697674424
46918_marine,234,279,137,121,513,58.54700854700855,51.70940170940172
47124_marine,326,323,207,132,649,63.49693251533742,40.49079754601227
47125_marine,380,387,232,163,767,61.05263157894737,42.89473684210526
47126_marine,349,358,212,153,707,60.74498567335244,43.83954154727794
47127_marine,333,345,208,137,678,62.46246246246246,41.14114114114114
47128_marine,388,406,236,175,794,60.824742268041234,45.103092783505154
47129_marine,407,430,255,174,837,62.65356265356266,42.75184275184275
47153_marine,246,251,192,89,497,78.04878048780488,36.17886178861789
47154_marine,254,258,197,90,512,77.55905511811024,35.43307086614173
47155_marine,263,258,202,97,521,76.80608365019012,36.88212927756654
47156_marine,235,218,184,82,453,78.29787234042553,34.8936170212766
47157_marine,240,254,192,76,494,80,31.666666666666664
47268_marine,163,222,97,87,385,59.50920245398773,53.37423312883436
47275_marine,203,250,123,99,453,60.591133004926114,48.76847290640394
47276_marine,218,269,130,113,487,59.63302752293578,51.8348623853211
47277_marine,215,279,127,110,494,59.06976744186046,51.162790697674424
47278_marine,225,284,133,116,509,59.111111111111114,51.55555555555556
47485_marine,342,361,215,149,703,62.86549707602339,43.567251461988306
47486_marine,334,355,200,145,689,59.88023952095808,43.41317365269461
47487_marine,348,356,209,160,704,60.05747126436781,45.97701149425287
47488_marine,337,346,199,157,683,59.05044510385756,46.58753709198813
47489_marine,374,381,236,160,755,63.101604278074866,42.780748663101605
47512_marine,223,243,175,75,466,78.47533632286996,33.6322869955157
47513_marine,212,224,164,71,436,77.35849056603774,33.490566037735846
47514_marine,244,236,187,95,480,76.63934426229508,38.9344262295082
47515_marine,260,288,197,98,548,75.76923076923077,37.69230769230769
47516_marine,242,267,191,84,509,78.92561983471074,34.710743801652896
47517_marine,232,255,185,74,487,79.74137931034483,31.896551724137932
47636_marine,199,249,123,98,448,61.80904522613066,49.246231155778894
47846_marine,321,299,203,136,620,63.2398753894081,42.36760124610592
47848_marine,339,330,203,161,669,59.882005899705014,47.49262536873156
47849_marine,367,366,231,160,733,62.94277929155313,43.596730245231605
47871_marine,208,241,162,71,449,77.88461538461539,34.13461538461539
47872_marine,211,214,162,77,425,76.77725118483413,36.492890995260666
47874_marine,233,269,177,85,502,75.9656652360515,36.48068669527897
47995_marine,183,225,111,91,408,60.65573770491803,49.72677595628415
47996_marine,191,228,115,97,419,60.20942408376963,50.78534031413613
48206_marine,313,307,198,134,620,63.25878594249201,42.81150159744409
48207_marine,335,343,210,145,678,62.68656716417911,43.28358208955223
48208_marine,360,371,225,161,731,62.5,44.72222222222222
48209_marine,311,310,198,128,621,63.665594855305464,41.157556270096464
48229_marine,206,228,161,71,434,78.15533980582524,34.46601941747573
48230_marine,209,237,163,73,446,77.99043062200957,34.92822966507177
48231_marine,205,210,158,72,415,77.07317073170732,35.12195121951219
48232_marine,190,214,147,68,404,77.36842105263158,35.78947368421053
48233_marine,226,256,174,90,482,76.99115044247787,39.823008849557525
48234_marine,227,274,176,85,501,77.5330396475771,37.44493392070485
48588_marine,200,221,155,68,421,77.5,34
48589_marine,199,218,155,67,417,77.88944723618091,33.66834170854271
48591_marine,72,25,41,54,97,56.94444444444444,75
48592_marine,217,257,168,81,474,77.41935483870968,37.327188940092164
48947_marine,203,220,156,73,423,76.84729064039408,35.960591133004925
48948_marine,192,207,149,67,399,77.60416666666666,34.89583333333333
48951_marine,207,243,159,75,450,76.81159420289855,36.231884057971016
49307_marine,196,230,154,72,426,78.57142857142857,36.734693877551024
49308_marine,214,245,162,87,459,75.70093457943925,40.654205607476634
49309_marine,216,229,161,91,445,74.53703703703704,42.129629629629626
49310_marine,207,243,160,78,450,77.29468599033817,37.68115942028986
49668_marine,186,243,146,71,429,78.49462365591397,38.17204301075269
49669_marine,181,239,142,68,420,78.45303867403315,37.569060773480665
2263_terrestrial,30,7,18,14,37,60,46.666666666666664
2264_terrestrial,30,7,18,14,37,60,46.666666666666664
2265_terrestrial,30,7,18,14,37,60,46.666666666666664
2266_terrestrial,30,3,18,14,33,60,46.666666666666664
2267_terrestrial,28,7,16,14,35,57.14285714285714,50
2268_terrestrial,28,7,16,14,35,57.14285714285714,50
2269_terrestrial,29,7,17,14,36,58.620689655172406,48.275862068965516
2270_terrestrial,28,7,16,14,35,57.14285714285714,50
2271_terrestrial,28,7,16,14,35,57.14285714285714,50
2272_terrestrial,28,7,16,14,35,57.14285714285714,50
2294_terrestrial,8,8,7,4,16,87.5,50
2295_terrestrial,18,8,11,4,26,61.111111111111114,22.22222222222222
2296_terrestrial,18,8,11,4,26,61.111111111111114,22.22222222222222
2297_terrestrial,18,8,11,4,26,61.111111111111114,22.22222222222222
2298_terrestrial,18,10,11,4,28,61.111111111111114,22.22222222222222
2299_terrestrial,18,8,11,4,26,61.111111111111114,22.22222222222222
2300_terrestrial,18,10,11,4,28,61.111111111111114,22.22222222222222
2301_terrestrial,17,10,11,4,27,64.70588235294117,23.52941176470588
2302_terrestrial,17,8,11,4,25,64.70588235294117,23.52941176470588
2303_terrestrial,17,8,11,4,25,64.70588235294117,23.52941176470588
2304_terrestrial,17,8,11,4,25,64.70588235294117,23.52941176470588
2305_terrestrial,16,5,10,4,21,62.5,25
2306_terrestrial,17,8,11,4,25,64.70588235294117,23.52941176470588
2307_terrestrial,17,10,11,4,27,64.70588235294117,23.52941176470588
2308_terrestrial,17,10,11,4,27,64.70588235294117,23.52941176470588
2309_terrestrial,17,11,11,4,28,64.70588235294117,23.52941176470588
2310_terrestrial,17,11,11,4,28,64.70588235294117,23.52941176470588
2311_terrestrial,18,9,12,4,27,66.66666666666666,22.22222222222222
2312_terrestrial,18,11,12,4,29,66.66666666666666,22.22222222222222
2313_terrestrial,18,11,12,4,29,66.66666666666666,22.22222222222222
2314_terrestrial,18,11,12,4,29,66.66666666666666,22.22222222222222
2315_terrestrial,18,11,12,4,29,66.66666666666666,22.22222222222222
2316_terrestrial,18,9,12,4,27,66.66666666666666,22.22222222222222
2612_terrestrial,33,7,19,14,40,57.57575757575758,42.42424242424242
2613_terrestrial,33,7,19,14,40,57.57575757575758,42.42424242424242
2614_terrestrial,33,7,19,14,40,57.57575757575758,42.42424242424242
2615_terrestrial,31,7,19,14,38,61.29032258064516,45.16129032258064
2616_terrestrial,31,7,19,14,38,61.29032258064516,45.16129032258064
2617_terrestrial,31,7,19,14,38,61.29032258064516,45.16129032258064
2618_terrestrial,30,7,18,14,37,60,46.666666666666664
2619_terrestrial,30,7,18,14,37,60,46.666666666666664
2620_terrestrial,30,7,18,14,37,60,46.666666666666664
2621_terrestrial,30,7,18,14,37,60,46.666666666666664
2622_terrestrial,30,7,18,14,37,60,46.666666666666664
2623_terrestrial,30,9,18,14,39,60,46.666666666666664
2624_terrestrial,30,9,18,14,39,60,46.666666666666664
2625_terrestrial,30,9,18,14,39,60,46.666666666666664
2626_terrestrial,30,3,18,14,33,60,46.666666666666664
2627_terrestrial,30,9,18,14,39,60,46.666666666666664
2628_terrestrial,30,7,18,14,37,60,46.666666666666664
2629_terrestrial,28,7,16,14,35,57.14285714285714,50
2630_terrestrial,28,7,16,14,35,57.14285714285714,50
2631_terrestrial,29,7,16,15,36,55.172413793103445,51.724137931034484
2632_terrestrial,31,7,18,15,38,58.06451612903226,48.38709677419355
2633_terrestrial,31,9,18,15,40,58.06451612903226,48.38709677419355
2634_terrestrial,32,9,19,15,41,59.375,46.875
2635_terrestrial,32,7,19,15,39,59.375,46.875
2636_terrestrial,32,7,19,15,39,59.375,46.875
2637_terrestrial,32,9,19,15,41,59.375,46.875
2638_terrestrial,32,11,19,15,43,59.375,46.875
2639_terrestrial,32,11,19,15,43,59.375,46.875
2641_terrestrial,15,5,8,4,20,53.333333333333336,26.666666666666668
2642_terrestrial,16,8,9,4,24,56.25,25
2643_terrestrial,18,8,11,4,26,61.111111111111114,22.22222222222222
2644_terrestrial,18,8,11,4,26,61.111111111111114,22.22222222222222
2645_terrestrial,18,8,11,4,26,61.111111111111114,22.22222222222222
2646_terrestrial,18,10,11,4,28,61.111111111111114,22.22222222222222
2647_terrestrial,18,10,11,4,28,61.111111111111114,22.22222222222222
2648_terrestrial,18,10,11,4,28,61.111111111111114,22.22222222222222
2649_terrestrial,8,8,7,4,16,87.5,50
2650_terrestrial,18,8,11,4,26,61.111111111111114,22.22222222222222
2651_terrestrial,17,7,10,4,24,58.82352941176471,23.52941176470588
2652_terrestrial,18,10,11,4,28,61.111111111111114,22.22222222222222
2653_terrestrial,18,10,11,4,28,61.111111111111114,22.22222222222222
2654_terrestrial,18,10,11,4,28,61.111111111111114,22.22222222222222
2655_terrestrial,18,10,11,4,28,61.111111111111114,22.22222222222222
2656_terrestrial,18,10,11,4,28,61.111111111111114,22.22222222222222
2657_terrestrial,18,10,11,4,28,61.111111111111114,22.22222222222222
2658_terrestrial,18,10,11,4,28,61.111111111111114,22.22222222222222
2659_terrestrial,18,10,11,4,28,61.111111111111114,22.22222222222222
2660_terrestrial,18,10,11,4,28,61.111111111111114,22.22222222222222
2661_terrestrial,18,10,11,4,28,61.111111111111114,22.22222222222222
2662_terrestrial,17,8,11,4,25,64.70588235294117,23.52941176470588
2663_terrestrial,16,5,10,4,21,62.5,25
2664_terrestrial,16,5,10,4,21,62.5,25
2665_terrestrial,17,8,11,4,25,64.70588235294117,23.52941176470588
2666_terrestrial,17,8,11,4,25,64.70588235294117,23.52941176470588
2667_terrestrial,17,8,11,4,25,64.70588235294117,23.52941176470588
2668_terrestrial,17,8,11,4,25,64.70588235294117,23.52941176470588
2669_terrestrial,17,10,11,4,27,64.70588235294117,23.52941176470588
2670_terrestrial,18,10,12,4,28,66.66666666666666,22.22222222222222
2671_terrestrial,18,10,12,4,28,66.66666666666666,22.22222222222222
2672_terrestrial,18,10,12,4,28,66.66666666666666,22.22222222222222
2673_terrestrial,18,10,12,4,28,66.66666666666666,22.22222222222222
2674_terrestrial,18,10,12,4,28,66.66666666666666,22.22222222222222
2675_terrestrial,18,9,12,4,27,66.66666666666666,22.22222222222222
2676_terrestrial,18,9,12,4,27,66.66666666666666,22.22222222222222
2677_terrestrial,19,9,13,5,28,68.42105263157895,26.31578947368421
2678_terrestrial,19,9,13,5,28,68.42105263157895,26.31578947368421
2679_terrestrial,19,9,13,5,28,68.42105263157895,26.31578947368421
2681_terrestrial,8,8,7,4,16,87.5,50
2682_terrestrial,8,6,7,4,14,87.5,50
2965_terrestrial,31,9,20,14,40,64.51612903225806,45.16129032258064
2966_terrestrial,31,9,20,14,40,64.51612903225806,45.16129032258064
2967_terrestrial,31,9,20,14,40,64.51612903225806,45.16129032258064
2968_terrestrial,31,9,20,14,40,64.51612903225806,45.16129032258064
2969_terrestrial,42,9,25,15,51,59.523809523809526,35.714285714285715
2970_terrestrial,33,7,19,14,40,57.57575757575758,42.42424242424242
2971_terrestrial,35,7,21,14,42,60,40
2972_terrestrial,34,7,20,14,41,58.82352941176471,41.17647058823529
2973_terrestrial,35,7,21,14,42,60,40
2974_terrestrial,36,7,21,15,43,58.333333333333336,41.66666666666667
2975_terrestrial,35,7,20,15,42,57.14285714285714,42.857142857142854
2976_terrestrial,35,7,20,15,42,57.14285714285714,42.857142857142854
2977_terrestrial,35,7,20,15,42,57.14285714285714,42.857142857142854
2978_terrestrial,35,6,20,15,41,57.14285714285714,42.857142857142854
2979_terrestrial,33,3,18,15,36,54.54545454545454,45.45454545454545
2980_terrestrial,31,6,18,15,37,58.06451612903226,48.38709677419355
2981_terrestrial,33,7,20,15,40,60.60606060606061,45.45454545454545
2982_terrestrial,33,9,20,15,42,60.60606060606061,45.45454545454545
2983_terrestrial,33,8,20,15,41,60.60606060606061,45.45454545454545
2984_terrestrial,33,6,20,15,39,60.60606060606061,45.45454545454545
2985_terrestrial,31,3,18,15,34,58.06451612903226,48.38709677419355
2986_terrestrial,30,3,17,14,33,56.666666666666664,46.666666666666664
2987_terrestrial,28,4,15,14,32,53.57142857142857,50
2988_terrestrial,28,4,15,14,32,53.57142857142857,50
2989_terrestrial,29,4,16,15,33,55.172413793103445,51.724137931034484
2990_terrestrial,36,10,23,15,46,63.888888888888886,41.66666666666667
2991_terrestrial,36,12,23,15,48,63.888888888888886,41.66666666666667
2992_terrestrial,34,12,21,15,46,61.76470588235294,44.11764705882353
2993_terrestrial,34,12,21,15,46,61.76470588235294,44.11764705882353
2994_terrestrial,34,12,21,15,46,61.76470588235294,44.11764705882353
2995_terrestrial,34,12,21,15,46,61.76470588235294,44.11764705882353
2996_terrestrial,49,18,27,22,67,55.10204081632652,44.89795918367347
2997_terrestrial,49,17,27,22,66,55.10204081632652,44.89795918367347
2998_terrestrial,48,16,26,21,64,54.166666666666664,43.75
2999_terrestrial,26,10,16,9,36,61.53846153846154,34.61538461538461
3000_terrestrial,24,10,15,7,34,62.5,29.166666666666668
3001_terrestrial,18,10,10,5,28,55.55555555555556,27.77777777777778
3002_terrestrial,18,8,10,5,26,55.55555555555556,27.77777777777778
3003_terrestrial,19,8,12,4,27,63.1578947368421,21.052631578947366
3004_terrestrial,18,8,11,4,26,61.111111111111114,22.22222222222222
3005_terrestrial,17,5,10,4,22,58.82352941176471,23.52941176470588
3006_terrestrial,17,7,10,4,24,58.82352941176471,23.52941176470588
3007_terrestrial,18,10,11,4,28,61.111111111111114,22.22222222222222
3008_terrestrial,18,10,11,4,28,61.111111111111114,22.22222222222222
3009_terrestrial,18,10,11,4,28,61.111111111111114,22.22222222222222
3010_terrestrial,18,8,11,4,26,61.111111111111114,22.22222222222222
3011_terrestrial,18,8,11,4,26,61.111111111111114,22.22222222222222
3012_terrestrial,17,5,10,4,22,58.82352941176471,23.52941176470588
3013_terrestrial,17,7,10,4,24,58.82352941176471,23.52941176470588
3014_terrestrial,18,10,11,4,28,61.111111111111114,22.22222222222222
3015_terrestrial,16,10,9,4,26,56.25,25
3016_terrestrial,16,8,9,4,24,56.25,25
3017_terrestrial,15,5,8,4,20,53.333333333333336,26.666666666666668
3018_terrestrial,14,5,7,4,19,50,28.57142857142857
3019_terrestrial,14,5,7,4,19,50,28.57142857142857
3020_terrestrial,14,5,7,4,19,50,28.57142857142857
3021_terrestrial,13,5,7,4,18,53.84615384615385,30.76923076923077
3022_terrestrial,13,5,7,4,18,53.84615384615385,30.76923076923077
3023_terrestrial,14,5,8,4,19,57.14285714285714,28.57142857142857
3024_terrestrial,14,5,8,4,19,57.14285714285714,28.57142857142857
3025_terrestrial,16,5,10,4,21,62.5,25
3026_terrestrial,16,5,10,4,21,62.5,25
3027_terrestrial,16,5,10,4,21,62.5,25
3028_terrestrial,17,10,11,4,27,64.70588235294117,23.52941176470588
3029_terrestrial,17,10,11,4,27,64.70588235294117,23.52941176470588
3030_terrestrial,18,10,12,4,28,66.66666666666666,22.22222222222222
3031_terrestrial,18,10,12,4,28,66.66666666666666,22.22222222222222
3032_terrestrial,18,8,12,4,26,66.66666666666666,22.22222222222222
3033_terrestrial,17,5,11,4,22,64.70588235294117,23.52941176470588
3034_terrestrial,18,10,12,4,28,66.66666666666666,22.22222222222222
3035_terrestrial,18,10,12,4,28,66.66666666666666,22.22222222222222
3036_terrestrial,19,10,13,5,29,68.42105263157895,26.31578947368421
3037_terrestrial,19,8,13,5,27,68.42105263157895,26.31578947368421
3038_terrestrial,19,10,13,5,29,68.42105263157895,26.31578947368421
3039_terrestrial,19,11,13,5,30,68.42105263157895,26.31578947368421
3040_terrestrial,19,9,13,4,28,68.42105263157895,21.052631578947366
3041_terrestrial,17,11,11,4,28,64.70588235294117,23.52941176470588
3042_terrestrial,18,11,12,4,29,66.66666666666666,22.22222222222222
3043_terrestrial,17,9,11,4,26,64.70588235294117,23.52941176470588
3044_terrestrial,17,11,11,4,28,64.70588235294117,23.52941176470588
3045_terrestrial,18,11,12,4,29,66.66666666666666,22.22222222222222
3046_terrestrial,26,14,20,4,40,76.92307692307693,15.384615384615385
3047_terrestrial,26,12,20,4,38,76.92307692307693,15.384615384615385
3048_terrestrial,26,13,20,4,39,76.92307692307693,15.384615384615385
3049_terrestrial,23,13,17,4,36,73.91304347826086,17.391304347826086
3111_terrestrial,18,11,14,5,29,77.77777777777779,27.77777777777778
3115_terrestrial,19,10,15,6,29,78.94736842105263,31.57894736842105
3116_terrestrial,19,10,15,6,29,78.94736842105263,31.57894736842105
3117_terrestrial,19,10,16,6,29,84.21052631578947,31.57894736842105
3118_terrestrial,19,10,16,6,29,84.21052631578947,31.57894736842105
3119_terrestrial,19,10,16,6,29,84.21052631578947,31.57894736842105
3120_terrestrial,17,10,14,4,27,82.35294117647058,23.52941176470588
3121_terrestrial,16,10,13,3,26,81.25,18.75
3122_terrestrial,16,9,13,3,25,81.25,18.75
3123_terrestrial,16,10,13,3,26,81.25,18.75
3124_terrestrial,16,10,13,3,26,81.25,18.75
3125_terrestrial,18,10,14,4,28,77.77777777777779,22.22222222222222
3126_terrestrial,18,10,14,4,28,77.77777777777779,22.22222222222222
3150_terrestrial,15,6,14,4,21,93.33333333333333,26.666666666666668
3151_terrestrial,16,8,15,5,24,93.75,31.25
3152_terrestrial,8,2,7,6,10,87.5,75
3154_terrestrial,21,9,18,6,30,85.71428571428571,28.57142857142857
3155_terrestrial,21,9,18,6,30,85.71428571428571,28.57142857142857
3156_terrestrial,20,7,17,6,27,85,30
3157_terrestrial,20,9,17,6,29,85,30
3320_terrestrial,21,6,14,10,27,66.66666666666666,47.61904761904761
3321_terrestrial,21,6,14,10,27,66.66666666666666,47.61904761904761
3322_terrestrial,21,6,14,10,27,66.66666666666666,47.61904761904761
3324_terrestrial,31,10,20,14,41,64.51612903225806,45.16129032258064
3325_terrestrial,31,10,20,14,41,64.51612903225806,45.16129032258064
3326_terrestrial,32,10,21,15,42,65.625,46.875
3327_terrestrial,31,10,20,14,41,64.51612903225806,45.16129032258064
3328_terrestrial,28,6,17,14,34,60.71428571428571,50
3329_terrestrial,31,10,20,14,41,64.51612903225806,45.16129032258064
3330_terrestrial,31,10,20,14,41,64.51612903225806,45.16129032258064
3331_terrestrial,42,10,25,15,52,59.523809523809526,35.714285714285715
3332_terrestrial,42,10,25,15,52,59.523809523809526,35.714285714285715
3333_terrestrial,42,9,25,15,51,59.523809523809526,35.714285714285715
3334_terrestrial,37,7,22,16,44,59.45945945945946,43.24324324324324
3335_terrestrial,36,7,21,15,43,58.333333333333336,41.66666666666667
3336_terrestrial,36,7,21,15,43,58.333333333333336,41.66666666666667
3337_terrestrial,36,7,21,15,43,58.333333333333336,41.66666666666667
3338_terrestrial,36,7,21,15,43,58.333333333333336,41.66666666666667
3339_terrestrial,35,8,20,15,43,57.14285714285714,42.857142857142854
3340_terrestrial,35,8,20,15,43,57.14285714285714,42.857142857142854
3341_terrestrial,35,8,20,15,43,57.14285714285714,42.857142857142854
3342_terrestrial,34,10,20,16,44,58.82352941176471,47.05882352941176
3343_terrestrial,34,10,20,16,44,58.82352941176471,47.05882352941176
3344_terrestrial,34,9,20,16,43,58.82352941176471,47.05882352941176
3345_terrestrial,32,4,18,16,36,56.25,50
3346_terrestrial,31,4,18,15,35,58.06451612903226,48.38709677419355
3347_terrestrial,29,4,16,15,33,55.172413793103445,51.724137931034484
3348_terrestrial,36,12,23,15,48,63.888888888888886,41.66666666666667
3349_terrestrial,36,14,23,15,50,63.888888888888886,41.66666666666667
3350_terrestrial,36,14,23,15,50,63.888888888888886,41.66666666666667
3351_terrestrial,36,12,23,15,48,63.888888888888886,41.66666666666667
3352_terrestrial,37,12,24,15,49,64.86486486486487,40.54054054054054
3353_terrestrial,52,20,31,22,72,59.61538461538461,42.30769230769231
3354_terrestrial,51,20,30,22,71,58.82352941176471,43.13725490196079
3355_terrestrial,31,16,20,12,47,64.51612903225806,38.70967741935484
3356_terrestrial,31,16,20,12,47,64.51612903225806,38.70967741935484
3357_terrestrial,31,13,20,12,44,64.51612903225806,38.70967741935484
3358_terrestrial,29,11,18,12,40,62.06896551724138,41.37931034482759
3359_terrestrial,24,6,13,12,30,54.166666666666664,50
3360_terrestrial,24,6,13,12,30,54.166666666666664,50
3361_terrestrial,24,6,13,12,30,54.166666666666664,50
3362_terrestrial,24,6,13,12,30,54.166666666666664,50
3363_terrestrial,22,6,12,10,28,54.54545454545454,45.45454545454545
3364_terrestrial,19,6,11,8,25,57.89473684210527,42.10526315789473
3365_terrestrial,18,5,11,7,23,61.111111111111114,38.88888888888889
3366_terrestrial,16,5,9,6,21,56.25,37.5
3367_terrestrial,15,5,8,5,20,53.333333333333336,33.33333333333333
3368_terrestrial,13,5,7,3,18,53.84615384615385,23.076923076923077
3369_terrestrial,13,5,7,3,18,53.84615384615385,23.076923076923077
3370_terrestrial,13,5,7,3,18,53.84615384615385,23.076923076923077
3371_terrestrial,13,5,7,3,18,53.84615384615385,23.076923076923077
3372_terrestrial,12,5,6,2,17,50,16.666666666666664
3373_terrestrial,12,5,6,2,17,50,16.666666666666664
3374_terrestrial,12,5,6,2,17,50,16.666666666666664
3375_terrestrial,9,5,4,2,14,44.44444444444444,22.22222222222222
3376_terrestrial,9,5,4,2,14,44.44444444444444,22.22222222222222
3377_terrestrial,9,5,4,2,14,44.44444444444444,22.22222222222222
3378_terrestrial,9,3,4,2,12,44.44444444444444,22.22222222222222
3379_terrestrial,9,3,4,2,12,44.44444444444444,22.22222222222222
3380_terrestrial,9,3,4,2,12,44.44444444444444,22.22222222222222
3381_terrestrial,9,3,4,2,12,44.44444444444444,22.22222222222222
3382_terrestrial,11,3,6,2,14,54.54545454545454,18.181818181818183
3383_terrestrial,11,3,6,2,14,54.54545454545454,18.181818181818183
3384_terrestrial,12,3,6,3,15,50,25
3385_terrestrial,12,3,6,3,15,50,25
3386_terrestrial,12,3,6,3,15,50,25
3387_terrestrial,12,5,6,3,17,50,25
3388_terrestrial,12,5,6,3,17,50,25
3389_terrestrial,12,5,6,3,17,50,25
3390_terrestrial,13,5,7,3,18,53.84615384615385,23.076923076923077
3391_terrestrial,15,5,9,3,20,60,20
3392_terrestrial,16,5,10,3,21,62.5,18.75
3393_terrestrial,16,5,10,3,21,62.5,18.75
3394_terrestrial,16,6,10,3,22,62.5,18.75
3395_terrestrial,16,6,10,3,22,62.5,18.75
3396_terrestrial,16,6,10,3,22,62.5,18.75
3397_terrestrial,18,11,12,4,29,66.66666666666666,22.22222222222222
3398_terrestrial,18,11,12,4,29,66.66666666666666,22.22222222222222
3399_terrestrial,17,6,11,4,23,64.70588235294117,23.52941176470588
3400_terrestrial,29,11,23,5,40,79.3103448275862,17.24137931034483
3401_terrestrial,29,13,23,5,42,79.3103448275862,17.24137931034483
3402_terrestrial,28,13,22,5,41,78.57142857142857,17.857142857142858
3403_terrestrial,28,13,22,5,41,78.57142857142857,17.857142857142858
3404_terrestrial,28,13,22,5,41,78.57142857142857,17.857142857142858
3405_terrestrial,28,13,22,4,41,78.57142857142857,14.285714285714285
3406_terrestrial,28,14,22,4,42,78.57142857142857,14.285714285714285
3437_terrestrial,31,11,25,12,42,80.64516129032258,38.70967741935484
3438_terrestrial,34,12,27,9,46,79.41176470588235,26.47058823529412
3439_terrestrial,38,12,30,12,50,78.94736842105263,31.57894736842105
3440_terrestrial,35,10,29,10,45,82.85714285714286,28.57142857142857
3441_terrestrial,33,11,28,8,44,84.84848484848484,24.242424242424242
3442_terrestrial,31,11,26,9,42,83.87096774193549,29.03225806451613
3443_terrestrial,31,12,26,9,43,83.87096774193549,29.03225806451613
3444_terrestrial,32,10,27,10,42,84.375,31.25
3445_terrestrial,30,10,25,8,40,83.33333333333334,26.666666666666668
3446_terrestrial,30,10,25,8,40,83.33333333333334,26.666666666666668
3447_terrestrial,31,10,26,8,41,83.87096774193549,25.806451612903224
3448_terrestrial,31,12,26,8,43,83.87096774193549,25.806451612903224
3452_terrestrial,8,5,7,2,13,87.5,25
3453_terrestrial,8,6,7,2,14,87.5,25
3454_terrestrial,22,8,21,3,30,95.45454545454545,13.636363636363635
3465_terrestrial,19,10,15,6,29,78.94736842105263,31.57894736842105
3466_terrestrial,19,11,15,6,30,78.94736842105263,31.57894736842105
3467_terrestrial,19,11,15,6,30,78.94736842105263,31.57894736842105
3468_terrestrial,20,11,16,7,31,80,35
3469_terrestrial,20,11,16,7,31,80,35
3470_terrestrial,20,11,16,7,31,80,35
3471_terrestrial,21,11,17,8,32,80.95238095238095,38.095238095238095
3472_terrestrial,21,11,17,8,32,80.95238095238095,38.095238095238095
3473_terrestrial,22,9,17,8,31,77.27272727272727,36.36363636363637
3474_terrestrial,23,9,18,9,32,78.26086956521739,39.130434782608695
3475_terrestrial,20,10,16,7,30,80,35
3476_terrestrial,20,10,16,7,30,80,35
3477_terrestrial,21,10,17,8,31,80.95238095238095,38.095238095238095
3478_terrestrial,21,10,17,8,31,80.95238095238095,38.095238095238095
3479_terrestrial,22,10,18,9,32,81.81818181818183,40.909090909090914
3480_terrestrial,23,10,19,10,33,82.6086956521739,43.47826086956522
3481_terrestrial,21,10,18,8,31,85.71428571428571,38.095238095238095
3482_terrestrial,19,10,16,6,29,84.21052631578947,31.57894736842105
3483_terrestrial,20,10,15,6,30,75,30
3484_terrestrial,19,10,15,5,29,78.94736842105263,26.31578947368421
3485_terrestrial,18,10,14,4,28,77.77777777777779,22.22222222222222
3486_terrestrial,18,9,14,4,27,77.77777777777779,22.22222222222222
3499_terrestrial,10,3,10,0,13,100,0
3500_terrestrial,11,6,11,1,17,100,9.090909090909092
3501_terrestrial,11,5,11,1,16,100,9.090909090909092
3512_terrestrial,24,9,20,8,33,83.33333333333334,33.33333333333333
3513_terrestrial,24,9,20,8,33,83.33333333333334,33.33333333333333
3514_terrestrial,23,9,19,8,32,82.6086956521739,34.78260869565217
3515_terrestrial,23,9,19,8,32,82.6086956521739,34.78260869565217
3516_terrestrial,20,9,17,6,29,85,30
3517_terrestrial,20,9,17,6,29,85,30
3518_terrestrial,20,9,17,6,29,85,30
3519_terrestrial,20,9,17,6,29,85,30
3520_terrestrial,18,9,15,6,27,83.33333333333334,33.33333333333333
3675_terrestrial,24,7,15,11,31,62.5,45.83333333333333
3676_terrestrial,24,7,15,11,31,62.5,45.83333333333333
3677_terrestrial,24,7,15,11,31,62.5,45.83333333333333
3678_terrestrial,24,7,15,11,31,62.5,45.83333333333333
3679_terrestrial,24,7,15,11,31,62.5,45.83333333333333
3680_terrestrial,19,3,12,10,22,63.1578947368421,52.63157894736842
3681_terrestrial,22,6,15,10,28,68.18181818181817,45.45454545454545
3682_terrestrial,20,3,13,10,23,65,50
3684_terrestrial,31,10,20,14,41,64.51612903225806,45.16129032258064
3685_terrestrial,31,10,20,14,41,64.51612903225806,45.16129032258064
3686_terrestrial,32,10,21,15,42,65.625,46.875
3687_terrestrial,31,10,20,14,41,64.51612903225806,45.16129032258064
3688_terrestrial,31,10,20,14,41,64.51612903225806,45.16129032258064
3689_terrestrial,31,9,20,14,40,64.51612903225806,45.16129032258064
3690_terrestrial,31,9,20,14,40,64.51612903225806,45.16129032258064
3691_terrestrial,28,6,17,14,34,60.71428571428571,50
3692_terrestrial,33,9,22,14,42,66.66666666666666,42.42424242424242
3693_terrestrial,33,10,22,14,43,66.66666666666666,42.42424242424242
3694_terrestrial,44,10,27,15,54,61.36363636363637,34.090909090909086
3695_terrestrial,44,10,27,15,54,61.36363636363637,34.090909090909086
3696_terrestrial,39,7,24,15,46,61.53846153846154,38.46153846153847
3697_terrestrial,39,7,24,15,46,61.53846153846154,38.46153846153847
3698_terrestrial,37,8,22,15,45,59.45945945945946,40.54054054054054
3699_terrestrial,39,8,24,15,47,61.53846153846154,38.46153846153847
3700_terrestrial,37,8,21,16,45,56.75675675675676,43.24324324324324
3701_terrestrial,36,7,21,15,43,58.333333333333336,41.66666666666667
3702_terrestrial,39,12,25,16,51,64.1025641025641,41.02564102564102
3703_terrestrial,40,14,26,16,54,65,40
3704_terrestrial,38,14,24,16,52,63.1578947368421,42.10526315789473
3705_terrestrial,38,14,24,16,52,63.1578947368421,42.10526315789473
3706_terrestrial,38,14,24,16,52,63.1578947368421,42.10526315789473
3707_terrestrial,37,14,23,16,51,62.16216216216216,43.24324324324324
3708_terrestrial,31,6,18,15,37,58.06451612903226,48.38709677419355
3709_terrestrial,36,14,23,15,50,63.888888888888886,41.66666666666667
3710_terrestrial,36,14,23,15,50,63.888888888888886,41.66666666666667
3712_terrestrial,31,8,19,13,39,61.29032258064516,41.935483870967744
3713_terrestrial,34,15,22,12,49,64.70588235294117,35.294117647058826
3714_terrestrial,33,15,22,12,48,66.66666666666666,36.36363636363637
3715_terrestrial,31,17,20,12,48,64.51612903225806,38.70967741935484
3716_terrestrial,31,17,20,12,48,64.51612903225806,38.70967741935484
3717_terrestrial,24,7,13,12,31,54.166666666666664,50
3718_terrestrial,24,7,13,12,31,54.166666666666664,50
3719_terrestrial,24,6,13,12,30,54.166666666666664,50
3720_terrestrial,21,6,11,11,27,52.38095238095239,52.38095238095239
3721_terrestrial,18,6,11,10,24,61.111111111111114,55.55555555555556
3722_terrestrial,16,4,10,9,20,62.5,56.25
3723_terrestrial,16,4,10,9,20,62.5,56.25
3724_terrestrial,13,4,8,6,17,61.53846153846154,46.15384615384615
3725_terrestrial,11,3,7,5,14,63.63636363636363,45.45454545454545
3726_terrestrial,9,3,5,5,12,55.55555555555556,55.55555555555556
3727_terrestrial,7,3,3,3,10,42.857142857142854,42.857142857142854
3728_terrestrial,7,3,3,3,10,42.857142857142854,42.857142857142854
3729_terrestrial,6,3,2,2,9,33.33333333333333,33.33333333333333
3730_terrestrial,6,3,2,2,9,33.33333333333333,33.33333333333333
3731_terrestrial,6,3,2,2,9,33.33333333333333,33.33333333333333
3732_terrestrial,5,3,2,2,8,40,40
3733_terrestrial,5,3,2,2,8,40,40
3734_terrestrial,5,3,2,2,8,40,40
3735_terrestrial,5,3,2,2,8,40,40
3736_terrestrial,5,3,2,2,8,40,40
3737_terrestrial,5,3,2,2,8,40,40
3738_terrestrial,5,3,2,2,8,40,40
3739_terrestrial,5,3,2,2,8,40,40
3740_terrestrial,5,3,2,2,8,40,40
3741_terrestrial,5,3,2,2,8,40,40
3742_terrestrial,5,3,2,2,8,40,40
3743_terrestrial,4,3,2,2,7,50,50
3744_terrestrial,4,3,2,2,7,50,50
3745_terrestrial,4,3,2,2,7,50,50
3746_terrestrial,5,3,2,2,8,40,40
3747_terrestrial,7,3,4,2,10,57.14285714285714,28.57142857142857
3748_terrestrial,7,3,4,2,10,57.14285714285714,28.57142857142857
3749_terrestrial,7,3,4,2,10,57.14285714285714,28.57142857142857
3750_terrestrial,7,3,4,2,10,57.14285714285714,28.57142857142857
3751_terrestrial,9,3,5,3,12,55.55555555555556,33.33333333333333
3752_terrestrial,11,3,5,3,14,45.45454545454545,27.27272727272727
3753_terrestrial,13,3,7,3,16,53.84615384615385,23.076923076923077
3754_terrestrial,13,6,7,3,19,53.84615384615385,23.076923076923077
3755_terrestrial,15,6,9,3,21,60,20
3756_terrestrial,16,6,10,3,22,62.5,18.75
3757_terrestrial,17,6,11,4,23,64.70588235294117,23.52941176470588
3758_terrestrial,18,6,12,5,24,66.66666666666666,27.77777777777778
3759_terrestrial,18,6,12,5,24,66.66666666666666,27.77777777777778
3760_terrestrial,29,13,23,5,42,79.3103448275862,17.24137931034483
3761_terrestrial,31,13,23,7,44,74.19354838709677,22.58064516129032
3762_terrestrial,31,13,23,7,44,74.19354838709677,22.58064516129032
3763_terrestrial,19,8,13,5,27,68.42105263157895,26.31578947368421
3791_terrestrial,48,17,35,20,65,72.91666666666666,41.66666666666667
3792_terrestrial,53,19,39,21,72,73.58490566037736,39.62264150943396
3793_terrestrial,50,20,37,21,70,74,42
3794_terrestrial,41,17,33,14,58,80.48780487804879,34.146341463414636
3795_terrestrial,39,10,31,14,49,79.48717948717949,35.8974358974359
3796_terrestrial,37,11,29,13,48,78.37837837837837,35.13513513513514
3797_terrestrial,38,14,30,13,52,78.94736842105263,34.21052631578947
3798_terrestrial,30,12,24,8,42,80,26.666666666666668
3799_terrestrial,38,12,30,10,50,78.94736842105263,26.31578947368421
3800_terrestrial,35,12,28,9,47,80,25.71428571428571
3801_terrestrial,34,12,26,8,46,76.47058823529412,23.52941176470588
3802_terrestrial,30,13,24,8,43,80,26.666666666666668
3803_terrestrial,29,13,24,8,42,82.75862068965517,27.586206896551722
3804_terrestrial,28,12,23,9,40,82.14285714285714,32.142857142857146
3805_terrestrial,31,12,26,8,43,83.87096774193549,25.806451612903224
3806_terrestrial,31,12,26,8,43,83.87096774193549,25.806451612903224
3807_terrestrial,32,12,26,9,44,81.25,28.125
3808_terrestrial,31,12,26,8,43,83.87096774193549,25.806451612903224
3831_terrestrial,20,11,16,7,31,80,35
3832_terrestrial,20,10,16,7,30,80,35
3839_terrestrial,21,10,17,8,31,80.95238095238095,38.095238095238095
3840_terrestrial,21,10,17,8,31,80.95238095238095,38.095238095238095
3857_terrestrial,13,6,13,1,19,100,7.6923076923076925
3858_terrestrial,13,6,13,1,19,100,7.6923076923076925
3872_terrestrial,21,9,19,8,30,90.47619047619048,38.095238095238095
3873_terrestrial,21,9,19,8,30,90.47619047619048,38.095238095238095
3874_terrestrial,23,9,19,8,32,82.6086956521739,34.78260869565217
3875_terrestrial,23,9,19,8,32,82.6086956521739,34.78260869565217
3876_terrestrial,21,9,18,7,30,85.71428571428571,33.33333333333333
3877_terrestrial,21,9,18,7,30,85.71428571428571,33.33333333333333
3878_terrestrial,20,9,17,6,29,85,30
3879_terrestrial,20,9,17,6,29,85,30
3880_terrestrial,20,9,17,6,29,85,30
3881_terrestrial,20,11,17,6,31,85,30
3882_terrestrial,22,11,19,6,33,86.36363636363636,27.27272727272727
3883_terrestrial,20,11,17,6,31,85,30
3884_terrestrial,19,11,16,5,30,84.21052631578947,26.31578947368421
3885_terrestrial,19,11,16,5,30,84.21052631578947,26.31578947368421
4026_terrestrial,21,7,15,10,28,71.42857142857143,47.61904761904761
4027_terrestrial,23,7,15,10,30,65.21739130434783,43.47826086956522
4028_terrestrial,27,7,19,10,34,70.37037037037037,37.03703703703704
4029_terrestrial,27,7,19,10,34,70.37037037037037,37.03703703703704
4030_terrestrial,27,7,19,10,34,70.37037037037037,37.03703703703704
4031_terrestrial,27,7,19,10,34,70.37037037037037,37.03703703703704
4036_terrestrial,24,7,15,11,31,62.5,45.83333333333333
4037_terrestrial,24,7,15,11,31,62.5,45.83333333333333
4038_terrestrial,24,7,15,11,31,62.5,45.83333333333333
4039_terrestrial,25,7,16,11,32,64,44
4040_terrestrial,25,7,16,11,32,64,44
4041_terrestrial,25,7,16,11,32,64,44
4042_terrestrial,27,8,18,11,35,66.66666666666666,40.74074074074074
4043_terrestrial,28,8,19,11,36,67.85714285714286,39.285714285714285
4044_terrestrial,28,8,19,11,36,67.85714285714286,39.285714285714285
4045_terrestrial,28,8,19,11,36,67.85714285714286,39.285714285714285
4046_terrestrial,34,10,23,15,44,67.64705882352942,44.11764705882353
4047_terrestrial,31,10,20,14,41,64.51612903225806,45.16129032258064
4048_terrestrial,31,10,20,14,41,64.51612903225806,45.16129032258064
4049_terrestrial,32,10,21,15,42,65.625,46.875
4050_terrestrial,34,10,23,15,44,67.64705882352942,44.11764705882353
4051_terrestrial,35,10,24,16,45,68.57142857142857,45.714285714285715
4052_terrestrial,34,10,23,15,44,67.64705882352942,44.11764705882353
4053_terrestrial,45,10,28,15,55,62.22222222222222,33.33333333333333
4054_terrestrial,45,10,28,15,55,62.22222222222222,33.33333333333333
4055_terrestrial,39,8,24,15,47,61.53846153846154,38.46153846153847
4056_terrestrial,39,8,24,15,47,61.53846153846154,38.46153846153847
4057_terrestrial,39,7,24,15,46,61.53846153846154,38.46153846153847
4058_terrestrial,39,8,24,15,47,61.53846153846154,38.46153846153847
4059_terrestrial,40,7,24,16,47,60,40
4060_terrestrial,35,4,19,16,39,54.285714285714285,45.714285714285715
4061_terrestrial,34,4,19,15,38,55.88235294117647,44.11764705882353
4062_terrestrial,32,4,17,15,36,53.125,46.875
4063_terrestrial,37,12,23,16,49,62.16216216216216,43.24324324324324
4064_terrestrial,44,14,30,16,58,68.18181818181817,36.36363636363637
4065_terrestrial,43,14,29,16,57,67.44186046511628,37.2093023255814
4066_terrestrial,40,14,26,16,54,65,40
4068_terrestrial,44,19,32,13,63,72.72727272727273,29.545454545454547
4069_terrestrial,42,17,30,13,59,71.42857142857143,30.952380952380953
4070_terrestrial,42,17,30,13,59,71.42857142857143,30.952380952380953
4071_terrestrial,39,17,27,13,56,69.23076923076923,33.33333333333333
4072_terrestrial,39,17,27,13,56,69.23076923076923,33.33333333333333
4073_terrestrial,31,9,19,13,40,61.29032258064516,41.935483870967744
4074_terrestrial,29,9,17,13,38,58.620689655172406,44.827586206896555
4075_terrestrial,29,9,17,14,38,58.620689655172406,48.275862068965516
4076_terrestrial,27,6,15,14,33,55.55555555555556,51.85185185185185
4077_terrestrial,26,6,15,14,32,57.692307692307686,53.84615384615385
4078_terrestrial,26,6,15,14,32,57.692307692307686,53.84615384615385
4079_terrestrial,26,6,15,14,32,57.692307692307686,53.84615384615385
4080_terrestrial,18,6,13,10,24,72.22222222222221,55.55555555555556
4081_terrestrial,14,5,9,8,19,64.28571428571429,57.14285714285714
4082_terrestrial,13,4,8,8,17,61.53846153846154,61.53846153846154
4083_terrestrial,13,4,8,7,17,61.53846153846154,53.84615384615385
4084_terrestrial,11,3,6,6,14,54.54545454545454,54.54545454545454
4085_terrestrial,7,3,3,3,10,42.857142857142854,42.857142857142854
4086_terrestrial,7,3,3,3,10,42.857142857142854,42.857142857142854
4087_terrestrial,7,3,3,3,10,42.857142857142854,42.857142857142854
4088_terrestrial,6,3,3,3,9,50,50
4089_terrestrial,5,3,2,2,8,40,40
4090_terrestrial,5,3,2,2,8,40,40
4091_terrestrial,4,3,2,2,7,50,50
4092_terrestrial,4,3,2,2,7,50,50
4093_terrestrial,4,3,2,2,7,50,50
4094_terrestrial,4,3,2,2,7,50,50
4095_terrestrial,4,3,2,2,7,50,50
4096_terrestrial,4,3,2,2,7,50,50
4097_terrestrial,4,3,2,2,7,50,50
4098_terrestrial,4,3,2,2,7,50,50
4099_terrestrial,4,3,2,2,7,50,50
4100_terrestrial,4,3,2,2,7,50,50
4101_terrestrial,4,3,2,2,7,50,50
4102_terrestrial,4,3,2,2,7,50,50
4103_terrestrial,4,3,2,2,7,50,50
4104_terrestrial,4,3,2,2,7,50,50
4105_terrestrial,4,3,2,2,7,50,50
4106_terrestrial,4,3,2,2,7,50,50
4107_terrestrial,4,3,2,2,7,50,50
4108_terrestrial,4,3,2,2,7,50,50
4109_terrestrial,4,3,2,2,7,50,50
4110_terrestrial,4,3,2,2,7,50,50
4111_terrestrial,7,3,5,2,10,71.42857142857143,28.57142857142857
4112_terrestrial,7,3,5,2,10,71.42857142857143,28.57142857142857
4113_terrestrial,8,3,5,2,11,62.5,25
4114_terrestrial,11,3,5,3,14,45.45454545454545,27.27272727272727
4115_terrestrial,13,3,7,3,16,53.84615384615385,23.076923076923077
4116_terrestrial,15,5,9,3,20,60,20
4117_terrestrial,18,5,12,5,23,66.66666666666666,27.77777777777778
4118_terrestrial,18,5,12,5,23,66.66666666666666,27.77777777777778
4119_terrestrial,34,11,25,9,45,73.52941176470588,26.47058823529412
4120_terrestrial,33,13,25,8,46,75.75757575757575,24.242424242424242
4121_terrestrial,34,13,25,9,47,73.52941176470588,26.47058823529412
4122_terrestrial,25,7,21,9,32,84,36
4151_terrestrial,45,18,35,15,63,77.77777777777779,33.33333333333333
4152_terrestrial,54,20,40,20,74,74.07407407407408,37.03703703703704
4153_terrestrial,58,20,45,22,78,77.58620689655173,37.93103448275862
4154_terrestrial,54,22,43,20,76,79.62962962962963,37.03703703703704
4155_terrestrial,55,18,44,20,73,80,36.36363636363637
4156_terrestrial,53,25,41,21,78,77.35849056603774,39.62264150943396
4157_terrestrial,47,20,36,16,67,76.59574468085107,34.04255319148936
4158_terrestrial,42,17,33,12,59,78.57142857142857,28.57142857142857
4159_terrestrial,35,14,29,10,49,82.85714285714286,28.57142857142857
4160_terrestrial,36,14,29,11,50,80.55555555555556,30.555555555555557
4161_terrestrial,42,14,30,14,56,71.42857142857143,33.33333333333333
4162_terrestrial,41,15,30,13,56,73.17073170731707,31.70731707317073
4163_terrestrial,34,14,28,9,48,82.35294117647058,26.47058823529412
4164_terrestrial,32,14,27,7,46,84.375,21.875
4167_terrestrial,27,14,24,5,41,88.88888888888889,18.51851851851852
4168_terrestrial,27,13,24,5,40,88.88888888888889,18.51851851851852
4169_terrestrial,23,12,22,4,35,95.65217391304348,17.391304347826086
4170_terrestrial,23,12,22,4,35,95.65217391304348,17.391304347826086
4237_terrestrial,21,9,18,7,30,85.71428571428571,33.33333333333333
4238_terrestrial,21,9,18,7,30,85.71428571428571,33.33333333333333
4239_terrestrial,21,9,18,7,30,85.71428571428571,33.33333333333333
4240_terrestrial,23,11,20,7,34,86.95652173913044,30.434782608695656
4241_terrestrial,23,11,20,7,34,86.95652173913044,30.434782608695656
4242_terrestrial,23,11,20,7,34,86.95652173913044,30.434782608695656
4243_terrestrial,23,11,20,7,34,86.95652173913044,30.434782608695656
4244_terrestrial,15,5,12,6,20,80,40
4245_terrestrial,20,11,17,6,31,85,30
4246_terrestrial,19,11,16,5,30,84.21052631578947,26.31578947368421
4247_terrestrial,15,8,13,5,23,86.66666666666667,33.33333333333333
4248_terrestrial,15,8,13,5,23,86.66666666666667,33.33333333333333
4380_terrestrial,27,5,16,12,32,59.25925925925925,44.44444444444444
4381_terrestrial,29,9,18,12,38,62.06896551724138,41.37931034482759
4382_terrestrial,29,9,18,12,38,62.06896551724138,41.37931034482759
4383_terrestrial,29,9,18,12,38,62.06896551724138,41.37931034482759
4384_terrestrial,29,9,18,12,38,62.06896551724138,41.37931034482759
4385_terrestrial,31,10,20,12,41,64.51612903225806,38.70967741935484
4386_terrestrial,21,7,15,10,28,71.42857142857143,47.61904761904761
4387_terrestrial,29,7,21,10,36,72.41379310344827,34.48275862068966
4388_terrestrial,25,7,17,10,32,68,40
4389_terrestrial,25,7,17,10,32,68,40
4390_terrestrial,25,7,17,10,32,68,40
4391_terrestrial,23,3,15,10,26,65.21739130434783,43.47826086956522
4394_terrestrial,21,5,12,10,26,57.14285714285714,47.61904761904761
4395_terrestrial,23,9,14,10,32,60.86956521739131,43.47826086956522
4396_terrestrial,23,9,14,10,32,60.86956521739131,43.47826086956522
4398_terrestrial,20,7,13,10,27,65,50
4399_terrestrial,20,7,13,10,27,65,50
4400_terrestrial,25,7,16,11,32,64,44
4401_terrestrial,25,7,16,11,32,64,44
4402_terrestrial,5,4,5,0,9,100,0
4403_terrestrial,28,8,19,11,36,67.85714285714286,39.285714285714285
4404_terrestrial,38,10,26,16,48,68.42105263157895,42.10526315789473
4405_terrestrial,38,10,26,16,48,68.42105263157895,42.10526315789473
4406_terrestrial,25,8,17,11,33,68,44
4407_terrestrial,23,8,15,11,31,65.21739130434783,47.82608695652174
4409_terrestrial,27,7,19,13,34,70.37037037037037,48.148148148148145
4410_terrestrial,29,7,21,13,36,72.41379310344827,44.827586206896555
4411_terrestrial,30,7,22,13,37,73.33333333333333,43.333333333333336
4412_terrestrial,43,8,26,16,51,60.46511627906976,37.2093023255814
4413_terrestrial,41,8,24,16,49,58.536585365853654,39.02439024390244
4414_terrestrial,41,8,24,16,49,58.536585365853654,39.02439024390244
4415_terrestrial,41,8,24,16,49,58.536585365853654,39.02439024390244
4416_terrestrial,41,8,24,16,49,58.536585365853654,39.02439024390244
4417_terrestrial,41,8,24,16,49,58.536585365853654,39.02439024390244
4418_terrestrial,47,12,28,18,59,59.57446808510638,38.297872340425535
4419_terrestrial,49,12,30,18,61,61.224489795918366,36.734693877551024
4420_terrestrial,48,14,30,17,62,62.5,35.41666666666667
4421_terrestrial,49,14,31,17,63,63.26530612244898,34.69387755102041
4422_terrestrial,47,14,30,16,61,63.829787234042556,34.04255319148936
4423_terrestrial,44,14,30,16,58,68.18181818181817,36.36363636363637
4424_terrestrial,44,14,30,16,58,68.18181818181817,36.36363636363637
4425_terrestrial,31,6,18,15,37,58.06451612903226,48.38709677419355
4428_terrestrial,46,18,33,15,64,71.73913043478261,32.608695652173914
4429_terrestrial,50,18,36,18,68,72,36
4430_terrestrial,52,20,37,18,72,71.15384615384616,34.61538461538461
4431_terrestrial,53,20,38,19,73,71.69811320754717,35.84905660377358
4432_terrestrial,52,20,37,19,72,71.15384615384616,36.53846153846153
4433_terrestrial,49,20,34,19,69,69.38775510204081,38.775510204081634
4434_terrestrial,48,20,33,19,68,68.75,39.58333333333333
4435_terrestrial,33,7,19,16,40,57.57575757575758,48.484848484848484
4436_terrestrial,31,7,18,15,38,58.06451612903226,48.38709677419355
4437_terrestrial,29,7,16,15,36,55.172413793103445,51.724137931034484
4438_terrestrial,29,6,16,15,35,55.172413793103445,51.724137931034484
4439_terrestrial,28,6,16,14,34,57.14285714285714,50
4440_terrestrial,22,5,11,12,27,50,54.54545454545454
4441_terrestrial,21,5,10,12,26,47.61904761904761,57.14285714285714
4442_terrestrial,18,5,10,11,23,55.55555555555556,61.111111111111114
4443_terrestrial,13,5,9,8,18,69.23076923076923,61.53846153846154
4444_terrestrial,12,5,8,7,17,66.66666666666666,58.333333333333336
4445_terrestrial,9,5,5,6,14,55.55555555555556,66.66666666666666
4446_terrestrial,7,4,3,4,11,42.857142857142854,57.14285714285714
4447_terrestrial,6,4,2,3,10,33.33333333333333,50
4448_terrestrial,5,3,2,2,8,40,40
4449_terrestrial,5,3,2,2,8,40,40
4450_terrestrial,5,3,2,2,8,40,40
4451_terrestrial,5,3,2,2,8,40,40
4452_terrestrial,3,3,1,1,6,33.33333333333333,33.33333333333333
4453_terrestrial,3,3,1,1,6,33.33333333333333,33.33333333333333
4454_terrestrial,3,3,1,1,6,33.33333333333333,33.33333333333333
4455_terrestrial,3,3,1,1,6,33.33333333333333,33.33333333333333
4456_terrestrial,3,3,1,1,6,33.33333333333333,33.33333333333333
4457_terrestrial,3,3,1,1,6,33.33333333333333,33.33333333333333
4458_terrestrial,3,3,1,1,6,33.33333333333333,33.33333333333333
4459_terrestrial,3,3,1,1,6,33.33333333333333,33.33333333333333
4460_terrestrial,3,3,1,1,6,33.33333333333333,33.33333333333333
4461_terrestrial,3,3,1,1,6,33.33333333333333,33.33333333333333
4462_terrestrial,3,3,1,1,6,33.33333333333333,33.33333333333333
4463_terrestrial,3,3,1,1,6,33.33333333333333,33.33333333333333
4464_terrestrial,3,3,1,1,6,33.33333333333333,33.33333333333333
4465_terrestrial,3,3,1,1,6,33.33333333333333,33.33333333333333
4466_terrestrial,3,3,1,1,6,33.33333333333333,33.33333333333333
4467_terrestrial,3,3,1,1,6,33.33333333333333,33.33333333333333
4468_terrestrial,3,3,1,1,6,33.33333333333333,33.33333333333333
4469_terrestrial,3,3,1,1,6,33.33333333333333,33.33333333333333
4470_terrestrial,4,3,2,2,7,50,50
4471_terrestrial,4,3,2,2,7,50,50
4472_terrestrial,5,3,3,2,8,60,40
4473_terrestrial,5,3,3,2,8,60,40
4474_terrestrial,11,3,5,3,14,45.45454545454545,27.27272727272727
4475_terrestrial,17,5,10,4,22,58.82352941176471,23.52941176470588
4476_terrestrial,18,5,11,5,23,61.111111111111114,27.77777777777778
4477_terrestrial,19,5,12,6,24,63.1578947368421,31.57894736842105
4478_terrestrial,39,10,30,12,49,76.92307692307693,30.76923076923077
4479_terrestrial,39,12,30,12,51,76.92307692307693,30.76923076923077
4480_terrestrial,39,10,30,12,49,76.92307692307693,30.76923076923077
4481_terrestrial,39,12,30,12,51,76.92307692307693,30.76923076923077
4482_terrestrial,39,12,30,12,51,76.92307692307693,30.76923076923077
4483_terrestrial,24,10,20,9,34,83.33333333333334,37.5
4514_terrestrial,50,18,38,21,68,76,42
4515_terrestrial,56,18,42,23,74,75,41.07142857142857
4516_terrestrial,56,23,44,20,79,78.57142857142857,35.714285714285715
4517_terrestrial,45,18,36,14,63,80,31.11111111111111
4518_terrestrial,43,16,35,12,59,81.3953488372093,27.906976744186046
4519_terrestrial,37,13,31,10,50,83.78378378378379,27.027027027027028
4521_terrestrial,38,15,29,11,53,76.31578947368422,28.947368421052634
4522_terrestrial,40,15,31,13,55,77.5,32.5
4523_terrestrial,42,15,33,14,57,78.57142857142857,33.33333333333333
4524_terrestrial,40,14,32,11,54,80,27.500000000000004
4525_terrestrial,31,14,26,7,45,83.87096774193549,22.58064516129032
4568_terrestrial,28,18,21,9,46,75,32.142857142857146
4590_terrestrial,20,7,16,10,27,80,50
4596_terrestrial,33,17,27,17,50,81.81818181818183,51.515151515151516
4597_terrestrial,33,17,27,17,50,81.81818181818183,51.515151515151516
4600_terrestrial,22,11,19,6,33,86.36363636363636,27.27272727272727
4601_terrestrial,14,5,11,5,19,78.57142857142857,35.714285714285715
4602_terrestrial,48,24,32,20,72,66.66666666666666,41.66666666666667
4603_terrestrial,50,24,34,20,74,68,40
4604_terrestrial,50,24,34,20,74,68,40
4605_terrestrial,49,24,33,21,73,67.3469387755102,42.857142857142854
4606_terrestrial,48,24,32,21,72,66.66666666666666,43.75
4607_terrestrial,49,24,33,21,73,67.3469387755102,42.857142857142854
4608_terrestrial,49,24,33,21,73,67.3469387755102,42.857142857142854
4738_terrestrial,29,11,18,12,40,62.06896551724138,41.37931034482759
4739_terrestrial,29,11,18,12,40,62.06896551724138,41.37931034482759
4740_terrestrial,29,11,18,12,40,62.06896551724138,41.37931034482759
4741_terrestrial,29,11,18,12,40,62.06896551724138,41.37931034482759
4742_terrestrial,32,11,20,13,43,62.5,40.625
4743_terrestrial,32,12,20,13,44,62.5,40.625
4744_terrestrial,39,12,22,16,51,56.41025641025641,41.02564102564102
4745_terrestrial,39,10,22,16,49,56.41025641025641,41.02564102564102
4746_terrestrial,35,10,20,16,45,57.14285714285714,45.714285714285715
4747_terrestrial,35,10,20,16,45,57.14285714285714,45.714285714285715
4748_terrestrial,36,10,21,17,46,58.333333333333336,47.22222222222222
4750_terrestrial,36,11,20,17,47,55.55555555555556,47.22222222222222
4751_terrestrial,36,11,20,17,47,55.55555555555556,47.22222222222222
4752_terrestrial,36,11,20,17,47,55.55555555555556,47.22222222222222
4753_terrestrial,36,7,19,18,43,52.77777777777778,50
4754_terrestrial,42,11,24,19,53,57.14285714285714,45.23809523809524
4755_terrestrial,40,7,22,19,47,55.00000000000001,47.5
4756_terrestrial,24,10,16,12,34,66.66666666666666,50
4757_terrestrial,24,10,16,12,34,66.66666666666666,50
4758_terrestrial,34,10,23,15,44,67.64705882352942,44.11764705882353
4759_terrestrial,34,10,23,16,44,67.64705882352942,47.05882352941176
4760_terrestrial,34,10,23,16,44,67.64705882352942,47.05882352941176
4761_terrestrial,35,10,23,17,45,65.71428571428571,48.57142857142857
4762_terrestrial,35,10,23,17,45,65.71428571428571,48.57142857142857
4763_terrestrial,34,12,22,17,46,64.70588235294117,50
4764_terrestrial,36,11,24,16,47,66.66666666666666,44.44444444444444
4765_terrestrial,36,13,24,16,49,66.66666666666666,44.44444444444444
4766_terrestrial,36,13,24,16,49,66.66666666666666,44.44444444444444
4767_terrestrial,37,13,24,17,50,64.86486486486487,45.94594594594595
4768_terrestrial,37,13,24,17,50,64.86486486486487,45.94594594594595
4769_terrestrial,39,11,26,18,50,66.66666666666666,46.15384615384615
4770_terrestrial,44,12,31,18,56,70.45454545454545,40.909090909090914
4771_terrestrial,53,12,34,17,65,64.15094339622641,32.075471698113205
4772_terrestrial,44,10,27,16,54,61.36363636363637,36.36363636363637
4773_terrestrial,43,10,26,16,53,60.46511627906976,37.2093023255814
4774_terrestrial,43,10,26,16,53,60.46511627906976,37.2093023255814
4775_terrestrial,43,10,26,16,53,60.46511627906976,37.2093023255814
4776_terrestrial,43,10,26,16,53,60.46511627906976,37.2093023255814
4777_terrestrial,43,10,26,16,53,60.46511627906976,37.2093023255814
4778_terrestrial,44,10,26,17,54,59.09090909090909,38.63636363636363
4779_terrestrial,47,10,29,17,57,61.702127659574465,36.17021276595745
4780_terrestrial,51,14,33,18,65,64.70588235294117,35.294117647058826
4781_terrestrial,52,16,34,18,68,65.38461538461539,34.61538461538461
4782_terrestrial,52,16,34,18,68,65.38461538461539,34.61538461538461
4783_terrestrial,36,4,19,16,40,52.77777777777778,44.44444444444444
4789_terrestrial,35,9,22,15,44,62.857142857142854,42.857142857142854
4790_terrestrial,49,20,34,18,69,69.38775510204081,36.734693877551024
4791_terrestrial,54,20,38,19,74,70.37037037037037,35.18518518518518
4792_terrestrial,55,20,40,19,75,72.72727272727273,34.54545454545455
4793_terrestrial,55,20,40,19,75,72.72727272727273,34.54545454545455
4794_terrestrial,53,20,38,20,73,71.69811320754717,37.735849056603776
4795_terrestrial,53,20,38,20,73,71.69811320754717,37.735849056603776
4796_terrestrial,51,20,36,19,71,70.58823529411765,37.254901960784316
4797_terrestrial,49,20,34,19,69,69.38775510204081,38.775510204081634
4798_terrestrial,48,22,34,18,70,70.83333333333334,37.5
4799_terrestrial,46,21,32,18,67,69.56521739130434,39.130434782608695
4800_terrestrial,47,21,34,20,68,72.3404255319149,42.5531914893617
4801_terrestrial,30,6,19,17,36,63.33333333333333,56.666666666666664
4802_terrestrial,27,6,16,16,33,59.25925925925925,59.25925925925925
4803_terrestrial,27,6,16,16,33,59.25925925925925,59.25925925925925
4804_terrestrial,21,5,11,14,26,52.38095238095239,66.66666666666666
4805_terrestrial,16,5,9,11,21,56.25,68.75
4806_terrestrial,13,5,8,9,18,61.53846153846154,69.23076923076923
4807_terrestrial,9,5,5,5,14,55.55555555555556,55.55555555555556
4808_terrestrial,7,4,3,4,11,42.857142857142854,57.14285714285714
4809_terrestrial,4,3,1,1,7,25,25
4810_terrestrial,4,3,1,1,7,25,25
4811_terrestrial,4,3,1,1,7,25,25
4812_terrestrial,4,3,1,1,7,25,25
4813_terrestrial,3,3,1,1,6,33.33333333333333,33.33333333333333
4814_terrestrial,3,3,1,1,6,33.33333333333333,33.33333333333333
4815_terrestrial,3,3,1,1,6,33.33333333333333,33.33333333333333
4816_terrestrial,3,3,1,1,6,33.33333333333333,33.33333333333333
4821_terrestrial,3,3,1,1,6,33.33333333333333,33.33333333333333
4822_terrestrial,3,3,1,1,6,33.33333333333333,33.33333333333333
4823_terrestrial,3,3,1,1,6,33.33333333333333,33.33333333333333
4824_terrestrial,3,3,1,1,6,33.33333333333333,33.33333333333333
4825_terrestrial,3,3,1,1,6,33.33333333333333,33.33333333333333
4826_terrestrial,3,3,1,1,6,33.33333333333333,33.33333333333333
4827_terrestrial,3,3,1,1,6,33.33333333333333,33.33333333333333
4828_terrestrial,3,3,1,1,6,33.33333333333333,33.33333333333333
4829_terrestrial,3,3,1,1,6,33.33333333333333,33.33333333333333
4830_terrestrial,3,3,1,1,6,33.33333333333333,33.33333333333333
4831_terrestrial,4,3,2,2,7,50,50
4832_terrestrial,5,3,3,2,8,60,40
4833_terrestrial,9,3,5,2,12,55.55555555555556,22.22222222222222
4834_terrestrial,13,5,8,3,18,61.53846153846154,23.076923076923077
4835_terrestrial,19,5,12,6,24,63.1578947368421,31.57894736842105
4836_terrestrial,20,5,13,6,25,65,30
4837_terrestrial,21,5,14,7,26,66.66666666666666,33.33333333333333
4838_terrestrial,40,12,31,11,52,77.5,27.500000000000004
4839_terrestrial,41,12,32,11,53,78.04878048780488,26.82926829268293
4840_terrestrial,42,12,33,11,54,78.57142857142857,26.190476190476193
4841_terrestrial,42,12,33,11,54,78.57142857142857,26.190476190476193
4842_terrestrial,44,12,35,11,56,79.54545454545455,25
4876_terrestrial,47,22,36,15,69,76.59574468085107,31.914893617021278
4877_terrestrial,46,16,35,15,62,76.08695652173914,32.608695652173914
4878_terrestrial,44,14,35,13,58,79.54545454545455,29.545454545454547
4921_terrestrial,33,18,24,12,51,72.72727272727273,36.36363636363637
4922_terrestrial,32,18,23,11,50,71.875,34.375
4923_terrestrial,33,19,24,12,52,72.72727272727273,36.36363636363637
4924_terrestrial,32,19,24,12,51,75,37.5
4925_terrestrial,31,19,23,11,50,74.19354838709677,35.483870967741936
4926_terrestrial,32,19,23,12,51,71.875,37.5
4927_terrestrial,34,19,25,12,53,73.52941176470588,35.294117647058826
4928_terrestrial,33,19,24,12,52,72.72727272727273,36.36363636363637
4929_terrestrial,33,20,25,11,53,75.75757575757575,33.33333333333333
4953_terrestrial,51,23,34,23,74,66.66666666666666,45.09803921568628
4954_terrestrial,51,24,34,23,75,66.66666666666666,45.09803921568628
4955_terrestrial,51,24,34,23,75,66.66666666666666,45.09803921568628
4956_terrestrial,50,24,33,22,74,66,44
4957_terrestrial,50,24,33,22,74,66,44
4958_terrestrial,50,24,33,22,74,66,44
4959_terrestrial,50,24,33,22,74,66,44
4960_terrestrial,51,24,34,23,75,66.66666666666666,45.09803921568628
4961_terrestrial,51,24,34,23,75,66.66666666666666,45.09803921568628
4962_terrestrial,51,24,34,23,75,66.66666666666666,45.09803921568628
4963_terrestrial,45,18,29,22,63,64.44444444444444,48.888888888888886
4964_terrestrial,43,19,27,20,62,62.7906976744186,46.51162790697674
4965_terrestrial,43,19,28,19,62,65.11627906976744,44.18604651162791
4966_terrestrial,49,25,33,21,74,67.3469387755102,42.857142857142854
4967_terrestrial,51,24,35,23,75,68.62745098039215,45.09803921568628
4968_terrestrial,52,24,35,24,76,67.3076923076923,46.15384615384615
4969_terrestrial,52,24,35,24,76,67.3076923076923,46.15384615384615
4970_terrestrial,52,24,35,24,76,67.3076923076923,46.15384615384615
4971_terrestrial,52,24,35,24,76,67.3076923076923,46.15384615384615
4972_terrestrial,52,24,35,24,76,67.3076923076923,46.15384615384615
4973_terrestrial,52,24,35,24,76,67.3076923076923,46.15384615384615
4974_terrestrial,52,24,35,24,76,67.3076923076923,46.15384615384615
4998_terrestrial,39,14,30,21,53,76.92307692307693,53.84615384615385
4999_terrestrial,39,14,30,21,53,76.92307692307693,53.84615384615385
5000_terrestrial,37,14,28,20,51,75.67567567567568,54.054054054054056
5002_terrestrial,37,13,28,20,50,75.67567567567568,54.054054054054056
5003_terrestrial,36,13,27,19,49,75,52.77777777777778
5009_terrestrial,17,9,13,7,26,76.47058823529412,41.17647058823529
5010_terrestrial,15,9,12,5,24,80,33.33333333333333
5013_terrestrial,14,7,11,4,21,78.57142857142857,28.57142857142857
5098_terrestrial,29,11,18,12,40,62.06896551724138,41.37931034482759
5099_terrestrial,30,11,19,12,41,63.33333333333333,40
5100_terrestrial,30,11,19,12,41,63.33333333333333,40
5101_terrestrial,33,11,21,13,44,63.63636363636363,39.39393939393939
5102_terrestrial,25,9,16,11,34,64,44
5103_terrestrial,39,12,23,17,51,58.97435897435898,43.58974358974359
5104_terrestrial,36,12,21,16,48,58.333333333333336,44.44444444444444
5105_terrestrial,39,12,24,17,51,61.53846153846154,43.58974358974359
5106_terrestrial,38,12,23,17,50,60.526315789473685,44.73684210526316
5107_terrestrial,40,12,24,17,52,60,42.5
5108_terrestrial,42,13,26,18,55,61.904761904761905,42.857142857142854
5109_terrestrial,42,13,26,18,55,61.904761904761905,42.857142857142854
5110_terrestrial,44,13,27,18,57,61.36363636363637,40.909090909090914
5111_terrestrial,43,11,25,19,54,58.139534883720934,44.18604651162791
5112_terrestrial,43,11,25,19,54,58.139534883720934,44.18604651162791
5113_terrestrial,43,11,25,19,54,58.139534883720934,44.18604651162791
5114_terrestrial,43,11,25,19,54,58.139534883720934,44.18604651162791
5115_terrestrial,43,11,25,19,54,58.139534883720934,44.18604651162791
5116_terrestrial,29,9,21,16,38,72.41379310344827,55.172413793103445
5117_terrestrial,29,10,21,16,39,72.41379310344827,55.172413793103445
5118_terrestrial,37,10,25,17,47,67.56756756756756,45.94594594594595
5119_terrestrial,35,10,23,17,45,65.71428571428571,48.57142857142857
5120_terrestrial,37,10,25,17,47,67.56756756756756,45.94594594594595
5121_terrestrial,39,10,27,18,49,69.23076923076923,46.15384615384615
5122_terrestrial,38,14,25,19,52,65.78947368421053,50
5123_terrestrial,41,14,28,20,55,68.29268292682927,48.78048780487805
5124_terrestrial,37,13,25,19,50,67.56756756756756,51.35135135135135
5125_terrestrial,36,13,24,17,49,66.66666666666666,47.22222222222222
5126_terrestrial,38,13,26,17,51,68.42105263157895,44.73684210526316
5127_terrestrial,36,13,23,18,49,63.888888888888886,50
5128_terrestrial,37,13,24,17,50,64.86486486486487,45.94594594594595
5129_terrestrial,39,13,25,18,52,64.1025641025641,46.15384615384615
5130_terrestrial,41,11,28,18,52,68.29268292682927,43.90243902439025
5131_terrestrial,41,11,28,18,52,68.29268292682927,43.90243902439025
5132_terrestrial,41,11,27,19,52,65.85365853658537,46.34146341463415
5133_terrestrial,40,12,26,18,52,65,45
5134_terrestrial,43,12,28,20,55,65.11627906976744,46.51162790697674
5135_terrestrial,43,12,28,20,55,65.11627906976744,46.51162790697674
5136_terrestrial,42,12,27,21,54,64.28571428571429,50
5137_terrestrial,44,11,29,21,55,65.9090909090909,47.72727272727273
5138_terrestrial,44,11,29,22,55,65.9090909090909,50
5139_terrestrial,49,15,33,21,64,67.3469387755102,42.857142857142854
5140_terrestrial,51,17,35,21,68,68.62745098039215,41.17647058823529
5141_terrestrial,54,18,36,24,72,66.66666666666666,44.44444444444444
5153_terrestrial,51,20,36,18,71,70.58823529411765,35.294117647058826
5154_terrestrial,36,9,22,16,45,61.111111111111114,44.44444444444444
5160_terrestrial,45,21,32,19,66,71.11111111111111,42.22222222222222
5161_terrestrial,46,21,33,20,67,71.73913043478261,43.47826086956522
5162_terrestrial,49,22,34,22,71,69.38775510204081,44.89795918367347
5163_terrestrial,50,22,34,23,72,68,46
5164_terrestrial,29,7,16,18,36,55.172413793103445,62.06896551724138
5165_terrestrial,24,6,12,14,30,50,58.333333333333336
5166_terrestrial,21,5,10,12,26,47.61904761904761,57.14285714285714
5167_terrestrial,18,5,9,9,23,50,50
5168_terrestrial,10,4,4,6,14,40,60
5169_terrestrial,6,4,2,2,10,33.33333333333333,33.33333333333333
5170_terrestrial,4,4,1,1,8,25,25
5191_terrestrial,3,3,1,1,6,33.33333333333333,33.33333333333333
5192_terrestrial,8,3,4,1,11,50,12.5
5193_terrestrial,8,3,4,1,11,50,12.5
5194_terrestrial,12,5,8,3,17,66.66666666666666,25
5195_terrestrial,15,5,9,4,20,60,26.666666666666668
5196_terrestrial,19,5,12,5,24,63.1578947368421,26.31578947368421
5197_terrestrial,24,5,17,8,29,70.83333333333334,33.33333333333333
5198_terrestrial,48,14,38,14,62,79.16666666666666,29.166666666666668
5199_terrestrial,48,16,38,14,64,79.16666666666666,29.166666666666668
5200_terrestrial,48,14,38,14,62,79.16666666666666,29.166666666666668
5201_terrestrial,48,14,38,14,62,79.16666666666666,29.166666666666668
5202_terrestrial,39,12,34,14,51,87.17948717948718,35.8974358974359
5203_terrestrial,41,12,36,14,53,87.8048780487805,34.146341463414636
5276_terrestrial,37,18,26,14,55,70.27027027027027,37.83783783783784
5277_terrestrial,38,18,27,15,56,71.05263157894737,39.473684210526315
5278_terrestrial,38,18,28,14,56,73.68421052631578,36.84210526315789
5279_terrestrial,37,18,27,14,55,72.97297297297297,37.83783783783784
5280_terrestrial,36,18,26,13,54,72.22222222222221,36.11111111111111
5281_terrestrial,36,18,25,14,54,69.44444444444444,38.88888888888889
5282_terrestrial,30,16,22,10,46,73.33333333333333,33.33333333333333
5283_terrestrial,30,17,22,10,47,73.33333333333333,33.33333333333333
5284_terrestrial,30,17,22,10,47,73.33333333333333,33.33333333333333
5285_terrestrial,28,17,21,9,45,75,32.142857142857146
5286_terrestrial,15,11,9,6,26,60,40
5287_terrestrial,24,16,17,7,40,70.83333333333334,29.166666666666668
5302_terrestrial,29,9,22,18,38,75.86206896551724,62.06896551724138
5303_terrestrial,29,9,22,18,38,75.86206896551724,62.06896551724138
5307_terrestrial,53,23,34,25,76,64.15094339622641,47.16981132075472
5308_terrestrial,55,23,36,27,78,65.45454545454545,49.09090909090909
5309_terrestrial,54,23,35,26,77,64.81481481481481,48.148148148148145
5310_terrestrial,52,23,33,24,75,63.46153846153846,46.15384615384615
5311_terrestrial,53,23,33,25,76,62.264150943396224,47.16981132075472
5312_terrestrial,52,23,33,24,75,63.46153846153846,46.15384615384615
5313_terrestrial,53,24,34,23,77,64.15094339622641,43.39622641509434
5314_terrestrial,53,25,34,23,78,64.15094339622641,43.39622641509434
5315_terrestrial,53,25,34,23,78,64.15094339622641,43.39622641509434
5316_terrestrial,54,25,34,24,79,62.96296296296296,44.44444444444444
5317_terrestrial,53,24,33,23,77,62.264150943396224,43.39622641509434
5318_terrestrial,55,24,33,25,79,60,45.45454545454545
5319_terrestrial,49,19,28,25,68,57.14285714285714,51.02040816326531
5320_terrestrial,51,20,30,26,71,58.82352941176471,50.98039215686274
5321_terrestrial,53,19,32,28,72,60.37735849056604,52.83018867924528
5322_terrestrial,56,20,34,29,76,60.71428571428571,51.78571428571429
5323_terrestrial,55,20,33,29,75,60,52.72727272727272
5324_terrestrial,56,20,33,30,76,58.92857142857143,53.57142857142857
5325_terrestrial,58,22,35,31,80,60.3448275862069,53.44827586206896
5326_terrestrial,57,21,34,30,78,59.64912280701754,52.63157894736842
5327_terrestrial,60,21,37,32,81,61.66666666666667,53.333333333333336
5328_terrestrial,54,21,34,28,75,62.96296296296296,51.85185185185185
5329_terrestrial,52,21,33,27,73,63.46153846153846,51.92307692307693
5330_terrestrial,52,20,33,27,72,63.46153846153846,51.92307692307693
5331_terrestrial,50,20,33,24,70,66,48
5332_terrestrial,50,21,33,25,71,66,50
5333_terrestrial,56,28,38,27,84,67.85714285714286,48.214285714285715
5334_terrestrial,55,28,37,26,83,67.27272727272727,47.27272727272727
5356_terrestrial,34,9,26,21,43,76.47058823529412,61.76470588235294
5357_terrestrial,39,14,29,22,53,74.35897435897436,56.41025641025641
5358_terrestrial,41,14,31,23,55,75.60975609756098,56.09756097560976
5359_terrestrial,34,8,25,20,42,73.52941176470588,58.82352941176471
5360_terrestrial,38,14,29,20,52,76.31578947368422,52.63157894736842
5361_terrestrial,37,14,28,20,51,75.67567567567568,54.054054054054056
5362_terrestrial,39,13,29,22,52,74.35897435897436,56.41025641025641
5363_terrestrial,41,13,30,24,54,73.17073170731707,58.536585365853654
5364_terrestrial,41,13,30,24,54,73.17073170731707,58.536585365853654
5365_terrestrial,40,13,29,23,53,72.5,57.49999999999999
5366_terrestrial,40,13,29,23,53,72.5,57.49999999999999
5367_terrestrial,38,14,28,21,52,73.68421052631578,55.26315789473685
5368_terrestrial,38,14,28,21,52,73.68421052631578,55.26315789473685
5369_terrestrial,36,14,26,19,50,72.22222222222221,52.77777777777778
5370_terrestrial,35,13,25,19,48,71.42857142857143,54.285714285714285
5371_terrestrial,36,13,26,19,49,72.22222222222221,52.77777777777778
5456_terrestrial,44,18,25,22,62,56.81818181818182,50
5457_terrestrial,45,16,26,22,61,57.77777777777777,48.888888888888886
5458_terrestrial,45,16,26,22,61,57.77777777777777,48.888888888888886
5459_terrestrial,46,16,28,21,62,60.86956521739131,45.65217391304348
5460_terrestrial,47,16,29,22,63,61.702127659574465,46.808510638297875
5461_terrestrial,45,16,27,22,61,60,48.888888888888886
5462_terrestrial,47,16,29,22,63,61.702127659574465,46.808510638297875
5463_terrestrial,45,16,27,22,61,60,48.888888888888886
5464_terrestrial,42,10,24,22,52,57.14285714285714,52.38095238095239
5465_terrestrial,39,12,24,17,51,61.53846153846154,43.58974358974359
5466_terrestrial,43,12,26,18,55,60.46511627906976,41.86046511627907
5467_terrestrial,42,12,25,18,54,59.523809523809526,42.857142857142854
5468_terrestrial,42,13,25,18,55,59.523809523809526,42.857142857142854
5469_terrestrial,42,13,25,18,55,59.523809523809526,42.857142857142854
5470_terrestrial,42,11,25,18,53,59.523809523809526,42.857142857142854
5471_terrestrial,43,11,25,19,54,58.139534883720934,44.18604651162791
5472_terrestrial,43,11,25,19,54,58.139534883720934,44.18604651162791
5473_terrestrial,43,11,25,19,54,58.139534883720934,44.18604651162791
5474_terrestrial,43,11,25,19,54,58.139534883720934,44.18604651162791
5481_terrestrial,32,5,20,17,37,62.5,53.125
5482_terrestrial,31,16,21,17,47,67.74193548387096,54.83870967741935
5483_terrestrial,32,16,22,17,48,68.75,53.125
5484_terrestrial,36,13,24,18,49,66.66666666666666,50
5485_terrestrial,48,15,34,23,63,70.83333333333334,47.91666666666667
5486_terrestrial,48,15,33,24,63,68.75,50
5487_terrestrial,48,15,33,24,63,68.75,50
5488_terrestrial,49,15,34,24,64,69.38775510204081,48.97959183673469
5489_terrestrial,51,15,35,26,66,68.62745098039215,50.98039215686274
5490_terrestrial,41,13,27,18,54,65.85365853658537,43.90243902439025
5491_terrestrial,41,13,27,18,54,65.85365853658537,43.90243902439025
5492_terrestrial,42,13,28,19,55,66.66666666666666,45.23809523809524
5493_terrestrial,43,13,29,20,56,67.44186046511628,46.51162790697674
5494_terrestrial,44,15,30,21,59,68.18181818181817,47.72727272727273
5495_terrestrial,45,15,30,22,60,66.66666666666666,48.888888888888886
5496_terrestrial,46,15,31,22,61,67.3913043478261,47.82608695652174
5497_terrestrial,48,15,33,21,63,68.75,43.75
5498_terrestrial,47,17,31,21,64,65.95744680851064,44.680851063829785
5499_terrestrial,52,17,35,22,69,67.3076923076923,42.30769230769231
5500_terrestrial,52,17,35,22,69,67.3076923076923,42.30769230769231
5501_terrestrial,50,17,33,21,67,66,42
5523_terrestrial,50,23,34,23,73,68,46
5524_terrestrial,51,21,35,23,72,68.62745098039215,45.09803921568628
5525_terrestrial,30,6,18,17,36,60,56.666666666666664
5526_terrestrial,26,6,14,15,32,53.84615384615385,57.692307692307686
5527_terrestrial,23,6,11,14,29,47.82608695652174,60.86956521739131
5528_terrestrial,21,5,10,12,26,47.61904761904761,57.14285714285714
5529_terrestrial,17,4,9,8,21,52.94117647058824,47.05882352941176
5530_terrestrial,7,4,3,3,11,42.857142857142854,42.857142857142854
5531_terrestrial,4,4,1,1,8,25,25
5550_terrestrial,3,3,1,1,6,33.33333333333333,33.33333333333333
5551_terrestrial,7,3,3,1,10,42.857142857142854,14.285714285714285
5552_terrestrial,12,3,7,2,15,58.333333333333336,16.666666666666664
5553_terrestrial,16,5,11,3,21,68.75,18.75
5554_terrestrial,17,5,11,4,22,64.70588235294117,23.52941176470588
5555_terrestrial,22,5,16,8,27,72.72727272727273,36.36363636363637
5556_terrestrial,23,5,16,8,28,69.56521739130434,34.78260869565217
5557_terrestrial,23,5,16,8,28,69.56521739130434,34.78260869565217
5558_terrestrial,47,15,37,15,62,78.72340425531915,31.914893617021278
5559_terrestrial,47,15,37,15,62,78.72340425531915,31.914893617021278
5560_terrestrial,47,17,37,15,64,78.72340425531915,31.914893617021278
5561_terrestrial,48,16,38,14,64,79.16666666666666,29.166666666666668
5563_terrestrial,40,12,35,13,52,87.5,32.5
5599_terrestrial,45,17,37,15,62,82.22222222222221,33.33333333333333
5600_terrestrial,45,17,37,15,62,82.22222222222221,33.33333333333333
5635_terrestrial,40,20,27,17,60,67.5,42.5
5636_terrestrial,42,20,28,18,62,66.66666666666666,42.857142857142854
5637_terrestrial,41,20,27,18,61,65.85365853658537,43.90243902439025
5638_terrestrial,35,18,24,15,53,68.57142857142857,42.857142857142854
5639_terrestrial,34,19,23,14,53,67.64705882352942,41.17647058823529
5640_terrestrial,33,17,22,13,50,66.66666666666666,39.39393939393939
5641_terrestrial,30,17,21,10,47,70,33.33333333333333
5663_terrestrial,43,16,31,27,59,72.09302325581395,62.7906976744186
5664_terrestrial,43,16,31,27,59,72.09302325581395,62.7906976744186
5665_terrestrial,42,17,32,26,59,76.19047619047619,61.904761904761905
5666_terrestrial,53,25,34,25,78,64.15094339622641,47.16981132075472
5667_terrestrial,59,26,37,30,85,62.71186440677966,50.847457627118644
5668_terrestrial,61,29,38,32,90,62.295081967213115,52.459016393442624
5669_terrestrial,52,21,32,27,73,61.53846153846154,51.92307692307693
5670_terrestrial,53,22,32,27,75,60.37735849056604,50.943396226415096
5671_terrestrial,53,21,32,28,74,60.37735849056604,52.83018867924528
5672_terrestrial,55,21,34,28,76,61.81818181818181,50.90909090909091
5673_terrestrial,58,19,35,30,77,60.3448275862069,51.724137931034484
5674_terrestrial,55,18,33,29,73,60,52.72727272727272
5675_terrestrial,58,18,36,32,76,62.06896551724138,55.172413793103445
5676_terrestrial,59,19,37,33,78,62.71186440677966,55.932203389830505
5677_terrestrial,61,19,37,35,80,60.65573770491803,57.377049180327866
5678_terrestrial,61,22,37,35,83,60.65573770491803,57.377049180327866
5679_terrestrial,64,22,39,37,86,60.9375,57.8125
5680_terrestrial,63,21,38,36,84,60.317460317460316,57.14285714285714
5681_terrestrial,61,21,36,36,82,59.01639344262295,59.01639344262295
5682_terrestrial,62,22,37,36,84,59.67741935483871,58.06451612903226
5683_terrestrial,62,22,37,36,84,59.67741935483871,58.06451612903226
5684_terrestrial,60,22,35,35,82,58.333333333333336,58.333333333333336
5685_terrestrial,62,22,37,35,84,59.67741935483871,56.451612903225815
5686_terrestrial,62,24,38,35,86,61.29032258064516,56.451612903225815
5687_terrestrial,63,25,40,36,88,63.49206349206349,57.14285714285714
5688_terrestrial,63,27,40,36,90,63.49206349206349,57.14285714285714
5689_terrestrial,70,34,46,37,104,65.71428571428571,52.85714285714286
5690_terrestrial,68,33,46,37,101,67.64705882352942,54.41176470588235
5691_terrestrial,77,33,49,40,110,63.63636363636363,51.94805194805194
5692_terrestrial,78,32,51,41,110,65.38461538461539,52.56410256410257
5693_terrestrial,70,27,48,39,97,68.57142857142857,55.714285714285715
5694_terrestrial,48,12,35,33,60,72.91666666666666,68.75
5716_terrestrial,29,9,21,17,38,72.41379310344827,58.620689655172406
5717_terrestrial,28,9,21,16,37,75,57.14285714285714
5718_terrestrial,40,14,30,23,54,75,57.49999999999999
5719_terrestrial,41,14,31,23,55,75.60975609756098,56.09756097560976
5720_terrestrial,41,14,31,23,55,75.60975609756098,56.09756097560976
5721_terrestrial,47,14,34,29,61,72.3404255319149,61.702127659574465
5722_terrestrial,47,14,34,29,61,72.3404255319149,61.702127659574465
5723_terrestrial,40,13,30,23,53,75,57.49999999999999
5724_terrestrial,32,7,23,20,39,71.875,62.5
5728_terrestrial,37,14,27,20,51,72.97297297297297,54.054054054054056
5729_terrestrial,30,8,21,18,38,70,60
5730_terrestrial,29,7,20,18,36,68.96551724137932,62.06896551724138
5731_terrestrial,30,7,21,18,37,70,60
5816_terrestrial,47,18,26,24,65,55.319148936170215,51.06382978723404
5817_terrestrial,46,18,26,23,64,56.52173913043478,50
5818_terrestrial,43,10,24,22,53,55.81395348837209,51.162790697674424
5819_terrestrial,45,10,26,22,55,57.77777777777777,48.888888888888886
5820_terrestrial,46,10,27,23,56,58.69565217391305,50
5821_terrestrial,49,16,30,23,65,61.224489795918366,46.93877551020408
5822_terrestrial,48,16,28,24,64,58.333333333333336,50
5823_terrestrial,47,16,27,24,63,57.446808510638306,51.06382978723404
5824_terrestrial,55,16,32,25,71,58.18181818181818,45.45454545454545
5825_terrestrial,55,16,32,25,71,58.18181818181818,45.45454545454545
5826_terrestrial,44,14,27,22,58,61.36363636363637,50
5830_terrestrial,42,13,26,20,55,61.904761904761905,47.61904761904761
5832_terrestrial,42,12,26,20,54,61.904761904761905,47.61904761904761
5833_terrestrial,42,12,26,20,54,61.904761904761905,47.61904761904761
5834_terrestrial,46,12,30,20,58,65.21739130434783,43.47826086956522
5835_terrestrial,46,12,30,20,58,65.21739130434783,43.47826086956522
5836_terrestrial,34,10,23,17,44,67.64705882352942,50
5838_terrestrial,41,14,27,20,55,65.85365853658537,48.78048780487805
5839_terrestrial,42,15,27,21,57,64.28571428571429,50
5840_terrestrial,42,14,27,21,56,64.28571428571429,50
5841_terrestrial,45,16,29,22,61,64.44444444444444,48.888888888888886
5842_terrestrial,45,18,29,22,63,64.44444444444444,48.888888888888886
5843_terrestrial,46,18,30,23,64,65.21739130434783,50
5844_terrestrial,44,17,28,23,61,63.63636363636363,52.27272727272727
5845_terrestrial,45,14,30,23,59,66.66666666666666,51.11111111111111
5846_terrestrial,45,14,30,23,59,66.66666666666666,51.11111111111111
5847_terrestrial,38,7,25,21,45,65.78947368421053,55.26315789473685
5848_terrestrial,46,14,31,23,60,67.3913043478261,50
5849_terrestrial,48,14,33,24,62,68.75,50
5850_terrestrial,49,14,35,24,63,71.42857142857143,48.97959183673469
5851_terrestrial,49,18,30,23,67,61.224489795918366,46.93877551020408
5852_terrestrial,48,18,29,23,66,60.416666666666664,47.91666666666667
5853_terrestrial,48,20,29,23,68,60.416666666666664,47.91666666666667
5854_terrestrial,50,22,31,23,72,62,46
5855_terrestrial,51,22,32,23,73,62.745098039215684,45.09803921568628
5856_terrestrial,51,22,32,23,73,62.745098039215684,45.09803921568628
5857_terrestrial,51,22,30,22,73,58.82352941176471,43.13725490196079
5858_terrestrial,53,23,33,22,76,62.264150943396224,41.509433962264154
5859_terrestrial,55,22,34,22,77,61.81818181818181,40
5860_terrestrial,68,24,41,28,92,60.29411764705882,41.17647058823529
5861_terrestrial,52,18,36,24,70,69.23076923076923,46.15384615384615
5862_terrestrial,54,18,38,24,72,70.37037037037037,44.44444444444444
5863_terrestrial,52,18,37,24,70,71.15384615384616,46.15384615384615
5864_terrestrial,54,18,39,24,72,72.22222222222221,44.44444444444444
5884_terrestrial,56,21,39,25,77,69.64285714285714,44.642857142857146
5885_terrestrial,60,21,41,28,81,68.33333333333333,46.666666666666664
5886_terrestrial,58,21,40,26,79,68.96551724137932,44.827586206896555
5887_terrestrial,29,7,16,15,36,55.172413793103445,51.724137931034484
5888_terrestrial,27,6,15,13,33,55.55555555555556,48.148148148148145
5889_terrestrial,26,5,14,14,31,53.84615384615385,53.84615384615385
5890_terrestrial,18,5,9,9,23,50,50
5891_terrestrial,6,4,2,3,10,33.33333333333333,50
5907_terrestrial,3,3,0,1,6,0,33.33333333333333
5908_terrestrial,3,3,0,1,6,0,33.33333333333333
5909_terrestrial,4,3,1,2,7,25,50
5910_terrestrial,7,3,3,1,10,42.857142857142854,14.285714285714285
5911_terrestrial,12,5,7,2,17,58.333333333333336,16.666666666666664
5912_terrestrial,17,5,12,4,22,70.58823529411765,23.52941176470588
5913_terrestrial,47,19,38,12,66,80.85106382978722,25.53191489361702
5914_terrestrial,48,19,39,13,67,81.25,27.083333333333332
5915_terrestrial,51,19,42,15,70,82.35294117647058,29.411764705882355
5916_terrestrial,50,17,40,14,67,80,28.000000000000004
5917_terrestrial,50,17,40,14,67,80,28.000000000000004
5918_terrestrial,50,17,40,14,67,80,28.000000000000004
5919_terrestrial,49,17,39,14,66,79.59183673469387,28.57142857142857
5920_terrestrial,48,17,38,14,65,79.16666666666666,29.166666666666668
5994_terrestrial,58,26,43,30,84,74.13793103448276,51.724137931034484
5995_terrestrial,57,24,42,30,81,73.68421052631578,52.63157894736842
5996_terrestrial,56,24,40,28,80,71.42857142857143,50
5997_terrestrial,48,22,36,23,70,75,47.91666666666667
5998_terrestrial,35,18,24,15,53,68.57142857142857,42.857142857142854
6010_terrestrial,45,18,34,29,63,75.55555555555556,64.44444444444444
6011_terrestrial,50,18,39,33,68,78,66
6012_terrestrial,49,18,38,32,67,77.55102040816327,65.3061224489796
6015_terrestrial,52,19,40,34,71,76.92307692307693,65.38461538461539
6016_terrestrial,45,19,35,28,64,77.77777777777779,62.22222222222222
6017_terrestrial,40,10,30,28,50,75,70
6019_terrestrial,44,13,32,28,57,72.72727272727273,63.63636363636363
6020_terrestrial,45,13,33,29,58,73.33333333333333,64.44444444444444
6021_terrestrial,65,24,40,34,89,61.53846153846154,52.307692307692314
6022_terrestrial,65,24,40,34,89,61.53846153846154,52.307692307692314
6023_terrestrial,64,25,39,33,89,60.9375,51.5625
6024_terrestrial,63,25,39,32,88,61.904761904761905,50.79365079365079
6025_terrestrial,62,25,38,32,87,61.29032258064516,51.61290322580645
6026_terrestrial,62,27,38,33,89,61.29032258064516,53.2258064516129
6027_terrestrial,62,29,38,33,91,61.29032258064516,53.2258064516129
6028_terrestrial,63,28,39,33,91,61.904761904761905,52.38095238095239
6029_terrestrial,57,21,34,32,78,59.64912280701754,56.14035087719298
6030_terrestrial,59,23,35,32,82,59.32203389830508,54.23728813559322
6031_terrestrial,60,25,36,33,85,60,55.00000000000001
6032_terrestrial,60,24,36,34,84,60,56.666666666666664
6033_terrestrial,63,24,38,35,87,60.317460317460316,55.55555555555556
6034_terrestrial,64,24,39,36,88,60.9375,56.25
6035_terrestrial,65,24,39,37,89,60,56.92307692307692
6036_terrestrial,66,24,39,38,90,59.09090909090909,57.57575757575758
6037_terrestrial,67,24,39,39,91,58.2089552238806,58.2089552238806
6038_terrestrial,66,25,38,38,91,57.57575757575758,57.57575757575758
6039_terrestrial,65,25,37,38,90,56.92307692307692,58.46153846153847
6040_terrestrial,64,25,36,37,89,56.25,57.8125
6041_terrestrial,67,25,38,38,92,56.71641791044776,56.71641791044776
6042_terrestrial,72,26,43,40,98,59.72222222222222,55.55555555555556
6043_terrestrial,72,26,43,40,98,59.72222222222222,55.55555555555556
6044_terrestrial,70,26,42,39,96,60,55.714285714285715
6045_terrestrial,76,30,48,43,106,63.1578947368421,56.57894736842105
6046_terrestrial,74,30,46,43,104,62.16216216216216,58.108108108108105
6047_terrestrial,82,36,51,45,118,62.19512195121951,54.87804878048781
6048_terrestrial,82,34,51,45,116,62.19512195121951,54.87804878048781
6049_terrestrial,81,34,51,44,115,62.96296296296296,54.32098765432099
6050_terrestrial,77,34,48,41,111,62.33766233766234,53.246753246753244
6051_terrestrial,79,34,51,40,113,64.55696202531645,50.63291139240506
6052_terrestrial,77,36,49,39,113,63.63636363636363,50.649350649350644
6053_terrestrial,78,35,50,39,113,64.1025641025641,50
6054_terrestrial,78,35,50,39,113,64.1025641025641,50
6055_terrestrial,77,34,50,38,111,64.93506493506493,49.35064935064935
6056_terrestrial,70,34,45,34,104,64.28571428571429,48.57142857142857
6057_terrestrial,70,34,45,34,104,64.28571428571429,48.57142857142857
6058_terrestrial,70,34,45,34,104,64.28571428571429,48.57142857142857
6059_terrestrial,72,32,46,36,104,63.888888888888886,50
6060_terrestrial,74,32,48,37,106,64.86486486486487,50
6061_terrestrial,59,20,45,36,79,76.27118644067797,61.016949152542374
6063_terrestrial,76,30,50,38,106,65.78947368421053,50
6064_terrestrial,75,35,49,37,110,65.33333333333333,49.333333333333336
6065_terrestrial,75,35,49,37,110,65.33333333333333,49.333333333333336
6066_terrestrial,76,35,50,38,111,65.78947368421053,50
6067_terrestrial,76,37,50,39,113,65.78947368421053,51.31578947368421
6068_terrestrial,77,38,51,40,115,66.23376623376623,51.94805194805194
6069_terrestrial,76,38,50,39,114,65.78947368421053,51.31578947368421
6070_terrestrial,76,35,50,39,111,65.78947368421053,51.31578947368421
6076_terrestrial,29,9,21,17,38,72.41379310344827,58.620689655172406
6077_terrestrial,28,9,21,16,37,75,57.14285714285714
6080_terrestrial,43,16,30,25,59,69.76744186046511,58.139534883720934
6081_terrestrial,45,16,32,26,61,71.11111111111111,57.77777777777777
6082_terrestrial,45,16,32,26,61,71.11111111111111,57.77777777777777
6083_terrestrial,43,15,30,25,58,69.76744186046511,58.139534883720934
6084_terrestrial,37,9,25,23,46,67.56756756756756,62.16216216216216
6175_terrestrial,51,18,29,28,69,56.86274509803921,54.90196078431373
6176_terrestrial,52,18,30,29,70,57.692307692307686,55.769230769230774
6177_terrestrial,49,10,28,28,59,57.14285714285714,57.14285714285714
6178_terrestrial,46,10,27,25,56,58.69565217391305,54.347826086956516
6179_terrestrial,47,10,28,26,57,59.57446808510638,55.319148936170215
6180_terrestrial,51,16,30,27,67,58.82352941176471,52.94117647058824
6181_terrestrial,50,16,29,26,66,57.99999999999999,52
6182_terrestrial,56,16,32,26,72,57.14285714285714,46.42857142857143
6183_terrestrial,56,16,32,26,72,57.14285714285714,46.42857142857143
6184_terrestrial,45,16,27,23,61,60,51.11111111111111
6185_terrestrial,42,10,24,23,52,57.14285714285714,54.761904761904766
6186_terrestrial,44,14,27,22,58,61.36363636363637,50
6187_terrestrial,44,14,27,22,58,61.36363636363637,50
6188_terrestrial,43,14,27,21,57,62.7906976744186,48.837209302325576
6189_terrestrial,45,14,29,21,59,64.44444444444444,46.666666666666664
6190_terrestrial,42,14,26,20,56,61.904761904761905,47.61904761904761
6191_terrestrial,42,13,26,20,55,61.904761904761905,47.61904761904761
6192_terrestrial,42,13,26,20,55,61.904761904761905,47.61904761904761
6193_terrestrial,42,13,26,20,55,61.904761904761905,47.61904761904761
6194_terrestrial,39,9,23,20,48,58.97435897435898,51.28205128205128
6195_terrestrial,46,13,30,20,59,65.21739130434783,43.47826086956522
6196_terrestrial,42,12,26,20,54,61.904761904761905,47.61904761904761
6198_terrestrial,41,14,27,20,55,65.85365853658537,48.78048780487805
6199_terrestrial,41,14,27,20,55,65.85365853658537,48.78048780487805
6200_terrestrial,42,14,27,21,56,64.28571428571429,50
6201_terrestrial,43,14,27,22,57,62.7906976744186,51.162790697674424
6202_terrestrial,44,17,28,23,61,63.63636363636363,52.27272727272727
6203_terrestrial,46,18,30,23,64,65.21739130434783,50
6204_terrestrial,45,17,30,22,62,66.66666666666666,48.888888888888886
6205_terrestrial,45,16,31,23,61,68.88888888888889,51.11111111111111
6206_terrestrial,48,14,34,24,62,70.83333333333334,50
6207_terrestrial,46,12,32,22,58,69.56521739130434,47.82608695652174
6208_terrestrial,44,12,30,22,56,68.18181818181817,50
6209_terrestrial,40,7,27,21,47,67.5,52.5
6211_terrestrial,50,18,31,24,68,62,48
6212_terrestrial,40,11,23,21,51,57.49999999999999,52.5
6213_terrestrial,40,11,23,21,51,57.49999999999999,52.5
6214_terrestrial,50,22,31,24,72,62,48
6215_terrestrial,50,21,31,22,71,62,44
6216_terrestrial,50,21,30,22,71,60,44
6217_terrestrial,40,10,21,20,50,52.5,50
6218_terrestrial,40,10,20,20,50,50,50
6219_terrestrial,56,22,34,23,78,60.71428571428571,41.07142857142857
6220_terrestrial,63,24,37,25,87,58.730158730158735,39.682539682539684
6221_terrestrial,61,24,36,23,85,59.01639344262295,37.704918032786885
6222_terrestrial,65,24,39,25,89,60,38.46153846153847
6223_terrestrial,63,24,39,23,87,61.904761904761905,36.507936507936506
6224_terrestrial,65,24,40,25,89,61.53846153846154,38.46153846153847
6225_terrestrial,54,21,34,19,75,62.96296296296296,35.18518518518518
6226_terrestrial,50,21,30,18,71,60,36
6244_terrestrial,51,21,38,26,72,74.50980392156863,50.98039215686274
6245_terrestrial,63,21,44,30,84,69.84126984126983,47.61904761904761
6246_terrestrial,63,21,44,30,84,69.84126984126983,47.61904761904761
6247_terrestrial,39,7,25,21,46,64.1025641025641,53.84615384615385
6248_terrestrial,59,19,40,27,78,67.79661016949152,45.76271186440678
6249_terrestrial,33,6,20,19,39,60.60606060606061,57.57575757575758
6250_terrestrial,28,6,16,16,34,57.14285714285714,57.14285714285714
6251_terrestrial,13,5,7,7,18,53.84615384615385,53.84615384615385
6252_terrestrial,6,5,1,2,11,16.666666666666664,33.33333333333333
6265_terrestrial,3,3,0,1,6,0,33.33333333333333
6266_terrestrial,3,3,0,1,6,0,33.33333333333333
6267_terrestrial,4,3,0,2,7,0,50
6268_terrestrial,6,3,1,2,9,16.666666666666664,33.33333333333333
6269_terrestrial,6,3,1,2,9,16.666666666666664,33.33333333333333
6270_terrestrial,8,3,3,2,11,37.5,25
6271_terrestrial,16,5,10,5,21,62.5,31.25
6272_terrestrial,59,21,49,13,80,83.05084745762711,22.033898305084744
6273_terrestrial,59,19,48,14,78,81.35593220338984,23.728813559322035
6274_terrestrial,51,17,40,16,68,78.43137254901961,31.372549019607842
6275_terrestrial,54,19,44,16,73,81.48148148148148,29.629629629629626
6276_terrestrial,55,19,45,17,74,81.81818181818183,30.909090909090907
6277_terrestrial,55,21,45,17,76,81.81818181818183,30.909090909090907
6278_terrestrial,57,19,47,17,76,82.45614035087719,29.82456140350877
6352_terrestrial,55,28,42,28,83,76.36363636363637,50.90909090909091
6353_terrestrial,60,26,44,32,86,73.33333333333333,53.333333333333336
6354_terrestrial,61,26,44,33,87,72.1311475409836,54.09836065573771
6355_terrestrial,37,14,26,25,51,70.27027027027027,67.56756756756756
6356_terrestrial,48,22,35,26,70,72.91666666666666,54.166666666666664
6357_terrestrial,44,22,32,22,66,72.72727272727273,50
6369_terrestrial,66,26,44,33,92,66.66666666666666,50
6370_terrestrial,66,26,43,32,92,65.15151515151516,48.484848484848484
6371_terrestrial,66,26,43,34,92,65.15151515151516,51.515151515151516
6372_terrestrial,66,26,43,34,92,65.15151515151516,51.515151515151516
6373_terrestrial,64,28,42,34,92,65.625,53.125
6375_terrestrial,67,27,43,37,94,64.17910447761194,55.223880597014926
6376_terrestrial,66,27,42,36,93,63.63636363636363,54.54545454545454
6377_terrestrial,68,25,44,36,93,64.70588235294117,52.94117647058824
6378_terrestrial,69,25,45,37,94,65.21739130434783,53.62318840579711
6379_terrestrial,69,25,45,37,94,65.21739130434783,53.62318840579711
6380_terrestrial,69,25,45,37,94,65.21739130434783,53.62318840579711
6381_terrestrial,69,26,43,38,95,62.31884057971014,55.072463768115945
6382_terrestrial,64,24,40,33,88,62.5,51.5625
6383_terrestrial,65,27,41,34,92,63.07692307692307,52.307692307692314
6384_terrestrial,58,22,35,32,80,60.3448275862069,55.172413793103445
6385_terrestrial,56,23,33,31,79,58.92857142857143,55.35714285714286
6386_terrestrial,57,24,33,32,81,57.89473684210527,56.14035087719298
6387_terrestrial,58,26,34,33,84,58.620689655172406,56.896551724137936
6388_terrestrial,62,26,36,37,88,58.06451612903226,59.67741935483871
6389_terrestrial,64,26,38,39,90,59.375,60.9375
6390_terrestrial,67,24,40,39,91,59.70149253731343,58.2089552238806
6391_terrestrial,67,24,40,39,91,59.70149253731343,58.2089552238806
6392_terrestrial,66,24,39,39,90,59.09090909090909,59.09090909090909
6393_terrestrial,67,24,38,40,91,56.71641791044776,59.70149253731343
6394_terrestrial,71,24,40,41,95,56.33802816901409,57.74647887323944
6395_terrestrial,71,24,38,43,95,53.52112676056338,60.56338028169014
6396_terrestrial,72,25,37,44,97,51.388888888888886,61.111111111111114
6397_terrestrial,75,27,38,46,102,50.66666666666667,61.33333333333333
6398_terrestrial,78,29,39,47,107,50,60.256410256410255
6399_terrestrial,78,28,41,47,106,52.56410256410257,60.256410256410255
6400_terrestrial,81,26,44,48,107,54.32098765432099,59.25925925925925
6401_terrestrial,83,29,46,48,112,55.42168674698795,57.831325301204814
6402_terrestrial,87,34,46,50,121,52.87356321839081,57.47126436781609
6403_terrestrial,88,34,47,50,122,53.40909090909091,56.81818181818182
6404_terrestrial,88,33,49,50,121,55.68181818181818,56.81818181818182
6405_terrestrial,93,34,53,54,127,56.98924731182796,58.06451612903226
6406_terrestrial,100,41,60,58,141,60,57.99999999999999
6407_terrestrial,94,39,55,53,133,58.51063829787234,56.38297872340425
6408_terrestrial,86,33,49,49,119,56.97674418604651,56.97674418604651
6409_terrestrial,85,33,48,49,118,56.470588235294116,57.647058823529406
6410_terrestrial,83,32,45,49,115,54.21686746987952,59.036144578313255
6411_terrestrial,81,32,44,47,113,54.32098765432099,58.0246913580247
6412_terrestrial,81,33,45,46,114,55.55555555555556,56.79012345679012
6413_terrestrial,81,30,45,46,111,55.55555555555556,56.79012345679012
6414_terrestrial,79,32,48,42,111,60.75949367088608,53.16455696202531
6415_terrestrial,77,32,48,40,109,62.33766233766234,51.94805194805194
6416_terrestrial,72,31,44,37,103,61.111111111111114,51.388888888888886
6417_terrestrial,70,31,42,37,101,60,52.85714285714286
6418_terrestrial,70,32,42,37,102,60,52.85714285714286
6419_terrestrial,75,33,47,39,108,62.66666666666667,52
6420_terrestrial,76,32,48,39,108,63.1578947368421,51.31578947368421
6421_terrestrial,81,38,53,39,119,65.4320987654321,48.148148148148145
6422_terrestrial,81,38,53,39,119,65.4320987654321,48.148148148148145
6423_terrestrial,83,38,55,41,121,66.26506024096386,49.39759036144578
6424_terrestrial,81,38,53,40,119,65.4320987654321,49.382716049382715
6425_terrestrial,75,33,48,38,108,64,50.66666666666667
6426_terrestrial,74,33,47,38,107,63.51351351351351,51.35135135135135
6427_terrestrial,76,37,50,39,113,65.78947368421053,51.31578947368421
6428_terrestrial,76,37,50,39,113,65.78947368421053,51.31578947368421
6429_terrestrial,81,43,55,40,124,67.90123456790124,49.382716049382715
6430_terrestrial,80,38,54,41,118,67.5,51.24999999999999
6440_terrestrial,76,40,48,39,116,63.1578947368421,51.31578947368421
6441_terrestrial,76,42,48,39,118,63.1578947368421,51.31578947368421
6442_terrestrial,76,41,48,39,117,63.1578947368421,51.31578947368421
6443_terrestrial,76,41,48,39,117,63.1578947368421,51.31578947368421
6444_terrestrial,77,43,49,39,120,63.63636363636363,50.649350649350644
6445_terrestrial,70,40,44,36,110,62.857142857142854,51.42857142857142
6446_terrestrial,70,35,44,37,105,62.857142857142854,52.85714285714286
6447_terrestrial,70,37,44,37,107,62.857142857142854,52.85714285714286
6448_terrestrial,77,43,49,39,120,63.63636363636363,50.649350649350644
6449_terrestrial,77,42,49,38,119,63.63636363636363,49.35064935064935
6450_terrestrial,76,41,49,38,117,64.47368421052632,50
6481_terrestrial,43,23,30,20,66,69.76744186046511,46.51162790697674
6482_terrestrial,42,25,30,19,67,71.42857142857143,45.23809523809524
6483_terrestrial,43,25,31,20,68,72.09302325581395,46.51162790697674
6503_terrestrial,96,47,56,49,143,58.333333333333336,51.041666666666664
6504_terrestrial,95,47,55,49,142,57.89473684210527,51.578947368421055
6505_terrestrial,93,47,53,47,140,56.98924731182796,50.53763440860215
6506_terrestrial,78,32,42,43,110,53.84615384615385,55.12820512820513
6535_terrestrial,51,18,29,28,69,56.86274509803921,54.90196078431373
6536_terrestrial,54,18,32,29,72,59.25925925925925,53.70370370370371
6537_terrestrial,53,18,32,28,71,60.37735849056604,52.83018867924528
6538_terrestrial,54,18,33,28,72,61.111111111111114,51.85185185185185
6539_terrestrial,53,18,31,29,71,58.490566037735846,54.71698113207547
6540_terrestrial,52,18,31,28,70,59.61538461538461,53.84615384615385
6542_terrestrial,48,18,29,24,66,60.416666666666664,50
6543_terrestrial,48,18,29,24,66,60.416666666666664,50
6544_terrestrial,48,18,29,24,66,60.416666666666664,50
6545_terrestrial,48,18,29,24,66,60.416666666666664,50
6546_terrestrial,44,10,26,23,54,59.09090909090909,52.27272727272727
6547_terrestrial,41,10,24,22,51,58.536585365853654,53.65853658536586
6548_terrestrial,41,10,24,22,51,58.536585365853654,53.65853658536586
6549_terrestrial,41,10,24,22,51,58.536585365853654,53.65853658536586
6550_terrestrial,41,10,24,22,51,58.536585365853654,53.65853658536586
6551_terrestrial,41,10,24,22,51,58.536585365853654,53.65853658536586
6552_terrestrial,44,14,26,22,58,59.09090909090909,50
6553_terrestrial,43,14,26,21,57,60.46511627906976,48.837209302325576
6554_terrestrial,40,10,23,21,50,57.49999999999999,52.5
6555_terrestrial,42,10,26,22,52,61.904761904761905,52.38095238095239
6556_terrestrial,45,14,29,22,59,64.44444444444444,48.888888888888886
6560_terrestrial,41,14,27,20,55,65.85365853658537,48.78048780487805
6561_terrestrial,42,14,28,21,56,66.66666666666666,50
6562_terrestrial,42,14,28,21,56,66.66666666666666,50
6563_terrestrial,44,16,30,21,60,68.18181818181817,47.72727272727273
6564_terrestrial,64,24,39,27,88,60.9375,42.1875
6565_terrestrial,56,25,33,26,81,58.92857142857143,46.42857142857143
6566_terrestrial,57,25,33,27,82,57.89473684210527,47.368421052631575
6567_terrestrial,54,21,30,25,75,55.55555555555556,46.2962962962963
6568_terrestrial,46,16,23,24,62,50,52.17391304347826
6570_terrestrial,35,12,24,23,47,68.57142857142857,65.71428571428571
6571_terrestrial,48,18,29,24,66,60.416666666666664,50
6572_terrestrial,48,18,29,24,66,60.416666666666664,50
6573_terrestrial,49,18,29,25,67,59.183673469387756,51.02040816326531
6574_terrestrial,52,22,32,25,74,61.53846153846154,48.07692307692308
6575_terrestrial,53,21,33,25,74,62.264150943396224,47.16981132075472
6576_terrestrial,54,23,33,26,77,61.111111111111114,48.148148148148145
6577_terrestrial,39,10,21,19,49,53.84615384615385,48.717948717948715
6578_terrestrial,40,10,21,20,50,52.5,50
6579_terrestrial,41,10,21,21,51,51.21951219512195,51.21951219512195
6580_terrestrial,57,22,35,24,79,61.40350877192983,42.10526315789473
6581_terrestrial,56,22,35,23,78,62.5,41.07142857142857
6582_terrestrial,56,21,35,23,77,62.5,41.07142857142857
6583_terrestrial,56,21,35,23,77,62.5,41.07142857142857
6584_terrestrial,58,23,37,23,81,63.793103448275865,39.6551724137931
6585_terrestrial,56,21,35,21,77,62.5,37.5
6586_terrestrial,57,23,36,22,80,63.1578947368421,38.59649122807017
6587_terrestrial,55,23,35,20,78,63.63636363636363,36.36363636363637
6588_terrestrial,53,23,34,18,76,64.15094339622641,33.9622641509434
6589_terrestrial,53,23,34,18,76,64.15094339622641,33.9622641509434
6590_terrestrial,51,21,32,18,72,62.745098039215684,35.294117647058826
6605_terrestrial,65,21,46,30,86,70.76923076923077,46.15384615384615
6606_terrestrial,66,23,47,29,89,71.21212121212122,43.93939393939394
6607_terrestrial,68,25,49,30,93,72.05882352941177,44.11764705882353
6608_terrestrial,67,27,48,31,94,71.64179104477611,46.26865671641791
6609_terrestrial,64,29,45,29,93,70.3125,45.3125
6610_terrestrial,61,22,42,28,83,68.85245901639344,45.90163934426229
6611_terrestrial,31,5,18,18,36,58.06451612903226,58.06451612903226
6612_terrestrial,12,5,7,6,17,58.333333333333336,50
6613_terrestrial,5,5,2,2,10,40,40
6614_terrestrial,4,3,1,1,7,25,25
6623_terrestrial,3,3,0,1,6,0,33.33333333333333
6624_terrestrial,3,3,0,1,6,0,33.33333333333333
6625_terrestrial,3,3,0,1,6,0,33.33333333333333
6626_terrestrial,6,3,1,2,9,16.666666666666664,33.33333333333333
6627_terrestrial,7,3,1,3,10,14.285714285714285,42.857142857142854
6628_terrestrial,7,3,1,3,10,14.285714285714285,42.857142857142854
6629_terrestrial,11,3,5,5,14,45.45454545454545,45.45454545454545
6630_terrestrial,17,3,9,9,20,52.94117647058824,52.94117647058824
6631_terrestrial,22,4,13,11,26,59.09090909090909,50
6632_terrestrial,65,23,53,19,88,81.53846153846153,29.230769230769234
6633_terrestrial,66,27,54,20,93,81.81818181818183,30.303030303030305
6634_terrestrial,69,25,57,21,94,82.6086956521739,30.434782608695656
6635_terrestrial,72,23,60,23,95,83.33333333333334,31.944444444444443
6636_terrestrial,71,21,60,21,92,84.50704225352112,29.577464788732392
6637_terrestrial,61,18,50,20,79,81.9672131147541,32.78688524590164
6638_terrestrial,69,19,58,20,88,84.05797101449275,28.985507246376812
6639_terrestrial,68,19,58,19,87,85.29411764705883,27.941176470588236
6652_terrestrial,50,18,44,10,68,88,20
6653_terrestrial,49,18,43,10,67,87.75510204081633,20.408163265306122
6685_terrestrial,125,44,96,78,169,76.8,62.4
6686_terrestrial,126,46,98,79,172,77.77777777777779,62.698412698412696
6687_terrestrial,122,48,95,75,170,77.8688524590164,61.47540983606557
6712_terrestrial,57,28,44,29,85,77.19298245614034,50.877192982456144
6713_terrestrial,57,30,43,31,87,75.43859649122807,54.385964912280706
6714_terrestrial,56,30,43,30,86,76.78571428571429,53.57142857142857
6715_terrestrial,55,30,42,29,85,76.36363636363637,52.72727272727272
6716_terrestrial,48,24,36,27,72,75,56.25
6717_terrestrial,53,24,41,27,77,77.35849056603774,50.943396226415096
6727_terrestrial,69,26,46,34,95,66.66666666666666,49.275362318840585
6728_terrestrial,69,28,46,34,97,66.66666666666666,49.275362318840585
6729_terrestrial,69,28,46,34,97,66.66666666666666,49.275362318840585
6730_terrestrial,56,23,35,30,79,62.5,53.57142857142857
6731_terrestrial,56,23,35,30,79,62.5,53.57142857142857
6732_terrestrial,68,28,44,36,96,64.70588235294117,52.94117647058824
6733_terrestrial,68,28,44,36,96,64.70588235294117,52.94117647058824
6734_terrestrial,67,27,43,37,94,64.17910447761194,55.223880597014926
6735_terrestrial,68,27,43,37,95,63.23529411764706,54.41176470588235
6736_terrestrial,68,27,43,37,95,63.23529411764706,54.41176470588235
6737_terrestrial,70,27,45,36,97,64.28571428571429,51.42857142857142
6738_terrestrial,70,27,45,36,97,64.28571428571429,51.42857142857142
6739_terrestrial,70,25,45,36,95,64.28571428571429,51.42857142857142
6740_terrestrial,61,23,38,33,84,62.295081967213115,54.09836065573771
6741_terrestrial,65,28,42,33,93,64.61538461538461,50.76923076923077
6742_terrestrial,69,30,44,37,99,63.76811594202898,53.62318840579711
6743_terrestrial,71,30,45,38,101,63.38028169014085,53.52112676056338
6744_terrestrial,74,35,46,41,109,62.16216216216216,55.4054054054054
6745_terrestrial,70,30,43,40,100,61.42857142857143,57.14285714285714
6746_terrestrial,71,26,42,43,97,59.154929577464785,60.56338028169014
6747_terrestrial,75,28,44,45,103,58.666666666666664,60
6748_terrestrial,73,28,42,45,101,57.534246575342465,61.64383561643836
6749_terrestrial,74,30,43,46,104,58.108108108108105,62.16216216216216
6750_terrestrial,76,28,41,47,104,53.94736842105263,61.8421052631579
6751_terrestrial,77,28,41,49,105,53.246753246753244,63.63636363636363
6752_terrestrial,81,29,42,51,110,51.85185185185185,62.96296296296296
6753_terrestrial,82,33,42,52,115,51.21951219512195,63.41463414634146
6754_terrestrial,85,35,44,54,120,51.76470588235295,63.52941176470588
6755_terrestrial,88,37,45,56,125,51.13636363636363,63.63636363636363
6756_terrestrial,87,37,45,55,124,51.724137931034484,63.2183908045977
6757_terrestrial,93,38,50,59,131,53.76344086021505,63.44086021505376
6758_terrestrial,94,37,49,58,131,52.12765957446809,61.702127659574465
6759_terrestrial,94,39,49,58,133,52.12765957446809,61.702127659574465
6760_terrestrial,94,40,49,58,134,52.12765957446809,61.702127659574465
6761_terrestrial,94,41,47,56,135,50,59.57446808510638
6762_terrestrial,96,42,49,58,138,51.041666666666664,60.416666666666664
6763_terrestrial,94,42,48,55,136,51.06382978723404,58.51063829787234
6764_terrestrial,91,42,48,52,133,52.74725274725275,57.14285714285714
6765_terrestrial,93,41,50,54,134,53.76344086021505,58.06451612903226
6766_terrestrial,95,42,52,56,137,54.736842105263165,58.94736842105262
6767_terrestrial,95,40,53,53,135,55.78947368421052,55.78947368421052
6768_terrestrial,89,39,48,51,128,53.93258426966292,57.30337078651685
6769_terrestrial,88,36,48,49,124,54.54545454545454,55.68181818181818
6770_terrestrial,89,36,48,50,125,53.93258426966292,56.17977528089888
6771_terrestrial,91,36,50,50,127,54.94505494505495,54.94505494505495
6772_terrestrial,88,33,47,49,121,53.40909090909091,55.68181818181818
6773_terrestrial,90,35,49,51,125,54.44444444444444,56.666666666666664
6774_terrestrial,91,37,50,52,128,54.94505494505495,57.14285714285714
6775_terrestrial,89,39,48,50,128,53.93258426966292,56.17977528089888
6776_terrestrial,88,39,47,50,127,53.40909090909091,56.81818181818182
6777_terrestrial,89,37,47,51,126,52.80898876404494,57.30337078651685
6778_terrestrial,86,38,47,50,124,54.65116279069767,58.139534883720934
6779_terrestrial,82,37,47,47,119,57.3170731707317,57.3170731707317
6780_terrestrial,83,37,47,48,120,56.62650602409639,57.831325301204814
6781_terrestrial,83,39,48,47,122,57.831325301204814,56.62650602409639
6782_terrestrial,85,40,48,47,125,56.470588235294116,55.294117647058826
6783_terrestrial,83,41,48,43,124,57.831325301204814,51.80722891566265
6784_terrestrial,83,39,48,45,122,57.831325301204814,54.21686746987952
6785_terrestrial,78,39,47,42,117,60.256410256410255,53.84615384615385
6786_terrestrial,80,37,50,43,117,62.5,53.75
6787_terrestrial,82,38,53,43,120,64.63414634146342,52.4390243902439
6788_terrestrial,85,39,57,44,124,67.05882352941175,51.76470588235295
6789_terrestrial,91,47,63,45,138,69.23076923076923,49.45054945054945
6790_terrestrial,83,42,55,43,125,66.26506024096386,51.80722891566265
6791_terrestrial,76,35,49,40,111,64.47368421052632,52.63157894736842
6792_terrestrial,79,43,52,39,122,65.82278481012658,49.36708860759494
6795_terrestrial,75,44,49,38,119,65.33333333333333,50.66666666666667
6796_terrestrial,75,40,49,38,115,65.33333333333333,50.66666666666667
6797_terrestrial,77,44,51,39,121,66.23376623376623,50.649350649350644
6798_terrestrial,79,40,52,41,119,65.82278481012658,51.89873417721519
6799_terrestrial,80,41,52,42,121,65,52.5
6800_terrestrial,80,44,51,42,124,63.74999999999999,52.5
6801_terrestrial,79,49,51,41,128,64.55696202531645,51.89873417721519
6802_terrestrial,74,41,47,39,115,63.51351351351351,52.702702702702695
6803_terrestrial,74,44,46,40,118,62.16216216216216,54.054054054054056
6804_terrestrial,75,45,47,42,120,62.66666666666667,56.00000000000001
6805_terrestrial,76,46,48,43,122,63.1578947368421,56.57894736842105
6806_terrestrial,77,47,49,42,124,63.63636363636363,54.54545454545454
6807_terrestrial,76,45,48,41,121,63.1578947368421,53.94736842105263
6808_terrestrial,73,42,45,40,115,61.64383561643836,54.794520547945204
6809_terrestrial,74,42,46,40,116,62.16216216216216,54.054054054054056
6810_terrestrial,80,48,52,41,128,65,51.24999999999999
6811_terrestrial,80,49,52,41,129,65,51.24999999999999
6812_terrestrial,79,49,51,40,128,64.55696202531645,50.63291139240506
6813_terrestrial,78,47,50,39,125,64.1025641025641,50
6815_terrestrial,75,45,46,39,120,61.33333333333333,52
6816_terrestrial,77,45,48,40,122,62.33766233766234,51.94805194805194
6817_terrestrial,78,44,49,40,122,62.82051282051282,51.28205128205128
6818_terrestrial,78,44,49,40,122,62.82051282051282,51.28205128205128
6819_terrestrial,77,44,48,40,121,62.33766233766234,51.94805194805194
6839_terrestrial,40,25,29,22,65,72.5,55.00000000000001
6840_terrestrial,40,25,29,22,65,72.5,55.00000000000001
6841_terrestrial,44,25,31,21,69,70.45454545454545,47.72727272727273
6842_terrestrial,33,12,22,19,45,66.66666666666666,57.57575757575758
6858_terrestrial,76,33,39,42,109,51.31578947368421,55.26315789473685
6859_terrestrial,78,33,40,44,111,51.28205128205128,56.41025641025641
6860_terrestrial,100,49,59,49,149,59,49
6861_terrestrial,103,49,61,51,152,59.22330097087378,49.51456310679612
6862_terrestrial,102,48,59,52,150,57.84313725490197,50.98039215686274
6863_terrestrial,103,50,58,54,153,56.310679611650485,52.42718446601942
6864_terrestrial,101,51,56,54,152,55.44554455445545,53.46534653465347
6865_terrestrial,102,53,55,55,155,53.92156862745098,53.92156862745098
6866_terrestrial,102,51,56,56,153,54.90196078431373,54.90196078431373
6867_terrestrial,99,50,55,54,149,55.55555555555556,54.54545454545454
6868_terrestrial,98,50,55,53,148,56.12244897959183,54.08163265306123
6869_terrestrial,96,50,53,50,146,55.208333333333336,52.083333333333336
6870_terrestrial,96,51,53,50,147,55.208333333333336,52.083333333333336
6871_terrestrial,92,49,50,49,141,54.347826086956516,53.2608695652174
6872_terrestrial,94,48,52,49,142,55.319148936170215,52.12765957446809
6873_terrestrial,90,47,51,45,137,56.666666666666664,50
6874_terrestrial,91,45,51,46,136,56.043956043956044,50.54945054945055
6875_terrestrial,90,45,51,45,135,56.666666666666664,50
6876_terrestrial,89,46,51,44,135,57.30337078651685,49.43820224719101
6877_terrestrial,90,46,50,45,136,55.55555555555556,50
6878_terrestrial,91,45,51,45,136,56.043956043956044,49.45054945054945
6889_terrestrial,87,43,42,51,130,48.275862068965516,58.620689655172406
6890_terrestrial,89,43,44,52,132,49.43820224719101,58.42696629213483
6891_terrestrial,89,41,44,52,130,49.43820224719101,58.42696629213483
6892_terrestrial,85,38,40,49,123,47.05882352941176,57.647058823529406
6893_terrestrial,84,38,41,49,122,48.80952380952381,58.333333333333336
6894_terrestrial,82,38,40,47,120,48.78048780487805,57.3170731707317
6896_terrestrial,77,35,39,45,112,50.649350649350644,58.44155844155844
6902_terrestrial,42,10,24,23,52,57.14285714285714,54.761904761904766
6903_terrestrial,48,19,28,26,67,58.333333333333336,54.166666666666664
6904_terrestrial,49,19,29,27,68,59.183673469387756,55.10204081632652
6905_terrestrial,49,18,29,27,67,59.183673469387756,55.10204081632652
6906_terrestrial,53,18,33,28,71,62.264150943396224,52.83018867924528
6907_terrestrial,53,18,33,28,71,62.264150943396224,52.83018867924528
6908_terrestrial,52,18,32,28,70,61.53846153846154,53.84615384615385
6909_terrestrial,52,18,32,28,70,61.53846153846154,53.84615384615385
6910_terrestrial,48,10,30,26,58,62.5,54.166666666666664
6911_terrestrial,45,10,27,25,55,60,55.55555555555556
6912_terrestrial,46,10,28,26,56,60.86956521739131,56.52173913043478
6913_terrestrial,46,10,28,26,56,60.86956521739131,56.52173913043478
6914_terrestrial,46,10,28,26,56,60.86956521739131,56.52173913043478
6915_terrestrial,46,10,28,26,56,60.86956521739131,56.52173913043478
6916_terrestrial,51,14,32,28,65,62.745098039215684,54.90196078431373
6917_terrestrial,50,14,31,27,64,62,54
6918_terrestrial,50,14,31,27,64,62,54
6919_terrestrial,50,14,31,27,64,62,54
6920_terrestrial,50,14,32,27,64,64,54
6924_terrestrial,52,19,29,25,71,55.769230769230774,48.07692307692308
6925_terrestrial,52,19,29,25,71,55.769230769230774,48.07692307692308
6926_terrestrial,49,16,26,25,65,53.06122448979592,51.02040816326531
6927_terrestrial,53,22,29,26,75,54.71698113207547,49.056603773584904
6928_terrestrial,55,22,31,28,77,56.36363636363636,50.90909090909091
6929_terrestrial,54,22,30,27,76,55.55555555555556,50
6931_terrestrial,47,17,28,23,64,59.57446808510638,48.93617021276596
6932_terrestrial,47,17,28,23,64,59.57446808510638,48.93617021276596
6933_terrestrial,48,17,28,24,65,58.333333333333336,50
6934_terrestrial,50,17,29,25,67,57.99999999999999,50
6935_terrestrial,50,17,29,25,67,57.99999999999999,50
6936_terrestrial,50,21,29,25,71,57.99999999999999,50
6937_terrestrial,49,19,31,22,68,63.26530612244898,44.89795918367347
6938_terrestrial,49,19,31,22,68,63.26530612244898,44.89795918367347
6939_terrestrial,50,19,31,23,69,62,46
6940_terrestrial,49,19,30,22,68,61.224489795918366,44.89795918367347
6941_terrestrial,50,19,32,21,69,64,42
6942_terrestrial,50,19,32,21,69,64,42
6943_terrestrial,47,19,30,20,66,63.829787234042556,42.5531914893617
6944_terrestrial,49,19,32,21,68,65.3061224489796,42.857142857142854
6945_terrestrial,41,10,23,21,51,56.09756097560976,51.21951219512195
6946_terrestrial,40,9,22,20,49,55.00000000000001,50
6947_terrestrial,57,21,37,22,78,64.91228070175438,38.59649122807017
6948_terrestrial,57,23,37,22,80,64.91228070175438,38.59649122807017
6949_terrestrial,56,23,36,20,79,64.28571428571429,35.714285714285715
6950_terrestrial,55,23,36,19,78,65.45454545454545,34.54545454545455
6951_terrestrial,54,23,35,18,77,64.81481481481481,33.33333333333333
6952_terrestrial,54,23,35,18,77,64.81481481481481,33.33333333333333
6953_terrestrial,53,21,34,19,74,64.15094339622641,35.84905660377358
6966_terrestrial,71,25,50,31,96,70.4225352112676,43.66197183098591
6967_terrestrial,75,27,54,30,102,72,40
6968_terrestrial,75,27,54,30,102,72,40
6969_terrestrial,72,29,53,30,101,73.61111111111111,41.66666666666667
6970_terrestrial,71,27,52,30,98,73.23943661971832,42.25352112676056
6971_terrestrial,37,6,23,20,43,62.16216216216216,54.054054054054056
6972_terrestrial,20,5,11,11,25,55.00000000000001,55.00000000000001
6973_terrestrial,9,5,4,5,14,44.44444444444444,55.55555555555556
6974_terrestrial,4,4,1,1,8,25,25
6975_terrestrial,4,3,1,1,7,25,25
6976_terrestrial,4,3,1,1,7,25,25
6977_terrestrial,3,3,1,1,6,33.33333333333333,33.33333333333333
6978_terrestrial,3,3,1,1,6,33.33333333333333,33.33333333333333
6979_terrestrial,3,3,1,1,6,33.33333333333333,33.33333333333333
6981_terrestrial,3,3,0,1,6,0,33.33333333333333
6982_terrestrial,3,3,0,1,6,0,33.33333333333333
6983_terrestrial,3,3,0,1,6,0,33.33333333333333
6984_terrestrial,4,3,1,2,7,25,50
6985_terrestrial,8,3,3,4,11,37.5,50
6986_terrestrial,8,3,3,4,11,37.5,50
6987_terrestrial,11,3,3,7,14,27.27272727272727,63.63636363636363
6988_terrestrial,16,3,7,10,19,43.75,62.5
6989_terrestrial,17,4,8,11,21,47.05882352941176,64.70588235294117
6990_terrestrial,25,4,13,13,29,52,52
6991_terrestrial,62,18,47,19,80,75.80645161290323,30.64516129032258
6992_terrestrial,69,25,55,21,94,79.71014492753623,30.434782608695656
6993_terrestrial,72,27,58,23,99,80.55555555555556,31.944444444444443
6994_terrestrial,74,27,60,25,101,81.08108108108108,33.78378378378378
6995_terrestrial,73,27,59,25,100,80.82191780821918,34.24657534246575
6996_terrestrial,76,21,62,26,97,81.57894736842105,34.21052631578947
6997_terrestrial,83,31,68,28,114,81.92771084337349,33.734939759036145
6998_terrestrial,83,31,68,28,114,81.92771084337349,33.734939759036145
6999_terrestrial,72,25,61,20,97,84.72222222222221,27.77777777777778
7011_terrestrial,49,20,43,10,69,87.75510204081633,20.408163265306122
7012_terrestrial,48,16,42,10,64,87.5,20.833333333333336
7039_terrestrial,135,56,103,85,191,76.29629629629629,62.96296296296296
7040_terrestrial,139,59,106,89,198,76.2589928057554,64.02877697841727
7041_terrestrial,139,54,108,85,193,77.6978417266187,61.15107913669065
7074_terrestrial,55,30,42,28,85,76.36363636363637,50.90909090909091
7075_terrestrial,56,30,43,29,86,76.78571428571429,51.78571428571429
7076_terrestrial,56,30,43,29,86,76.78571428571429,51.78571428571429
7077_terrestrial,56,28,43,29,84,76.78571428571429,51.78571428571429
7078_terrestrial,55,28,42,29,83,76.36363636363637,52.72727272727272
7079_terrestrial,69,28,50,43,97,72.46376811594203,62.31884057971014
7080_terrestrial,72,29,52,44,101,72.22222222222221,61.111111111111114
7081_terrestrial,71,28,53,43,99,74.64788732394366,60.56338028169014
7087_terrestrial,78,28,51,43,106,65.38461538461539,55.12820512820513
7088_terrestrial,79,32,52,44,111,65.82278481012658,55.69620253164557
7089_terrestrial,68,27,44,40,95,64.70588235294117,58.82352941176471
7090_terrestrial,67,25,43,39,92,64.17910447761194,58.2089552238806
7091_terrestrial,68,25,43,39,93,63.23529411764706,57.35294117647059
7092_terrestrial,69,25,44,40,94,63.76811594202898,57.971014492753625
7093_terrestrial,74,30,48,41,104,64.86486486486487,55.4054054054054
7094_terrestrial,69,29,45,39,98,65.21739130434783,56.52173913043478
7095_terrestrial,71,29,46,40,100,64.7887323943662,56.33802816901409
7096_terrestrial,62,26,39,36,88,62.903225806451616,58.06451612903226
7097_terrestrial,64,26,41,36,90,64.0625,56.25
7098_terrestrial,76,31,50,40,107,65.78947368421053,52.63157894736842
7099_terrestrial,77,30,50,40,107,64.93506493506493,51.94805194805194
7100_terrestrial,69,27,44,38,96,63.76811594202898,55.072463768115945
7101_terrestrial,69,27,44,38,96,63.76811594202898,55.072463768115945
7102_terrestrial,80,35,52,44,115,65,55.00000000000001
7103_terrestrial,82,40,53,47,122,64.63414634146342,57.3170731707317
7104_terrestrial,82,41,53,47,123,64.63414634146342,57.3170731707317
7105_terrestrial,74,38,46,45,112,62.16216216216216,60.810810810810814
7106_terrestrial,74,37,43,44,111,58.108108108108105,59.45945945945946
7107_terrestrial,83,36,45,52,119,54.21686746987952,62.65060240963856
7108_terrestrial,88,36,44,54,124,50,61.36363636363637
7109_terrestrial,97,39,50,62,136,51.546391752577314,63.91752577319587
7110_terrestrial,96,41,49,63,137,51.041666666666664,65.625
7111_terrestrial,100,40,51,65,140,51,65
7112_terrestrial,98,41,50,64,139,51.02040816326531,65.3061224489796
7113_terrestrial,98,39,51,62,137,52.04081632653062,63.26530612244898
7114_terrestrial,102,41,53,66,143,51.9607843137255,64.70588235294117
7115_terrestrial,101,43,53,65,144,52.475247524752476,64.35643564356435
7116_terrestrial,105,43,56,66,148,53.333333333333336,62.857142857142854
7117_terrestrial,103,43,55,64,146,53.398058252427184,62.13592233009708
7118_terrestrial,102,43,54,64,145,52.94117647058824,62.745098039215684
7119_terrestrial,101,43,53,64,144,52.475247524752476,63.366336633663366
7120_terrestrial,99,43,52,63,142,52.52525252525253,63.63636363636363
7121_terrestrial,97,43,52,61,140,53.608247422680414,62.88659793814433
7122_terrestrial,96,44,53,59,140,55.208333333333336,61.458333333333336
7123_terrestrial,99,42,55,59,141,55.55555555555556,59.59595959595959
7124_terrestrial,99,40,55,60,139,55.55555555555556,60.60606060606061
7125_terrestrial,100,40,56,61,140,56.00000000000001,61
7126_terrestrial,99,40,56,60,139,56.56565656565656,60.60606060606061
7127_terrestrial,97,38,54,59,135,55.670103092783506,60.824742268041234
7128_terrestrial,96,38,53,59,134,55.208333333333336,61.458333333333336
7129_terrestrial,93,38,50,56,131,53.76344086021505,60.215053763440864
7130_terrestrial,91,38,48,56,129,52.74725274725275,61.53846153846154
7131_terrestrial,95,38,50,59,133,52.63157894736842,62.10526315789474
7132_terrestrial,98,39,53,62,137,54.08163265306123,63.26530612244898
7133_terrestrial,102,43,57,65,145,55.88235294117647,63.725490196078425
7134_terrestrial,100,44,56,63,144,56.00000000000001,63
7135_terrestrial,96,42,53,60,138,55.208333333333336,62.5
7136_terrestrial,94,40,52,58,134,55.319148936170215,61.702127659574465
7137_terrestrial,94,40,53,57,134,56.38297872340425,60.63829787234043
7138_terrestrial,93,40,52,57,133,55.91397849462365,61.29032258064516
7139_terrestrial,91,40,51,55,131,56.043956043956044,60.43956043956044
7140_terrestrial,90,43,50,54,133,55.55555555555556,60
7141_terrestrial,90,41,51,53,131,56.666666666666664,58.88888888888889
7142_terrestrial,92,41,52,55,133,56.52173913043478,59.78260869565217
7143_terrestrial,96,43,55,58,139,57.291666666666664,60.416666666666664
7144_terrestrial,98,41,55,59,139,56.12244897959183,60.204081632653065
7145_terrestrial,97,42,55,58,139,56.70103092783505,59.79381443298969
7155_terrestrial,94,45,60,55,139,63.829787234042556,58.51063829787234
7156_terrestrial,98,47,61,58,145,62.244897959183675,59.183673469387756
7157_terrestrial,96,47,60,58,143,62.5,60.416666666666664
7158_terrestrial,99,46,62,59,145,62.62626262626263,59.59595959595959
7159_terrestrial,99,46,62,59,145,62.62626262626263,59.59595959595959
7160_terrestrial,95,45,60,58,140,63.1578947368421,61.05263157894737
7161_terrestrial,96,43,60,59,139,62.5,61.458333333333336
7162_terrestrial,96,43,59,59,139,61.458333333333336,61.458333333333336
7163_terrestrial,96,45,58,60,141,60.416666666666664,62.5
7164_terrestrial,98,47,58,60,145,59.183673469387756,61.224489795918366
7165_terrestrial,96,48,57,58,144,59.375,60.416666666666664
7166_terrestrial,97,48,59,59,145,60.824742268041234,60.824742268041234
7167_terrestrial,96,46,59,58,142,61.458333333333336,60.416666666666664
7168_terrestrial,94,46,57,55,140,60.63829787234043,58.51063829787234
7169_terrestrial,94,47,58,55,141,61.702127659574465,58.51063829787234
7170_terrestrial,89,46,55,51,135,61.79775280898876,57.30337078651685
7171_terrestrial,88,43,56,51,131,63.63636363636363,57.95454545454546
7172_terrestrial,93,51,60,51,144,64.51612903225806,54.83870967741935
7173_terrestrial,93,49,60,51,142,64.51612903225806,54.83870967741935
7174_terrestrial,90,50,58,49,140,64.44444444444444,54.44444444444444
7175_terrestrial,90,50,58,49,140,64.44444444444444,54.44444444444444
7176_terrestrial,82,42,52,47,124,63.41463414634146,57.3170731707317
7177_terrestrial,82,40,52,47,122,63.41463414634146,57.3170731707317
7178_terrestrial,78,42,48,44,120,61.53846153846154,56.41025641025641
7179_terrestrial,84,50,53,44,134,63.095238095238095,52.38095238095239
7180_terrestrial,85,49,53,45,134,62.35294117647059,52.94117647058824
7181_terrestrial,84,48,55,47,132,65.47619047619048,55.952380952380956
7189_terrestrial,68,28,53,41,96,77.94117647058823,60.29411764705882
7191_terrestrial,87,48,60,40,135,68.96551724137932,45.97701149425287
7192_terrestrial,87,46,60,40,133,68.96551724137932,45.97701149425287
7199_terrestrial,40,24,29,22,64,72.5,55.00000000000001
7200_terrestrial,35,17,24,22,52,68.57142857142857,62.857142857142854
7216_terrestrial,22,16,20,2,38,90.9090909090909,9.090909090909092
7217_terrestrial,108,53,62,54,161,57.407407407407405,50
7218_terrestrial,91,36,44,52,127,48.35164835164835,57.14285714285714
7219_terrestrial,91,38,44,53,129,48.35164835164835,58.24175824175825
7220_terrestrial,87,36,41,50,123,47.12643678160919,57.47126436781609
7221_terrestrial,90,37,41,54,127,45.55555555555556,60
7222_terrestrial,88,38,38,52,126,43.18181818181818,59.09090909090909
7223_terrestrial,89,39,39,54,128,43.82022471910113,60.67415730337079
7224_terrestrial,88,42,41,51,130,46.590909090909086,57.95454545454546
7225_terrestrial,87,44,41,51,131,47.12643678160919,58.620689655172406
7226_terrestrial,89,46,42,53,135,47.19101123595505,59.55056179775281
7227_terrestrial,90,45,43,54,135,47.77777777777778,60
7228_terrestrial,90,45,44,56,135,48.888888888888886,62.22222222222222
7229_terrestrial,90,43,44,56,133,48.888888888888886,62.22222222222222
7230_terrestrial,91,46,44,56,137,48.35164835164835,61.53846153846154
7231_terrestrial,91,45,44,56,136,48.35164835164835,61.53846153846154
7232_terrestrial,99,44,48,62,143,48.484848484848484,62.62626262626263
7233_terrestrial,100,45,49,63,145,49,63
7234_terrestrial,100,45,49,63,145,49,63
7235_terrestrial,113,56,58,64,169,51.32743362831859,56.63716814159292
7236_terrestrial,111,57,57,62,168,51.35135135135135,55.85585585585585
7237_terrestrial,99,45,49,59,144,49.494949494949495,59.59595959595959
7238_terrestrial,109,55,59,59,164,54.12844036697248,54.12844036697248
7239_terrestrial,110,55,58,58,165,52.72727272727272,52.72727272727272
7240_terrestrial,101,57,52,58,158,51.48514851485149,57.42574257425742
7241_terrestrial,98,53,52,57,151,53.06122448979592,58.16326530612245
7242_terrestrial,98,50,51,58,148,52.04081632653062,59.183673469387756
7243_terrestrial,95,48,48,55,143,50.526315789473685,57.89473684210527
7245_terrestrial,109,49,51,66,158,46.788990825688074,60.550458715596335
7246_terrestrial,108,52,49,63,160,45.370370370370374,58.333333333333336
7247_terrestrial,106,51,48,64,157,45.28301886792453,60.37735849056604
7248_terrestrial,108,51,49,66,159,45.370370370370374,61.111111111111114
7249_terrestrial,113,53,51,69,166,45.13274336283185,61.06194690265486
7250_terrestrial,111,48,51,66,159,45.94594594594595,59.45945945945946
7251_terrestrial,108,47,50,65,155,46.2962962962963,60.18518518518518
7252_terrestrial,104,45,48,61,149,46.15384615384615,58.65384615384615
7253_terrestrial,101,47,45,61,148,44.554455445544555,60.396039603960396
7254_terrestrial,96,43,44,57,139,45.83333333333333,59.375
7255_terrestrial,84,44,43,51,128,51.19047619047619,60.71428571428571
7256_terrestrial,80,37,41,48,117,51.24999999999999,60
7257_terrestrial,80,37,41,48,117,51.24999999999999,60
7258_terrestrial,78,35,40,46,113,51.28205128205128,58.97435897435898
7259_terrestrial,78,34,40,46,112,51.28205128205128,58.97435897435898
7260_terrestrial,76,32,38,44,108,50,57.89473684210527
7261_terrestrial,71,32,35,40,103,49.29577464788733,56.33802816901409
7262_terrestrial,70,32,36,39,102,51.42857142857142,55.714285714285715
7263_terrestrial,82,32,46,41,114,56.09756097560976,50
7264_terrestrial,50,19,30,28,69,60,56.00000000000001
7265_terrestrial,50,18,30,28,68,60,56.00000000000001
7266_terrestrial,51,18,31,28,69,60.78431372549019,54.90196078431373
7267_terrestrial,52,19,32,29,71,61.53846153846154,55.769230769230774
7268_terrestrial,48,10,29,28,58,60.416666666666664,58.333333333333336
7269_terrestrial,48,10,29,28,58,60.416666666666664,58.333333333333336
7270_terrestrial,47,10,29,27,57,61.702127659574465,57.446808510638306
7271_terrestrial,47,10,29,27,57,61.702127659574465,57.446808510638306
7272_terrestrial,49,10,30,29,59,61.224489795918366,59.183673469387756
7273_terrestrial,52,16,33,29,68,63.46153846153846,55.769230769230774
7274_terrestrial,55,18,36,30,73,65.45454545454545,54.54545454545454
7275_terrestrial,55,16,35,31,71,63.63636363636363,56.36363636363636
7276_terrestrial,54,14,34,32,68,62.96296296296296,59.25925925925925
7277_terrestrial,55,14,35,32,69,63.63636363636363,58.18181818181818
7278_terrestrial,55,14,35,32,69,63.63636363636363,58.18181818181818
7279_terrestrial,55,14,35,32,69,63.63636363636363,58.18181818181818
7280_terrestrial,54,14,34,31,68,62.96296296296296,57.407407407407405
7281_terrestrial,44,12,30,29,56,68.18181818181817,65.9090909090909
7282_terrestrial,44,12,30,29,56,68.18181818181817,65.9090909090909
7283_terrestrial,44,12,30,29,56,68.18181818181817,65.9090909090909
7284_terrestrial,62,20,37,31,82,59.67741935483871,50
7285_terrestrial,62,20,37,31,82,59.67741935483871,50
7286_terrestrial,55,20,32,26,75,58.18181818181818,47.27272727272727
7287_terrestrial,53,20,30,26,73,56.60377358490566,49.056603773584904
7288_terrestrial,57,23,33,28,80,57.89473684210527,49.122807017543856
7289_terrestrial,54,23,30,28,77,55.55555555555556,51.85185185185185
7290_terrestrial,54,25,30,28,79,55.55555555555556,51.85185185185185
7291_terrestrial,53,24,29,27,77,54.71698113207547,50.943396226415096
7292_terrestrial,52,24,29,26,76,55.769230769230774,50
7293_terrestrial,10,7,9,3,17,90,30
7294_terrestrial,30,13,21,19,43,70,63.33333333333333
7295_terrestrial,57,23,32,29,80,56.14035087719298,50.877192982456144
7296_terrestrial,69,26,36,29,95,52.17391304347826,42.028985507246375
7297_terrestrial,73,26,40,29,99,54.794520547945204,39.726027397260275
7298_terrestrial,72,26,40,28,98,55.55555555555556,38.88888888888889
7299_terrestrial,73,26,40,29,99,54.794520547945204,39.726027397260275
7300_terrestrial,50,19,32,23,69,64,46
7301_terrestrial,48,19,30,21,67,62.5,43.75
7302_terrestrial,48,19,30,21,67,62.5,43.75
7303_terrestrial,47,19,30,20,66,63.829787234042556,42.5531914893617
7304_terrestrial,48,19,30,21,67,62.5,43.75
7305_terrestrial,49,19,31,22,68,63.26530612244898,44.89795918367347
7306_terrestrial,42,10,23,23,52,54.761904761904766,54.761904761904766
7307_terrestrial,40,10,22,21,50,55.00000000000001,52.5
7308_terrestrial,40,10,21,20,50,52.5,50
7309_terrestrial,41,9,22,21,50,53.65853658536586,51.21951219512195
7310_terrestrial,59,21,38,22,80,64.40677966101694,37.28813559322034
7311_terrestrial,60,25,38,23,85,63.33333333333333,38.333333333333336
7312_terrestrial,57,25,37,20,82,64.91228070175438,35.08771929824561
7313_terrestrial,57,27,37,20,84,64.91228070175438,35.08771929824561
7314_terrestrial,55,23,36,19,78,65.45454545454545,34.54545454545455
7326_terrestrial,61,22,46,28,83,75.40983606557377,45.90163934426229
7327_terrestrial,64,28,49,28,92,76.5625,43.75
7328_terrestrial,64,28,49,28,92,76.5625,43.75
7329_terrestrial,76,32,55,31,108,72.36842105263158,40.78947368421053
7330_terrestrial,73,32,54,30,105,73.97260273972603,41.0958904109589
7331_terrestrial,39,6,25,21,45,64.1025641025641,53.84615384615385
7332_terrestrial,27,5,16,15,32,59.25925925925925,55.55555555555556
7333_terrestrial,10,5,5,5,15,50,50
7334_terrestrial,5,4,1,2,9,20,40
7335_terrestrial,4,3,1,1,7,25,25
7336_terrestrial,4,3,1,1,7,25,25
7337_terrestrial,3,3,1,1,6,33.33333333333333,33.33333333333333
7338_terrestrial,3,3,1,1,6,33.33333333333333,33.33333333333333
7339_terrestrial,4,3,1,2,7,25,50
7340_terrestrial,4,3,1,2,7,25,50
7341_terrestrial,4,3,1,2,7,25,50
7342_terrestrial,5,3,2,2,8,40,40
7343_terrestrial,8,3,3,3,11,37.5,37.5
7344_terrestrial,9,3,3,5,12,33.33333333333333,55.55555555555556
7345_terrestrial,12,3,4,8,15,33.33333333333333,66.66666666666666
7346_terrestrial,17,4,8,10,21,47.05882352941176,58.82352941176471
7347_terrestrial,20,4,10,12,24,50,60
7348_terrestrial,21,6,11,13,27,52.38095238095239,61.904761904761905
7349_terrestrial,24,6,13,15,30,54.166666666666664,62.5
7350_terrestrial,27,6,16,16,33,59.25925925925925,59.25925925925925
7351_terrestrial,26,6,15,15,32,57.692307692307686,57.692307692307686
7352_terrestrial,29,7,18,16,36,62.06896551724138,55.172413793103445
7353_terrestrial,67,18,53,23,85,79.1044776119403,34.32835820895522
7354_terrestrial,31,7,21,17,38,67.74193548387096,54.83870967741935
7355_terrestrial,71,24,57,26,95,80.28169014084507,36.61971830985916
7356_terrestrial,70,26,56,25,96,80,35.714285714285715
7357_terrestrial,73,26,59,27,99,80.82191780821918,36.986301369863014
7358_terrestrial,73,23,59,25,96,80.82191780821918,34.24657534246575
7396_terrestrial,156,69,114,100,225,73.07692307692307,64.1025641025641
7397_terrestrial,169,75,124,113,244,73.37278106508876,66.86390532544378
7429_terrestrial,70,27,49,40,97,70,57.14285714285714
7430_terrestrial,70,27,49,40,97,70,57.14285714285714
7431_terrestrial,70,27,49,40,97,70,57.14285714285714
7435_terrestrial,62,31,44,37,93,70.96774193548387,59.67741935483871
7439_terrestrial,72,34,51,46,106,70.83333333333334,63.888888888888886
7440_terrestrial,78,33,58,45,111,74.35897435897436,57.692307692307686
7441_terrestrial,101,52,63,54,153,62.37623762376238,53.46534653465347
7442_terrestrial,91,48,57,49,139,62.637362637362635,53.84615384615385
7443_terrestrial,87,47,54,47,134,62.06896551724138,54.02298850574713
7444_terrestrial,87,47,54,47,134,62.06896551724138,54.02298850574713
7445_terrestrial,88,49,55,46,137,62.5,52.27272727272727
7446_terrestrial,84,49,52,46,133,61.904761904761905,54.761904761904766
7447_terrestrial,95,51,61,51,146,64.21052631578948,53.68421052631579
7448_terrestrial,78,32,51,45,110,65.38461538461539,57.692307692307686
7449_terrestrial,83,42,54,46,125,65.06024096385542,55.42168674698795
7450_terrestrial,75,37,48,45,112,64,60
7451_terrestrial,75,37,47,45,112,62.66666666666667,60
7452_terrestrial,75,35,47,45,110,62.66666666666667,60
7453_terrestrial,81,39,52,49,120,64.19753086419753,60.49382716049383
7454_terrestrial,75,33,48,45,108,64,60
7455_terrestrial,75,33,47,44,108,62.66666666666667,58.666666666666664
7456_terrestrial,75,35,47,44,110,62.66666666666667,58.666666666666664
7457_terrestrial,78,38,50,43,116,64.1025641025641,55.12820512820513
7458_terrestrial,70,33,43,41,103,61.42857142857143,58.57142857142858
7459_terrestrial,72,34,45,42,106,62.5,58.333333333333336
7460_terrestrial,76,34,47,45,110,61.8421052631579,59.210526315789465
7461_terrestrial,75,31,46,45,106,61.33333333333333,60
7462_terrestrial,77,31,48,46,108,62.33766233766234,59.74025974025974
7463_terrestrial,89,44,58,51,133,65.1685393258427,57.30337078651685
7464_terrestrial,94,47,59,56,141,62.76595744680851,59.57446808510638
7465_terrestrial,99,49,60,58,148,60.60606060606061,58.58585858585859
7466_terrestrial,100,50,59,60,150,59,60
7467_terrestrial,107,52,62,67,159,57.943925233644855,62.616822429906534
7468_terrestrial,105,46,60,66,151,57.14285714285714,62.857142857142854
7469_terrestrial,105,45,57,65,150,54.285714285714285,61.904761904761905
7470_terrestrial,108,40,59,66,148,54.629629629629626,61.111111111111114
7471_terrestrial,105,40,57,68,145,54.285714285714285,64.76190476190476
7472_terrestrial,103,38,56,65,141,54.36893203883495,63.10679611650486
7473_terrestrial,99,32,53,63,131,53.535353535353536,63.63636363636363
7474_terrestrial,101,33,55,65,134,54.45544554455446,64.35643564356435
7475_terrestrial,103,35,57,65,138,55.33980582524271,63.10679611650486
7476_terrestrial,104,35,58,66,139,55.769230769230774,63.46153846153846
7477_terrestrial,105,34,59,66,139,56.19047619047619,62.857142857142854
7478_terrestrial,105,36,59,66,141,56.19047619047619,62.857142857142854
7479_terrestrial,105,34,59,66,139,56.19047619047619,62.857142857142854
7480_terrestrial,102,38,57,63,140,55.88235294117647,61.76470588235294
7481_terrestrial,105,40,58,65,145,55.23809523809524,61.904761904761905
7482_terrestrial,105,42,58,65,147,55.23809523809524,61.904761904761905
7483_terrestrial,104,43,58,64,147,55.769230769230774,61.53846153846154
7484_terrestrial,105,43,58,66,148,55.23809523809524,62.857142857142854
7485_terrestrial,107,43,60,68,150,56.074766355140184,63.55140186915887
7486_terrestrial,106,43,59,67,149,55.660377358490564,63.20754716981132
7487_terrestrial,107,43,59,68,150,55.140186915887845,63.55140186915887
7488_terrestrial,102,39,57,64,141,55.88235294117647,62.745098039215684
7489_terrestrial,98,39,55,60,137,56.12244897959183,61.224489795918366
7490_terrestrial,97,41,54,59,138,55.670103092783506,60.824742268041234
7491_terrestrial,98,41,55,62,139,56.12244897959183,63.26530612244898
7492_terrestrial,99,43,56,63,142,56.56565656565656,63.63636363636363
7493_terrestrial,101,43,57,65,144,56.43564356435643,64.35643564356435
7494_terrestrial,102,43,57,65,145,55.88235294117647,63.725490196078425
7495_terrestrial,102,43,55,65,145,53.92156862745098,63.725490196078425
7496_terrestrial,103,43,57,65,146,55.33980582524271,63.10679611650486
7497_terrestrial,102,43,57,64,145,55.88235294117647,62.745098039215684
7498_terrestrial,104,43,58,65,147,55.769230769230774,62.5
7499_terrestrial,107,41,59,68,148,55.140186915887845,63.55140186915887
7500_terrestrial,105,41,59,68,146,56.19047619047619,64.76190476190476
7501_terrestrial,106,41,59,69,147,55.660377358490564,65.09433962264151
7502_terrestrial,106,41,59,69,147,55.660377358490564,65.09433962264151
7503_terrestrial,107,41,60,68,148,56.074766355140184,63.55140186915887
7504_terrestrial,108,43,61,69,151,56.481481481481474,63.888888888888886
7516_terrestrial,125,47,75,74,172,60,59.199999999999996
7517_terrestrial,121,41,71,73,162,58.67768595041323,60.33057851239669
7518_terrestrial,118,43,71,73,161,60.16949152542372,61.86440677966102
7519_terrestrial,114,39,68,70,153,59.64912280701754,61.40350877192983
7520_terrestrial,106,36,63,62,142,59.43396226415094,58.490566037735846
7521_terrestrial,106,37,63,62,143,59.43396226415094,58.490566037735846
7522_terrestrial,109,42,66,65,151,60.550458715596335,59.63302752293578
7523_terrestrial,109,44,66,65,153,60.550458715596335,59.63302752293578
7524_terrestrial,112,45,67,67,157,59.82142857142857,59.82142857142857
7525_terrestrial,114,45,70,70,159,61.40350877192983,61.40350877192983
7526_terrestrial,115,43,69,71,158,60,61.73913043478261
7527_terrestrial,114,47,68,72,161,59.64912280701754,63.1578947368421
7528_terrestrial,110,49,64,71,159,58.18181818181818,64.54545454545455
7529_terrestrial,113,49,66,73,162,58.4070796460177,64.60176991150442
7530_terrestrial,113,44,65,75,157,57.52212389380531,66.3716814159292
7531_terrestrial,114,46,68,74,160,59.64912280701754,64.91228070175438
7532_terrestrial,113,48,69,72,161,61.06194690265486,63.716814159292035
7533_terrestrial,109,46,66,68,155,60.550458715596335,62.38532110091744
7534_terrestrial,109,48,67,68,157,61.46788990825688,62.38532110091744
7535_terrestrial,108,44,65,69,152,60.18518518518518,63.888888888888886
7536_terrestrial,109,44,66,70,153,60.550458715596335,64.22018348623854
7537_terrestrial,108,46,67,68,154,62.03703703703704,62.96296296296296
7538_terrestrial,104,46,62,67,150,59.61538461538461,64.42307692307693
7539_terrestrial,106,47,65,66,153,61.32075471698113,62.264150943396224
7540_terrestrial,111,60,71,64,171,63.96396396396396,57.65765765765766
7541_terrestrial,110,60,71,63,170,64.54545454545455,57.27272727272727
7542_terrestrial,108,62,72,57,170,66.66666666666666,52.77777777777778
7543_terrestrial,96,53,64,51,149,66.66666666666666,53.125
7544_terrestrial,92,48,61,45,140,66.30434782608695,48.91304347826087
7545_terrestrial,89,44,58,43,133,65.1685393258427,48.31460674157304
7546_terrestrial,87,46,56,41,133,64.36781609195403,47.12643678160919
7547_terrestrial,85,47,57,39,132,67.05882352941175,45.88235294117647
7548_terrestrial,91,47,64,42,138,70.32967032967034,46.15384615384615
7549_terrestrial,91,45,64,43,136,70.32967032967034,47.25274725274725
7550_terrestrial,91,45,64,43,136,70.32967032967034,47.25274725274725
7551_terrestrial,88,53,61,40,141,69.31818181818183,45.45454545454545
7552_terrestrial,88,55,61,41,143,69.31818181818183,46.590909090909086
7553_terrestrial,89,50,61,42,139,68.53932584269663,47.19101123595505
7554_terrestrial,89,47,61,42,136,68.53932584269663,47.19101123595505
7555_terrestrial,90,44,62,43,134,68.88888888888889,47.77777777777778
7556_terrestrial,90,44,62,43,134,68.88888888888889,47.77777777777778
7557_terrestrial,89,45,61,42,134,68.53932584269663,47.19101123595505
7558_terrestrial,87,45,58,42,132,66.66666666666666,48.275862068965516
7559_terrestrial,87,45,58,43,132,66.66666666666666,49.42528735632184
7560_terrestrial,74,34,45,42,108,60.810810810810814,56.75675675675676
7561_terrestrial,88,44,60,43,132,68.18181818181817,48.86363636363637
7562_terrestrial,88,44,60,43,132,68.18181818181817,48.86363636363637
7563_terrestrial,85,44,57,42,129,67.05882352941175,49.411764705882355
7564_terrestrial,83,44,57,39,127,68.67469879518072,46.98795180722892
7574_terrestrial,114,55,66,56,169,57.89473684210527,49.122807017543856
7575_terrestrial,115,56,66,55,171,57.391304347826086,47.82608695652174
7576_terrestrial,112,56,65,52,168,58.03571428571429,46.42857142857143
7577_terrestrial,118,58,65,57,176,55.08474576271186,48.30508474576271
7578_terrestrial,101,43,45,61,144,44.554455445544555,60.396039603960396
7579_terrestrial,99,42,43,63,141,43.43434343434344,63.63636363636363
7580_terrestrial,99,42,42,62,141,42.42424242424242,62.62626262626263
7581_terrestrial,98,43,41,60,141,41.83673469387755,61.224489795918366
7582_terrestrial,98,46,41,60,144,41.83673469387755,61.224489795918366
7583_terrestrial,97,48,41,60,145,42.2680412371134,61.855670103092784
7584_terrestrial,99,49,41,62,148,41.41414141414141,62.62626262626263
7585_terrestrial,100,49,41,63,149,41,63
7586_terrestrial,103,48,42,66,151,40.77669902912621,64.07766990291263
7587_terrestrial,107,47,43,68,154,40.18691588785047,63.55140186915887
7588_terrestrial,108,48,42,67,156,38.88888888888889,62.03703703703704
7589_terrestrial,114,48,46,73,162,40.35087719298245,64.03508771929825
7590_terrestrial,113,51,45,72,164,39.823008849557525,63.716814159292035
7591_terrestrial,118,53,49,75,171,41.52542372881356,63.559322033898304
7592_terrestrial,119,56,51,76,175,42.857142857142854,63.86554621848739
7593_terrestrial,122,57,52,78,179,42.62295081967213,63.934426229508205
7594_terrestrial,116,55,49,74,171,42.241379310344826,63.793103448275865
7595_terrestrial,118,54,51,73,172,43.22033898305085,61.86440677966102
7596_terrestrial,115,55,50,70,170,43.47826086956522,60.86956521739131
7597_terrestrial,108,57,47,66,165,43.51851851851852,61.111111111111114
7598_terrestrial,111,56,49,67,167,44.14414414414414,60.36036036036037
7599_terrestrial,117,57,51,70,174,43.58974358974359,59.82905982905983
7600_terrestrial,117,56,53,73,173,45.2991452991453,62.39316239316239
7601_terrestrial,117,56,53,73,173,45.2991452991453,62.39316239316239
7602_terrestrial,123,59,56,79,182,45.52845528455284,64.22764227642277
7603_terrestrial,134,74,63,85,208,47.01492537313433,63.43283582089553
7604_terrestrial,133,74,62,82,207,46.616541353383454,61.65413533834586
7605_terrestrial,135,67,63,83,202,46.666666666666664,61.48148148148148
7606_terrestrial,128,54,57,82,182,44.53125,64.0625
7607_terrestrial,127,59,57,83,186,44.881889763779526,65.35433070866141
7608_terrestrial,120,56,56,77,176,46.666666666666664,64.16666666666667
7609_terrestrial,116,51,52,75,167,44.827586206896555,64.65517241379311
7610_terrestrial,117,52,52,76,169,44.44444444444444,64.95726495726495
7611_terrestrial,112,51,48,73,163,42.857142857142854,65.17857142857143
7612_terrestrial,111,51,47,72,162,42.34234234234234,64.86486486486487
7613_terrestrial,110,46,48,73,156,43.63636363636363,66.36363636363637
7614_terrestrial,103,45,47,70,148,45.63106796116505,67.96116504854369
7615_terrestrial,99,45,45,66,144,45.45454545454545,66.66666666666666
7616_terrestrial,97,43,46,64,140,47.42268041237113,65.97938144329896
7617_terrestrial,89,37,41,59,126,46.06741573033708,66.29213483146067
7618_terrestrial,84,35,40,54,119,47.61904761904761,64.28571428571429
7619_terrestrial,85,32,42,53,117,49.411764705882355,62.35294117647059
7620_terrestrial,81,30,39,49,111,48.148148148148145,60.49382716049383
7621_terrestrial,78,29,37,48,107,47.43589743589743,61.53846153846154
7622_terrestrial,74,27,35,45,101,47.2972972972973,60.810810810810814
7623_terrestrial,74,34,36,43,108,48.64864864864865,58.108108108108105
7624_terrestrial,73,33,37,41,106,50.68493150684932,56.16438356164384
7625_terrestrial,72,33,37,40,105,51.388888888888886,55.55555555555556
7626_terrestrial,71,32,37,39,103,52.112676056338024,54.929577464788736
7627_terrestrial,79,32,44,40,111,55.69620253164557,50.63291139240506
7628_terrestrial,51,17,31,28,68,60.78431372549019,54.90196078431373
7629_terrestrial,51,16,31,28,67,60.78431372549019,54.90196078431373
7630_terrestrial,51,16,32,28,67,62.745098039215684,54.90196078431373
7631_terrestrial,57,17,35,34,74,61.40350877192983,59.64912280701754
7632_terrestrial,73,26,43,34,99,58.9041095890411,46.57534246575342
7633_terrestrial,73,28,43,34,101,58.9041095890411,46.57534246575342
7634_terrestrial,61,30,32,33,91,52.459016393442624,54.09836065573771
7635_terrestrial,74,26,43,35,100,58.108108108108105,47.2972972972973
7636_terrestrial,75,24,43,36,99,57.333333333333336,48
7637_terrestrial,75,24,43,36,99,57.333333333333336,48
7638_terrestrial,55,14,35,32,69,63.63636363636363,58.18181818181818
7639_terrestrial,55,14,35,32,69,63.63636363636363,58.18181818181818
7640_terrestrial,35,12,24,26,47,68.57142857142857,74.28571428571429
7641_terrestrial,44,12,30,29,56,68.18181818181817,65.9090909090909
7642_terrestrial,65,23,38,33,88,58.46153846153847,50.76923076923077
7643_terrestrial,65,23,38,33,88,58.46153846153847,50.76923076923077
7644_terrestrial,65,23,38,33,88,58.46153846153847,50.76923076923077
7645_terrestrial,65,23,38,33,88,58.46153846153847,50.76923076923077
7646_terrestrial,53,22,30,26,75,56.60377358490566,49.056603773584904
7647_terrestrial,53,25,30,26,78,56.60377358490566,49.056603773584904
7648_terrestrial,50,20,27,26,70,54,52
7649_terrestrial,49,20,26,26,69,53.06122448979592,53.06122448979592
7650_terrestrial,54,26,30,28,80,55.55555555555556,51.85185185185185
7651_terrestrial,54,27,30,28,81,55.55555555555556,51.85185185185185
7652_terrestrial,53,24,30,27,77,56.60377358490566,50.943396226415096
7653_terrestrial,52,24,29,26,76,55.769230769230774,50
7654_terrestrial,57,24,32,31,81,56.14035087719298,54.385964912280706
7655_terrestrial,57,23,32,30,80,56.14035087719298,52.63157894736842
7656_terrestrial,58,23,33,30,81,56.896551724137936,51.724137931034484
7657_terrestrial,51,16,28,27,67,54.90196078431373,52.94117647058824
7658_terrestrial,62,27,37,30,89,59.67741935483871,48.38709677419355
7659_terrestrial,61,25,37,29,86,60.65573770491803,47.540983606557376
7661_terrestrial,32,16,23,18,48,71.875,56.25
7662_terrestrial,32,16,23,18,48,71.875,56.25
7663_terrestrial,39,15,27,21,54,69.23076923076923,53.84615384615385
7664_terrestrial,52,19,31,23,71,59.61538461538461,44.230769230769226
7665_terrestrial,52,19,31,23,71,59.61538461538461,44.230769230769226
7666_terrestrial,50,19,30,22,69,60,44
7667_terrestrial,53,19,33,23,72,62.264150943396224,43.39622641509434
7668_terrestrial,54,19,34,24,73,62.96296296296296,44.44444444444444
7669_terrestrial,44,10,23,22,54,52.27272727272727,50
7670_terrestrial,43,10,23,21,53,53.48837209302325,48.837209302325576
7671_terrestrial,61,23,39,24,84,63.934426229508205,39.34426229508197
7672_terrestrial,60,25,38,21,85,63.33333333333333,35
7673_terrestrial,60,25,39,21,85,65,35
7674_terrestrial,61,25,40,21,86,65.57377049180327,34.42622950819672
7675_terrestrial,60,25,39,21,85,65,35
7676_terrestrial,38,9,19,17,47,50,44.73684210526316
7687_terrestrial,75,24,54,32,99,72,42.66666666666667
7688_terrestrial,77,26,56,32,103,72.72727272727273,41.55844155844156
7689_terrestrial,78,26,57,33,104,73.07692307692307,42.30769230769231
7690_terrestrial,77,26,56,33,103,72.72727272727273,42.857142857142854
7691_terrestrial,43,6,27,25,49,62.7906976744186,58.139534883720934
7692_terrestrial,26,6,16,14,32,61.53846153846154,53.84615384615385
7693_terrestrial,10,5,5,5,15,50,50
7694_terrestrial,5,4,1,2,9,20,40
7695_terrestrial,4,3,1,1,7,25,25
7696_terrestrial,4,3,1,1,7,25,25
7697_terrestrial,3,3,1,1,6,33.33333333333333,33.33333333333333
7698_terrestrial,4,3,1,2,7,25,50
7699_terrestrial,5,3,2,2,8,40,40
7700_terrestrial,5,3,2,2,8,40,40
7701_terrestrial,7,3,2,2,10,28.57142857142857,28.57142857142857
7702_terrestrial,9,3,3,4,12,33.33333333333333,44.44444444444444
7703_terrestrial,14,4,4,8,18,28.57142857142857,57.14285714285714
7704_terrestrial,21,4,10,14,25,47.61904761904761,66.66666666666666
7705_terrestrial,26,5,14,17,31,53.84615384615385,65.38461538461539
7706_terrestrial,25,5,14,16,30,56.00000000000001,64
7707_terrestrial,26,6,15,16,32,57.692307692307686,61.53846153846154
7708_terrestrial,68,29,53,26,97,77.94117647058823,38.23529411764706
7709_terrestrial,72,33,57,26,105,79.16666666666666,36.11111111111111
7710_terrestrial,72,31,57,26,103,79.16666666666666,36.11111111111111
7711_terrestrial,67,27,53,23,94,79.1044776119403,34.32835820895522
7712_terrestrial,71,26,57,25,97,80.28169014084507,35.2112676056338
7713_terrestrial,75,26,60,26,101,80,34.66666666666667
7714_terrestrial,74,26,60,25,100,81.08108108108108,33.78378378378378
7715_terrestrial,73,24,59,26,97,80.82191780821918,35.61643835616438
7753_terrestrial,132,64,100,81,196,75.75757575757575,61.36363636363637
7754_terrestrial,153,71,117,93,224,76.47058823529412,60.78431372549019
7755_terrestrial,177,76,130,108,253,73.44632768361582,61.016949152542374
7779_terrestrial,141,62,94,87,203,66.66666666666666,61.702127659574465
7780_terrestrial,132,62,86,83,194,65.15151515151516,62.878787878787875
7781_terrestrial,78,35,53,53,113,67.94871794871796,67.94871794871796
7784_terrestrial,104,55,65,56,159,62.5,53.84615384615385
7785_terrestrial,108,53,67,58,161,62.03703703703704,53.70370370370371
7786_terrestrial,105,53,64,58,158,60.952380952380956,55.23809523809524
7787_terrestrial,105,53,65,57,158,61.904761904761905,54.285714285714285
7789_terrestrial,69,27,48,41,96,69.56521739130434,59.42028985507246
7790_terrestrial,108,56,69,57,164,63.888888888888886,52.77777777777778
7800_terrestrial,110,60,72,57,170,65.45454545454545,51.81818181818182
7801_terrestrial,111,58,74,58,169,66.66666666666666,52.25225225225225
7802_terrestrial,113,58,75,61,171,66.3716814159292,53.98230088495575
7803_terrestrial,95,44,59,56,139,62.10526315789474,58.94736842105262
7804_terrestrial,91,47,55,55,138,60.43956043956044,60.43956043956044
7805_terrestrial,89,47,52,53,136,58.42696629213483,59.55056179775281
7806_terrestrial,89,51,52,54,140,58.42696629213483,60.67415730337079
7807_terrestrial,103,61,65,55,164,63.10679611650486,53.398058252427184
7808_terrestrial,104,56,67,56,160,64.42307692307693,53.84615384615385
7809_terrestrial,99,48,62,59,147,62.62626262626263,59.59595959595959
7810_terrestrial,97,47,63,57,144,64.94845360824742,58.76288659793815
7811_terrestrial,78,41,48,49,119,61.53846153846154,62.82051282051282
7812_terrestrial,81,41,51,51,122,62.96296296296296,62.96296296296296
7813_terrestrial,91,45,60,55,136,65.93406593406593,60.43956043956044
7814_terrestrial,84,46,53,50,130,63.095238095238095,59.523809523809526
7815_terrestrial,86,45,54,49,131,62.7906976744186,56.97674418604651
7816_terrestrial,87,46,55,50,133,63.2183908045977,57.47126436781609
7817_terrestrial,86,48,53,50,134,61.627906976744185,58.139534883720934
7818_terrestrial,87,46,53,51,133,60.91954022988506,58.620689655172406
7819_terrestrial,87,49,54,51,136,62.06896551724138,58.620689655172406
7820_terrestrial,81,43,46,51,124,56.79012345679012,62.96296296296296
7821_terrestrial,83,38,48,52,121,57.831325301204814,62.65060240963856
7822_terrestrial,86,42,49,55,128,56.97674418604651,63.95348837209303
7823_terrestrial,89,44,52,56,133,58.42696629213483,62.92134831460674
7824_terrestrial,91,46,53,57,137,58.24175824175825,62.637362637362635
7825_terrestrial,98,49,60,65,147,61.224489795918366,66.3265306122449
7826_terrestrial,109,50,64,70,159,58.71559633027523,64.22018348623854
7829_terrestrial,113,50,59,74,163,52.21238938053098,65.48672566371681
7830_terrestrial,120,47,64,77,167,53.333333333333336,64.16666666666667
7831_terrestrial,116,45,62,77,161,53.44827586206896,66.37931034482759
7832_terrestrial,114,41,63,74,155,55.26315789473685,64.91228070175438
7833_terrestrial,113,40,64,75,153,56.63716814159292,66.3716814159292
7834_terrestrial,111,38,62,75,149,55.85585585585585,67.56756756756756
7835_terrestrial,111,38,63,73,149,56.75675675675676,65.76576576576578
7836_terrestrial,113,38,65,75,151,57.52212389380531,66.3716814159292
7837_terrestrial,113,38,65,75,151,57.52212389380531,66.3716814159292
7838_terrestrial,112,38,64,73,150,57.14285714285714,65.17857142857143
7839_terrestrial,115,42,66,76,157,57.391304347826086,66.08695652173913
7840_terrestrial,113,42,64,75,155,56.63716814159292,66.3716814159292
7841_terrestrial,113,44,64,76,157,56.63716814159292,67.2566371681416
7842_terrestrial,112,44,64,75,156,57.14285714285714,66.96428571428571
7843_terrestrial,113,40,65,74,153,57.52212389380531,65.48672566371681
7844_terrestrial,113,38,63,76,151,55.75221238938053,67.2566371681416
7845_terrestrial,116,39,65,78,155,56.03448275862068,67.24137931034483
7846_terrestrial,114,39,63,76,153,55.26315789473685,66.66666666666666
7847_terrestrial,110,41,61,74,151,55.45454545454545,67.27272727272727
7848_terrestrial,111,39,62,75,150,55.85585585585585,67.56756756756756
7849_terrestrial,112,38,63,75,150,56.25,66.96428571428571
7850_terrestrial,113,39,63,76,152,55.75221238938053,67.2566371681416
7851_terrestrial,112,38,62,77,150,55.35714285714286,68.75
7852_terrestrial,112,39,62,77,151,55.35714285714286,68.75
7853_terrestrial,114,41,64,78,155,56.14035087719298,68.42105263157895
7854_terrestrial,115,41,64,79,156,55.65217391304348,68.69565217391305
7855_terrestrial,115,41,65,78,156,56.52173913043478,67.82608695652173
7856_terrestrial,114,42,65,77,156,57.01754385964912,67.54385964912281
7857_terrestrial,109,42,62,72,151,56.88073394495413,66.05504587155964
7858_terrestrial,108,42,61,71,150,56.481481481481474,65.74074074074075
7859_terrestrial,108,42,60,71,150,55.55555555555556,65.74074074074075
7860_terrestrial,108,40,60,71,148,55.55555555555556,65.74074074074075
7861_terrestrial,110,41,59,72,151,53.63636363636364,65.45454545454545
7862_terrestrial,110,41,60,72,151,54.54545454545454,65.45454545454545
7863_terrestrial,110,43,60,72,153,54.54545454545454,65.45454545454545
7887_terrestrial,115,46,64,74,161,55.65217391304348,64.34782608695652
7888_terrestrial,113,46,63,73,159,55.75221238938053,64.60176991150442
7889_terrestrial,115,44,65,75,159,56.52173913043478,65.21739130434783
7890_terrestrial,114,41,64,75,155,56.14035087719298,65.78947368421053
7891_terrestrial,115,41,65,74,156,56.52173913043478,64.34782608695652
7892_terrestrial,120,45,67,76,165,55.833333333333336,63.33333333333333
7893_terrestrial,122,45,67,79,167,54.91803278688525,64.75409836065575
7894_terrestrial,124,46,68,81,170,54.83870967741935,65.32258064516128
7895_terrestrial,124,46,68,81,170,54.83870967741935,65.32258064516128
7896_terrestrial,122,44,69,79,166,56.557377049180324,64.75409836065575
7897_terrestrial,125,47,72,81,172,57.599999999999994,64.8
7898_terrestrial,127,51,75,80,178,59.055118110236215,62.99212598425197
7899_terrestrial,129,56,76,82,185,58.91472868217055,63.565891472868216
7900_terrestrial,129,58,76,82,187,58.91472868217055,63.565891472868216
7901_terrestrial,136,57,81,84,193,59.55882352941176,61.76470588235294
7902_terrestrial,138,57,82,86,195,59.42028985507246,62.31884057971014
7903_terrestrial,130,55,78,82,185,60,63.07692307692307
7904_terrestrial,125,52,76,77,177,60.8,61.6
7905_terrestrial,119,43,71,72,162,59.66386554621849,60.50420168067227
7906_terrestrial,119,45,71,71,164,59.66386554621849,59.66386554621849
7907_terrestrial,112,46,68,70,158,60.71428571428571,62.5
7908_terrestrial,111,47,68,67,158,61.261261261261254,60.36036036036037
7909_terrestrial,104,46,63,62,150,60.57692307692307,59.61538461538461
7910_terrestrial,109,54,73,59,163,66.97247706422019,54.12844036697248
7911_terrestrial,105,56,71,55,161,67.61904761904762,52.38095238095239
7912_terrestrial,90,48,57,52,138,63.33333333333333,57.77777777777777
7913_terrestrial,86,48,53,49,134,61.627906976744185,56.97674418604651
7914_terrestrial,80,43,50,44,123,62.5,55.00000000000001
7915_terrestrial,78,41,49,43,119,62.82051282051282,55.12820512820513
7916_terrestrial,78,37,48,42,115,61.53846153846154,53.84615384615385
7917_terrestrial,75,37,47,39,112,62.66666666666667,52
7918_terrestrial,78,36,47,42,114,60.256410256410255,53.84615384615385
7919_terrestrial,78,36,47,45,114,60.256410256410255,57.692307692307686
7920_terrestrial,95,44,63,48,139,66.3157894736842,50.526315789473685
7921_terrestrial,66,36,37,38,102,56.060606060606055,57.57575757575758
7922_terrestrial,64,35,37,37,99,57.8125,57.8125
7923_terrestrial,66,31,39,39,97,59.09090909090909,59.09090909090909
7924_terrestrial,86,47,57,42,133,66.27906976744185,48.837209302325576
7925_terrestrial,90,45,58,45,135,64.44444444444444,50
7926_terrestrial,91,46,59,44,137,64.83516483516483,48.35164835164835
7927_terrestrial,93,46,59,46,139,63.44086021505376,49.46236559139785
7928_terrestrial,91,46,58,45,137,63.73626373626373,49.45054945054945
7935_terrestrial,91,39,48,49,130,52.74725274725275,53.84615384615385
7936_terrestrial,117,58,66,60,175,56.41025641025641,51.28205128205128
7937_terrestrial,139,69,78,78,208,56.11510791366906,56.11510791366906
7938_terrestrial,147,73,80,86,220,54.421768707483,58.50340136054422
7939_terrestrial,151,74,77,89,225,50.993377483443716,58.94039735099338
7940_terrestrial,127,55,53,85,182,41.732283464566926,66.92913385826772
7941_terrestrial,118,56,49,77,174,41.52542372881356,65.2542372881356
7942_terrestrial,115,54,43,76,169,37.391304347826086,66.08695652173913
7943_terrestrial,114,53,40,76,167,35.08771929824561,66.66666666666666
7944_terrestrial,118,55,42,80,173,35.59322033898305,67.79661016949152
7945_terrestrial,113,55,41,77,168,36.283185840707965,68.14159292035397
7946_terrestrial,116,60,44,80,176,37.93103448275862,68.96551724137932
7947_terrestrial,120,63,45,82,183,37.5,68.33333333333333
7948_terrestrial,120,64,45,82,184,37.5,68.33333333333333
7949_terrestrial,122,62,47,83,184,38.52459016393443,68.0327868852459
7950_terrestrial,124,64,49,85,188,39.516129032258064,68.54838709677419
7951_terrestrial,125,64,49,87,189,39.2,69.6
7952_terrestrial,123,63,47,85,186,38.21138211382114,69.10569105691057
7953_terrestrial,124,68,48,86,192,38.70967741935484,69.35483870967742
7954_terrestrial,125,70,48,87,195,38.4,69.6
7955_terrestrial,127,70,49,89,197,38.582677165354326,70.07874015748031
7956_terrestrial,127,70,47,89,197,37.00787401574803,70.07874015748031
7957_terrestrial,125,65,48,87,190,38.4,69.6
7958_terrestrial,121,68,45,83,189,37.1900826446281,68.59504132231406
7959_terrestrial,122,68,45,81,190,36.885245901639344,66.39344262295081
7960_terrestrial,122,65,47,83,187,38.52459016393443,68.0327868852459
7961_terrestrial,115,64,47,77,179,40.869565217391305,66.95652173913044
7962_terrestrial,117,65,47,79,182,40.17094017094017,67.52136752136752
7963_terrestrial,123,66,50,86,189,40.65040650406504,69.91869918699187
7964_terrestrial,126,64,51,84,190,40.476190476190474,66.66666666666666
7965_terrestrial,126,62,53,83,188,42.06349206349206,65.87301587301587
7966_terrestrial,128,60,55,85,188,42.96875,66.40625
7967_terrestrial,122,56,51,83,178,41.80327868852459,68.0327868852459
7968_terrestrial,116,57,47,80,173,40.51724137931034,68.96551724137932
7969_terrestrial,115,55,48,78,170,41.73913043478261,67.82608695652173
7970_terrestrial,115,57,48,78,172,41.73913043478261,67.82608695652173
7971_terrestrial,120,52,54,78,172,45,65
7972_terrestrial,117,51,50,76,168,42.73504273504273,64.95726495726495
7973_terrestrial,116,47,49,75,163,42.241379310344826,64.65517241379311
7974_terrestrial,109,46,48,72,155,44.03669724770643,66.05504587155964
7975_terrestrial,105,43,47,69,148,44.761904761904766,65.71428571428571
7976_terrestrial,103,42,47,67,145,45.63106796116505,65.0485436893204
7977_terrestrial,103,41,46,65,144,44.66019417475729,63.10679611650486
7978_terrestrial,103,45,47,66,148,45.63106796116505,64.07766990291263
7979_terrestrial,99,45,45,62,144,45.45454545454545,62.62626262626263
7980_terrestrial,99,45,46,62,144,46.464646464646464,62.62626262626263
7981_terrestrial,99,42,48,62,141,48.484848484848484,62.62626262626263
7982_terrestrial,99,40,45,64,139,45.45454545454545,64.64646464646465
7983_terrestrial,90,37,39,56,127,43.333333333333336,62.22222222222222
7984_terrestrial,82,33,36,50,115,43.90243902439025,60.97560975609756
7985_terrestrial,79,33,37,46,112,46.835443037974684,58.22784810126582
7986_terrestrial,70,32,33,41,102,47.14285714285714,58.57142857142858
7987_terrestrial,67,30,32,38,97,47.76119402985074,56.71641791044776
7988_terrestrial,67,30,32,38,97,47.76119402985074,56.71641791044776
7989_terrestrial,67,29,32,38,96,47.76119402985074,56.71641791044776
7990_terrestrial,64,29,32,36,93,50,56.25
7991_terrestrial,66,28,34,36,94,51.515151515151516,54.54545454545454
7992_terrestrial,64,28,33,36,92,51.5625,56.25
7993_terrestrial,63,28,33,35,91,52.38095238095239,55.55555555555556
7994_terrestrial,60,24,31,34,84,51.66666666666667,56.666666666666664
7995_terrestrial,59,23,31,33,82,52.54237288135594,55.932203389830505
7996_terrestrial,63,24,33,35,87,52.38095238095239,55.55555555555556
7997_terrestrial,63,24,33,35,87,52.38095238095239,55.55555555555556
7998_terrestrial,63,24,34,36,87,53.96825396825397,57.14285714285714
7999_terrestrial,62,24,34,35,86,54.83870967741935,56.451612903225815
8000_terrestrial,61,24,33,34,85,54.09836065573771,55.73770491803278
8001_terrestrial,61,23,33,34,84,54.09836065573771,55.73770491803278
8002_terrestrial,61,23,33,34,84,54.09836065573771,55.73770491803278
8003_terrestrial,56,19,29,31,75,51.78571428571429,55.35714285714286
8004_terrestrial,58,22,31,31,80,53.44827586206896,53.44827586206896
8005_terrestrial,59,22,33,30,81,55.932203389830505,50.847457627118644
8006_terrestrial,53,20,28,28,73,52.83018867924528,52.83018867924528
8007_terrestrial,52,20,28,27,72,53.84615384615385,51.92307692307693
8008_terrestrial,51,19,27,26,70,52.94117647058824,50.98039215686274
8009_terrestrial,50,19,26,26,69,52,52
8010_terrestrial,50,18,27,26,68,54,52
8011_terrestrial,49,17,26,26,66,53.06122448979592,53.06122448979592
8012_terrestrial,54,25,30,28,79,55.55555555555556,51.85185185185185
8013_terrestrial,55,24,31,29,79,56.36363636363636,52.72727272727272
8014_terrestrial,57,24,32,31,81,56.14035087719298,54.385964912280706
8015_terrestrial,52,16,29,28,68,55.769230769230774,53.84615384615385
8016_terrestrial,61,27,37,28,88,60.65573770491803,45.90163934426229
8017_terrestrial,51,16,28,27,67,54.90196078431373,52.94117647058824
8018_terrestrial,62,27,37,30,89,59.67741935483871,48.38709677419355
8019_terrestrial,63,27,38,30,90,60.317460317460316,47.61904761904761
8023_terrestrial,39,15,27,21,54,69.23076923076923,53.84615384615385
8024_terrestrial,31,6,19,20,37,61.29032258064516,64.51612903225806
8025_terrestrial,39,15,27,21,54,69.23076923076923,53.84615384615385
8026_terrestrial,34,15,24,19,49,70.58823529411765,55.88235294117647
8027_terrestrial,34,15,24,19,49,70.58823529411765,55.88235294117647
8028_terrestrial,58,21,38,27,79,65.51724137931035,46.55172413793103
8029_terrestrial,49,12,29,27,61,59.183673469387756,55.10204081632652
8030_terrestrial,45,12,26,24,57,57.77777777777777,53.333333333333336
8031_terrestrial,43,12,23,22,55,53.48837209302325,51.162790697674424
8032_terrestrial,45,11,25,23,56,55.55555555555556,51.11111111111111
8033_terrestrial,61,25,39,24,86,63.934426229508205,39.34426229508197
8034_terrestrial,62,27,41,22,89,66.12903225806451,35.483870967741936
8035_terrestrial,62,26,41,23,88,66.12903225806451,37.096774193548384
8036_terrestrial,64,27,43,23,91,67.1875,35.9375
8037_terrestrial,66,27,45,23,93,68.18181818181817,34.84848484848485
8038_terrestrial,67,27,46,23,94,68.65671641791045,34.32835820895522
8039_terrestrial,65,25,44,23,90,67.6923076923077,35.38461538461539
8047_terrestrial,81,28,59,36,109,72.8395061728395,44.44444444444444
8048_terrestrial,80,28,58,35,108,72.5,43.75
8049_terrestrial,81,28,59,34,109,72.8395061728395,41.9753086419753
8050_terrestrial,81,26,60,32,107,74.07407407407408,39.50617283950617
8051_terrestrial,73,24,53,27,97,72.6027397260274,36.986301369863014
8052_terrestrial,25,6,15,11,31,60,44
8053_terrestrial,7,5,2,4,12,28.57142857142857,57.14285714285714
8054_terrestrial,5,3,1,2,8,20,40
8055_terrestrial,5,3,1,2,8,20,40
8056_terrestrial,4,3,1,1,7,25,25
8057_terrestrial,4,3,1,2,7,25,50
8058_terrestrial,4,3,1,2,7,25,50
8059_terrestrial,8,3,3,3,11,37.5,37.5
8060_terrestrial,10,3,3,4,13,30,40
8061_terrestrial,15,5,6,9,20,40,60
8062_terrestrial,23,6,12,13,29,52.17391304347826,56.52173913043478
8063_terrestrial,25,6,14,15,31,56.00000000000001,60
8064_terrestrial,27,7,14,17,34,51.85185185185185,62.96296296296296
8065_terrestrial,29,7,15,18,36,51.724137931034484,62.06896551724138
8066_terrestrial,69,23,51,26,92,73.91304347826086,37.68115942028986
8067_terrestrial,73,25,55,28,98,75.34246575342466,38.35616438356164
8068_terrestrial,71,24,56,27,95,78.87323943661971,38.028169014084504
8113_terrestrial,139,68,107,84,207,76.97841726618705,60.431654676258994
8138_terrestrial,147,50,85,109,197,57.82312925170068,74.14965986394559
8139_terrestrial,150,51,90,109,201,60,72.66666666666667
8140_terrestrial,168,69,105,110,237,62.5,65.47619047619048
8141_terrestrial,160,67,100,100,227,62.5,62.5
8142_terrestrial,140,63,94,85,203,67.14285714285714,60.71428571428571
8144_terrestrial,108,56,66,61,164,61.111111111111114,56.481481481481474
8145_terrestrial,127,60,82,71,187,64.56692913385827,55.90551181102362
8146_terrestrial,123,60,79,70,183,64.22764227642277,56.91056910569105
8147_terrestrial,106,53,65,58,159,61.32075471698113,54.71698113207547
8173_terrestrial,94,50,57,54,144,60.63829787234043,57.446808510638306
8174_terrestrial,96,49,59,54,145,61.458333333333336,56.25
8175_terrestrial,90,52,53,50,142,58.88888888888889,55.55555555555556
8176_terrestrial,83,47,47,49,130,56.62650602409639,59.036144578313255
8177_terrestrial,86,47,50,52,133,58.139534883720934,60.46511627906976
8178_terrestrial,95,54,57,56,149,60,58.94736842105262
8179_terrestrial,102,56,61,63,158,59.80392156862745,61.76470588235294
8180_terrestrial,105,59,64,65,164,60.952380952380956,61.904761904761905
8181_terrestrial,109,58,69,68,167,63.30275229357798,62.38532110091744
8182_terrestrial,104,49,60,70,153,57.692307692307686,67.3076923076923
8189_terrestrial,126,48,68,87,174,53.96825396825397,69.04761904761905
8190_terrestrial,120,46,66,84,166,55.00000000000001,70
8191_terrestrial,117,46,64,83,163,54.700854700854705,70.94017094017094
8192_terrestrial,116,42,63,83,158,54.310344827586206,71.55172413793103
8193_terrestrial,116,42,64,81,158,55.172413793103445,69.82758620689656
8194_terrestrial,114,40,62,80,154,54.385964912280706,70.17543859649122
8195_terrestrial,117,40,65,81,157,55.55555555555556,69.23076923076923
8196_terrestrial,117,43,64,81,160,54.700854700854705,69.23076923076923
8197_terrestrial,115,43,62,79,158,53.91304347826087,68.69565217391305
8198_terrestrial,115,43,62,79,158,53.91304347826087,68.69565217391305
8199_terrestrial,116,43,63,80,159,54.310344827586206,68.96551724137932
8200_terrestrial,115,45,63,80,160,54.78260869565217,69.56521739130434
8201_terrestrial,116,45,65,80,161,56.03448275862068,68.96551724137932
8202_terrestrial,118,43,66,82,161,55.932203389830505,69.49152542372882
8203_terrestrial,118,43,66,82,161,55.932203389830505,69.49152542372882
8204_terrestrial,117,43,65,81,160,55.55555555555556,69.23076923076923
8205_terrestrial,122,43,69,86,165,56.557377049180324,70.49180327868852
8206_terrestrial,119,41,67,83,160,56.30252100840336,69.74789915966386
8207_terrestrial,119,41,67,83,160,56.30252100840336,69.74789915966386
8208_terrestrial,117,39,66,81,156,56.41025641025641,69.23076923076923
8209_terrestrial,117,37,65,81,154,55.55555555555556,69.23076923076923
8210_terrestrial,117,37,64,81,154,54.700854700854705,69.23076923076923
8211_terrestrial,118,37,65,82,155,55.08474576271186,69.49152542372882
8212_terrestrial,116,37,63,82,153,54.310344827586206,70.6896551724138
8213_terrestrial,117,37,64,83,154,54.700854700854705,70.94017094017094
8214_terrestrial,119,37,65,84,156,54.621848739495796,70.58823529411765
8215_terrestrial,119,37,65,84,156,54.621848739495796,70.58823529411765
8216_terrestrial,119,37,66,84,156,55.46218487394958,70.58823529411765
8217_terrestrial,115,37,63,80,152,54.78260869565217,69.56521739130434
8218_terrestrial,116,39,63,81,155,54.310344827586206,69.82758620689656
8219_terrestrial,118,39,64,82,157,54.23728813559322,69.49152542372882
8220_terrestrial,119,39,64,83,158,53.78151260504202,69.74789915966386
8221_terrestrial,118,42,63,82,160,53.38983050847458,69.49152542372882
8222_terrestrial,121,42,65,85,163,53.71900826446281,70.24793388429752
8223_terrestrial,122,45,65,85,167,53.278688524590166,69.67213114754098
8257_terrestrial,130,50,74,86,180,56.92307692307692,66.15384615384615
8258_terrestrial,127,51,72,82,178,56.69291338582677,64.56692913385827
8259_terrestrial,128,53,73,82,181,57.03125,64.0625
8260_terrestrial,131,52,74,86,183,56.48854961832062,65.64885496183206
8261_terrestrial,130,54,72,86,184,55.38461538461539,66.15384615384615
8262_terrestrial,130,52,72,84,182,55.38461538461539,64.61538461538461
8263_terrestrial,129,48,71,84,177,55.03875968992248,65.11627906976744
8264_terrestrial,126,45,69,82,171,54.761904761904766,65.07936507936508
8265_terrestrial,118,42,66,75,160,55.932203389830505,63.559322033898304
8266_terrestrial,117,42,67,74,159,57.26495726495726,63.24786324786324
8267_terrestrial,113,41,66,70,154,58.4070796460177,61.94690265486725
8268_terrestrial,115,42,68,72,157,59.130434782608695,62.60869565217392
8269_terrestrial,117,41,69,73,158,58.97435897435898,62.39316239316239
8270_terrestrial,108,45,65,67,153,60.18518518518518,62.03703703703704
8271_terrestrial,109,44,66,67,153,60.550458715596335,61.46788990825688
8272_terrestrial,99,44,60,61,143,60.60606060606061,61.61616161616161
8273_terrestrial,92,43,57,56,135,61.95652173913043,60.86956521739131
8274_terrestrial,85,46,53,52,131,62.35294117647059,61.1764705882353
8275_terrestrial,83,44,52,51,127,62.65060240963856,61.44578313253012
8276_terrestrial,72,40,45,41,112,62.5,56.94444444444444
8277_terrestrial,72,37,43,41,109,59.72222222222222,56.94444444444444
8278_terrestrial,71,36,44,39,107,61.97183098591549,54.929577464788736
8279_terrestrial,66,37,40,36,103,60.60606060606061,54.54545454545454
8280_terrestrial,74,40,41,41,114,55.4054054054054,55.4054054054054
8281_terrestrial,102,58,68,46,160,66.66666666666666,45.09803921568628
8282_terrestrial,97,57,65,42,154,67.0103092783505,43.29896907216495
8283_terrestrial,62,32,36,34,94,58.06451612903226,54.83870967741935
8284_terrestrial,62,30,35,32,92,56.451612903225815,51.61290322580645
8285_terrestrial,71,33,43,39,104,60.56338028169014,54.929577464788736
8286_terrestrial,97,49,64,46,146,65.97938144329896,47.42268041237113
8287_terrestrial,96,51,63,46,147,65.625,47.91666666666667
8288_terrestrial,94,50,61,46,144,64.8936170212766,48.93617021276596
8289_terrestrial,95,50,62,47,145,65.26315789473685,49.473684210526315
8290_terrestrial,101,56,67,49,157,66.33663366336634,48.51485148514851
8291_terrestrial,98,56,65,48,154,66.3265306122449,48.97959183673469
8294_terrestrial,128,62,75,67,190,58.59375,52.34375
8295_terrestrial,130,63,76,69,193,58.46153846153847,53.07692307692308
8296_terrestrial,138,68,80,75,206,57.971014492753625,54.347826086956516
8297_terrestrial,138,70,81,75,208,58.69565217391305,54.347826086956516
8298_terrestrial,149,74,82,87,223,55.033557046979865,58.38926174496645
8299_terrestrial,157,82,82,96,239,52.22929936305732,61.146496815286625
8300_terrestrial,159,89,81,96,248,50.943396226415096,60.37735849056604
8301_terrestrial,131,66,53,90,197,40.458015267175576,68.70229007633588
8302_terrestrial,118,60,43,83,178,36.440677966101696,70.33898305084746
8303_terrestrial,117,60,44,82,177,37.60683760683761,70.08547008547008
8304_terrestrial,120,65,48,85,185,40,70.83333333333334
8305_terrestrial,120,64,48,86,184,40,71.66666666666667
8306_terrestrial,121,62,48,87,183,39.66942148760331,71.900826446281
8307_terrestrial,120,65,47,86,185,39.166666666666664,71.66666666666667
8308_terrestrial,124,69,50,90,193,40.32258064516129,72.58064516129032
8309_terrestrial,126,70,51,92,196,40.476190476190474,73.01587301587301
8310_terrestrial,124,71,50,90,195,40.32258064516129,72.58064516129032
8311_terrestrial,125,70,51,91,195,40.8,72.8
8312_terrestrial,126,71,51,92,197,40.476190476190474,73.01587301587301
8313_terrestrial,128,75,52,94,203,40.625,73.4375
8314_terrestrial,131,75,51,95,206,38.93129770992366,72.51908396946564
8315_terrestrial,131,73,50,95,204,38.16793893129771,72.51908396946564
8316_terrestrial,129,75,49,93,204,37.98449612403101,72.09302325581395
8317_terrestrial,128,73,48,92,201,37.5,71.875
8318_terrestrial,123,72,47,87,195,38.21138211382114,70.73170731707317
8319_terrestrial,124,72,48,86,196,38.70967741935484,69.35483870967742
8320_terrestrial,126,69,50,88,195,39.682539682539684,69.84126984126983
8321_terrestrial,126,68,51,87,194,40.476190476190474,69.04761904761905
8322_terrestrial,125,68,51,86,193,40.8,68.8
8323_terrestrial,120,68,49,83,188,40.833333333333336,69.16666666666667
8324_terrestrial,122,70,48,81,192,39.34426229508197,66.39344262295081
8325_terrestrial,120,68,48,81,188,40,67.5
8326_terrestrial,123,64,49,83,187,39.83739837398374,67.47967479674797
8327_terrestrial,119,63,48,81,182,40.33613445378151,68.0672268907563
8328_terrestrial,118,62,48,80,180,40.67796610169492,67.79661016949152
8329_terrestrial,120,63,51,83,183,42.5,69.16666666666667
8330_terrestrial,119,62,48,83,181,40.33613445378151,69.74789915966386
8331_terrestrial,118,59,48,83,177,40.67796610169492,70.33898305084746
8332_terrestrial,117,61,47,82,178,40.17094017094017,70.08547008547008
8333_terrestrial,119,60,50,82,179,42.016806722689076,68.90756302521008
8334_terrestrial,120,59,50,82,179,41.66666666666667,68.33333333333333
8335_terrestrial,116,55,47,80,171,40.51724137931034,68.96551724137932
8336_terrestrial,109,54,44,74,163,40.36697247706422,67.88990825688074
8337_terrestrial,108,49,43,72,157,39.81481481481482,66.66666666666666
8338_terrestrial,109,49,43,73,158,39.44954128440367,66.97247706422019
8339_terrestrial,107,49,43,71,156,40.18691588785047,66.35514018691589
8340_terrestrial,99,47,40,64,146,40.4040404040404,64.64646464646465
8341_terrestrial,94,45,39,62,139,41.48936170212766,65.95744680851064
8342_terrestrial,96,44,40,62,140,41.66666666666667,64.58333333333334
8343_terrestrial,100,43,44,63,143,44,63
8344_terrestrial,99,38,43,62,137,43.43434343434344,62.62626262626263
8345_terrestrial,88,35,39,57,123,44.31818181818182,64.77272727272727
8346_terrestrial,83,32,34,53,115,40.963855421686745,63.85542168674698
8347_terrestrial,70,31,31,46,101,44.285714285714285,65.71428571428571
8348_terrestrial,68,30,30,43,98,44.11764705882353,63.23529411764706
8349_terrestrial,65,26,30,40,91,46.15384615384615,61.53846153846154
8350_terrestrial,63,26,28,38,89,44.44444444444444,60.317460317460316
8351_terrestrial,63,26,30,36,89,47.61904761904761,57.14285714285714
8352_terrestrial,65,30,32,36,95,49.23076923076923,55.38461538461539
8353_terrestrial,64,30,32,36,94,50,56.25
8354_terrestrial,64,25,31,38,89,48.4375,59.375
8355_terrestrial,66,24,31,40,90,46.96969696969697,60.60606060606061
8356_terrestrial,63,22,30,37,85,47.61904761904761,58.730158730158735
8357_terrestrial,61,21,30,36,82,49.18032786885246,59.01639344262295
8358_terrestrial,60,21,31,35,81,51.66666666666667,58.333333333333336
8359_terrestrial,60,21,31,35,81,51.66666666666667,58.333333333333336
8360_terrestrial,58,21,30,33,79,51.724137931034484,56.896551724137936
8361_terrestrial,58,21,30,33,79,51.724137931034484,56.896551724137936
8362_terrestrial,57,23,30,32,80,52.63157894736842,56.14035087719298
8363_terrestrial,56,23,30,31,79,53.57142857142857,55.35714285714286
8364_terrestrial,57,22,30,32,79,52.63157894736842,56.14035087719298
8365_terrestrial,57,22,30,32,79,52.63157894736842,56.14035087719298
8366_terrestrial,52,22,26,29,74,50,55.769230769230774
8367_terrestrial,50,21,24,27,71,48,54
8368_terrestrial,49,21,24,26,70,48.97959183673469,53.06122448979592
8369_terrestrial,51,22,27,28,73,52.94117647058824,54.90196078431373
8370_terrestrial,51,20,29,27,71,56.86274509803921,52.94117647058824
8371_terrestrial,54,17,31,28,71,57.407407407407405,51.85185185185185
8372_terrestrial,51,17,28,27,68,54.90196078431373,52.94117647058824
8373_terrestrial,51,16,28,27,67,54.90196078431373,52.94117647058824
8374_terrestrial,63,28,38,30,91,60.317460317460316,47.61904761904761
8375_terrestrial,66,30,41,33,96,62.121212121212125,50
8376_terrestrial,65,29,40,32,94,61.53846153846154,49.23076923076923
8377_terrestrial,64,27,39,30,91,60.9375,46.875
8378_terrestrial,65,27,40,30,92,61.53846153846154,46.15384615384615
8379_terrestrial,63,27,38,30,90,60.317460317460316,47.61904761904761
8386_terrestrial,56,21,34,28,77,60.71428571428571,50
8387_terrestrial,57,21,35,29,78,61.40350877192983,50.877192982456144
8388_terrestrial,58,21,36,30,79,62.06896551724138,51.724137931034484
8389_terrestrial,49,12,28,28,61,57.14285714285714,57.14285714285714
8390_terrestrial,46,12,26,25,58,56.52173913043478,54.347826086956516
8391_terrestrial,46,12,26,25,58,56.52173913043478,54.347826086956516
8392_terrestrial,70,28,47,29,98,67.14285714285714,41.42857142857143
8393_terrestrial,69,30,46,28,99,66.66666666666666,40.57971014492754
8394_terrestrial,69,29,46,25,98,66.66666666666666,36.231884057971016
8395_terrestrial,68,29,46,24,97,67.64705882352942,35.294117647058826
8396_terrestrial,65,29,44,23,94,67.6923076923077,35.38461538461539
8397_terrestrial,65,26,44,23,91,67.6923076923077,35.38461538461539
8398_terrestrial,70,28,49,23,98,70,32.857142857142854
8399_terrestrial,70,28,49,23,98,70,32.857142857142854
8407_terrestrial,83,33,61,34,116,73.49397590361446,40.963855421686745
8408_terrestrial,82,33,60,31,115,73.17073170731707,37.80487804878049
8409_terrestrial,83,33,62,30,116,74.69879518072288,36.144578313253014
8410_terrestrial,77,29,56,28,106,72.72727272727273,36.36363636363637
8411_terrestrial,36,7,22,16,43,61.111111111111114,44.44444444444444
8412_terrestrial,25,6,15,11,31,60,44
8413_terrestrial,12,5,7,6,17,58.333333333333336,50
8414_terrestrial,5,3,1,2,8,20,40
8415_terrestrial,5,3,1,2,8,20,40
8416_terrestrial,5,3,1,2,8,20,40
8417_terrestrial,6,3,2,4,9,33.33333333333333,66.66666666666666
8418_terrestrial,8,3,2,4,11,25,50
8419_terrestrial,14,5,5,7,19,35.714285714285715,50
8420_terrestrial,25,6,12,16,31,48,64
8421_terrestrial,28,7,14,17,35,50,60.71428571428571
8422_terrestrial,71,26,51,28,97,71.83098591549296,39.436619718309856
8423_terrestrial,72,28,52,29,100,72.22222222222221,40.27777777777778
8424_terrestrial,75,28,54,31,103,72,41.333333333333336
8425_terrestrial,77,34,58,29,111,75.32467532467533,37.66233766233766
8426_terrestrial,75,28,57,29,103,76,38.666666666666664
8427_terrestrial,70,25,53,27,95,75.71428571428571,38.57142857142858
8437_terrestrial,105,42,82,54,147,78.0952380952381,51.42857142857142
8438_terrestrial,107,44,83,56,151,77.57009345794393,52.336448598130836
8439_terrestrial,104,39,80,57,143,76.92307692307693,54.807692307692314
8440_terrestrial,108,38,84,62,146,77.77777777777779,57.407407407407405
8441_terrestrial,115,40,89,68,155,77.39130434782608,59.130434782608695
8442_terrestrial,118,43,92,69,161,77.96610169491525,58.47457627118644
8443_terrestrial,119,39,93,72,158,78.15126050420169,60.50420168067227
8444_terrestrial,127,44,99,78,171,77.95275590551181,61.417322834645674
8445_terrestrial,117,43,91,71,160,77.77777777777779,60.68376068376068
8446_terrestrial,112,45,88,64,157,78.57142857142857,57.14285714285714
8496_terrestrial,181,67,115,115,248,63.53591160220995,63.53591160220995
8497_terrestrial,175,65,113,113,240,64.57142857142857,64.57142857142857
8498_terrestrial,145,51,88,103,196,60.689655172413794,71.03448275862068
8499_terrestrial,171,65,108,112,236,63.1578947368421,65.49707602339181
8500_terrestrial,175,65,112,117,240,64,66.85714285714286
8501_terrestrial,201,70,125,133,271,62.189054726368155,66.16915422885572
8502_terrestrial,198,71,123,128,269,62.121212121212125,64.64646464646465
8503_terrestrial,168,61,103,108,229,61.30952380952381,64.28571428571429
8504_terrestrial,173,60,106,112,233,61.27167630057804,64.73988439306359
8550_terrestrial,132,49,73,97,181,55.3030303030303,73.48484848484848
8551_terrestrial,131,47,72,97,178,54.961832061068705,74.04580152671755
8552_terrestrial,128,48,70,94,176,54.6875,73.4375
8553_terrestrial,128,48,69,95,176,53.90625,74.21875
8554_terrestrial,128,48,71,93,176,55.46875,72.65625
8555_terrestrial,128,47,70,91,175,54.6875,71.09375
8556_terrestrial,127,47,70,91,174,55.118110236220474,71.65354330708661
8557_terrestrial,128,43,71,92,171,55.46875,71.875
8558_terrestrial,129,45,72,93,174,55.81395348837209,72.09302325581395
8559_terrestrial,128,45,71,92,173,55.46875,71.875
8560_terrestrial,129,46,73,92,175,56.58914728682171,71.31782945736434
8561_terrestrial,128,44,73,91,172,57.03125,71.09375
8562_terrestrial,122,44,69,87,166,56.557377049180324,71.31147540983606
8563_terrestrial,120,44,67,86,164,55.833333333333336,71.66666666666667
8564_terrestrial,120,46,66,86,166,55.00000000000001,71.66666666666667
8565_terrestrial,122,46,67,88,168,54.91803278688525,72.1311475409836
8566_terrestrial,120,46,67,86,166,55.833333333333336,71.66666666666667
8567_terrestrial,123,46,69,89,169,56.09756097560976,72.35772357723577
8568_terrestrial,123,42,69,89,165,56.09756097560976,72.35772357723577
8569_terrestrial,124,39,69,90,163,55.64516129032258,72.58064516129032
8570_terrestrial,124,39,69,90,163,55.64516129032258,72.58064516129032
8571_terrestrial,123,39,68,89,162,55.28455284552846,72.35772357723577
8572_terrestrial,123,39,68,91,162,55.28455284552846,73.98373983739837
8573_terrestrial,124,39,68,92,163,54.83870967741935,74.19354838709677
8616_terrestrial,124,47,71,87,171,57.25806451612904,70.16129032258065
8617_terrestrial,123,49,69,87,172,56.09756097560976,70.73170731707317
8618_terrestrial,121,51,67,85,172,55.371900826446286,70.24793388429752
8619_terrestrial,122,51,68,85,173,55.73770491803278,69.67213114754098
8620_terrestrial,125,51,71,86,176,56.8,68.8
8621_terrestrial,122,49,68,83,171,55.73770491803278,68.0327868852459
8622_terrestrial,120,47,67,78,167,55.833333333333336,65
8623_terrestrial,123,49,67,79,172,54.47154471544715,64.22764227642277
8624_terrestrial,121,43,66,78,164,54.54545454545454,64.46280991735537
8625_terrestrial,122,43,67,80,165,54.91803278688525,65.57377049180327
8626_terrestrial,119,41,64,77,160,53.78151260504202,64.70588235294117
8627_terrestrial,120,40,66,78,160,55.00000000000001,65
8628_terrestrial,122,41,68,80,163,55.73770491803278,65.57377049180327
8629_terrestrial,119,42,67,76,161,56.30252100840336,63.86554621848739
8630_terrestrial,115,41,64,73,156,55.65217391304348,63.47826086956522
8631_terrestrial,114,44,64,70,158,56.14035087719298,61.40350877192983
8632_terrestrial,106,44,60,64,150,56.60377358490566,60.37735849056604
8633_terrestrial,102,47,58,62,149,56.86274509803921,60.78431372549019
8634_terrestrial,102,48,58,63,150,56.86274509803921,61.76470588235294
8635_terrestrial,98,48,57,62,146,58.16326530612245,63.26530612244898
8636_terrestrial,92,51,54,57,143,58.69565217391305,61.95652173913043
8637_terrestrial,89,49,53,55,138,59.55056179775281,61.79775280898876
8638_terrestrial,87,45,50,52,132,57.47126436781609,59.77011494252874
8639_terrestrial,80,45,45,46,125,56.25,57.49999999999999
8640_terrestrial,86,49,48,47,135,55.81395348837209,54.65116279069767
8641_terrestrial,103,55,68,47,158,66.01941747572816,45.63106796116505
8642_terrestrial,93,54,62,41,147,66.66666666666666,44.086021505376344
8643_terrestrial,63,31,36,34,94,57.14285714285714,53.96825396825397
8644_terrestrial,93,57,62,40,150,66.66666666666666,43.01075268817204
8645_terrestrial,96,57,64,42,153,66.66666666666666,43.75
8646_terrestrial,66,34,38,37,100,57.57575757575758,56.060606060606055
8647_terrestrial,68,34,40,37,102,58.82352941176471,54.41176470588235
8648_terrestrial,99,60,66,44,159,66.66666666666666,44.44444444444444
8649_terrestrial,97,60,65,44,157,67.0103092783505,45.36082474226804
8650_terrestrial,100,60,67,47,160,67,47
8651_terrestrial,58,30,42,29,88,72.41379310344827,50
8652_terrestrial,136,66,81,70,202,59.55882352941176,51.470588235294116
8653_terrestrial,141,69,86,73,210,60.99290780141844,51.77304964539007
8654_terrestrial,142,74,85,75,216,59.859154929577464,52.816901408450704
8655_terrestrial,120,51,62,73,171,51.66666666666667,60.83333333333333
8656_terrestrial,125,54,64,79,179,51.2,63.2
8657_terrestrial,125,58,65,79,183,52,63.2
8658_terrestrial,128,60,62,82,188,48.4375,64.0625
8659_terrestrial,136,65,64,88,201,47.05882352941176,64.70588235294117
8660_terrestrial,139,73,61,93,212,43.884892086330936,66.90647482014388
8661_terrestrial,133,71,50,94,204,37.59398496240601,70.67669172932331
8662_terrestrial,128,66,49,90,194,38.28125,70.3125
8663_terrestrial,127,66,49,90,193,38.582677165354326,70.86614173228347
8664_terrestrial,120,64,45,87,184,37.5,72.5
8665_terrestrial,123,66,46,90,189,37.39837398373984,73.17073170731707
8666_terrestrial,122,70,46,90,192,37.704918032786885,73.77049180327869
8667_terrestrial,125,70,48,93,195,38.4,74.4
8668_terrestrial,126,66,49,94,192,38.88888888888889,74.60317460317461
8669_terrestrial,127,68,49,95,195,38.582677165354326,74.80314960629921
8670_terrestrial,128,71,51,94,199,39.84375,73.4375
8671_terrestrial,128,74,51,94,202,39.84375,73.4375
8672_terrestrial,132,77,51,96,209,38.63636363636363,72.72727272727273
8673_terrestrial,134,77,52,98,211,38.80597014925373,73.13432835820896
8674_terrestrial,134,77,52,98,211,38.80597014925373,73.13432835820896
8675_terrestrial,133,79,51,97,212,38.34586466165413,72.93233082706767
8676_terrestrial,131,79,50,95,210,38.16793893129771,72.51908396946564
8677_terrestrial,131,79,52,95,210,39.69465648854962,72.51908396946564
8678_terrestrial,130,77,52,94,207,40,72.3076923076923
8679_terrestrial,130,80,50,92,210,38.46153846153847,70.76923076923077
8680_terrestrial,125,77,49,89,202,39.2,71.2
8681_terrestrial,123,81,48,87,204,39.02439024390244,70.73170731707317
8682_terrestrial,121,78,47,85,199,38.84297520661157,70.24793388429752
8683_terrestrial,122,75,48,85,197,39.34426229508197,69.67213114754098
8684_terrestrial,121,75,47,84,196,38.84297520661157,69.42148760330579
8685_terrestrial,121,73,47,82,194,38.84297520661157,67.76859504132231
8686_terrestrial,122,69,48,83,191,39.34426229508197,68.0327868852459
8687_terrestrial,122,67,49,83,189,40.16393442622951,68.0327868852459
8688_terrestrial,119,69,49,81,188,41.17647058823529,68.0672268907563
8689_terrestrial,116,76,49,79,192,42.241379310344826,68.10344827586206
8690_terrestrial,120,78,48,83,198,40,69.16666666666667
8691_terrestrial,120,74,48,85,194,40,70.83333333333334
8692_terrestrial,125,73,49,90,198,39.2,72
8693_terrestrial,131,68,51,94,199,38.93129770992366,71.7557251908397
8694_terrestrial,129,68,51,94,197,39.53488372093023,72.86821705426357
8695_terrestrial,129,68,49,94,197,37.98449612403101,72.86821705426357
8696_terrestrial,124,69,45,91,193,36.29032258064516,73.38709677419355
8697_terrestrial,120,64,45,87,184,37.5,72.5
8698_terrestrial,111,56,41,78,167,36.93693693693694,70.27027027027027
8699_terrestrial,108,54,39,75,162,36.11111111111111,69.44444444444444
8700_terrestrial,108,53,40,75,161,37.03703703703704,69.44444444444444
8701_terrestrial,104,53,40,71,157,38.46153846153847,68.26923076923077
8702_terrestrial,105,49,40,70,154,38.095238095238095,66.66666666666666
8703_terrestrial,101,49,39,67,150,38.613861386138616,66.33663366336634
8704_terrestrial,96,47,37,64,143,38.54166666666667,66.66666666666666
8705_terrestrial,99,46,39,65,145,39.39393939393939,65.65656565656566
8706_terrestrial,92,44,39,59,136,42.391304347826086,64.13043478260869
8707_terrestrial,84,35,38,54,119,45.23809523809524,64.28571428571429
8708_terrestrial,80,33,34,51,113,42.5,63.74999999999999
8709_terrestrial,71,30,32,47,101,45.07042253521127,66.19718309859155
8710_terrestrial,71,30,33,47,101,46.478873239436616,66.19718309859155
8711_terrestrial,67,31,32,43,98,47.76119402985074,64.17910447761194
8712_terrestrial,66,28,31,42,94,46.96969696969697,63.63636363636363
8713_terrestrial,68,27,32,42,95,47.05882352941176,61.76470588235294
8714_terrestrial,66,27,31,40,93,46.96969696969697,60.60606060606061
8715_terrestrial,64,24,31,39,88,48.4375,60.9375
8716_terrestrial,65,24,31,40,89,47.69230769230769,61.53846153846154
8717_terrestrial,63,26,32,38,89,50.79365079365079,60.317460317460316
8718_terrestrial,63,26,32,38,89,50.79365079365079,60.317460317460316
8719_terrestrial,63,24,31,39,87,49.2063492063492,61.904761904761905
8720_terrestrial,63,25,32,38,88,50.79365079365079,60.317460317460316
8721_terrestrial,61,24,31,36,85,50.81967213114754,59.01639344262295
8722_terrestrial,58,22,29,34,80,50,58.620689655172406
8723_terrestrial,57,22,28,33,79,49.122807017543856,57.89473684210527
8724_terrestrial,57,22,28,33,79,49.122807017543856,57.89473684210527
8725_terrestrial,54,22,28,30,76,51.85185185185185,55.55555555555556
8726_terrestrial,53,22,26,30,75,49.056603773584904,56.60377358490566
8727_terrestrial,51,21,25,28,72,49.01960784313725,54.90196078431373
8728_terrestrial,50,20,24,28,70,48,56.00000000000001
8729_terrestrial,60,33,37,29,93,61.66666666666667,48.333333333333336
8730_terrestrial,63,32,38,32,95,60.317460317460316,50.79365079365079
8731_terrestrial,63,32,38,32,95,60.317460317460316,50.79365079365079
8732_terrestrial,64,32,38,33,96,59.375,51.5625
8733_terrestrial,66,33,40,34,99,60.60606060606061,51.515151515151516
8734_terrestrial,73,30,45,34,103,61.64383561643836,46.57534246575342
8735_terrestrial,56,23,38,31,79,67.85714285714286,55.35714285714286
8736_terrestrial,59,24,39,33,83,66.10169491525424,55.932203389830505
8737_terrestrial,60,23,39,33,83,65,55.00000000000001
8742_terrestrial,56,21,35,26,77,62.5,46.42857142857143
8743_terrestrial,57,23,36,27,80,63.1578947368421,47.368421052631575
8744_terrestrial,56,21,35,27,77,62.5,48.214285714285715
8745_terrestrial,56,21,35,27,77,62.5,48.214285714285715
8746_terrestrial,60,21,36,31,81,60,51.66666666666667
8747_terrestrial,62,21,38,31,83,61.29032258064516,50
8748_terrestrial,50,12,27,29,62,54,57.99999999999999
8749_terrestrial,46,12,25,25,58,54.347826086956516,54.347826086956516
8750_terrestrial,44,12,24,23,56,54.54545454545454,52.27272727272727
8751_terrestrial,45,12,25,24,57,55.55555555555556,53.333333333333336
8752_terrestrial,70,28,46,29,98,65.71428571428571,41.42857142857143
8753_terrestrial,70,32,46,28,102,65.71428571428571,40
8754_terrestrial,68,28,44,26,96,64.70588235294117,38.23529411764706
8755_terrestrial,66,29,44,24,95,66.66666666666666,36.36363636363637
8756_terrestrial,70,30,47,24,100,67.14285714285714,34.285714285714285
8757_terrestrial,67,28,45,23,95,67.16417910447761,34.32835820895522
8758_terrestrial,67,28,46,22,95,68.65671641791045,32.83582089552239
8767_terrestrial,83,32,62,32,115,74.69879518072288,38.55421686746988
8768_terrestrial,82,34,61,31,116,74.39024390243902,37.80487804878049
8769_terrestrial,84,30,63,31,114,75,36.904761904761905
8770_terrestrial,84,28,63,31,112,75,36.904761904761905
8771_terrestrial,37,7,22,18,44,59.45945945945946,48.64864864864865
8772_terrestrial,25,7,13,13,32,52,52
8773_terrestrial,11,6,7,5,17,63.63636363636363,45.45454545454545
8774_terrestrial,5,4,1,2,9,20,40
8775_terrestrial,5,3,1,2,8,20,40
8776_terrestrial,7,3,1,2,10,14.285714285714285,28.57142857142857
8777_terrestrial,9,5,2,4,14,22.22222222222222,44.44444444444444
8778_terrestrial,20,5,8,11,25,40,55.00000000000001
8779_terrestrial,68,26,49,27,94,72.05882352941177,39.705882352941174
8780_terrestrial,75,26,55,31,101,73.33333333333333,41.333333333333336
8781_terrestrial,73,28,52,31,101,71.23287671232876,42.465753424657535
8782_terrestrial,75,28,54,31,103,72,41.333333333333336
8783_terrestrial,80,32,59,32,112,73.75,40
8784_terrestrial,77,28,55,33,105,71.42857142857143,42.857142857142854
8796_terrestrial,113,46,88,60,159,77.87610619469027,53.09734513274337
8797_terrestrial,124,48,97,71,172,78.2258064516129,57.25806451612904
8798_terrestrial,124,49,95,72,173,76.61290322580645,58.06451612903226
8799_terrestrial,129,50,101,75,179,78.29457364341084,58.139534883720934
8800_terrestrial,123,44,95,75,167,77.23577235772358,60.97560975609756
8801_terrestrial,124,40,95,77,164,76.61290322580645,62.096774193548384
8802_terrestrial,121,43,94,73,164,77.68595041322314,60.33057851239669
8803_terrestrial,126,40,97,79,166,76.98412698412699,62.698412698412696
8804_terrestrial,70,16,49,61,86,70,87.14285714285714
8805_terrestrial,64,15,45,54,79,70.3125,84.375
8806_terrestrial,128,48,100,76,176,78.125,59.375
8807_terrestrial,112,51,88,64,163,78.57142857142857,57.14285714285714
8856_terrestrial,158,41,111,114,199,70.25316455696202,72.15189873417721
8857_terrestrial,191,68,120,124,259,62.82722513089005,64.92146596858639
8858_terrestrial,192,68,121,125,260,63.020833333333336,65.10416666666666
8860_terrestrial,145,53,81,103,198,55.86206896551724,71.03448275862068
8861_terrestrial,189,73,117,121,262,61.904761904761905,64.02116402116403
8911_terrestrial,138,53,79,105,191,57.2463768115942,76.08695652173914
8912_terrestrial,135,51,77,104,186,57.03703703703704,77.03703703703704
8913_terrestrial,135,49,77,104,184,57.03703703703704,77.03703703703704
8914_terrestrial,134,49,76,103,183,56.71641791044776,76.86567164179104
8915_terrestrial,135,50,77,103,185,57.03703703703704,76.29629629629629
8916_terrestrial,133,50,75,101,183,56.390977443609025,75.93984962406014
8917_terrestrial,132,50,74,100,182,56.060606060606055,75.75757575757575
8918_terrestrial,134,47,76,100,181,56.71641791044776,74.6268656716418
8919_terrestrial,133,47,77,99,180,57.89473684210527,74.43609022556392
8920_terrestrial,133,45,77,98,178,57.89473684210527,73.68421052631578
8921_terrestrial,134,45,78,99,179,58.2089552238806,73.88059701492537
8922_terrestrial,134,45,77,99,179,57.46268656716418,73.88059701492537
8923_terrestrial,137,47,79,102,184,57.66423357664233,74.45255474452554
8924_terrestrial,138,47,79,103,185,57.2463768115942,74.63768115942028
8925_terrestrial,138,46,77,104,184,55.79710144927537,75.36231884057972
8926_terrestrial,139,46,79,104,185,56.83453237410072,74.82014388489209
8927_terrestrial,141,46,79,106,187,56.02836879432624,75.177304964539
8975_terrestrial,123,52,68,85,175,55.28455284552846,69.10569105691057
8976_terrestrial,121,50,66,85,171,54.54545454545454,70.24793388429752
8977_terrestrial,117,51,63,83,168,53.84615384615385,70.94017094017094
8978_terrestrial,116,49,62,82,165,53.44827586206896,70.6896551724138
8979_terrestrial,118,49,64,82,167,54.23728813559322,69.49152542372882
8980_terrestrial,120,49,66,82,169,55.00000000000001,68.33333333333333
8981_terrestrial,119,49,65,81,168,54.621848739495796,68.0672268907563
8982_terrestrial,120,49,66,81,169,55.00000000000001,67.5
8983_terrestrial,121,49,67,81,170,55.371900826446286,66.94214876033058
8984_terrestrial,125,47,70,84,172,56.00000000000001,67.2
8985_terrestrial,127,47,72,86,174,56.69291338582677,67.71653543307087
8986_terrestrial,125,45,71,85,170,56.8,68
8987_terrestrial,124,49,69,83,173,55.64516129032258,66.93548387096774
8988_terrestrial,121,49,68,81,170,56.19834710743802,66.94214876033058
8989_terrestrial,120,50,67,79,170,55.833333333333336,65.83333333333333
8990_terrestrial,120,51,67,79,171,55.833333333333336,65.83333333333333
8991_terrestrial,120,49,70,79,169,58.333333333333336,65.83333333333333
8992_terrestrial,119,47,71,75,166,59.66386554621849,63.02521008403361
8993_terrestrial,114,51,66,72,165,57.89473684210527,63.1578947368421
8994_terrestrial,110,52,64,71,162,58.18181818181818,64.54545454545455
8995_terrestrial,107,54,62,71,161,57.943925233644855,66.35514018691589
8996_terrestrial,109,56,63,74,165,57.798165137614674,67.88990825688074
8997_terrestrial,108,57,63,71,165,58.333333333333336,65.74074074074075
8998_terrestrial,101,54,57,64,155,56.43564356435643,63.366336633663366
8999_terrestrial,90,53,48,54,143,53.333333333333336,60
9000_terrestrial,92,56,51,52,148,55.434782608695656,56.52173913043478
9005_terrestrial,96,56,65,42,152,67.70833333333334,43.75
9006_terrestrial,98,57,66,43,155,67.3469387755102,43.87755102040816
9007_terrestrial,101,59,68,46,160,67.32673267326733,45.54455445544555
9008_terrestrial,100,59,68,45,159,68,45
9014_terrestrial,140,74,84,74,214,60,52.85714285714286
9015_terrestrial,143,75,83,76,218,58.04195804195804,53.14685314685315
9016_terrestrial,121,48,62,76,169,51.2396694214876,62.8099173553719
9017_terrestrial,150,76,87,83,226,57.99999999999999,55.333333333333336
9018_terrestrial,144,78,81,80,222,56.25,55.55555555555556
9019_terrestrial,153,83,82,88,236,53.59477124183007,57.51633986928104
9020_terrestrial,164,90,86,97,254,52.4390243902439,59.14634146341463
9021_terrestrial,134,65,52,95,199,38.80597014925373,70.8955223880597
9022_terrestrial,126,64,49,88,190,38.88888888888889,69.84126984126983
9023_terrestrial,126,62,49,89,188,38.88888888888889,70.63492063492063
9024_terrestrial,120,63,47,85,183,39.166666666666664,70.83333333333334
9025_terrestrial,122,65,48,87,187,39.34426229508197,71.31147540983606
9026_terrestrial,125,68,51,91,193,40.8,72.8
9027_terrestrial,126,70,50,92,196,39.682539682539684,73.01587301587301
9028_terrestrial,128,73,51,94,201,39.84375,73.4375
9029_terrestrial,131,75,51,95,206,38.93129770992366,72.51908396946564
9030_terrestrial,132,79,53,96,211,40.15151515151515,72.72727272727273
9031_terrestrial,135,79,55,99,214,40.74074074074074,73.33333333333333
9032_terrestrial,136,78,56,100,214,41.17647058823529,73.52941176470588
9033_terrestrial,137,80,56,101,217,40.87591240875913,73.72262773722628
9034_terrestrial,142,78,61,106,220,42.95774647887324,74.64788732394366
9035_terrestrial,143,79,60,107,222,41.95804195804196,74.82517482517483
9036_terrestrial,142,77,59,106,219,41.54929577464789,74.64788732394366
9037_terrestrial,140,78,58,104,218,41.42857142857143,74.28571428571429
9038_terrestrial,139,78,56,103,217,40.28776978417266,74.10071942446042
9039_terrestrial,137,80,53,99,217,38.68613138686132,72.26277372262774
9040_terrestrial,132,79,51,94,211,38.63636363636363,71.21212121212122
9041_terrestrial,129,85,50,93,214,38.759689922480625,72.09302325581395
9042_terrestrial,125,85,49,89,210,39.2,71.2
9043_terrestrial,125,81,49,89,206,39.2,71.2
9044_terrestrial,122,79,47,86,201,38.52459016393443,70.49180327868852
9045_terrestrial,120,78,46,83,198,38.333333333333336,69.16666666666667
9046_terrestrial,118,78,44,81,196,37.28813559322034,68.64406779661016
9047_terrestrial,119,77,45,82,196,37.81512605042017,68.90756302521008
9048_terrestrial,121,74,45,82,195,37.1900826446281,67.76859504132231
9049_terrestrial,123,74,47,83,197,38.21138211382114,67.47967479674797
9050_terrestrial,123,81,47,84,204,38.21138211382114,68.29268292682927
9051_terrestrial,123,85,49,86,208,39.83739837398374,69.91869918699187
9052_terrestrial,127,78,49,92,205,38.582677165354326,72.44094488188976
9053_terrestrial,129,77,49,94,206,37.98449612403101,72.86821705426357
9054_terrestrial,133,78,50,98,211,37.59398496240601,73.68421052631578
9055_terrestrial,134,73,51,99,207,38.059701492537314,73.88059701492537
9056_terrestrial,135,75,51,100,210,37.77777777777778,74.07407407407408
9057_terrestrial,132,74,50,97,206,37.878787878787875,73.48484848484848
9058_terrestrial,132,69,52,97,201,39.39393939393939,73.48484848484848
9059_terrestrial,130,65,51,95,195,39.23076923076923,73.07692307692307
9060_terrestrial,125,62,49,90,187,39.2,72
9061_terrestrial,123,56,48,88,179,39.02439024390244,71.54471544715447
9062_terrestrial,116,55,45,81,171,38.793103448275865,69.82758620689656
9063_terrestrial,111,57,43,76,168,38.73873873873874,68.46846846846847
9064_terrestrial,110,53,43,75,163,39.09090909090909,68.18181818181817
9065_terrestrial,106,52,39,71,158,36.79245283018868,66.98113207547169
9066_terrestrial,102,52,39,67,154,38.23529411764706,65.68627450980392
9067_terrestrial,99,49,39,65,148,39.39393939393939,65.65656565656566
9068_terrestrial,97,47,39,63,144,40.20618556701031,64.94845360824742
9069_terrestrial,90,43,41,56,133,45.55555555555556,62.22222222222222
9070_terrestrial,86,42,38,56,128,44.18604651162791,65.11627906976744
9071_terrestrial,77,38,37,51,115,48.05194805194805,66.23376623376623
9072_terrestrial,75,37,37,49,112,49.333333333333336,65.33333333333333
9073_terrestrial,75,37,38,49,112,50.66666666666667,65.33333333333333
9074_terrestrial,69,32,34,44,101,49.275362318840585,63.76811594202898
9075_terrestrial,65,30,29,42,95,44.61538461538462,64.61538461538461
9076_terrestrial,63,30,28,40,93,44.44444444444444,63.49206349206349
9077_terrestrial,63,30,28,41,93,44.44444444444444,65.07936507936508
9078_terrestrial,63,28,28,41,91,44.44444444444444,65.07936507936508
9079_terrestrial,61,28,27,39,89,44.26229508196721,63.934426229508205
9080_terrestrial,58,29,27,36,87,46.55172413793103,62.06896551724138
9081_terrestrial,59,25,27,38,84,45.76271186440678,64.40677966101694
9082_terrestrial,57,25,26,36,82,45.614035087719294,63.1578947368421
9083_terrestrial,57,24,28,34,81,49.122807017543856,59.64912280701754
9084_terrestrial,58,22,29,34,80,50,58.620689655172406
9085_terrestrial,57,21,28,33,78,49.122807017543856,57.89473684210527
9086_terrestrial,59,21,30,37,80,50.847457627118644,62.71186440677966
9087_terrestrial,65,28,37,36,93,56.92307692307692,55.38461538461539
9088_terrestrial,56,21,29,33,77,51.78571428571429,58.92857142857143
9089_terrestrial,56,22,30,33,78,53.57142857142857,58.92857142857143
9090_terrestrial,65,34,39,34,99,60,52.307692307692314
9091_terrestrial,64,36,39,33,100,60.9375,51.5625
9092_terrestrial,65,33,40,34,98,61.53846153846154,52.307692307692314
9093_terrestrial,64,33,38,33,97,59.375,51.5625
9094_terrestrial,58,22,40,31,80,68.96551724137932,53.44827586206896
9095_terrestrial,46,10,28,28,56,60.86956521739131,60.86956521739131
9096_terrestrial,46,9,28,28,55,60.86956521739131,60.86956521739131
9097_terrestrial,57,21,38,30,78,66.66666666666666,52.63157894736842
9098_terrestrial,57,21,37,30,78,64.91228070175438,52.63157894736842
9099_terrestrial,56,21,37,29,77,66.07142857142857,51.78571428571429
9100_terrestrial,55,21,37,29,76,67.27272727272727,52.72727272727272
9102_terrestrial,59,21,37,27,80,62.71186440677966,45.76271186440678
9103_terrestrial,62,26,40,28,88,64.51612903225806,45.16129032258064
9104_terrestrial,59,24,37,27,83,62.71186440677966,45.76271186440678
9105_terrestrial,60,26,37,28,86,61.66666666666667,46.666666666666664
9106_terrestrial,63,26,40,29,89,63.49206349206349,46.03174603174603
9107_terrestrial,62,26,39,28,88,62.903225806451616,45.16129032258064
9108_terrestrial,63,26,41,29,89,65.07936507936508,46.03174603174603
9109_terrestrial,46,12,26,24,58,56.52173913043478,52.17391304347826
9110_terrestrial,48,12,27,26,60,56.25,54.166666666666664
9111_terrestrial,48,12,27,26,60,56.25,54.166666666666664
9112_terrestrial,48,12,26,26,60,54.166666666666664,54.166666666666664
9113_terrestrial,45,12,24,23,57,53.333333333333336,51.11111111111111
9114_terrestrial,67,28,44,25,95,65.67164179104478,37.3134328358209
9115_terrestrial,68,31,45,26,99,66.17647058823529,38.23529411764706
9116_terrestrial,72,30,49,28,102,68.05555555555556,38.88888888888889
9117_terrestrial,69,30,47,23,99,68.11594202898551,33.33333333333333
9128_terrestrial,83,30,62,34,113,74.69879518072288,40.963855421686745
9129_terrestrial,85,30,64,34,115,75.29411764705883,40
9130_terrestrial,83,30,62,32,113,74.69879518072288,38.55421686746988
9131_terrestrial,77,28,56,31,105,72.72727272727273,40.25974025974026
9132_terrestrial,27,7,14,15,34,51.85185185185185,55.55555555555556
9133_terrestrial,21,7,10,12,28,47.61904761904761,57.14285714285714
9134_terrestrial,9,6,2,4,15,22.22222222222222,44.44444444444444
9135_terrestrial,8,3,1,3,11,12.5,37.5
9136_terrestrial,10,4,2,5,14,20,50
9137_terrestrial,16,5,5,8,21,31.25,50
9138_terrestrial,27,6,15,16,33,55.55555555555556,59.25925925925925
9139_terrestrial,72,27,52,31,99,72.22222222222221,43.05555555555556
9140_terrestrial,72,28,52,30,100,72.22222222222221,41.66666666666667
9156_terrestrial,111,46,86,60,157,77.47747747747748,54.054054054054056
9157_terrestrial,116,47,91,63,163,78.44827586206897,54.310344827586206
9158_terrestrial,143,51,111,87,194,77.62237762237763,60.83916083916085
9159_terrestrial,142,53,111,89,195,78.16901408450704,62.676056338028175
9160_terrestrial,71,17,50,58,88,70.4225352112676,81.69014084507043
9161_terrestrial,54,14,37,42,68,68.51851851851852,77.77777777777779
9162_terrestrial,54,14,37,43,68,68.51851851851852,79.62962962962963
9163_terrestrial,60,16,42,49,76,70,81.66666666666667
9164_terrestrial,106,57,83,59,163,78.30188679245283,55.660377358490564
9165_terrestrial,132,58,103,76,190,78.03030303030303,57.57575757575758
9166_terrestrial,132,56,104,76,188,78.78787878787878,57.57575757575758
9167_terrestrial,112,46,88,60,158,78.57142857142857,53.57142857142857
9190_terrestrial,207,77,153,122,284,73.91304347826086,58.93719806763285
9272_terrestrial,143,53,84,110,196,58.74125874125874,76.92307692307693
9273_terrestrial,140,51,81,107,191,57.85714285714286,76.42857142857142
9274_terrestrial,139,49,80,106,188,57.55395683453237,76.2589928057554
9275_terrestrial,139,49,78,105,188,56.11510791366906,75.53956834532374
9276_terrestrial,140,49,79,106,189,56.42857142857143,75.71428571428571
9277_terrestrial,143,49,81,107,192,56.64335664335665,74.82517482517483
9278_terrestrial,143,48,81,107,191,56.64335664335665,74.82517482517483
9279_terrestrial,143,50,81,107,193,56.64335664335665,74.82517482517483
9280_terrestrial,143,49,81,106,192,56.64335664335665,74.12587412587412
9281_terrestrial,143,49,81,106,192,56.64335664335665,74.12587412587412
9282_terrestrial,144,49,81,107,193,56.25,74.30555555555556
9283_terrestrial,146,47,81,109,193,55.47945205479452,74.65753424657534
9284_terrestrial,146,48,80,109,194,54.794520547945204,74.65753424657534
9285_terrestrial,149,48,81,112,197,54.36241610738255,75.16778523489933
9286_terrestrial,151,48,83,114,199,54.966887417218544,75.49668874172185
9287_terrestrial,153,48,85,116,201,55.55555555555556,75.81699346405229
9335_terrestrial,124,54,66,86,178,53.2258064516129,69.35483870967742
9336_terrestrial,125,52,67,88,177,53.6,70.39999999999999
9337_terrestrial,123,51,64,88,174,52.03252032520326,71.54471544715447
9338_terrestrial,123,50,64,88,173,52.03252032520326,71.54471544715447
9339_terrestrial,122,52,65,87,174,53.278688524590166,71.31147540983606
9340_terrestrial,123,54,67,87,177,54.47154471544715,70.73170731707317
9341_terrestrial,122,56,66,86,178,54.09836065573771,70.49180327868852
9342_terrestrial,124,56,68,88,180,54.83870967741935,70.96774193548387
9343_terrestrial,124,54,69,87,178,55.64516129032258,70.16129032258065
9344_terrestrial,130,53,73,89,183,56.15384615384615,68.46153846153847
9345_terrestrial,129,52,73,88,181,56.58914728682171,68.21705426356588
9346_terrestrial,127,55,71,88,182,55.90551181102362,69.29133858267717
9347_terrestrial,122,56,70,84,178,57.377049180327866,68.85245901639344
9348_terrestrial,121,60,69,84,181,57.02479338842975,69.42148760330579
9349_terrestrial,115,56,64,78,171,55.65217391304348,67.82608695652173
9350_terrestrial,116,53,65,81,169,56.03448275862068,69.82758620689656
9351_terrestrial,117,51,67,80,168,57.26495726495726,68.37606837606837
9352_terrestrial,113,50,65,76,163,57.52212389380531,67.2566371681416
9353_terrestrial,108,53,62,72,161,57.407407407407405,66.66666666666666
9354_terrestrial,109,54,60,73,163,55.04587155963303,66.97247706422019
9355_terrestrial,109,57,62,74,166,56.88073394495413,67.88990825688074
9356_terrestrial,146,81,94,83,227,64.38356164383562,56.849315068493155
9357_terrestrial,142,81,92,79,223,64.7887323943662,55.633802816901415
9358_terrestrial,138,81,91,74,219,65.94202898550725,53.62318840579711
9359_terrestrial,136,74,89,72,210,65.44117647058823,52.94117647058824
9360_terrestrial,85,50,47,50,135,55.294117647058826,58.82352941176471
9369_terrestrial,74,45,57,33,119,77.02702702702703,44.5945945945946
9370_terrestrial,72,47,57,31,119,79.16666666666666,43.05555555555556
9371_terrestrial,77,48,59,34,125,76.62337662337663,44.15584415584416
9372_terrestrial,71,45,55,31,116,77.46478873239437,43.66197183098591
9376_terrestrial,133,71,76,69,204,57.14285714285714,51.8796992481203
9377_terrestrial,136,73,77,72,209,56.61764705882353,52.94117647058824
9378_terrestrial,140,72,80,76,212,57.14285714285714,54.285714285714285
9379_terrestrial,154,79,82,86,233,53.246753246753244,55.84415584415584
9380_terrestrial,168,88,87,101,256,51.78571428571429,60.11904761904761
9381_terrestrial,135,65,53,97,200,39.25925925925926,71.85185185185186
9382_terrestrial,126,63,50,89,189,39.682539682539684,70.63492063492063
9383_terrestrial,121,61,48,85,182,39.66942148760331,70.24793388429752
9384_terrestrial,121,63,49,87,184,40.49586776859504,71.900826446281
9385_terrestrial,125,67,52,91,192,41.6,72.8
9386_terrestrial,129,71,53,95,200,41.08527131782946,73.64341085271317
9387_terrestrial,129,74,53,95,203,41.08527131782946,73.64341085271317
9388_terrestrial,132,74,54,95,206,40.909090909090914,71.96969696969697
9389_terrestrial,139,75,56,101,214,40.28776978417266,72.66187050359713
9390_terrestrial,138,77,55,100,215,39.85507246376812,72.46376811594203
9391_terrestrial,138,78,54,100,216,39.130434782608695,72.46376811594203
9392_terrestrial,140,84,55,102,224,39.285714285714285,72.85714285714285
9393_terrestrial,139,87,54,103,226,38.84892086330935,74.10071942446042
9398_terrestrial,141,81,57,106,222,40.42553191489361,75.177304964539
9399_terrestrial,142,84,55,103,226,38.732394366197184,72.53521126760563
9400_terrestrial,138,82,52,99,220,37.68115942028986,71.73913043478261
9401_terrestrial,133,83,51,96,216,38.34586466165413,72.18045112781954
9402_terrestrial,129,82,50,95,211,38.759689922480625,73.64341085271317
9403_terrestrial,130,82,50,94,212,38.46153846153847,72.3076923076923
9404_terrestrial,133,83,50,95,216,37.59398496240601,71.42857142857143
9405_terrestrial,128,81,48,92,209,37.5,71.875
9406_terrestrial,127,80,49,90,207,38.582677165354326,70.86614173228347
9407_terrestrial,126,82,49,89,208,38.88888888888889,70.63492063492063
9408_terrestrial,128,79,51,90,207,39.84375,70.3125
9409_terrestrial,129,75,51,91,204,39.53488372093023,70.54263565891473
9410_terrestrial,134,83,52,92,217,38.80597014925373,68.65671641791045
9411_terrestrial,133,85,52,91,218,39.097744360902254,68.42105263157895
9412_terrestrial,130,89,53,92,219,40.76923076923077,70.76923076923077
9413_terrestrial,131,87,54,95,218,41.221374045801525,72.51908396946564
9414_terrestrial,133,85,52,98,218,39.097744360902254,73.68421052631578
9415_terrestrial,136,81,52,101,217,38.23529411764706,74.26470588235294
9416_terrestrial,138,81,52,103,219,37.68115942028986,74.63768115942028
9417_terrestrial,134,78,50,103,212,37.3134328358209,76.86567164179104
9418_terrestrial,136,83,50,103,219,36.76470588235294,75.73529411764706
9419_terrestrial,136,79,50,103,215,36.76470588235294,75.73529411764706
9420_terrestrial,136,72,50,103,208,36.76470588235294,75.73529411764706
9421_terrestrial,134,67,50,101,201,37.3134328358209,75.3731343283582
9422_terrestrial,132,66,51,99,198,38.63636363636363,75
9423_terrestrial,129,63,51,94,192,39.53488372093023,72.86821705426357
9424_terrestrial,131,67,52,96,198,39.69465648854962,73.2824427480916
9425_terrestrial,127,65,51,92,192,40.15748031496063,72.44094488188976
9426_terrestrial,125,59,50,88,184,40,70.39999999999999
9427_terrestrial,120,59,46,83,179,38.333333333333336,69.16666666666667
9428_terrestrial,115,62,46,80,177,40,69.56521739130434
9429_terrestrial,114,61,46,78,175,40.35087719298245,68.42105263157895
9430_terrestrial,113,58,47,75,171,41.5929203539823,66.3716814159292
9431_terrestrial,107,59,48,71,166,44.85981308411215,66.35514018691589
9432_terrestrial,96,52,43,62,148,44.79166666666667,64.58333333333334
9433_terrestrial,92,44,40,60,136,43.47826086956522,65.21739130434783
9434_terrestrial,84,43,39,56,127,46.42857142857143,66.66666666666666
9435_terrestrial,79,41,33,48,120,41.77215189873418,60.75949367088608
9436_terrestrial,72,36,31,45,108,43.05555555555556,62.5
9437_terrestrial,69,33,29,42,102,42.028985507246375,60.86956521739131
9438_terrestrial,72,32,30,43,104,41.66666666666667,59.72222222222222
9439_terrestrial,66,33,29,43,99,43.93939393939394,65.15151515151516
9440_terrestrial,63,33,29,40,96,46.03174603174603,63.49206349206349
9441_terrestrial,61,31,27,38,92,44.26229508196721,62.295081967213115
9442_terrestrial,61,31,27,38,92,44.26229508196721,62.295081967213115
9443_terrestrial,63,30,30,37,93,47.61904761904761,58.730158730158735
9444_terrestrial,60,26,30,36,86,50,60
9445_terrestrial,58,27,28,36,85,48.275862068965516,62.06896551724138
9446_terrestrial,68,37,37,40,105,54.41176470588235,58.82352941176471
9447_terrestrial,70,38,38,42,108,54.285714285714285,60
9448_terrestrial,71,38,39,42,109,54.929577464788736,59.154929577464785
9449_terrestrial,72,38,40,43,110,55.55555555555556,59.72222222222222
9450_terrestrial,73,36,44,42,109,60.273972602739725,57.534246575342465
9451_terrestrial,65,33,39,34,98,60,52.307692307692314
9452_terrestrial,63,32,38,32,95,60.317460317460316,50.79365079365079
9453_terrestrial,56,21,38,32,77,67.85714285714286,57.14285714285714
9454_terrestrial,56,21,38,32,77,67.85714285714286,57.14285714285714
9455_terrestrial,55,21,37,31,76,67.27272727272727,56.36363636363636
9456_terrestrial,57,21,38,31,78,66.66666666666666,54.385964912280706
9457_terrestrial,55,21,37,29,76,67.27272727272727,52.72727272727272
9458_terrestrial,57,21,38,30,78,66.66666666666666,52.63157894736842
9459_terrestrial,56,21,38,30,77,67.85714285714286,53.57142857142857
9460_terrestrial,56,21,38,30,77,67.85714285714286,53.57142857142857
9462_terrestrial,41,18,31,23,59,75.60975609756098,56.09756097560976
9463_terrestrial,43,19,33,25,62,76.74418604651163,58.139534883720934
9464_terrestrial,42,19,32,22,61,76.19047619047619,52.38095238095239
9468_terrestrial,64,26,41,30,90,64.0625,46.875
9469_terrestrial,65,28,41,29,93,63.07692307692307,44.61538461538462
9470_terrestrial,62,26,39,28,88,62.903225806451616,45.16129032258064
9471_terrestrial,46,12,24,25,58,52.17391304347826,54.347826086956516
9472_terrestrial,73,26,48,29,99,65.75342465753424,39.726027397260275
9473_terrestrial,72,26,47,28,98,65.27777777777779,38.88888888888889
9474_terrestrial,71,26,46,28,97,64.7887323943662,39.436619718309856
9475_terrestrial,72,32,47,29,104,65.27777777777779,40.27777777777778
9476_terrestrial,75,30,50,30,105,66.66666666666666,40
9489_terrestrial,83,30,61,33,113,73.49397590361446,39.75903614457831
9490_terrestrial,81,30,59,33,111,72.8395061728395,40.74074074074074
9491_terrestrial,79,28,57,32,107,72.15189873417721,40.50632911392405
9492_terrestrial,34,7,19,19,41,55.88235294117647,55.88235294117647
9493_terrestrial,26,7,13,14,33,50,53.84615384615385
9494_terrestrial,15,7,5,8,22,33.33333333333333,53.333333333333336
9495_terrestrial,10,5,3,4,15,30,40
9496_terrestrial,14,6,4,6,20,28.57142857142857,42.857142857142854
9497_terrestrial,22,7,10,11,29,45.45454545454545,50
9498_terrestrial,68,30,49,27,98,72.05882352941177,39.705882352941174
9499_terrestrial,76,30,56,32,106,73.68421052631578,42.10526315789473
9500_terrestrial,73,27,53,31,100,72.6027397260274,42.465753424657535
9518_terrestrial,127,51,98,72,178,77.16535433070865,56.69291338582677
9519_terrestrial,140,53,108,82,193,77.14285714285715,58.57142857142858
9520_terrestrial,136,59,107,79,195,78.67647058823529,58.08823529411765
9521_terrestrial,132,59,103,75,191,78.03030303030303,56.81818181818182
9522_terrestrial,130,54,104,70,184,80,53.84615384615385
9523_terrestrial,134,56,106,74,190,79.1044776119403,55.223880597014926
9524_terrestrial,128,58,100,68,186,78.125,53.125
9633_terrestrial,150,56,88,114,206,58.666666666666664,76
9634_terrestrial,153,54,89,117,207,58.16993464052288,76.47058823529412
9635_terrestrial,153,50,87,118,203,56.86274509803921,77.12418300653596
9636_terrestrial,153,50,87,118,203,56.86274509803921,77.12418300653596
9637_terrestrial,153,52,88,116,205,57.51633986928104,75.81699346405229
9638_terrestrial,154,52,90,117,206,58.44155844155844,75.97402597402598
9639_terrestrial,155,52,90,118,207,58.06451612903226,76.12903225806451
9640_terrestrial,154,52,89,117,206,57.7922077922078,75.97402597402598
9641_terrestrial,156,51,91,118,207,58.333333333333336,75.64102564102564
9642_terrestrial,158,51,91,120,209,57.59493670886076,75.9493670886076
9643_terrestrial,157,49,91,119,206,57.961783439490446,75.79617834394905
9644_terrestrial,157,48,92,119,205,58.59872611464968,75.79617834394905
9645_terrestrial,156,48,91,118,204,58.333333333333336,75.64102564102564
9646_terrestrial,157,49,91,119,206,57.961783439490446,75.79617834394905
9694_terrestrial,131,55,71,93,186,54.19847328244275,70.99236641221374
9695_terrestrial,128,55,68,91,183,53.125,71.09375
9696_terrestrial,129,55,70,90,184,54.263565891472865,69.76744186046511
9697_terrestrial,130,50,70,91,180,53.84615384615385,70
9698_terrestrial,130,53,69,92,183,53.07692307692308,70.76923076923077
9699_terrestrial,126,58,66,90,184,52.38095238095239,71.42857142857143
9700_terrestrial,128,57,69,89,185,53.90625,69.53125
9701_terrestrial,125,60,67,88,185,53.6,70.39999999999999
9702_terrestrial,125,59,67,88,184,53.6,70.39999999999999
9703_terrestrial,129,56,70,90,185,54.263565891472865,69.76744186046511
9704_terrestrial,126,56,67,92,182,53.17460317460318,73.01587301587301
9705_terrestrial,133,58,69,97,191,51.8796992481203,72.93233082706767
9706_terrestrial,128,56,66,95,184,51.5625,74.21875
9707_terrestrial,121,55,61,88,176,50.413223140495866,72.72727272727273
9708_terrestrial,116,55,61,83,171,52.58620689655172,71.55172413793103
9709_terrestrial,112,53,61,80,165,54.46428571428571,71.42857142857143
9710_terrestrial,112,52,64,77,164,57.14285714285714,68.75
9711_terrestrial,112,53,63,78,165,56.25,69.64285714285714
9712_terrestrial,110,51,60,77,161,54.54545454545454,70
9713_terrestrial,107,49,61,74,156,57.009345794392516,69.1588785046729
9714_terrestrial,105,51,59,69,156,56.19047619047619,65.71428571428571
9715_terrestrial,102,52,57,68,154,55.88235294117647,66.66666666666666
9716_terrestrial,106,53,60,71,159,56.60377358490566,66.98113207547169
9717_terrestrial,102,55,58,67,157,56.86274509803921,65.68627450980392
9718_terrestrial,98,57,57,63,155,58.16326530612245,64.28571428571429
9719_terrestrial,130,74,85,67,204,65.38461538461539,51.53846153846153
9720_terrestrial,122,73,80,61,195,65.57377049180327,50
9731_terrestrial,30,20,19,17,50,63.33333333333333,56.666666666666664
9735_terrestrial,133,73,79,66,206,59.3984962406015,49.62406015037594
9736_terrestrial,142,76,81,74,218,57.04225352112676,52.112676056338024
9737_terrestrial,119,49,56,74,168,47.05882352941176,62.18487394957983
9738_terrestrial,127,50,59,83,177,46.45669291338583,65.35433070866141
9739_terrestrial,131,56,61,88,187,46.56488549618321,67.17557251908397
9740_terrestrial,134,63,56,92,197,41.7910447761194,68.65671641791045
9741_terrestrial,134,64,53,96,198,39.55223880597015,71.64179104477611
9742_terrestrial,125,64,49,89,189,39.2,71.2
9743_terrestrial,126,66,50,90,192,39.682539682539684,71.42857142857143
9744_terrestrial,130,69,52,94,199,40,72.3076923076923
9745_terrestrial,125,67,50,92,192,40,73.6
9746_terrestrial,133,71,56,97,204,42.10526315789473,72.93233082706767
9747_terrestrial,138,72,58,101,210,42.028985507246375,73.18840579710145
9748_terrestrial,133,77,56,96,210,42.10526315789473,72.18045112781954
9749_terrestrial,144,80,62,104,224,43.05555555555556,72.22222222222221
9750_terrestrial,146,83,64,109,229,43.83561643835616,74.65753424657534
9751_terrestrial,145,77,59,110,222,40.689655172413794,75.86206896551724
9752_terrestrial,145,80,59,110,225,40.689655172413794,75.86206896551724
9753_terrestrial,146,85,59,111,231,40.41095890410959,76.02739726027397
9760_terrestrial,142,83,57,103,225,40.140845070422536,72.53521126760563
9761_terrestrial,141,87,58,100,228,41.13475177304964,70.92198581560284
9762_terrestrial,141,89,58,100,230,41.13475177304964,70.92198581560284
9763_terrestrial,141,86,59,100,227,41.843971631205676,70.92198581560284
9764_terrestrial,134,89,55,97,223,41.04477611940299,72.38805970149254
9765_terrestrial,132,88,51,95,220,38.63636363636363,71.96969696969697
9766_terrestrial,134,88,52,97,222,38.80597014925373,72.38805970149254
9767_terrestrial,133,89,51,96,222,38.34586466165413,72.18045112781954
9768_terrestrial,137,87,54,99,224,39.416058394160586,72.26277372262774
9769_terrestrial,136,87,52,98,223,38.23529411764706,72.05882352941177
9770_terrestrial,139,83,54,99,222,38.84892086330935,71.22302158273382
9771_terrestrial,144,84,54,100,228,37.5,69.44444444444444
9772_terrestrial,138,87,52,96,225,37.68115942028986,69.56521739130434
9773_terrestrial,137,89,54,97,226,39.416058394160586,70.8029197080292
9774_terrestrial,142,93,55,103,235,38.732394366197184,72.53521126760563
9775_terrestrial,142,92,57,106,234,40.140845070422536,74.64788732394366
9776_terrestrial,149,88,57,113,237,38.25503355704698,75.83892617449665
9777_terrestrial,149,86,57,111,235,38.25503355704698,74.49664429530202
9778_terrestrial,146,87,57,110,233,39.04109589041096,75.34246575342466
9779_terrestrial,147,87,55,112,234,37.41496598639456,76.19047619047619
9780_terrestrial,151,87,56,114,238,37.086092715231786,75.49668874172185
9781_terrestrial,147,84,53,113,231,36.054421768707485,76.87074829931973
9782_terrestrial,151,82,55,117,233,36.423841059602644,77.48344370860927
9783_terrestrial,148,77,55,114,225,37.16216216216216,77.02702702702703
9784_terrestrial,148,76,56,114,224,37.83783783783784,77.02702702702703
9785_terrestrial,146,76,54,112,222,36.986301369863014,76.71232876712328
9786_terrestrial,143,72,53,110,215,37.06293706293706,76.92307692307693
9787_terrestrial,133,67,50,100,200,37.59398496240601,75.18796992481202
9788_terrestrial,130,67,50,95,197,38.46153846153847,73.07692307692307
9789_terrestrial,134,72,53,97,206,39.55223880597015,72.38805970149254
9790_terrestrial,127,68,50,92,195,39.37007874015748,72.44094488188976
9791_terrestrial,124,69,51,89,193,41.12903225806452,71.7741935483871
9792_terrestrial,115,68,48,82,183,41.73913043478261,71.30434782608695
9793_terrestrial,111,55,49,75,166,44.14414414414414,67.56756756756756
9794_terrestrial,105,50,48,69,155,45.714285714285715,65.71428571428571
9795_terrestrial,99,46,43,65,145,43.43434343434344,65.65656565656566
9796_terrestrial,96,44,42,63,140,43.75,65.625
9797_terrestrial,89,43,37,59,132,41.57303370786517,66.29213483146067
9798_terrestrial,84,43,33,52,127,39.285714285714285,61.904761904761905
9799_terrestrial,78,39,32,48,117,41.02564102564102,61.53846153846154
9800_terrestrial,71,30,29,43,101,40.845070422535215,60.56338028169014
9801_terrestrial,66,31,25,41,97,37.878787878787875,62.121212121212125
9802_terrestrial,67,29,26,42,96,38.80597014925373,62.68656716417911
9803_terrestrial,69,27,29,41,96,42.028985507246375,59.42028985507246
9804_terrestrial,64,27,29,38,91,45.3125,59.375
9805_terrestrial,67,26,32,43,93,47.76119402985074,64.17910447761194
9806_terrestrial,64,25,30,39,89,46.875,60.9375
9807_terrestrial,77,36,40,47,113,51.94805194805194,61.038961038961034
9808_terrestrial,75,34,41,43,109,54.666666666666664,57.333333333333336
9809_terrestrial,70,36,39,41,106,55.714285714285715,58.57142857142858
9810_terrestrial,67,32,37,38,99,55.223880597014926,56.71641791044776
9817_terrestrial,48,16,34,27,64,70.83333333333334,56.25
9818_terrestrial,48,16,34,27,64,70.83333333333334,56.25
9819_terrestrial,47,16,33,26,63,70.2127659574468,55.319148936170215
9820_terrestrial,36,17,23,20,53,63.888888888888886,55.55555555555556
9821_terrestrial,37,17,24,20,54,64.86486486486487,54.054054054054056
9822_terrestrial,66,28,35,34,94,53.03030303030303,51.515151515151516
9823_terrestrial,69,29,38,34,98,55.072463768115945,49.275362318840585
9824_terrestrial,67,28,36,33,95,53.73134328358209,49.25373134328358
9825_terrestrial,66,30,35,32,96,53.03030303030303,48.484848484848484
9826_terrestrial,67,30,38,32,97,56.71641791044776,47.76119402985074
9827_terrestrial,65,30,36,32,95,55.38461538461539,49.23076923076923
9828_terrestrial,63,29,35,31,92,55.55555555555556,49.2063492063492
9829_terrestrial,62,26,40,27,88,64.51612903225806,43.54838709677419
9830_terrestrial,63,26,41,28,89,65.07936507936508,44.44444444444444
9831_terrestrial,64,26,41,28,90,64.0625,43.75
9832_terrestrial,68,26,45,28,94,66.17647058823529,41.17647058823529
9833_terrestrial,72,26,48,29,98,66.66666666666666,40.27777777777778
9834_terrestrial,75,28,50,31,103,66.66666666666666,41.333333333333336
9835_terrestrial,75,30,50,31,105,66.66666666666666,41.333333333333336
9836_terrestrial,76,36,51,30,112,67.10526315789474,39.473684210526315
9850_terrestrial,80,29,58,33,109,72.5,41.25
9851_terrestrial,81,29,59,32,110,72.8395061728395,39.50617283950617
9852_terrestrial,81,29,59,32,110,72.8395061728395,39.50617283950617
9853_terrestrial,33,8,18,18,41,54.54545454545454,54.54545454545454
9854_terrestrial,24,8,10,14,32,41.66666666666667,58.333333333333336
9855_terrestrial,21,8,10,11,29,47.61904761904761,52.38095238095239
9856_terrestrial,20,6,9,9,26,45,45
9857_terrestrial,65,30,47,24,95,72.3076923076923,36.92307692307693
9858_terrestrial,70,30,51,28,100,72.85714285714285,40
9859_terrestrial,68,28,48,28,96,70.58823529411765,41.17647058823529
9893_terrestrial,118,58,90,53,176,76.27118644067797,44.91525423728814
9894_terrestrial,120,58,91,55,178,75.83333333333333,45.83333333333333
9994_terrestrial,161,55,93,124,216,57.7639751552795,77.01863354037268
9995_terrestrial,161,53,92,125,214,57.14285714285714,77.63975155279503
9996_terrestrial,160,51,94,122,211,58.75,76.25
9997_terrestrial,163,52,96,124,215,58.895705521472394,76.07361963190185
9998_terrestrial,163,54,96,124,217,58.895705521472394,76.07361963190185
9999_terrestrial,164,55,96,125,219,58.536585365853654,76.21951219512195
10000_terrestrial,166,55,97,127,221,58.43373493975904,76.50602409638554
10001_terrestrial,166,54,99,128,220,59.63855421686747,77.10843373493977
10002_terrestrial,162,54,95,124,216,58.64197530864198,76.5432098765432
10003_terrestrial,163,54,96,125,217,58.895705521472394,76.68711656441718
10004_terrestrial,162,54,96,124,216,59.25925925925925,76.5432098765432
10005_terrestrial,161,52,96,123,213,59.62732919254658,76.3975155279503
10054_terrestrial,128,56,71,91,184,55.46875,71.09375
10055_terrestrial,126,54,70,89,180,55.55555555555556,70.63492063492063
10056_terrestrial,128,53,70,91,181,54.6875,71.09375
10057_terrestrial,130,62,70,91,192,53.84615384615385,70
10058_terrestrial,131,60,71,92,191,54.19847328244275,70.22900763358778
10059_terrestrial,132,62,73,91,194,55.3030303030303,68.93939393939394
10060_terrestrial,128,60,70,89,188,54.6875,69.53125
10061_terrestrial,125,63,69,90,188,55.2,72
10062_terrestrial,122,59,66,88,181,54.09836065573771,72.1311475409836
10063_terrestrial,126,56,68,91,182,53.96825396825397,72.22222222222221
10064_terrestrial,155,74,93,100,229,60,64.51612903225806
10065_terrestrial,160,80,98,103,240,61.25000000000001,64.375
10066_terrestrial,155,80,96,100,235,61.935483870967744,64.51612903225806
10067_terrestrial,118,56,62,87,174,52.54237288135594,73.72881355932203
10068_terrestrial,110,49,61,84,159,55.45454545454545,76.36363636363637
10069_terrestrial,107,50,59,81,157,55.140186915887845,75.70093457943925
10070_terrestrial,104,51,57,77,155,54.807692307692314,74.03846153846155
10071_terrestrial,101,52,56,75,153,55.44554455445545,74.25742574257426
10072_terrestrial,105,46,58,76,151,55.23809523809524,72.38095238095238
10073_terrestrial,103,48,57,71,151,55.33980582524271,68.93203883495146
10074_terrestrial,97,46,54,65,143,55.670103092783506,67.0103092783505
10075_terrestrial,98,48,55,65,146,56.12244897959183,66.3265306122449
10076_terrestrial,103,48,58,66,151,56.310679611650485,64.07766990291263
10077_terrestrial,97,50,55,61,147,56.70103092783505,62.88659793814433
10078_terrestrial,91,48,53,57,139,58.24175824175825,62.637362637362635
10079_terrestrial,94,51,55,58,145,58.51063829787234,61.702127659574465
10080_terrestrial,129,82,83,65,211,64.34108527131784,50.3875968992248
10094_terrestrial,130,72,78,65,202,60,50
10095_terrestrial,139,73,86,71,212,61.87050359712231,51.07913669064749
10096_terrestrial,142,78,83,72,220,58.45070422535211,50.70422535211267
10097_terrestrial,116,46,56,70,162,48.275862068965516,60.3448275862069
10098_terrestrial,120,53,56,79,173,46.666666666666664,65.83333333333333
10099_terrestrial,121,55,56,81,176,46.28099173553719,66.94214876033058
10100_terrestrial,124,64,54,85,188,43.54838709677419,68.54838709677419
10101_terrestrial,126,67,50,89,193,39.682539682539684,70.63492063492063
10102_terrestrial,124,67,49,88,191,39.516129032258064,70.96774193548387
10103_terrestrial,121,66,47,86,187,38.84297520661157,71.07438016528926
10104_terrestrial,128,67,51,93,195,39.84375,72.65625
10105_terrestrial,133,69,52,95,202,39.097744360902254,71.42857142857143
10106_terrestrial,137,71,55,99,208,40.14598540145985,72.26277372262774
10107_terrestrial,141,78,58,102,219,41.13475177304964,72.3404255319149
10108_terrestrial,158,79,62,117,237,39.24050632911392,74.0506329113924
10109_terrestrial,214,131,109,131,345,50.93457943925234,61.21495327102804
10121_terrestrial,152,89,59,113,241,38.81578947368421,74.3421052631579
10122_terrestrial,154,93,65,115,247,42.2077922077922,74.67532467532467
10123_terrestrial,156,96,66,114,252,42.30769230769231,73.07692307692307
10124_terrestrial,152,96,65,110,248,42.76315789473684,72.36842105263158
10125_terrestrial,147,95,61,107,242,41.49659863945578,72.78911564625851
10129_terrestrial,145,94,56,105,239,38.62068965517241,72.41379310344827
10130_terrestrial,147,94,57,105,241,38.775510204081634,71.42857142857143
10131_terrestrial,147,96,58,109,243,39.455782312925166,74.14965986394559
10132_terrestrial,152,94,56,108,246,36.84210526315789,71.05263157894737
10133_terrestrial,155,91,59,111,246,38.064516129032256,71.61290322580646
10134_terrestrial,154,91,58,110,245,37.66233766233766,71.42857142857143
10135_terrestrial,156,93,58,113,249,37.17948717948718,72.43589743589743
10136_terrestrial,162,94,59,119,256,36.41975308641975,73.4567901234568
10137_terrestrial,162,98,61,120,260,37.65432098765432,74.07407407407408
10138_terrestrial,162,94,62,123,256,38.2716049382716,75.92592592592592
10139_terrestrial,157,94,58,120,251,36.94267515923567,76.43312101910828
10140_terrestrial,153,96,53,118,249,34.64052287581699,77.12418300653596
10141_terrestrial,153,94,52,119,247,33.98692810457516,77.77777777777779
10142_terrestrial,159,94,56,125,253,35.22012578616352,78.61635220125787
10143_terrestrial,165,89,58,129,254,35.15151515151515,78.18181818181819
10144_terrestrial,162,89,57,126,251,35.18518518518518,77.77777777777779
10145_terrestrial,155,88,55,121,243,35.483870967741936,78.06451612903226
10146_terrestrial,154,88,56,122,242,36.36363636363637,79.22077922077922
10149_terrestrial,142,75,50,109,217,35.2112676056338,76.76056338028168
10150_terrestrial,140,70,50,107,210,35.714285714285715,76.42857142857142
10151_terrestrial,132,66,48,101,198,36.36363636363637,76.51515151515152
10152_terrestrial,123,62,46,92,185,37.39837398373984,74.79674796747967
10153_terrestrial,122,64,48,87,186,39.34426229508197,71.31147540983606
10154_terrestrial,117,62,48,82,179,41.02564102564102,70.08547008547008
10155_terrestrial,109,56,45,74,165,41.284403669724774,67.88990825688074
10156_terrestrial,107,52,44,74,159,41.1214953271028,69.1588785046729
10157_terrestrial,100,50,41,69,150,41,69
10158_terrestrial,96,48,38,65,144,39.58333333333333,67.70833333333334
10159_terrestrial,90,47,37,62,137,41.11111111111111,68.88888888888889
10160_terrestrial,83,44,34,55,127,40.963855421686745,66.26506024096386
10161_terrestrial,80,42,31,52,122,38.75,65
10162_terrestrial,79,41,33,50,120,41.77215189873418,63.29113924050633
10163_terrestrial,81,35,36,53,116,44.44444444444444,65.4320987654321
10164_terrestrial,77,28,34,49,105,44.15584415584416,63.63636363636363
10165_terrestrial,80,28,34,54,108,42.5,67.5
10166_terrestrial,84,36,40,52,120,47.61904761904761,61.904761904761905
10167_terrestrial,78,35,39,48,113,50,61.53846153846154
10168_terrestrial,46,19,30,35,65,65.21739130434783,76.08695652173914
10180_terrestrial,36,17,23,20,53,63.888888888888886,55.55555555555556
10181_terrestrial,37,17,24,20,54,64.86486486486487,54.054054054054056
10182_terrestrial,53,16,24,30,69,45.28301886792453,56.60377358490566
10183_terrestrial,67,29,36,35,96,53.73134328358209,52.23880597014925
10184_terrestrial,53,18,24,30,71,45.28301886792453,56.60377358490566
10185_terrestrial,52,18,22,30,70,42.30769230769231,57.692307692307686
10186_terrestrial,50,20,22,30,70,44,60
10187_terrestrial,48,20,21,29,68,43.75,60.416666666666664
10188_terrestrial,63,33,34,32,96,53.96825396825397,50.79365079365079
10189_terrestrial,64,31,36,32,95,56.25,50
10190_terrestrial,65,31,36,33,96,55.38461538461539,50.76923076923077
10191_terrestrial,66,31,36,35,97,54.54545454545454,53.03030303030303
10194_terrestrial,75,26,51,30,101,68,40
10195_terrestrial,55,27,43,24,82,78.18181818181819,43.63636363636363
10196_terrestrial,58,27,46,25,85,79.3103448275862,43.103448275862064
10211_terrestrial,84,30,62,35,114,73.80952380952381,41.66666666666667
10212_terrestrial,88,34,66,35,122,75,39.77272727272727
10213_terrestrial,82,28,61,33,110,74.39024390243902,40.243902439024396
10214_terrestrial,79,26,60,30,105,75.9493670886076,37.9746835443038
10215_terrestrial,78,39,59,29,117,75.64102564102564,37.17948717948718
10216_terrestrial,29,8,15,16,37,51.724137931034484,55.172413793103445
10217_terrestrial,65,31,46,25,96,70.76923076923077,38.46153846153847
10218_terrestrial,66,30,47,26,96,71.21212121212122,39.39393939393939
10254_terrestrial,125,60,95,58,185,76,46.400000000000006
10355_terrestrial,163,64,95,124,227,58.282208588957054,76.07361963190185
10356_terrestrial,162,66,94,124,228,58.0246913580247,76.5432098765432
10357_terrestrial,163,64,95,125,227,58.282208588957054,76.68711656441718
10358_terrestrial,161,62,94,123,223,58.38509316770186,76.3975155279503
10359_terrestrial,163,60,95,125,223,58.282208588957054,76.68711656441718
10360_terrestrial,163,61,96,125,224,58.895705521472394,76.68711656441718
10361_terrestrial,164,59,97,126,223,59.14634146341463,76.82926829268293
10362_terrestrial,165,58,98,126,223,59.3939393939394,76.36363636363637
10363_terrestrial,167,58,98,128,225,58.68263473053892,76.64670658682635
10364_terrestrial,167,60,98,128,227,58.68263473053892,76.64670658682635
10415_terrestrial,132,58,72,93,190,54.54545454545454,70.45454545454545
10416_terrestrial,133,60,73,94,193,54.88721804511278,70.67669172932331
10417_terrestrial,166,77,102,102,243,61.44578313253012,61.44578313253012
10418_terrestrial,129,54,72,94,183,55.81395348837209,72.86821705426357
10419_terrestrial,146,78,88,94,224,60.273972602739725,64.38356164383562
10420_terrestrial,148,76,92,94,224,62.16216216216216,63.51351351351351
10421_terrestrial,150,75,92,95,225,61.33333333333333,63.33333333333333
10422_terrestrial,148,75,90,95,223,60.810810810810814,64.1891891891892
10423_terrestrial,148,71,90,97,219,60.810810810810814,65.54054054054053
10424_terrestrial,158,78,96,105,236,60.75949367088608,66.45569620253164
10425_terrestrial,152,75,93,98,227,61.18421052631579,64.47368421052632
10426_terrestrial,122,57,66,92,179,54.09836065573771,75.40983606557377
10427_terrestrial,114,54,61,85,168,53.50877192982456,74.56140350877193
10428_terrestrial,105,51,59,79,156,56.19047619047619,75.23809523809524
10429_terrestrial,101,51,55,76,152,54.45544554455446,75.24752475247524
10430_terrestrial,101,51,54,75,152,53.46534653465347,74.25742574257426
10431_terrestrial,101,49,54,73,150,53.46534653465347,72.27722772277228
10432_terrestrial,102,48,53,74,150,51.9607843137255,72.54901960784314
10433_terrestrial,144,79,87,81,223,60.416666666666664,56.25
10434_terrestrial,131,79,80,70,210,61.06870229007634,53.43511450381679
10435_terrestrial,125,82,78,64,207,62.4,51.2
10436_terrestrial,80,43,40,55,123,50,68.75
10447_terrestrial,52,37,43,12,89,82.6923076923077,23.076923076923077
10448_terrestrial,53,37,44,13,90,83.01886792452831,24.528301886792452
10453_terrestrial,60,48,49,25,108,81.66666666666667,41.66666666666667
10454_terrestrial,65,48,54,30,113,83.07692307692308,46.15384615384615
10455_terrestrial,147,78,92,75,225,62.585034013605444,51.02040816326531
10456_terrestrial,139,78,86,70,217,61.87050359712231,50.35971223021583
10457_terrestrial,102,49,50,63,151,49.01960784313725,61.76470588235294
10458_terrestrial,138,83,75,76,221,54.347826086956516,55.072463768115945
10459_terrestrial,121,62,54,83,183,44.62809917355372,68.59504132231406
10460_terrestrial,118,68,52,84,186,44.06779661016949,71.1864406779661
10461_terrestrial,122,67,48,86,189,39.34426229508197,70.49180327868852
10462_terrestrial,119,69,46,83,188,38.655462184873954,69.74789915966386
10463_terrestrial,119,69,47,83,188,39.49579831932773,69.74789915966386
10464_terrestrial,126,72,52,90,198,41.269841269841265,71.42857142857143
10465_terrestrial,137,76,56,97,213,40.87591240875913,70.8029197080292
10466_terrestrial,144,78,58,104,222,40.27777777777778,72.22222222222221
10467_terrestrial,157,82,65,112,239,41.40127388535032,71.3375796178344
10468_terrestrial,215,129,107,127,344,49.76744186046512,59.06976744186046
10469_terrestrial,220,137,109,131,357,49.54545454545455,59.54545454545455
10470_terrestrial,207,130,103,126,337,49.75845410628019,60.86956521739131
10482_terrestrial,167,102,59,124,269,35.32934131736527,74.25149700598801
10483_terrestrial,165,103,62,125,268,37.57575757575757,75.75757575757575
10484_terrestrial,165,106,68,124,271,41.21212121212121,75.15151515151514
10485_terrestrial,165,112,71,122,277,43.03030303030303,73.93939393939394
10489_terrestrial,156,101,58,112,257,37.17948717948718,71.7948717948718
10490_terrestrial,154,98,58,110,252,37.66233766233766,71.42857142857143
10491_terrestrial,158,97,62,114,255,39.24050632911392,72.15189873417721
10492_terrestrial,158,97,62,116,255,39.24050632911392,73.41772151898735
10497_terrestrial,166,105,57,122,271,34.33734939759036,73.49397590361446
10498_terrestrial,167,105,61,125,272,36.52694610778443,74.8502994011976
10499_terrestrial,167,103,60,125,270,35.92814371257485,74.8502994011976
10500_terrestrial,164,99,57,124,263,34.756097560975604,75.60975609756098
10501_terrestrial,163,98,54,126,261,33.12883435582822,77.30061349693251
10502_terrestrial,165,101,57,131,266,34.54545454545455,79.39393939393939
10503_terrestrial,169,99,59,135,268,34.9112426035503,79.88165680473372
10504_terrestrial,168,102,58,134,270,34.523809523809526,79.76190476190477
10505_terrestrial,171,104,58,137,275,33.91812865497076,80.11695906432749
10506_terrestrial,174,106,61,140,280,35.05747126436782,80.45977011494253
10511_terrestrial,154,77,52,121,231,33.76623376623377,78.57142857142857
10512_terrestrial,149,75,52,116,224,34.899328859060404,77.85234899328859
10513_terrestrial,141,75,49,110,216,34.751773049645394,78.01418439716312
10514_terrestrial,128,67,45,98,195,35.15625,76.5625
10515_terrestrial,126,66,47,94,192,37.301587301587304,74.60317460317461
10516_terrestrial,122,59,44,90,181,36.0655737704918,73.77049180327869
10517_terrestrial,115,57,43,84,172,37.391304347826086,73.04347826086956
10518_terrestrial,116,56,43,83,172,37.06896551724138,71.55172413793103
10519_terrestrial,113,53,45,82,166,39.823008849557525,72.56637168141593
10520_terrestrial,106,54,43,77,160,40.56603773584906,72.64150943396226
10521_terrestrial,101,52,42,71,153,41.584158415841586,70.29702970297029
10522_terrestrial,94,47,38,65,141,40.42553191489361,69.14893617021278
10523_terrestrial,92,48,37,61,140,40.21739130434783,66.30434782608695
10524_terrestrial,87,40,36,59,127,41.37931034482759,67.81609195402298
10525_terrestrial,92,33,37,64,125,40.21739130434783,69.56521739130434
10526_terrestrial,96,43,45,63,139,46.875,65.625
10542_terrestrial,63,27,32,34,90,50.79365079365079,53.96825396825397
10543_terrestrial,64,31,33,36,95,51.5625,56.25
10544_terrestrial,52,21,22,31,73,42.30769230769231,59.61538461538461
10545_terrestrial,50,20,22,30,70,44,60
10546_terrestrial,49,19,22,30,68,44.89795918367347,61.224489795918366
10547_terrestrial,50,20,22,31,70,44,62
10548_terrestrial,50,21,24,31,71,48,62
10549_terrestrial,50,24,23,31,74,46,62
10550_terrestrial,68,37,39,35,105,57.35294117647059,51.470588235294116
10551_terrestrial,70,35,40,35,105,57.14285714285714,50
10552_terrestrial,43,20,30,26,63,69.76744186046511,60.46511627906976
10553_terrestrial,44,20,31,27,64,70.45454545454545,61.36363636363637
10555_terrestrial,88,38,52,44,126,59.09090909090909,50
10556_terrestrial,99,44,63,46,143,63.63636363636363,46.464646464646464
10572_terrestrial,80,28,60,33,108,75,41.25
10573_terrestrial,80,28,60,33,108,75,41.25
10574_terrestrial,81,28,62,31,109,76.5432098765432,38.2716049382716
10575_terrestrial,79,32,60,31,111,75.9493670886076,39.24050632911392
10576_terrestrial,74,32,55,28,106,74.32432432432432,37.83783783783784
10577_terrestrial,73,33,53,29,106,72.6027397260274,39.726027397260275
10578_terrestrial,67,31,47,27,98,70.1492537313433,40.298507462686565
10619_terrestrial,189,83,145,89,272,76.71957671957672,47.08994708994709
10620_terrestrial,175,80,133,82,255,76,46.85714285714286
10625_terrestrial,235,92,179,121,327,76.17021276595744,51.48936170212765
10716_terrestrial,166,74,97,127,240,58.43373493975904,76.50602409638554
10717_terrestrial,166,72,97,127,238,58.43373493975904,76.50602409638554
10718_terrestrial,164,72,95,126,236,57.92682926829268,76.82926829268293
10719_terrestrial,166,72,95,128,238,57.22891566265061,77.10843373493977
10720_terrestrial,166,68,95,128,234,57.22891566265061,77.10843373493977
10721_terrestrial,166,68,96,128,234,57.831325301204814,77.10843373493977
10722_terrestrial,166,70,97,128,236,58.43373493975904,77.10843373493977
10723_terrestrial,169,69,99,130,238,58.57988165680473,76.92307692307693
10724_terrestrial,170,69,100,131,239,58.82352941176471,77.05882352941177
10775_terrestrial,172,90,107,109,262,62.2093023255814,63.372093023255815
10776_terrestrial,161,81,101,101,242,62.732919254658384,62.732919254658384
10777_terrestrial,151,72,93,98,223,61.58940397350994,64.90066225165563
10780_terrestrial,140,72,87,90,212,62.142857142857146,64.28571428571429
10781_terrestrial,147,72,89,94,219,60.544217687074834,63.94557823129252
10782_terrestrial,167,82,104,113,249,62.27544910179641,67.66467065868264
10783_terrestrial,159,74,99,106,233,62.264150943396224,66.66666666666666
10784_terrestrial,178,95,112,115,273,62.92134831460674,64.60674157303372
10785_terrestrial,171,89,109,107,260,63.74269005847953,62.57309941520468
10786_terrestrial,164,90,105,101,254,64.02439024390245,61.58536585365854
10787_terrestrial,159,90,98,94,249,61.63522012578616,59.11949685534591
10788_terrestrial,152,90,96,88,242,63.1578947368421,57.89473684210527
10789_terrestrial,149,90,92,87,239,61.74496644295302,58.38926174496645
10790_terrestrial,151,86,95,84,237,62.913907284768214,55.62913907284768
10791_terrestrial,147,85,91,82,232,61.904761904761905,55.78231292517006
10792_terrestrial,139,76,84,77,215,60.431654676258994,55.39568345323741
10793_terrestrial,136,75,81,75,211,59.55882352941176,55.14705882352941
10813_terrestrial,61,48,50,26,109,81.9672131147541,42.62295081967213
10814_terrestrial,64,48,53,29,112,82.8125,45.3125
10815_terrestrial,63,48,52,28,111,82.53968253968253,44.44444444444444
10816_terrestrial,131,75,79,66,206,60.30534351145038,50.38167938931297
10817_terrestrial,95,44,45,59,139,47.368421052631575,62.10526315789474
10818_terrestrial,143,89,87,74,232,60.83916083916085,51.74825174825175
10819_terrestrial,150,94,90,80,244,60,53.333333333333336
10820_terrestrial,153,98,89,83,251,58.16993464052288,54.248366013071895
10821_terrestrial,121,72,53,86,193,43.80165289256198,71.07438016528926
10822_terrestrial,130,75,54,91,205,41.53846153846154,70
10823_terrestrial,132,76,55,93,208,41.66666666666667,70.45454545454545
10824_terrestrial,134,78,56,94,212,41.7910447761194,70.1492537313433
10825_terrestrial,132,79,54,95,211,40.909090909090914,71.96969696969697
10826_terrestrial,214,135,110,127,349,51.4018691588785,59.345794392523366
10827_terrestrial,216,132,113,127,348,52.31481481481482,58.79629629629629
10828_terrestrial,196,123,102,112,319,52.04081632653062,57.14285714285714
10829_terrestrial,224,127,115,132,351,51.33928571428571,58.92857142857143
10830_terrestrial,223,132,116,129,355,52.01793721973094,57.847533632286996
10831_terrestrial,218,126,115,126,344,52.752293577981646,57.798165137614674
10832_terrestrial,205,124,109,119,329,53.170731707317074,58.048780487804876
10833_terrestrial,170,88,105,114,258,61.76470588235294,67.05882352941175
10836_terrestrial,167,91,100,112,258,59.88023952095808,67.06586826347305
10850_terrestrial,157,103,62,114,260,39.490445859872615,72.61146496815286
10851_terrestrial,159,95,62,116,254,38.9937106918239,72.95597484276729
10852_terrestrial,161,95,61,116,256,37.88819875776397,72.04968944099379
10858_terrestrial,168,96,60,126,264,35.714285714285715,75
10859_terrestrial,168,92,60,126,260,35.714285714285715,75
10860_terrestrial,169,94,58,130,263,34.319526627218934,76.92307692307693
10861_terrestrial,175,99,61,134,274,34.85714285714286,76.57142857142857
10862_terrestrial,177,99,63,138,276,35.59322033898305,77.96610169491525
10863_terrestrial,175,101,61,136,276,34.85714285714286,77.71428571428571
10864_terrestrial,176,103,58,137,279,32.95454545454545,77.8409090909091
10865_terrestrial,174,102,59,138,276,33.90804597701149,79.3103448275862
10866_terrestrial,175,105,60,139,280,34.285714285714285,79.42857142857143
10867_terrestrial,177,107,62,141,284,35.02824858757062,79.66101694915254
10870_terrestrial,166,103,56,131,269,33.734939759036145,78.91566265060241
10871_terrestrial,167,95,55,132,262,32.93413173652694,79.04191616766467
10872_terrestrial,163,88,54,128,251,33.12883435582822,78.52760736196319
10873_terrestrial,158,88,52,124,246,32.91139240506329,78.48101265822784
10875_terrestrial,146,79,48,114,225,32.87671232876712,78.08219178082192
10876_terrestrial,139,77,48,107,216,34.53237410071942,76.97841726618705
10877_terrestrial,142,75,52,107,217,36.61971830985916,75.35211267605634
10878_terrestrial,136,68,50,101,204,36.76470588235294,74.26470588235294
10879_terrestrial,128,63,49,95,191,38.28125,74.21875
10880_terrestrial,124,58,47,92,182,37.903225806451616,74.19354838709677
10881_terrestrial,118,58,45,87,176,38.13559322033898,73.72881355932203
10882_terrestrial,116,58,46,84,174,39.6551724137931,72.41379310344827
10883_terrestrial,114,59,46,79,173,40.35087719298245,69.2982456140351
10884_terrestrial,113,57,42,77,170,37.16814159292036,68.14159292035397
10885_terrestrial,127,71,53,86,198,41.732283464566926,67.71653543307087
10886_terrestrial,121,67,54,80,188,44.62809917355372,66.11570247933885
10900_terrestrial,35,18,22,23,53,62.857142857142854,65.71428571428571
10901_terrestrial,33,18,22,21,51,66.66666666666666,63.63636363636363
10902_terrestrial,67,31,34,39,98,50.74626865671642,58.2089552238806
10903_terrestrial,69,31,35,41,100,50.72463768115942,59.42028985507246
10904_terrestrial,57,21,25,36,78,43.859649122807014,63.1578947368421
10905_terrestrial,52,22,23,33,74,44.230769230769226,63.46153846153846
10906_terrestrial,52,21,23,34,73,44.230769230769226,65.38461538461539
10907_terrestrial,54,21,24,34,75,44.44444444444444,62.96296296296296
10908_terrestrial,57,22,24,34,79,42.10526315789473,59.64912280701754
10909_terrestrial,56,22,23,31,78,41.07142857142857,55.35714285714286
10910_terrestrial,74,37,36,39,111,48.64864864864865,52.702702702702695
10911_terrestrial,80,37,40,42,117,50,52.5
10915_terrestrial,87,41,51,43,128,58.620689655172406,49.42528735632184
10916_terrestrial,101,48,65,46,149,64.35643564356435,45.54455445544555
10917_terrestrial,104,50,65,47,154,62.5,45.19230769230769
10936_terrestrial,65,30,52,28,95,80,43.07692307692308
10937_terrestrial,63,32,49,28,95,77.77777777777779,44.44444444444444
10979_terrestrial,185,83,144,84,268,77.83783783783784,45.40540540540541
11077_terrestrial,176,82,98,137,258,55.68181818181818,77.8409090909091
11078_terrestrial,178,85,98,139,263,55.0561797752809,78.08988764044943
11079_terrestrial,180,85,100,141,265,55.55555555555556,78.33333333333333
11080_terrestrial,179,83,101,139,262,56.424581005586596,77.6536312849162
11081_terrestrial,177,80,99,138,257,55.932203389830505,77.96610169491525
11082_terrestrial,178,81,100,138,259,56.17977528089888,77.52808988764045
11083_terrestrial,178,77,100,137,255,56.17977528089888,76.96629213483146
11136_terrestrial,161,92,101,105,253,62.732919254658384,65.21739130434783
11140_terrestrial,154,74,96,100,228,62.33766233766234,64.93506493506493
11141_terrestrial,166,76,101,112,242,60.8433734939759,67.46987951807229
11142_terrestrial,163,81,98,112,244,60.122699386503065,68.71165644171779
11143_terrestrial,173,92,108,110,265,62.42774566473989,63.58381502890174
11144_terrestrial,178,91,112,113,269,62.92134831460674,63.48314606741573
11145_terrestrial,178,91,114,112,269,64.04494382022472,62.92134831460674
11146_terrestrial,116,52,63,83,168,54.310344827586206,71.55172413793103
11147_terrestrial,151,84,95,86,235,62.913907284768214,56.95364238410596
11151_terrestrial,138,78,83,75,216,60.14492753623188,54.347826086956516
11178_terrestrial,139,87,87,69,226,62.589928057553955,49.64028776978417
11179_terrestrial,146,88,89,76,234,60.95890410958904,52.054794520547944
11180_terrestrial,147,92,87,77,239,59.183673469387756,52.38095238095239
11181_terrestrial,152,91,88,82,243,57.89473684210527,53.94736842105263
11182_terrestrial,154,99,87,84,253,56.493506493506494,54.54545454545454
11183_terrestrial,175,106,98,103,281,56.00000000000001,58.857142857142854
11184_terrestrial,175,111,98,104,286,56.00000000000001,59.42857142857143
11185_terrestrial,204,126,115,122,330,56.372549019607845,59.80392156862745
11186_terrestrial,209,126,116,124,335,55.50239234449761,59.33014354066985
11187_terrestrial,213,128,119,124,341,55.86854460093896,58.21596244131455
11188_terrestrial,151,80,97,95,231,64.23841059602648,62.913907284768214
11189_terrestrial,144,77,92,92,221,63.888888888888886,63.888888888888886
11211_terrestrial,156,105,61,113,261,39.1025641025641,72.43589743589743
11212_terrestrial,156,99,60,113,255,38.46153846153847,72.43589743589743
11213_terrestrial,160,102,60,113,262,37.5,70.625
11220_terrestrial,170,96,59,129,266,34.705882352941174,75.88235294117646
11221_terrestrial,173,97,60,132,270,34.68208092485549,76.30057803468208
11222_terrestrial,178,97,63,137,275,35.39325842696629,76.96629213483146
11223_terrestrial,181,101,61,140,282,33.70165745856354,77.34806629834254
11224_terrestrial,182,102,59,143,284,32.417582417582416,78.57142857142857
11225_terrestrial,188,103,63,147,291,33.51063829787234,78.19148936170212
11226_terrestrial,186,102,64,145,288,34.40860215053764,77.95698924731182
11227_terrestrial,185,102,63,144,287,34.054054054054056,77.83783783783784
11228_terrestrial,180,104,63,142,284,35,78.88888888888889
11229_terrestrial,186,106,63,148,292,33.87096774193548,79.56989247311827
11230_terrestrial,181,106,61,145,287,33.70165745856354,80.11049723756905
11231_terrestrial,164,100,56,132,264,34.146341463414636,80.48780487804879
11232_terrestrial,162,96,54,128,258,33.33333333333333,79.01234567901234
11233_terrestrial,161,90,55,127,251,34.161490683229815,78.88198757763976
11234_terrestrial,158,83,54,124,241,34.177215189873415,78.48101265822784
11235_terrestrial,153,81,51,119,234,33.33333333333333,77.77777777777779
11236_terrestrial,146,81,49,116,227,33.56164383561644,79.45205479452055
11237_terrestrial,143,77,50,112,220,34.96503496503497,78.32167832167832
11238_terrestrial,145,76,49,114,221,33.793103448275865,78.62068965517241
11239_terrestrial,144,77,50,113,221,34.72222222222222,78.47222222222221
11240_terrestrial,140,73,53,107,213,37.857142857142854,76.42857142857142
11241_terrestrial,137,69,54,105,206,39.416058394160586,76.64233576642336
11242_terrestrial,133,69,50,102,202,37.59398496240601,76.69172932330827
11243_terrestrial,136,73,54,102,209,39.705882352941174,75
11244_terrestrial,135,76,53,99,211,39.25925925925926,73.33333333333333
11245_terrestrial,136,76,55,98,212,40.44117647058824,72.05882352941177
11246_terrestrial,134,84,57,93,218,42.53731343283582,69.40298507462687
11247_terrestrial,131,78,55,92,209,41.98473282442748,70.22900763358778
11248_terrestrial,115,76,45,82,191,39.130434782608695,71.30434782608695
11262_terrestrial,71,32,35,43,103,49.29577464788733,60.56338028169014
11263_terrestrial,76,37,36,44,113,47.368421052631575,57.89473684210527
11264_terrestrial,72,37,32,43,109,44.44444444444444,59.72222222222222
11265_terrestrial,60,24,25,35,84,41.66666666666667,58.333333333333336
11266_terrestrial,58,23,24,33,81,41.37931034482759,56.896551724137936
11267_terrestrial,62,23,25,35,85,40.32258064516129,56.451612903225815
11268_terrestrial,71,25,30,40,96,42.25352112676056,56.33802816901409
11269_terrestrial,73,29,30,42,102,41.0958904109589,57.534246575342465
11270_terrestrial,96,44,46,50,140,47.91666666666667,52.083333333333336
11271_terrestrial,99,45,49,50,144,49.494949494949495,50.505050505050505
11272_terrestrial,102,48,50,55,150,49.01960784313725,53.92156862745098
11273_terrestrial,99,49,50,51,148,50.505050505050505,51.515151515151516
11274_terrestrial,97,48,49,51,145,50.51546391752577,52.57731958762887
11275_terrestrial,96,49,51,50,145,53.125,52.083333333333336
11276_terrestrial,73,31,32,47,104,43.83561643835616,64.38356164383562
11277_terrestrial,113,50,70,50,163,61.94690265486725,44.24778761061947
11278_terrestrial,112,50,69,50,162,61.60714285714286,44.642857142857146
11333_terrestrial,215,91,173,88,306,80.46511627906978,40.93023255813954
11334_terrestrial,251,94,200,110,345,79.6812749003984,43.82470119521912
11498_terrestrial,162,78,102,104,240,62.96296296296296,64.19753086419753
11499_terrestrial,164,80,104,107,244,63.41463414634146,65.2439024390244
11500_terrestrial,165,78,104,108,243,63.030303030303024,65.45454545454545
11501_terrestrial,128,58,70,97,186,54.6875,75.78125
11502_terrestrial,137,60,77,102,197,56.20437956204379,74.45255474452554
11503_terrestrial,136,56,77,101,192,56.61764705882353,74.26470588235294
11504_terrestrial,142,60,98,91,202,69.01408450704226,64.08450704225352
11505_terrestrial,136,62,95,87,198,69.85294117647058,63.970588235294116
11530_terrestrial,67,42,54,24,109,80.59701492537313,35.82089552238806
11542_terrestrial,147,81,91,74,228,61.904761904761905,50.34013605442177
11543_terrestrial,168,96,102,93,264,60.71428571428571,55.35714285714286
11544_terrestrial,196,115,115,109,311,58.673469387755105,55.61224489795919
11545_terrestrial,191,114,114,109,305,59.68586387434554,57.06806282722513
11546_terrestrial,151,77,94,93,228,62.251655629139066,61.58940397350994
11547_terrestrial,160,82,101,101,242,63.125,63.125
11548_terrestrial,158,79,100,99,237,63.29113924050633,62.65822784810127
11564_terrestrial,189,95,117,120,284,61.904761904761905,63.49206349206349
11565_terrestrial,203,99,124,125,302,61.083743842364534,61.57635467980296
11566_terrestrial,202,108,119,119,310,58.91089108910891,58.91089108910891
11571_terrestrial,154,106,56,112,260,36.36363636363637,72.72727272727273
11572_terrestrial,158,106,60,114,264,37.9746835443038,72.15189873417721
11573_terrestrial,163,104,61,118,267,37.423312883435585,72.39263803680981
11581_terrestrial,177,99,61,136,276,34.463276836158194,76.8361581920904
11582_terrestrial,182,102,59,139,284,32.417582417582416,76.37362637362637
11583_terrestrial,184,104,57,141,288,30.978260869565215,76.63043478260869
11584_terrestrial,183,104,57,142,287,31.147540983606557,77.59562841530054
11585_terrestrial,184,106,59,143,290,32.065217391304344,77.71739130434783
11586_terrestrial,185,104,61,144,289,32.972972972972975,77.83783783783784
11587_terrestrial,183,104,60,142,287,32.78688524590164,77.59562841530054
11588_terrestrial,185,102,63,144,287,34.054054054054056,77.83783783783784
11589_terrestrial,183,103,61,143,286,33.33333333333333,78.14207650273224
11590_terrestrial,180,102,61,141,282,33.88888888888889,78.33333333333333
11591_terrestrial,175,99,60,138,274,34.285714285714285,78.85714285714286
11592_terrestrial,168,98,57,136,266,33.92857142857143,80.95238095238095
11593_terrestrial,162,96,53,128,258,32.71604938271605,79.01234567901234
11594_terrestrial,158,94,51,124,252,32.278481012658226,78.48101265822784
11595_terrestrial,155,89,51,121,244,32.903225806451616,78.06451612903226
11596_terrestrial,150,84,49,115,234,32.666666666666664,76.66666666666667
11597_terrestrial,151,83,48,116,234,31.788079470198678,76.82119205298014
11598_terrestrial,147,82,47,114,229,31.97278911564626,77.55102040816327
11599_terrestrial,145,83,44,112,228,30.344827586206897,77.24137931034483
11600_terrestrial,143,79,45,110,222,31.46853146853147,76.92307692307693
11601_terrestrial,139,75,45,107,214,32.37410071942446,76.97841726618705
11602_terrestrial,137,76,45,105,213,32.846715328467155,76.64233576642336
11603_terrestrial,140,74,51,105,214,36.42857142857142,75
11604_terrestrial,140,73,53,107,213,37.857142857142854,76.42857142857142
11605_terrestrial,143,81,54,109,224,37.76223776223776,76.22377622377621
11606_terrestrial,136,83,51,102,219,37.5,75
11607_terrestrial,131,81,47,98,212,35.87786259541985,74.80916030534351
11608_terrestrial,134,91,54,96,225,40.298507462686565,71.64179104477611
11609_terrestrial,122,81,46,87,203,37.704918032786885,71.31147540983606
11610_terrestrial,118,77,44,84,195,37.28813559322034,71.1864406779661
11611_terrestrial,115,77,42,81,192,36.52173913043478,70.43478260869566
11621_terrestrial,33,18,19,23,51,57.57575757575758,69.6969696969697
11623_terrestrial,69,36,31,40,105,44.927536231884055,57.971014492753625
11624_terrestrial,84,42,37,47,126,44.047619047619044,55.952380952380956
11625_terrestrial,72,32,29,40,104,40.27777777777778,55.55555555555556
11626_terrestrial,71,32,28,40,103,39.436619718309856,56.33802816901409
11627_terrestrial,70,35,25,37,105,35.714285714285715,52.85714285714286
11628_terrestrial,73,34,27,41,107,36.986301369863014,56.16438356164384
11629_terrestrial,79,36,31,46,115,39.24050632911392,58.22784810126582
11630_terrestrial,89,41,35,55,130,39.325842696629216,61.79775280898876
11631_terrestrial,109,57,52,62,166,47.706422018348626,56.88073394495413
11632_terrestrial,107,57,51,61,164,47.66355140186916,57.009345794392516
11633_terrestrial,104,56,50,58,160,48.07692307692308,55.769230769230774
11634_terrestrial,82,41,34,51,123,41.46341463414634,62.19512195121951
11635_terrestrial,84,39,36,53,123,42.857142857142854,63.095238095238095
11636_terrestrial,81,38,34,52,119,41.9753086419753,64.19753086419753
11637_terrestrial,122,48,70,60,170,57.377049180327866,49.18032786885246
11638_terrestrial,127,55,74,61,182,58.26771653543307,48.031496062992126
11639_terrestrial,125,51,72,62,176,57.599999999999994,49.6
11693_terrestrial,262,96,212,121,358,80.91603053435115,46.18320610687023
11857_terrestrial,163,80,103,105,243,63.190184049079754,64.41717791411043
11858_terrestrial,166,83,106,106,249,63.85542168674698,63.85542168674698
11859_terrestrial,170,82,109,110,252,64.11764705882354,64.70588235294117
11860_terrestrial,133,59,75,101,192,56.390977443609025,75.93984962406014
11861_terrestrial,127,64,72,95,191,56.69291338582677,74.80314960629921
11862_terrestrial,140,66,81,102,206,57.85714285714286,72.85714285714285
11863_terrestrial,183,101,116,112,284,63.387978142076506,61.20218579234973
11864_terrestrial,176,90,111,108,266,63.06818181818182,61.36363636363637
11891_terrestrial,66,39,54,21,105,81.81818181818183,31.818181818181817
11899_terrestrial,141,77,88,75,218,62.4113475177305,53.191489361702125
11900_terrestrial,154,78,98,83,232,63.63636363636363,53.896103896103895
11901_terrestrial,147,77,93,79,224,63.26530612244898,53.74149659863946
11902_terrestrial,187,98,117,97,285,62.56684491978609,51.87165775401069
11903_terrestrial,181,99,110,94,280,60.773480662983424,51.93370165745856
11904_terrestrial,167,96,99,88,263,59.281437125748504,52.69461077844312
11906_terrestrial,156,80,98,97,236,62.82051282051282,62.17948717948718
11907_terrestrial,152,78,94,95,230,61.8421052631579,62.5
11925_terrestrial,185,92,114,112,277,61.62162162162163,60.54054054054055
11926_terrestrial,195,99,116,115,294,59.48717948717949,58.97435897435898
11927_terrestrial,205,101,117,126,306,57.073170731707314,61.46341463414634
11931_terrestrial,167,126,62,130,293,37.12574850299401,77.84431137724552
11932_terrestrial,158,114,55,116,272,34.810126582278485,73.41772151898735
11943_terrestrial,189,109,60,146,298,31.746031746031743,77.24867724867724
11944_terrestrial,188,109,59,147,297,31.382978723404253,78.19148936170212
11945_terrestrial,187,108,58,146,295,31.016042780748666,78.07486631016043
11946_terrestrial,186,106,59,145,292,31.72043010752688,77.95698924731182
11947_terrestrial,186,105,62,145,291,33.33333333333333,77.95698924731182
11948_terrestrial,184,105,60,144,289,32.608695652173914,78.26086956521739
11949_terrestrial,184,106,59,144,290,32.065217391304344,78.26086956521739
11950_terrestrial,186,101,62,146,287,33.33333333333333,78.49462365591397
11951_terrestrial,182,99,60,142,281,32.967032967032964,78.02197802197803
11952_terrestrial,180,100,62,140,280,34.44444444444444,77.77777777777779
11953_terrestrial,171,100,57,136,271,33.33333333333333,79.53216374269006
11954_terrestrial,167,96,56,134,263,33.532934131736525,80.23952095808383
11955_terrestrial,166,95,55,132,261,33.13253012048193,79.51807228915662
11956_terrestrial,162,92,53,128,254,32.71604938271605,79.01234567901234
11957_terrestrial,159,88,51,125,247,32.075471698113205,78.61635220125787
11958_terrestrial,153,86,49,118,239,32.02614379084967,77.12418300653596
11959_terrestrial,150,86,47,113,236,31.333333333333336,75.33333333333333
11960_terrestrial,149,81,45,113,230,30.201342281879196,75.83892617449665
11961_terrestrial,147,81,43,111,228,29.25170068027211,75.51020408163265
11962_terrestrial,146,81,43,110,227,29.45205479452055,75.34246575342466
11963_terrestrial,147,80,47,108,227,31.97278911564626,73.46938775510205
11964_terrestrial,141,79,47,105,220,33.33333333333333,74.46808510638297
11965_terrestrial,142,77,52,107,219,36.61971830985916,75.35211267605634
11966_terrestrial,146,82,54,108,228,36.986301369863014,73.97260273972603
11967_terrestrial,147,84,52,109,231,35.374149659863946,74.14965986394559
11968_terrestrial,150,96,57,110,246,38,73.33333333333333
11969_terrestrial,134,79,44,98,213,32.83582089552239,73.13432835820896
11970_terrestrial,130,73,44,94,203,33.84615384615385,72.3076923076923
11971_terrestrial,128,81,45,92,209,35.15625,71.875
11972_terrestrial,125,78,44,89,203,35.199999999999996,71.2
11980_terrestrial,36,20,20,26,56,55.55555555555556,72.22222222222221
11981_terrestrial,38,20,20,28,58,52.63157894736842,73.68421052631578
11982_terrestrial,38,20,20,28,58,52.63157894736842,73.68421052631578
11984_terrestrial,97,56,43,57,153,44.329896907216494,58.76288659793815
11985_terrestrial,84,45,34,50,129,40.476190476190474,59.523809523809526
11986_terrestrial,81,47,33,49,128,40.74074074074074,60.49382716049383
11987_terrestrial,80,49,32,48,129,40,60
11988_terrestrial,80,44,32,49,124,40,61.25000000000001
11989_terrestrial,83,44,33,52,127,39.75903614457831,62.65060240963856
11990_terrestrial,82,44,31,52,126,37.80487804878049,63.41463414634146
11991_terrestrial,84,44,31,53,128,36.904761904761905,63.095238095238095
11992_terrestrial,85,44,31,54,129,36.470588235294116,63.52941176470588
11993_terrestrial,90,45,35,57,135,38.88888888888889,63.33333333333333
11994_terrestrial,90,44,35,57,134,38.88888888888889,63.33333333333333
11995_terrestrial,89,46,35,56,135,39.325842696629216,62.92134831460674
11996_terrestrial,95,48,40,60,143,42.10526315789473,63.1578947368421
11997_terrestrial,96,47,39,63,143,40.625,65.625
11998_terrestrial,134,64,73,70,198,54.47761194029851,52.23880597014925
11999_terrestrial,138,63,77,70,201,55.79710144927537,50.72463768115942
12000_terrestrial,94,26,65,57,120,69.14893617021278,60.63829787234043
12053_terrestrial,220,93,180,85,313,81.81818181818183,38.63636363636363
12216_terrestrial,168,83,106,104,251,63.095238095238095,61.904761904761905
12217_terrestrial,172,82,110,109,254,63.95348837209303,63.372093023255815
12218_terrestrial,131,57,74,99,188,56.48854961832062,75.57251908396947
12219_terrestrial,126,60,71,94,186,56.34920634920635,74.60317460317461
12220_terrestrial,126,63,72,94,189,57.14285714285714,74.60317460317461
12221_terrestrial,130,62,76,96,192,58.46153846153847,73.84615384615385
12222_terrestrial,137,64,78,103,201,56.934306569343065,75.18248175182481
12223_terrestrial,184,109,115,116,293,62.5,63.04347826086957
12224_terrestrial,179,105,111,114,284,62.01117318435754,63.687150837988824
12257_terrestrial,163,94,99,86,257,60.73619631901841,52.760736196319016
12258_terrestrial,166,90,104,89,256,62.65060240963856,53.6144578313253
12259_terrestrial,172,90,108,92,262,62.7906976744186,53.48837209302325
12260_terrestrial,179,96,113,97,275,63.128491620111724,54.18994413407822
12261_terrestrial,181,96,115,97,277,63.53591160220995,53.591160220994475
12262_terrestrial,163,90,101,85,253,61.963190184049076,52.14723926380368
12265_terrestrial,119,62,85,67,181,71.42857142857143,56.30252100840336
12287_terrestrial,195,94,118,115,289,60.51282051282051,58.97435897435898
12306_terrestrial,200,114,65,159,314,32.5,79.5
12307_terrestrial,198,115,64,160,313,32.323232323232325,80.8080808080808
12308_terrestrial,193,112,61,155,305,31.606217616580313,80.31088082901555
12309_terrestrial,195,112,63,155,307,32.30769230769231,79.48717948717949
12310_terrestrial,193,111,63,153,304,32.64248704663213,79.27461139896373
12311_terrestrial,186,110,59,147,296,31.72043010752688,79.03225806451613
12312_terrestrial,187,108,60,148,295,32.085561497326204,79.14438502673798
12313_terrestrial,181,105,60,144,286,33.14917127071823,79.55801104972376
12314_terrestrial,181,105,60,144,286,33.14917127071823,79.55801104972376
12315_terrestrial,173,99,57,136,272,32.947976878612714,78.61271676300578
12316_terrestrial,167,101,54,131,268,32.33532934131736,78.44311377245509
12317_terrestrial,166,98,54,132,264,32.53012048192771,79.51807228915662
12318_terrestrial,166,98,52,130,264,31.32530120481928,78.3132530120482
12319_terrestrial,163,84,49,128,247,30.061349693251532,78.52760736196319
12320_terrestrial,164,84,50,129,248,30.48780487804878,78.65853658536585
12321_terrestrial,157,82,49,123,239,31.210191082802545,78.343949044586
12322_terrestrial,158,81,48,122,239,30.37974683544304,77.21518987341773
12323_terrestrial,160,87,49,122,247,30.625000000000004,76.25
12324_terrestrial,154,85,48,115,239,31.16883116883117,74.67532467532467
12325_terrestrial,149,80,47,111,229,31.543624161073826,74.49664429530202
12326_terrestrial,147,80,47,108,227,31.97278911564626,73.46938775510205
12327_terrestrial,148,79,50,109,227,33.78378378378378,73.64864864864865
12328_terrestrial,146,81,50,107,227,34.24657534246575,73.28767123287672
12329_terrestrial,145,80,50,106,225,34.48275862068966,73.10344827586206
12340_terrestrial,36,20,20,26,56,55.55555555555556,72.22222222222221
12341_terrestrial,38,20,20,28,58,52.63157894736842,73.68421052631578
12342_terrestrial,106,62,45,69,168,42.45283018867924,65.09433962264151
12343_terrestrial,102,60,43,65,162,42.15686274509804,63.725490196078425
12344_terrestrial,102,60,43,66,162,42.15686274509804,64.70588235294117
12345_terrestrial,91,51,35,60,142,38.46153846153847,65.93406593406593
12346_terrestrial,88,45,32,57,133,36.36363636363637,64.77272727272727
12347_terrestrial,85,46,29,54,131,34.11764705882353,63.52941176470588
12348_terrestrial,85,42,30,54,127,35.294117647058826,63.52941176470588
12349_terrestrial,87,43,30,56,130,34.48275862068966,64.36781609195403
12350_terrestrial,88,44,29,58,132,32.95454545454545,65.9090909090909
12351_terrestrial,87,44,29,57,131,33.33333333333333,65.51724137931035
12352_terrestrial,85,43,29,55,128,34.11764705882353,64.70588235294117
12353_terrestrial,85,46,29,55,131,34.11764705882353,64.70588235294117
12354_terrestrial,89,46,33,56,135,37.07865168539326,62.92134831460674
12355_terrestrial,92,44,33,59,136,35.869565217391305,64.13043478260869
12356_terrestrial,91,46,33,58,137,36.26373626373626,63.73626373626373
12357_terrestrial,97,50,39,62,147,40.20618556701031,63.91752577319587
12358_terrestrial,102,52,43,67,154,42.15686274509804,65.68627450980392
12359_terrestrial,145,73,80,78,218,55.172413793103445,53.79310344827586
12360_terrestrial,138,75,74,74,213,53.62318840579711,53.62318840579711
12361_terrestrial,138,71,75,73,209,54.347826086956516,52.89855072463768
12362_terrestrial,135,70,73,71,205,54.074074074074076,52.59259259259259
12523_terrestrial,207,107,116,162,314,56.038647342995176,78.26086956521739
12576_terrestrial,172,83,110,104,255,63.95348837209303,60.46511627906976
12577_terrestrial,129,57,73,95,186,56.58914728682171,73.64341085271317
12578_terrestrial,128,59,73,94,187,57.03125,73.4375
12579_terrestrial,129,63,75,95,192,58.139534883720934,73.64341085271317
12580_terrestrial,131,62,77,95,193,58.778625954198475,72.51908396946564
12581_terrestrial,135,64,78,99,199,57.77777777777777,73.33333333333333
12582_terrestrial,184,106,115,114,290,62.5,61.95652173913043
12583_terrestrial,134,58,75,101,192,55.970149253731336,75.3731343283582
12586_terrestrial,108,55,78,64,163,72.22222222222221,59.25925925925925
12587_terrestrial,108,55,78,64,163,72.22222222222221,59.25925925925925
12614_terrestrial,130,70,91,74,200,70,56.92307692307692
12615_terrestrial,126,67,87,73,193,69.04761904761905,57.936507936507944
12616_terrestrial,147,76,98,89,223,66.66666666666666,60.544217687074834
12617_terrestrial,174,92,107,92,266,61.49425287356321,52.87356321839081
12618_terrestrial,165,86,104,88,251,63.030303030303024,53.333333333333336
12620_terrestrial,128,67,89,78,195,69.53125,60.9375
12621_terrestrial,122,67,85,72,189,69.67213114754098,59.01639344262295
12666_terrestrial,209,127,66,169,336,31.57894736842105,80.86124401913875
12667_terrestrial,216,130,71,174,346,32.870370370370374,80.55555555555556
12668_terrestrial,214,128,72,172,342,33.64485981308411,80.37383177570094
12669_terrestrial,215,122,69,174,337,32.093023255813954,80.93023255813954
12670_terrestrial,211,121,68,170,332,32.22748815165877,80.56872037914692
12674_terrestrial,200,117,62,160,317,31,80
12675_terrestrial,195,118,60,155,313,30.76923076923077,79.48717948717949
12676_terrestrial,188,115,58,152,303,30.851063829787233,80.85106382978722
12683_terrestrial,169,100,51,133,269,30.17751479289941,78.69822485207101
12684_terrestrial,160,94,48,124,254,30,77.5
12685_terrestrial,148,87,44,114,235,29.72972972972973,77.02702702702703
12686_terrestrial,148,86,45,113,234,30.405405405405407,76.35135135135135
12687_terrestrial,149,82,44,113,231,29.53020134228188,75.83892617449665
12701_terrestrial,110,73,45,75,183,40.909090909090914,68.18181818181817
12702_terrestrial,116,72,48,79,188,41.37931034482759,68.10344827586206
12703_terrestrial,106,61,42,74,167,39.62264150943396,69.81132075471697
12704_terrestrial,100,64,38,69,164,38,69
12705_terrestrial,96,58,35,65,154,36.45833333333333,67.70833333333334
12706_terrestrial,92,50,32,61,142,34.78260869565217,66.30434782608695
12707_terrestrial,92,47,32,61,139,34.78260869565217,66.30434782608695
12708_terrestrial,90,47,30,62,137,33.33333333333333,68.88888888888889
12709_terrestrial,93,48,32,63,141,34.40860215053764,67.74193548387096
12710_terrestrial,93,50,32,63,143,34.40860215053764,67.74193548387096
12711_terrestrial,92,49,32,62,141,34.78260869565217,67.3913043478261
12712_terrestrial,92,49,32,62,141,34.78260869565217,67.3913043478261
12713_terrestrial,93,52,33,63,145,35.483870967741936,67.74193548387096
12714_terrestrial,93,55,33,63,148,35.483870967741936,67.74193548387096
12715_terrestrial,96,56,35,63,152,36.45833333333333,65.625
12716_terrestrial,96,56,35,63,152,36.45833333333333,65.625
12717_terrestrial,97,60,35,64,157,36.08247422680412,65.97938144329896
12718_terrestrial,100,60,37,66,160,37,66
12719_terrestrial,104,63,42,69,167,40.38461538461539,66.34615384615384
12720_terrestrial,151,79,83,84,230,54.966887417218544,55.62913907284768
12936_terrestrial,173,81,108,105,254,62.42774566473989,60.69364161849711
12937_terrestrial,129,58,73,95,187,56.58914728682171,73.64341085271317
12938_terrestrial,127,60,72,93,187,56.69291338582677,73.22834645669292
12939_terrestrial,131,67,74,95,198,56.48854961832062,72.51908396946564
12940_terrestrial,188,110,116,116,298,61.702127659574465,61.702127659574465
12941_terrestrial,189,107,117,117,296,61.904761904761905,61.904761904761905
12942_terrestrial,189,106,116,115,295,61.37566137566137,60.84656084656085
12943_terrestrial,178,99,109,110,277,61.23595505617978,61.79775280898876
12947_terrestrial,105,55,76,61,160,72.38095238095238,58.0952380952381
12948_terrestrial,103,54,76,59,157,73.7864077669903,57.28155339805825
12949_terrestrial,102,53,76,55,155,74.50980392156863,53.92156862745098
12972_terrestrial,132,68,94,74,200,71.21212121212122,56.060606060606055
12973_terrestrial,142,70,102,79,212,71.83098591549296,55.633802816901415
12974_terrestrial,143,69,100,81,212,69.93006993006993,56.64335664335665
13026_terrestrial,216,133,71,178,349,32.870370370370374,82.4074074074074
13027_terrestrial,223,128,72,181,351,32.28699551569507,81.16591928251121
13028_terrestrial,221,130,71,182,351,32.126696832579185,82.35294117647058
13059_terrestrial,68,32,30,56,100,44.11764705882353,82.35294117647058
13060_terrestrial,77,33,35,65,110,45.45454545454545,84.4155844155844
13061_terrestrial,115,83,46,80,198,40,69.56521739130434
13063_terrestrial,106,69,38,75,175,35.84905660377358,70.75471698113208
13064_terrestrial,100,68,36,69,168,36,69
13065_terrestrial,99,63,34,68,162,34.34343434343434,68.68686868686868
13066_terrestrial,96,60,34,68,156,35.41666666666667,70.83333333333334
13067_terrestrial,93,59,31,65,152,33.33333333333333,69.89247311827957
13068_terrestrial,90,57,30,64,147,33.33333333333333,71.11111111111111
13069_terrestrial,93,54,30,65,147,32.25806451612903,69.89247311827957
13070_terrestrial,92,53,29,64,145,31.521739130434785,69.56521739130434
13071_terrestrial,90,53,28,62,143,31.11111111111111,68.88888888888889
13072_terrestrial,89,56,28,61,145,31.46067415730337,68.53932584269663
13073_terrestrial,94,57,31,65,151,32.97872340425532,69.14893617021278
13074_terrestrial,99,61,35,68,160,35.35353535353536,68.68686868686868
13075_terrestrial,100,65,35,68,165,35,68
13076_terrestrial,97,67,34,65,164,35.051546391752574,67.0103092783505
13077_terrestrial,101,67,34,69,168,33.663366336633665,68.31683168316832
13078_terrestrial,102,67,36,70,169,35.294117647058826,68.62745098039215
13079_terrestrial,107,67,38,73,174,35.51401869158878,68.22429906542055
13084_terrestrial,160,89,90,89,249,56.25,55.625
13085_terrestrial,157,89,87,87,246,55.4140127388535,55.4140127388535
13296_terrestrial,172,81,108,104,253,62.7906976744186,60.46511627906976
13297_terrestrial,173,91,109,104,264,63.005780346820806,60.115606936416185
13298_terrestrial,131,65,75,95,196,57.25190839694656,72.51908396946564
13300_terrestrial,193,115,120,115,308,62.17616580310881,59.58549222797927
13301_terrestrial,184,98,112,112,282,60.86956521739131,60.86956521739131
13313_terrestrial,83,49,65,40,132,78.3132530120482,48.19277108433735
13324_terrestrial,110,59,79,64,169,71.81818181818181,58.18181818181818
13325_terrestrial,119,61,87,69,180,73.10924369747899,57.98319327731093
13326_terrestrial,117,60,84,70,177,71.7948717948718,59.82905982905983
13327_terrestrial,117,60,85,67,177,72.64957264957265,57.26495726495726
13328_terrestrial,114,55,81,67,169,71.05263157894737,58.77192982456141
13330_terrestrial,112,59,79,66,171,70.53571428571429,58.92857142857143
13331_terrestrial,126,66,89,76,192,70.63492063492063,60.317460317460316
13332_terrestrial,127,64,91,73,191,71.65354330708661,57.48031496062992
13368_terrestrial,167,93,107,89,260,64.07185628742515,53.293413173652695
13369_terrestrial,176,98,112,93,274,63.63636363636363,52.84090909090909
13371_terrestrial,188,104,125,114,292,66.48936170212765,60.63829787234043
13386_terrestrial,221,135,68,184,356,30.76923076923077,83.2579185520362
13387_terrestrial,212,136,65,179,348,30.660377358490564,84.43396226415094
13420_terrestrial,68,32,30,56,100,44.11764705882353,82.35294117647058
13421_terrestrial,74,29,31,66,103,41.891891891891895,89.1891891891892
13426_terrestrial,102,68,34,74,170,33.33333333333333,72.54901960784314
13427_terrestrial,98,67,31,72,165,31.63265306122449,73.46938775510205
13428_terrestrial,97,68,30,71,165,30.927835051546392,73.19587628865979
13429_terrestrial,96,70,29,69,166,30.208333333333332,71.875
13430_terrestrial,96,69,30,69,165,31.25,71.875
13431_terrestrial,96,65,31,69,161,32.29166666666667,71.875
13432_terrestrial,97,65,31,70,162,31.958762886597935,72.16494845360825
13433_terrestrial,100,68,33,72,168,33,72
13434_terrestrial,103,68,33,75,171,32.038834951456316,72.81553398058253
13435_terrestrial,106,68,34,75,174,32.075471698113205,70.75471698113208
13436_terrestrial,107,66,34,76,173,31.775700934579437,71.02803738317756
13437_terrestrial,106,66,33,76,172,31.132075471698112,71.69811320754717
13438_terrestrial,108,66,35,76,174,32.407407407407405,70.37037037037037
13439_terrestrial,110,64,38,77,174,34.54545454545455,70
13441_terrestrial,115,65,41,81,180,35.65217391304348,70.43478260869566
13442_terrestrial,112,69,42,78,181,37.5,69.64285714285714
13443_terrestrial,108,70,41,73,178,37.96296296296296,67.5925925925926
13444_terrestrial,170,96,96,95,266,56.470588235294116,55.88235294117647
13445_terrestrial,177,99,103,95,276,58.19209039548022,53.672316384180796
13657_terrestrial,183,100,114,112,283,62.295081967213115,61.20218579234973
13658_terrestrial,133,65,76,97,198,57.14285714285714,72.93233082706767
13659_terrestrial,193,114,119,117,307,61.6580310880829,60.62176165803109
13673_terrestrial,87,51,68,42,138,78.16091954022988,48.275862068965516
13674_terrestrial,92,52,73,47,144,79.34782608695652,51.08695652173913
13678_terrestrial,81,52,64,40,133,79.01234567901234,49.382716049382715
13680_terrestrial,78,48,62,37,126,79.48717948717949,47.43589743589743
13682_terrestrial,120,61,87,72,181,72.5,60
13683_terrestrial,122,61,89,73,183,72.95081967213115,59.83606557377049
13684_terrestrial,126,62,92,75,188,73.01587301587301,59.523809523809526
13685_terrestrial,62,47,49,19,109,79.03225806451613,30.64516129032258
13729_terrestrial,159,88,105,86,247,66.0377358490566,54.088050314465406
13732_terrestrial,195,101,126,119,296,64.61538461538461,61.02564102564103
13791_terrestrial,108,80,33,80,188,30.555555555555557,74.07407407407408
13792_terrestrial,106,80,33,78,186,31.132075471698112,73.58490566037736
13793_terrestrial,110,82,34,82,192,30.909090909090907,74.54545454545455
13794_terrestrial,109,79,33,81,188,30.275229357798167,74.31192660550458
13795_terrestrial,109,82,34,82,191,31.19266055045872,75.22935779816514
13796_terrestrial,110,79,35,83,189,31.818181818181817,75.45454545454545
13797_terrestrial,107,75,34,81,182,31.775700934579437,75.70093457943925
13798_terrestrial,105,71,34,79,176,32.38095238095238,75.23809523809524
13799_terrestrial,108,70,35,80,178,32.407407407407405,74.07407407407408
13800_terrestrial,113,72,39,85,185,34.51327433628318,75.22123893805309
13801_terrestrial,178,104,98,102,282,55.0561797752809,57.30337078651685
13802_terrestrial,183,110,104,100,293,56.830601092896174,54.644808743169406
13803_terrestrial,211,115,119,115,326,56.39810426540285,54.502369668246445
13804_terrestrial,218,112,124,117,330,56.88073394495413,53.669724770642205
13805_terrestrial,215,109,122,114,324,56.74418604651162,53.02325581395348
14017_terrestrial,201,108,126,120,309,62.68656716417911,59.70149253731343
14018_terrestrial,191,111,121,115,302,63.35078534031413,60.20942408376963
14019_terrestrial,178,101,109,106,279,61.23595505617978,59.55056179775281
14038_terrestrial,80,50,64,39,130,80,48.75
14039_terrestrial,86,54,67,43,140,77.90697674418605,50
14040_terrestrial,93,54,73,45,147,78.49462365591397,48.38709677419355
14160_terrestrial,189,121,101,108,310,53.43915343915344,57.14285714285714
14161_terrestrial,187,117,104,104,304,55.61497326203209,55.61497326203209
14162_terrestrial,173,107,98,94,280,56.64739884393064,54.33526011560693
14163_terrestrial,169,73,106,92,242,62.721893491124256,54.437869822485204
14164_terrestrial,177,71,110,100,248,62.14689265536724,56.49717514124294
14165_terrestrial,176,70,109,100,246,61.93181818181818,56.81818181818182
14320_terrestrial,255,130,153,191,385,60,74.90196078431373
14321_terrestrial,253,127,149,194,380,58.89328063241107,76.6798418972332
14376_terrestrial,171,85,110,106,256,64.32748538011695,61.98830409356725
14377_terrestrial,217,113,132,130,330,60.82949308755761,59.907834101382484
14524_terrestrial,184,73,109,111,257,59.2391304347826,60.32608695652174
14525_terrestrial,183,73,111,107,256,60.65573770491803,58.46994535519126
14526_terrestrial,182,74,110,104,256,60.43956043956044,57.14285714285714
14527_terrestrial,179,75,109,102,254,60.893854748603346,56.98324022346368
14657_terrestrial,206,100,129,155,306,62.62135922330098,75.24271844660194
14658_terrestrial,206,101,130,156,307,63.10679611650486,75.72815533980582
14659_terrestrial,210,102,135,160,312,64.28571428571429,76.19047619047619
14660_terrestrial,217,113,142,165,330,65.43778801843318,76.036866359447
14673_terrestrial,248,135,153,197,383,61.693548387096776,79.43548387096774
14674_terrestrial,249,139,152,197,388,61.044176706827315,79.11646586345381
14675_terrestrial,253,145,154,198,398,60.86956521739131,78.26086956521739
14722_terrestrial,70,30,56,24,100,80,34.285714285714285
14735_terrestrial,155,67,103,95,222,66.45161290322581,61.29032258064516
14881_terrestrial,200,86,114,126,286,56.99999999999999,63
14882_terrestrial,208,88,119,130,296,57.21153846153846,62.5
14883_terrestrial,206,79,114,130,285,55.33980582524271,63.10679611650486
14884_terrestrial,126,43,49,101,169,38.88888888888889,80.15873015873017
14885_terrestrial,120,42,47,98,162,39.166666666666664,81.66666666666667
14886_terrestrial,183,74,103,109,257,56.284153005464475,59.56284153005464
14887_terrestrial,194,76,117,111,270,60.30927835051546,57.21649484536082
14888_terrestrial,183,76,112,102,259,61.20218579234973,55.73770491803278
15003_terrestrial,177,103,113,138,280,63.84180790960452,77.96610169491525
15004_terrestrial,176,97,114,138,273,64.77272727272727,78.4090909090909
15005_terrestrial,176,91,114,135,267,64.77272727272727,76.70454545454545
15006_terrestrial,176,84,115,135,260,65.3409090909091,76.70454545454545
15007_terrestrial,176,85,112,133,261,63.63636363636363,75.56818181818183
15008_terrestrial,171,84,108,128,255,63.1578947368421,74.85380116959064
15009_terrestrial,171,86,107,126,257,62.57309941520468,73.68421052631578
15010_terrestrial,171,91,108,124,262,63.1578947368421,72.51461988304094
15011_terrestrial,178,93,111,130,271,62.35955056179775,73.03370786516854
15017_terrestrial,196,94,126,143,290,64.28571428571429,72.95918367346938
15018_terrestrial,200,101,129,145,301,64.5,72.5
15019_terrestrial,206,103,131,150,309,63.59223300970874,72.81553398058253
15020_terrestrial,211,112,136,155,323,64.45497630331754,73.45971563981043
15030_terrestrial,254,161,155,197,415,61.023622047244096,77.55905511811024
15031_terrestrial,248,137,152,193,385,61.29032258064516,77.82258064516128
15032_terrestrial,240,137,145,185,377,60.416666666666664,77.08333333333334
15033_terrestrial,227,132,142,177,359,62.55506607929515,77.97356828193833
15034_terrestrial,213,130,137,169,343,64.31924882629107,79.34272300469483
15035_terrestrial,231,134,146,179,365,63.20346320346321,77.48917748917748
15036_terrestrial,236,143,152,179,379,64.40677966101694,75.84745762711864
15094_terrestrial,148,61,99,88,209,66.8918918918919,59.45945945945946
15095_terrestrial,146,63,95,90,209,65.06849315068493,61.64383561643836
15214_terrestrial,12,45,8,9,57,66.66666666666666,75
15238_terrestrial,106,43,40,100,149,37.735849056603776,94.33962264150944
15239_terrestrial,175,82,104,113,257,59.42857142857143,64.57142857142857
15241_terrestrial,213,92,128,129,305,60.093896713615024,60.56338028169014
15242_terrestrial,217,86,130,133,303,59.907834101382484,61.29032258064516
15243_terrestrial,215,86,127,131,301,59.06976744186046,60.93023255813953
15244_terrestrial,212,85,130,123,297,61.32075471698113,58.01886792452831
15245_terrestrial,202,81,124,118,283,61.386138613861384,58.415841584158414
15246_terrestrial,201,80,122,117,281,60.69651741293532,58.2089552238806
15247_terrestrial,201,78,127,113,279,63.18407960199005,56.21890547263681
15248_terrestrial,193,76,121,108,269,62.69430051813472,55.95854922279793
15360_terrestrial,172,110,111,126,282,64.53488372093024,73.25581395348837
15361_terrestrial,184,111,120,138,295,65.21739130434783,75
15362_terrestrial,187,108,119,140,295,63.63636363636363,74.8663101604278
15363_terrestrial,187,103,122,137,290,65.24064171122996,73.2620320855615
15364_terrestrial,175,98,111,134,273,63.42857142857142,76.57142857142857
15365_terrestrial,170,101,108,129,271,63.52941176470588,75.88235294117646
15366_terrestrial,173,91,107,130,264,61.849710982658955,75.14450867052022
15367_terrestrial,176,92,111,132,268,63.06818181818182,75
15368_terrestrial,175,88,110,128,263,62.857142857142854,73.14285714285714
15369_terrestrial,172,93,111,126,265,64.53488372093024,73.25581395348837
15370_terrestrial,170,93,109,124,263,64.11764705882354,72.94117647058823
15371_terrestrial,170,94,112,126,264,65.88235294117646,74.11764705882354
15372_terrestrial,172,94,115,126,266,66.86046511627907,73.25581395348837
15373_terrestrial,177,102,119,131,279,67.2316384180791,74.01129943502825
15374_terrestrial,185,102,125,138,287,67.56756756756756,74.5945945945946
15375_terrestrial,185,104,126,139,289,68.10810810810811,75.13513513513513
15376_terrestrial,183,104,124,136,287,67.75956284153006,74.31693989071039
15377_terrestrial,187,100,126,139,287,67.37967914438502,74.33155080213903
15378_terrestrial,187,103,125,139,290,66.84491978609626,74.33155080213903
15379_terrestrial,196,110,127,147,306,64.79591836734694,75
15380_terrestrial,218,121,142,162,339,65.13761467889908,74.31192660550458
15387_terrestrial,269,175,167,209,444,62.0817843866171,77.69516728624535
15388_terrestrial,258,165,161,197,423,62.4031007751938,76.35658914728683
15389_terrestrial,248,165,154,191,413,62.096774193548384,77.01612903225806
15390_terrestrial,243,160,150,184,403,61.72839506172839,75.7201646090535
15391_terrestrial,232,150,144,173,382,62.06896551724138,74.56896551724138
15392_terrestrial,229,127,142,176,356,62.00873362445415,76.85589519650655
15393_terrestrial,229,125,143,173,354,62.44541484716157,75.54585152838428
15394_terrestrial,221,122,141,166,343,63.80090497737556,75.1131221719457
15395_terrestrial,196,124,125,153,320,63.775510204081634,78.06122448979592
15396_terrestrial,200,131,124,157,331,62,78.5
15453_terrestrial,152,66,103,96,218,67.76315789473685,63.1578947368421
15454_terrestrial,137,58,94,80,195,68.61313868613139,58.3941605839416
15604_terrestrial,156,71,101,84,227,64.74358974358975,53.84615384615385
15605_terrestrial,191,79,115,111,270,60.20942408376963,58.1151832460733
15606_terrestrial,190,76,118,106,266,62.10526315789474,55.78947368421052
15607_terrestrial,198,78,125,110,276,63.13131313131313,55.55555555555556
15608_terrestrial,184,75,113,104,259,61.41304347826087,56.52173913043478
15718_terrestrial,155,93,100,105,248,64.51612903225806,67.74193548387096
15719_terrestrial,174,96,111,122,270,63.793103448275865,70.11494252873564
15720_terrestrial,174,102,110,125,276,63.2183908045977,71.83908045977012
15721_terrestrial,187,109,119,134,296,63.63636363636363,71.65775401069519
15722_terrestrial,203,121,130,147,324,64.03940886699507,72.41379310344827
15723_terrestrial,202,111,131,148,313,64.85148514851485,73.26732673267327
15724_terrestrial,200,102,127,144,302,63.5,72
15725_terrestrial,194,95,124,144,289,63.91752577319587,74.22680412371135
15726_terrestrial,186,98,119,137,284,63.97849462365591,73.65591397849462
15727_terrestrial,172,98,109,128,270,63.372093023255815,74.4186046511628
15728_terrestrial,170,83,109,124,253,64.11764705882354,72.94117647058823
15729_terrestrial,176,82,114,130,258,64.77272727272727,73.86363636363636
15730_terrestrial,172,80,109,125,252,63.372093023255815,72.67441860465115
15731_terrestrial,166,86,110,125,252,66.26506024096386,75.30120481927712
15732_terrestrial,167,88,110,128,255,65.86826347305389,76.64670658682635
15733_terrestrial,171,92,112,131,263,65.49707602339181,76.60818713450293
15734_terrestrial,179,99,120,141,278,67.0391061452514,78.77094972067039
15735_terrestrial,183,112,117,145,295,63.934426229508205,79.23497267759562
15736_terrestrial,192,124,122,149,316,63.541666666666664,77.60416666666666
15737_terrestrial,189,125,121,148,314,64.02116402116403,78.3068783068783
15738_terrestrial,193,134,121,149,327,62.69430051813472,77.2020725388601
15739_terrestrial,214,138,135,165,352,63.084112149532714,77.10280373831776
15740_terrestrial,234,140,143,178,374,61.111111111111114,76.06837606837607
15744_terrestrial,247,163,157,191,410,63.56275303643725,77.32793522267207
15745_terrestrial,254,169,161,195,423,63.38582677165354,76.77165354330708
15746_terrestrial,256,157,163,196,413,63.671875,76.5625
15747_terrestrial,235,151,150,182,386,63.829787234042556,77.4468085106383
15748_terrestrial,198,126,125,157,324,63.13131313131313,79.29292929292929
15749_terrestrial,194,122,124,151,316,63.91752577319587,77.83505154639175
15750_terrestrial,208,135,130,156,343,62.5,75
15751_terrestrial,223,143,135,161,366,60.53811659192825,72.19730941704036
15752_terrestrial,223,145,135,164,368,60.53811659192825,73.54260089686099
15753_terrestrial,198,121,118,154,319,59.59595959595959,77.77777777777779
15754_terrestrial,200,108,126,148,308,63,74
15810_terrestrial,172,67,119,117,239,69.18604651162791,68.02325581395348
15811_terrestrial,175,73,120,120,248,68.57142857142857,68.57142857142857
15812_terrestrial,155,70,106,96,225,68.38709677419355,61.935483870967744
15813_terrestrial,147,64,100,94,211,68.02721088435374,63.94557823129252
16071_terrestrial,120,54,87,76,174,72.5,63.33333333333333
16072_terrestrial,171,101,114,103,272,66.66666666666666,60.23391812865497
16076_terrestrial,138,84,86,92,222,62.31884057971014,66.66666666666666
16077_terrestrial,139,86,88,92,225,63.30935251798561,66.18705035971223
16078_terrestrial,147,84,93,99,231,63.26530612244898,67.3469387755102
16079_terrestrial,160,88,101,112,248,63.125,70
16080_terrestrial,158,92,101,111,250,63.92405063291139,70.25316455696202
16081_terrestrial,181,86,116,128,267,64.08839779005525,70.71823204419888
16082_terrestrial,201,104,128,144,305,63.681592039801,71.64179104477611
16083_terrestrial,210,103,136,153,313,64.76190476190476,72.85714285714285
16084_terrestrial,209,107,132,151,316,63.1578947368421,72.24880382775119
16085_terrestrial,214,106,135,152,320,63.084112149532714,71.02803738317756
16086_terrestrial,212,106,135,151,318,63.67924528301887,71.22641509433963
16087_terrestrial,209,104,133,152,313,63.63636363636363,72.72727272727273
16088_terrestrial,188,92,122,136,280,64.8936170212766,72.3404255319149
16089_terrestrial,178,94,117,132,272,65.73033707865169,74.15730337078652
16090_terrestrial,171,87,111,127,258,64.91228070175438,74.26900584795322
16091_terrestrial,175,88,115,133,263,65.71428571428571,76
16092_terrestrial,185,89,123,139,274,66.48648648648648,75.13513513513513
16093_terrestrial,192,97,129,147,289,67.1875,76.5625
16094_terrestrial,202,93,132,155,295,65.34653465346535,76.73267326732673
16095_terrestrial,202,107,125,159,309,61.88118811881188,78.71287128712872
16096_terrestrial,207,108,126,163,315,60.86956521739131,78.74396135265701
16097_terrestrial,206,114,127,162,320,61.6504854368932,78.64077669902912
16098_terrestrial,226,128,139,176,354,61.504424778761056,77.87610619469027
16099_terrestrial,265,155,158,205,420,59.62264150943396,77.35849056603774
16103_terrestrial,251,169,154,197,420,61.354581673306775,78.48605577689243
16104_terrestrial,235,160,149,186,395,63.40425531914894,79.14893617021276
16105_terrestrial,225,148,144,178,373,64,79.11111111111111
16106_terrestrial,200,123,131,159,323,65.5,79.5
16107_terrestrial,177,118,115,140,295,64.97175141242938,79.09604519774011
16108_terrestrial,164,123,103,124,287,62.80487804878049,75.60975609756098
16109_terrestrial,161,119,100,120,280,62.11180124223602,74.53416149068323
16110_terrestrial,167,109,103,124,276,61.67664670658682,74.25149700598801
16111_terrestrial,176,120,114,122,296,64.77272727272727,69.31818181818183
16112_terrestrial,183,126,119,127,309,65.02732240437157,69.39890710382514
16113_terrestrial,181,130,117,125,311,64.64088397790056,69.06077348066299
16114_terrestrial,176,124,110,124,300,62.5,70.45454545454545
16115_terrestrial,169,118,104,117,287,61.53846153846154,69.23076923076923
16116_terrestrial,165,115,101,119,280,61.212121212121204,72.12121212121212
16117_terrestrial,158,115,100,114,273,63.29113924050633,72.15189873417721
16118_terrestrial,160,112,98,115,272,61.25000000000001,71.875
16161_terrestrial,215,120,158,129,335,73.48837209302326,60
16168_terrestrial,204,95,141,136,299,69.11764705882352,66.66666666666666
16169_terrestrial,201,97,141,133,298,70.1492537313433,66.16915422885572
16170_terrestrial,183,76,126,122,259,68.85245901639344,66.66666666666666
16171_terrestrial,178,73,124,118,251,69.66292134831461,66.29213483146067
16321_terrestrial,76,45,69,10,121,90.78947368421053,13.157894736842104
16430_terrestrial,117,53,85,75,170,72.64957264957265,64.1025641025641
16431_terrestrial,176,115,120,109,291,68.18181818181817,61.93181818181818
16432_terrestrial,175,114,116,107,289,66.28571428571428,61.142857142857146
16433_terrestrial,152,94,95,107,246,62.5,70.39473684210526
16434_terrestrial,133,86,84,101,219,63.1578947368421,75.93984962406014
16435_terrestrial,127,84,81,91,211,63.77952755905512,71.65354330708661
16436_terrestrial,128,79,80,88,207,62.5,68.75
16437_terrestrial,134,78,85,91,212,63.43283582089553,67.91044776119402
16438_terrestrial,150,78,94,102,228,62.66666666666667,68
16439_terrestrial,177,83,113,121,260,63.84180790960452,68.36158192090396
16440_terrestrial,137,44,88,106,181,64.23357664233576,77.37226277372264
16441_terrestrial,177,83,116,126,260,65.5367231638418,71.1864406779661
16442_terrestrial,187,90,122,133,277,65.24064171122996,71.12299465240642
16443_terrestrial,191,99,130,141,290,68.06282722513089,73.82198952879581
16444_terrestrial,200,106,132,147,306,66,73.5
16445_terrestrial,210,107,138,156,317,65.71428571428571,74.28571428571429
16446_terrestrial,216,103,143,160,319,66.20370370370371,74.07407407407408
16447_terrestrial,218,104,144,161,322,66.05504587155964,73.85321100917432
16448_terrestrial,224,108,144,162,332,64.28571428571429,72.32142857142857
16449_terrestrial,220,107,143,157,327,65,71.36363636363636
16450_terrestrial,206,101,130,154,307,63.10679611650486,74.75728155339806
16451_terrestrial,209,98,134,160,307,64.11483253588517,76.55502392344498
16452_terrestrial,208,104,134,161,312,64.42307692307693,77.40384615384616
16453_terrestrial,219,104,143,167,323,65.29680365296804,76.25570776255708
16454_terrestrial,225,120,141,175,345,62.66666666666667,77.77777777777779
16455_terrestrial,235,125,142,182,360,60.42553191489362,77.4468085106383
16456_terrestrial,241,132,144,188,373,59.75103734439834,78.00829875518673
16457_terrestrial,243,139,143,191,382,58.8477366255144,78.60082304526749
16458_terrestrial,260,145,155,200,405,59.61538461538461,76.92307692307693
16464_terrestrial,237,155,148,187,392,62.447257383966246,78.90295358649789
16465_terrestrial,223,148,143,178,371,64.12556053811659,79.82062780269058
16466_terrestrial,201,137,127,162,338,63.18407960199005,80.59701492537313
16467_terrestrial,179,125,113,142,304,63.128491620111724,79.3296089385475
16468_terrestrial,165,124,100,129,289,60.60606060606061,78.18181818181819
16469_terrestrial,160,121,100,119,281,62.5,74.375
16470_terrestrial,155,120,96,112,275,61.935483870967744,72.25806451612902
16471_terrestrial,152,112,96,104,264,63.1578947368421,68.42105263157895
16472_terrestrial,135,105,84,94,240,62.22222222222222,69.62962962962963
16473_terrestrial,139,113,90,98,252,64.74820143884892,70.50359712230215
16474_terrestrial,144,122,93,98,266,64.58333333333334,68.05555555555556
16475_terrestrial,144,127,92,98,271,63.888888888888886,68.05555555555556
16476_terrestrial,143,119,90,96,262,62.93706293706294,67.13286713286713
16477_terrestrial,139,96,87,96,235,62.589928057553955,69.06474820143885
16478_terrestrial,143,101,89,95,244,62.23776223776224,66.43356643356644
16479_terrestrial,144,109,88,96,253,61.111111111111114,66.66666666666666
16480_terrestrial,143,110,90,97,253,62.93706293706294,67.83216783216784
16522_terrestrial,307,165,215,195,472,70.03257328990227,63.51791530944625
16523_terrestrial,305,176,213,194,481,69.83606557377048,63.60655737704918
16524_terrestrial,297,173,209,186,470,70.37037037037037,62.62626262626263
16525_terrestrial,304,180,217,182,484,71.38157894736842,59.86842105263158
16526_terrestrial,349,210,240,211,559,68.76790830945558,60.458452722063036
16527_terrestrial,257,144,178,155,401,69.26070038910505,60.311284046692606
16528_terrestrial,213,102,150,136,315,70.4225352112676,63.84976525821596
16680_terrestrial,111,54,91,35,165,81.98198198198197,31.53153153153153
16681_terrestrial,110,54,91,34,164,82.72727272727273,30.909090909090907
16791_terrestrial,159,106,107,97,265,67.29559748427673,61.0062893081761
16792_terrestrial,175,118,116,110,293,66.28571428571428,62.857142857142854
16793_terrestrial,152,100,97,108,252,63.81578947368421,71.05263157894737
16794_terrestrial,129,91,79,94,220,61.240310077519375,72.86821705426357
16795_terrestrial,129,86,80,91,215,62.01550387596899,70.54263565891473
16796_terrestrial,130,84,82,94,214,63.07692307692307,72.3076923076923
16797_terrestrial,142,78,91,103,220,64.08450704225352,72.53521126760563
16798_terrestrial,168,80,107,116,248,63.69047619047619,69.04761904761905
16799_terrestrial,196,100,129,137,296,65.81632653061224,69.89795918367348
16800_terrestrial,192,96,124,138,288,64.58333333333334,71.875
16801_terrestrial,194,100,130,141,294,67.0103092783505,72.68041237113401
16802_terrestrial,173,91,116,123,264,67.05202312138728,71.09826589595376
16803_terrestrial,168,98,113,121,266,67.26190476190477,72.02380952380952
16804_terrestrial,165,99,110,120,264,66.66666666666666,72.72727272727273
16805_terrestrial,174,91,117,130,265,67.24137931034483,74.71264367816092
16806_terrestrial,200,89,133,153,289,66.5,76.5
16807_terrestrial,214,98,141,163,312,65.88785046728972,76.16822429906543
16808_terrestrial,238,105,158,176,343,66.38655462184873,73.94957983193278
16809_terrestrial,247,104,161,183,351,65.18218623481782,74.08906882591093
16810_terrestrial,241,115,155,180,356,64.31535269709543,74.68879668049793
16811_terrestrial,254,121,163,194,375,64.1732283464567,76.37795275590551
16812_terrestrial,251,123,153,195,374,60.95617529880478,77.68924302788844
16813_terrestrial,260,125,156,204,385,60,78.46153846153847
16814_terrestrial,273,132,164,217,405,60.07326007326007,79.48717948717949
16829_terrestrial,173,118,107,131,291,61.849710982658955,75.72254335260115
16830_terrestrial,146,116,90,103,262,61.64383561643836,70.54794520547945
16831_terrestrial,134,117,83,95,251,61.940298507462686,70.8955223880597
16832_terrestrial,127,107,80,92,234,62.99212598425197,72.44094488188976
16833_terrestrial,120,111,77,89,231,64.16666666666667,74.16666666666667
16834_terrestrial,120,112,75,88,232,62.5,73.33333333333333
16835_terrestrial,116,110,72,80,226,62.06896551724138,68.96551724137932
16836_terrestrial,118,111,73,78,229,61.86440677966102,66.10169491525424
16837_terrestrial,126,101,79,81,227,62.698412698412696,64.28571428571429
16838_terrestrial,117,90,71,76,207,60.68376068376068,64.95726495726495
16839_terrestrial,121,91,72,79,212,59.50413223140496,65.28925619834712
16840_terrestrial,125,91,70,85,216,56.00000000000001,68
16841_terrestrial,124,90,72,85,214,58.06451612903226,68.54838709677419
16881_terrestrial,311,169,222,192,480,71.38263665594855,61.7363344051447
16882_terrestrial,315,179,223,199,494,70.7936507936508,63.17460317460317
16883_terrestrial,200,118,129,162,318,64.5,81
16884_terrestrial,196,116,124,158,312,63.26530612244898,80.61224489795919
16885_terrestrial,336,194,241,192,530,71.72619047619048,57.14285714285714
16886_terrestrial,359,226,250,211,585,69.63788300835655,58.77437325905292
16887_terrestrial,234,125,172,138,359,73.50427350427351,58.97435897435898
17116_terrestrial,212,117,196,17,329,92.45283018867924,8.018867924528301
17152_terrestrial,155,93,103,96,248,66.45161290322581,61.935483870967744
17153_terrestrial,177,114,120,109,291,67.79661016949152,61.5819209039548
17154_terrestrial,159,97,103,110,256,64.77987421383648,69.18238993710692
17155_terrestrial,140,85,89,98,225,63.57142857142857,70
17156_terrestrial,132,80,87,96,212,65.9090909090909,72.72727272727273
17157_terrestrial,147,84,98,104,231,66.66666666666666,70.74829931972789
17158_terrestrial,168,98,112,117,266,66.66666666666666,69.64285714285714
17159_terrestrial,192,109,124,134,301,64.58333333333334,69.79166666666666
17160_terrestrial,204,111,134,146,315,65.68627450980392,71.56862745098039
17161_terrestrial,207,117,138,148,324,66.66666666666666,71.49758454106279
17162_terrestrial,197,106,134,144,303,68.02030456852792,73.09644670050761
17163_terrestrial,175,94,115,127,269,65.71428571428571,72.57142857142857
17164_terrestrial,162,90,104,119,252,64.19753086419753,73.4567901234568
17165_terrestrial,166,88,108,123,254,65.06024096385542,74.09638554216868
17166_terrestrial,177,84,119,131,261,67.2316384180791,74.01129943502825
17167_terrestrial,200,85,136,153,285,68,76.5
17168_terrestrial,226,102,151,172,328,66.8141592920354,76.10619469026548
17169_terrestrial,241,109,157,186,350,65.14522821576763,77.17842323651453
17170_terrestrial,268,130,169,209,398,63.059701492537314,77.98507462686567
17171_terrestrial,291,143,181,222,434,62.19931271477663,76.28865979381443
17172_terrestrial,288,141,179,220,429,62.15277777777778,76.38888888888889
17173_terrestrial,284,142,179,219,426,63.02816901408451,77.11267605633803
17174_terrestrial,270,148,170,212,418,62.96296296296296,78.51851851851852
17189_terrestrial,163,97,99,119,260,60.73619631901841,73.00613496932516
17190_terrestrial,132,98,86,93,230,65.15151515151516,70.45454545454545
17191_terrestrial,122,91,80,88,213,65.57377049180327,72.1311475409836
17192_terrestrial,116,84,73,85,200,62.93103448275862,73.27586206896551
17193_terrestrial,114,93,68,84,207,59.64912280701754,73.68421052631578
17194_terrestrial,113,104,67,83,217,59.29203539823009,73.45132743362832
17195_terrestrial,111,102,65,82,213,58.55855855855856,73.87387387387388
17196_terrestrial,114,99,68,80,213,59.64912280701754,70.17543859649122
17197_terrestrial,127,102,76,81,229,59.84251968503938,63.77952755905512
17198_terrestrial,119,94,71,76,213,59.66386554621849,63.86554621848739
17199_terrestrial,115,98,66,76,213,57.391304347826086,66.08695652173913
17200_terrestrial,111,95,67,74,206,60.36036036036037,66.66666666666666
17240_terrestrial,333,176,246,194,509,73.87387387387388,58.25825825825825
17242_terrestrial,341,201,254,189,542,74.48680351906158,55.42521994134897
17243_terrestrial,328,200,240,185,528,73.17073170731707,56.40243902439024
17244_terrestrial,333,202,239,187,535,71.77177177177178,56.15615615615616
17245_terrestrial,321,200,229,185,521,71.33956386292834,57.63239875389408
17513_terrestrial,178,108,122,110,286,68.53932584269663,61.79775280898876
17514_terrestrial,138,71,84,99,209,60.86956521739131,71.73913043478261
17515_terrestrial,146,81,91,106,227,62.328767123287676,72.6027397260274
17516_terrestrial,149,91,91,106,240,61.07382550335571,71.14093959731544
17517_terrestrial,156,94,99,113,250,63.46153846153846,72.43589743589743
17518_terrestrial,168,95,113,119,263,67.26190476190477,70.83333333333334
17519_terrestrial,184,98,123,130,282,66.84782608695652,70.65217391304348
17520_terrestrial,199,102,133,144,301,66.83417085427136,72.36180904522614
17521_terrestrial,205,110,138,149,315,67.31707317073172,72.6829268292683
17522_terrestrial,207,118,139,151,325,67.14975845410628,72.94685990338165
17523_terrestrial,209,108,140,154,317,66.98564593301435,73.68421052631578
17524_terrestrial,185,102,122,137,287,65.94594594594595,74.05405405405405
17525_terrestrial,187,99,121,141,286,64.70588235294117,75.40106951871658
17526_terrestrial,198,106,127,153,304,64.14141414141415,77.27272727272727
17527_terrestrial,224,104,146,178,328,65.17857142857143,79.46428571428571
17528_terrestrial,251,120,160,196,371,63.745019920318725,78.08764940239044
17529_terrestrial,268,119,167,209,387,62.31343283582089,77.98507462686567
17530_terrestrial,289,139,172,222,428,59.515570934256054,76.8166089965398
17531_terrestrial,290,150,175,224,440,60.3448275862069,77.24137931034483
17532_terrestrial,273,147,167,212,420,61.172161172161175,77.65567765567766
17533_terrestrial,273,140,169,209,413,61.904761904761905,76.55677655677655
17534_terrestrial,257,138,162,197,395,63.035019455252915,76.65369649805449
17535_terrestrial,247,143,158,189,390,63.96761133603239,76.51821862348179
17541_terrestrial,221,122,136,176,343,61.53846153846154,79.63800904977376
17542_terrestrial,202,115,124,160,317,61.386138613861384,79.20792079207921
17543_terrestrial,180,109,117,144,289,65,80
17544_terrestrial,167,101,109,134,268,65.26946107784431,80.23952095808383
17545_terrestrial,156,101,99,125,257,63.46153846153846,80.12820512820514
17546_terrestrial,146,97,91,115,243,62.328767123287676,78.76712328767124
17547_terrestrial,142,97,89,108,239,62.676056338028175,76.05633802816901
17548_terrestrial,133,81,83,97,214,62.40601503759399,72.93233082706767
17549_terrestrial,124,66,75,86,190,60.483870967741936,69.35483870967742
17550_terrestrial,117,61,74,82,178,63.24786324786324,70.08547008547008
17551_terrestrial,113,63,72,77,176,63.716814159292035,68.14159292035397
17552_terrestrial,106,64,65,75,170,61.32075471698113,70.75471698113208
17553_terrestrial,100,69,59,70,169,59,70
17554_terrestrial,98,89,56,68,187,57.14285714285714,69.38775510204081
17555_terrestrial,100,95,55,72,195,55.00000000000001,72
17556_terrestrial,107,91,61,76,198,57.009345794392516,71.02803738317756
17557_terrestrial,111,89,63,79,200,56.75675675675676,71.17117117117117
17600_terrestrial,195,108,128,150,303,65.64102564102564,76.92307692307693
17824_terrestrial,351,167,290,118,518,82.62108262108262,33.61823361823362
17825_terrestrial,355,162,291,122,517,81.97183098591549,34.36619718309859
17873_terrestrial,185,120,124,113,305,67.02702702702703,61.08108108108108
17874_terrestrial,195,120,131,120,315,67.17948717948717,61.53846153846154
17875_terrestrial,172,107,103,124,279,59.883720930232556,72.09302325581395
17876_terrestrial,159,107,97,116,266,61.0062893081761,72.95597484276729
17877_terrestrial,160,107,102,113,267,63.74999999999999,70.625
17878_terrestrial,157,96,105,112,253,66.87898089171973,71.3375796178344
17879_terrestrial,157,90,103,113,247,65.60509554140127,71.97452229299363
17880_terrestrial,175,89,118,129,264,67.42857142857143,73.71428571428571
17881_terrestrial,197,95,133,144,292,67.51269035532995,73.09644670050761
17882_terrestrial,211,118,139,157,329,65.87677725118483,74.40758293838863
17883_terrestrial,217,120,143,160,337,65.89861751152074,73.73271889400922
17884_terrestrial,223,114,146,167,337,65.47085201793722,74.88789237668162
17885_terrestrial,215,120,142,162,335,66.04651162790698,75.34883720930232
17886_terrestrial,228,120,144,171,348,63.1578947368421,75
17887_terrestrial,240,131,151,187,371,62.916666666666664,77.91666666666667
17888_terrestrial,259,137,162,203,396,62.54826254826254,78.37837837837837
17889_terrestrial,271,138,168,213,409,61.99261992619927,78.59778597785979
17890_terrestrial,278,154,165,218,432,59.352517985611506,78.41726618705036
17891_terrestrial,267,159,163,209,426,61.04868913857678,78.27715355805243
17892_terrestrial,268,151,167,206,419,62.31343283582089,76.86567164179104
17893_terrestrial,264,150,165,201,414,62.5,76.13636363636364
17894_terrestrial,259,151,167,197,410,64.47876447876449,76.06177606177607
17895_terrestrial,240,140,156,178,380,65,74.16666666666667
17896_terrestrial,222,136,143,169,358,64.41441441441441,76.12612612612612
17897_terrestrial,227,130,141,173,357,62.11453744493392,76.2114537444934
17899_terrestrial,200,121,120,156,321,60,78
17900_terrestrial,184,104,112,143,288,60.86956521739131,77.71739130434783
17901_terrestrial,155,82,96,125,237,61.935483870967744,80.64516129032258
17902_terrestrial,126,75,78,102,201,61.904761904761905,80.95238095238095
17903_terrestrial,112,66,70,88,178,62.5,78.57142857142857
17904_terrestrial,107,69,65,81,176,60.747663551401864,75.70093457943925
17905_terrestrial,97,67,57,71,164,58.76288659793815,73.19587628865979
17906_terrestrial,95,66,55,71,161,57.89473684210527,74.73684210526315
17907_terrestrial,95,70,57,69,165,60,72.63157894736842
17908_terrestrial,97,66,60,71,163,61.855670103092784,73.19587628865979
17909_terrestrial,95,65,58,67,160,61.05263157894737,70.52631578947368
17910_terrestrial,96,63,59,65,159,61.458333333333336,67.70833333333334
17911_terrestrial,92,63,55,64,155,59.78260869565217,69.56521739130434
17912_terrestrial,96,67,59,67,163,61.458333333333336,69.79166666666666
17913_terrestrial,101,71,64,70,172,63.366336633663366,69.3069306930693
17914_terrestrial,109,90,67,74,199,61.46788990825688,67.88990825688074
17915_terrestrial,116,96,73,80,212,62.93103448275862,68.96551724137932
17916_terrestrial,127,95,81,91,222,63.77952755905512,71.65354330708661
18149_terrestrial,163,87,144,32,250,88.34355828220859,19.631901840490798
18185_terrestrial,358,169,294,121,527,82.12290502793296,33.798882681564244
18233_terrestrial,177,114,121,107,291,68.36158192090396,60.451977401129945
18235_terrestrial,207,149,128,144,356,61.83574879227053,69.56521739130434
18236_terrestrial,202,146,119,143,348,58.91089108910891,70.79207920792079
18237_terrestrial,201,135,121,145,336,60.19900497512438,72.13930348258707
18238_terrestrial,178,116,109,132,294,61.23595505617978,74.15730337078652
18239_terrestrial,167,107,101,123,274,60.47904191616767,73.65269461077844
18240_terrestrial,164,98,107,120,262,65.2439024390244,73.17073170731707
18241_terrestrial,177,96,119,131,273,67.2316384180791,74.01129943502825
18242_terrestrial,202,101,133,151,303,65.84158415841584,74.75247524752476
18243_terrestrial,225,121,144,168,346,64,74.66666666666667
18244_terrestrial,227,125,145,169,352,63.87665198237885,74.44933920704845
18245_terrestrial,233,125,148,173,358,63.519313304721024,74.2489270386266
18246_terrestrial,235,121,149,177,356,63.40425531914894,75.31914893617021
18247_terrestrial,266,140,168,198,406,63.1578947368421,74.43609022556392
18248_terrestrial,280,156,173,209,436,61.78571428571429,74.64285714285714
18249_terrestrial,278,151,167,209,429,60.07194244604317,75.17985611510791
18250_terrestrial,265,155,165,201,420,62.264150943396224,75.84905660377359
18251_terrestrial,259,152,163,195,411,62.93436293436293,75.2895752895753
18252_terrestrial,246,139,159,186,385,64.63414634146342,75.60975609756098
18253_terrestrial,232,134,150,178,366,64.65517241379311,76.72413793103449
18254_terrestrial,229,132,150,176,361,65.50218340611353,76.85589519650655
18255_terrestrial,211,111,132,167,322,62.55924170616114,79.14691943127961
18256_terrestrial,214,125,133,163,339,62.149532710280376,76.16822429906543
18257_terrestrial,191,114,122,143,305,63.87434554973822,74.86910994764398
18258_terrestrial,172,105,109,130,277,63.372093023255815,75.5813953488372
18259_terrestrial,139,90,86,106,229,61.87050359712231,76.2589928057554
18260_terrestrial,117,76,68,90,193,58.119658119658126,76.92307692307693
18261_terrestrial,101,67,61,77,168,60.396039603960396,76.23762376237624
18262_terrestrial,85,62,53,66,147,62.35294117647059,77.64705882352942
18263_terrestrial,83,60,49,61,143,59.036144578313255,73.49397590361446
18264_terrestrial,77,59,45,57,136,58.44155844155844,74.02597402597402
18265_terrestrial,77,55,46,57,132,59.74025974025974,74.02597402597402
18266_terrestrial,79,57,48,59,136,60.75949367088608,74.68354430379746
18267_terrestrial,79,55,49,57,134,62.0253164556962,72.15189873417721
18268_terrestrial,74,66,47,52,140,63.51351351351351,70.27027027027027
18269_terrestrial,93,69,57,62,162,61.29032258064516,66.66666666666666
18270_terrestrial,106,75,63,65,181,59.43396226415094,61.32075471698113
18271_terrestrial,111,79,68,64,190,61.261261261261254,57.65765765765766
18272_terrestrial,112,82,68,66,194,60.71428571428571,58.92857142857143
18273_terrestrial,116,92,71,70,208,61.206896551724135,60.3448275862069
18274_terrestrial,125,103,75,76,228,60,60.8
18275_terrestrial,131,110,81,86,241,61.832061068702295,65.64885496183206
18276_terrestrial,134,112,82,89,246,61.19402985074627,66.4179104477612
18512_terrestrial,197,112,177,48,309,89.84771573604061,24.36548223350254
18513_terrestrial,193,110,173,48,303,89.63730569948186,24.870466321243523
18594_terrestrial,235,143,158,156,378,67.23404255319149,66.38297872340425
18595_terrestrial,276,156,176,189,432,63.76811594202898,68.47826086956522
18596_terrestrial,270,153,163,195,423,60.370370370370374,72.22222222222221
18597_terrestrial,259,170,155,185,429,59.84555984555985,71.42857142857143
18598_terrestrial,253,169,149,181,422,58.89328063241107,71.54150197628458
18599_terrestrial,232,164,133,168,396,57.327586206896555,72.41379310344827
18600_terrestrial,212,128,124,155,340,58.490566037735846,73.11320754716981
18601_terrestrial,194,114,117,142,308,60.30927835051546,73.19587628865979
18602_terrestrial,197,108,124,145,305,62.944162436548226,73.60406091370558
18603_terrestrial,206,118,130,155,324,63.10679611650486,75.24271844660194
18604_terrestrial,228,128,144,168,356,63.1578947368421,73.68421052631578
18605_terrestrial,239,131,147,175,370,61.50627615062761,73.22175732217573
18606_terrestrial,255,137,160,189,392,62.745098039215684,74.11764705882354
18607_terrestrial,284,154,181,210,438,63.732394366197184,73.94366197183099
18608_terrestrial,290,165,180,216,455,62.06896551724138,74.48275862068967
18609_terrestrial,275,173,172,208,448,62.54545454545455,75.63636363636364
18610_terrestrial,261,168,163,199,429,62.45210727969349,76.24521072796935
18611_terrestrial,255,156,163,189,411,63.921568627450974,74.11764705882354
18612_terrestrial,230,141,146,176,371,63.47826086956522,76.52173913043478
18613_terrestrial,213,105,135,160,318,63.38028169014085,75.11737089201877
18614_terrestrial,200,104,126,149,304,63,74.5
18615_terrestrial,194,100,126,142,294,64.94845360824742,73.19587628865979
18616_terrestrial,180,116,115,134,296,63.888888888888886,74.44444444444444
18617_terrestrial,161,105,106,119,266,65.83850931677019,73.91304347826086
18618_terrestrial,130,81,83,95,211,63.84615384615384,73.07692307692307
18619_terrestrial,111,73,66,83,184,59.45945945945946,74.77477477477478
18620_terrestrial,92,67,56,69,159,60.86956521739131,75
18621_terrestrial,85,65,52,62,150,61.1764705882353,72.94117647058823
18622_terrestrial,74,62,44,54,136,59.45945945945946,72.97297297297297
18623_terrestrial,77,59,45,53,136,58.44155844155844,68.83116883116884
18624_terrestrial,76,60,44,52,136,57.89473684210527,68.42105263157895
18625_terrestrial,78,64,47,52,142,60.256410256410255,66.66666666666666
18626_terrestrial,83,68,51,55,151,61.44578313253012,66.26506024096386
18627_terrestrial,93,73,54,58,166,58.06451612903226,62.365591397849464
18628_terrestrial,102,76,62,60,178,60.78431372549019,58.82352941176471
18629_terrestrial,101,75,61,58,176,60.396039603960396,57.42574257425742
18630_terrestrial,101,78,62,60,179,61.386138613861384,59.4059405940594
18631_terrestrial,104,75,63,63,179,60.57692307692307,60.57692307692307
18632_terrestrial,105,78,63,67,183,60,63.8095238095238
18633_terrestrial,105,85,64,70,190,60.952380952380956,66.66666666666666
18634_terrestrial,107,80,63,74,187,58.87850467289719,69.1588785046729
18635_terrestrial,122,86,76,87,208,62.295081967213115,71.31147540983606
18636_terrestrial,124,88,76,88,212,61.29032258064516,70.96774193548387
18637_terrestrial,130,82,80,92,212,61.53846153846154,70.76923076923077
18638_terrestrial,150,93,86,103,243,57.333333333333336,68.66666666666667
18875_terrestrial,198,113,177,48,311,89.39393939393939,24.242424242424242
18911_terrestrial,517,231,405,212,748,78.33655705996132,41.005802707930364
18912_terrestrial,477,218,380,179,695,79.66457023060796,37.526205450733755
18956_terrestrial,301,188,185,212,489,61.461794019933556,70.43189368770764
18957_terrestrial,254,178,147,179,432,57.874015748031496,70.47244094488188
18958_terrestrial,258,168,154,181,426,59.68992248062015,70.15503875968993
18959_terrestrial,258,177,152,177,435,58.91472868217055,68.6046511627907
18960_terrestrial,252,182,153,177,434,60.71428571428571,70.23809523809523
18961_terrestrial,242,163,149,173,405,61.57024793388429,71.48760330578511
18962_terrestrial,224,129,136,165,353,60.71428571428571,73.66071428571429
18963_terrestrial,221,117,136,161,338,61.53846153846154,72.85067873303167
18964_terrestrial,229,116,140,173,345,61.135371179039296,75.54585152838428
18965_terrestrial,254,126,158,184,380,62.20472440944882,72.44094488188976
18966_terrestrial,265,144,167,188,409,63.0188679245283,70.94339622641509
18967_terrestrial,278,163,179,200,441,64.38848920863309,71.94244604316546
18968_terrestrial,271,166,173,203,437,63.837638376383765,74.90774907749078
18969_terrestrial,265,166,170,201,431,64.15094339622641,75.84905660377359
18970_terrestrial,275,160,171,207,435,62.18181818181818,75.27272727272727
18971_terrestrial,262,149,166,201,411,63.358778625954194,76.7175572519084
18972_terrestrial,232,124,146,177,356,62.93103448275862,76.29310344827587
18973_terrestrial,228,107,145,169,335,63.59649122807017,74.12280701754386
18974_terrestrial,217,86,144,160,303,66.3594470046083,73.73271889400922
18975_terrestrial,212,99,144,148,311,67.9245283018868,69.81132075471697
18976_terrestrial,199,110,136,133,309,68.34170854271356,66.83417085427136
18977_terrestrial,158,98,102,114,256,64.55696202531645,72.15189873417721
18978_terrestrial,138,96,84,94,234,60.86956521739131,68.11594202898551
18979_terrestrial,119,80,71,80,199,59.66386554621849,67.22689075630252
18980_terrestrial,102,76,59,67,178,57.84313725490197,65.68627450980392
18981_terrestrial,87,75,52,58,162,59.77011494252874,66.66666666666666
18982_terrestrial,79,66,46,51,145,58.22784810126582,64.55696202531645
18983_terrestrial,81,66,48,52,147,59.25925925925925,64.19753086419753
18984_terrestrial,83,68,48,53,151,57.831325301204814,63.85542168674698
18985_terrestrial,96,76,54,61,172,56.25,63.541666666666664
18986_terrestrial,106,78,64,64,184,60.37735849056604,60.37735849056604
18987_terrestrial,104,73,64,62,177,61.53846153846154,59.61538461538461
18988_terrestrial,103,64,63,60,167,61.165048543689316,58.252427184466015
18989_terrestrial,101,63,64,60,164,63.366336633663366,59.4059405940594
18990_terrestrial,96,70,59,58,166,61.458333333333336,60.416666666666664
18991_terrestrial,98,73,61,61,171,62.244897959183675,62.244897959183675
18992_terrestrial,98,77,58,64,175,59.183673469387756,65.3061224489796
18993_terrestrial,95,70,56,63,165,58.94736842105262,66.3157894736842
18994_terrestrial,93,74,58,66,167,62.365591397849464,70.96774193548387
18995_terrestrial,113,81,66,81,194,58.4070796460177,71.68141592920354
18996_terrestrial,125,83,74,90,208,59.199999999999996,72
18997_terrestrial,131,86,79,94,217,60.30534351145038,71.7557251908397
18998_terrestrial,139,87,81,97,226,58.27338129496403,69.7841726618705
19031_terrestrial,162,54,147,48,216,90.74074074074075,29.629629629629626
19235_terrestrial,190,104,172,42,294,90.52631578947368,22.105263157894736
19271_terrestrial,530,254,412,221,784,77.73584905660378,41.69811320754717
19272_terrestrial,498,237,393,192,735,78.91566265060241,38.55421686746988
19273_terrestrial,286,141,255,47,427,89.16083916083916,16.433566433566433
19316_terrestrial,306,191,187,202,497,61.111111111111114,66.01307189542483
19317_terrestrial,233,163,131,161,396,56.22317596566524,69.09871244635193
19318_terrestrial,216,155,117,150,371,54.166666666666664,69.44444444444444
19319_terrestrial,222,154,123,152,376,55.4054054054054,68.46846846846847
19320_terrestrial,220,159,127,151,379,57.72727272727273,68.63636363636364
19321_terrestrial,249,168,150,176,417,60.24096385542169,70.68273092369478
19322_terrestrial,247,144,144,174,391,58.2995951417004,70.44534412955466
19323_terrestrial,229,127,139,164,356,60.698689956331876,71.61572052401746
19324_terrestrial,231,127,142,167,358,61.471861471861466,72.2943722943723
19325_terrestrial,239,137,149,175,376,62.34309623430963,73.22175732217573
19326_terrestrial,236,133,148,181,369,62.71186440677966,76.69491525423729
19327_terrestrial,248,137,157,190,385,63.306451612903224,76.61290322580645
19328_terrestrial,266,158,167,205,424,62.78195488721805,77.06766917293233
19329_terrestrial,263,155,162,200,418,61.59695817490495,76.04562737642586
19330_terrestrial,267,158,156,203,425,58.42696629213483,76.02996254681648
19334_terrestrial,261,133,175,190,394,67.04980842911877,72.79693486590038
19335_terrestrial,247,146,163,181,393,65.9919028340081,73.27935222672065
19336_terrestrial,209,136,141,147,345,67.46411483253588,70.33492822966507
19337_terrestrial,166,114,113,114,280,68.07228915662651,68.67469879518072
19338_terrestrial,130,93,82,90,223,63.07692307692307,69.23076923076923
19339_terrestrial,124,80,79,82,204,63.70967741935484,66.12903225806451
19340_terrestrial,112,86,71,72,198,63.39285714285714,64.28571428571429
19341_terrestrial,102,84,65,66,186,63.725490196078425,64.70588235294117
19342_terrestrial,99,78,60,62,177,60.60606060606061,62.62626262626263
19343_terrestrial,98,71,56,59,169,57.14285714285714,60.204081632653065
19344_terrestrial,100,67,57,61,167,56.99999999999999,61
19345_terrestrial,99,58,60,61,157,60.60606060606061,61.61616161616161
19346_terrestrial,94,53,56,60,147,59.57446808510638,63.829787234042556
19347_terrestrial,89,49,55,56,138,61.79775280898876,62.92134831460674
19348_terrestrial,93,52,57,59,145,61.29032258064516,63.44086021505376
19349_terrestrial,95,52,59,59,147,62.10526315789474,62.10526315789474
19350_terrestrial,93,54,58,57,147,62.365591397849464,61.29032258064516
19351_terrestrial,90,59,55,55,149,61.111111111111114,61.111111111111114
19352_terrestrial,91,62,56,57,153,61.53846153846154,62.637362637362635
19353_terrestrial,99,65,60,64,164,60.60606060606061,64.64646464646465
19354_terrestrial,102,74,62,67,176,60.78431372549019,65.68627450980392
19355_terrestrial,109,80,64,76,189,58.71559633027523,69.72477064220183
19356_terrestrial,124,91,77,88,215,62.096774193548384,70.96774193548387
19357_terrestrial,130,101,79,95,231,60.76923076923077,73.07692307692307
19358_terrestrial,145,102,85,105,247,58.620689655172406,72.41379310344827
19359_terrestrial,165,112,97,119,277,58.78787878787879,72.12121212121212
19624_terrestrial,250,152,148,173,402,59.199999999999996,69.19999999999999
19625_terrestrial,245,155,149,171,400,60.816326530612244,69.79591836734694
19626_terrestrial,253,159,153,174,412,60.47430830039525,68.77470355731225
19627_terrestrial,240,156,146,165,396,60.83333333333333,68.75
19628_terrestrial,233,148,140,159,381,60.08583690987125,68.24034334763948
19630_terrestrial,259,140,155,193,399,59.84555984555985,74.5173745173745
19631_terrestrial,505,236,391,203,741,77.42574257425743,40.1980198019802
19632_terrestrial,452,201,359,167,653,79.42477876106194,36.94690265486726
19659_terrestrial,204,122,127,161,326,62.254901960784316,78.92156862745098
19660_terrestrial,202,106,127,161,308,62.87128712871287,79.70297029702971
19676_terrestrial,213,128,126,154,341,59.154929577464785,72.30046948356808
19677_terrestrial,179,127,108,126,306,60.33519553072626,70.39106145251397
19678_terrestrial,180,134,108,127,314,60,70.55555555555556
19679_terrestrial,184,134,108,127,318,58.69565217391305,69.02173913043478
19680_terrestrial,196,143,113,136,339,57.6530612244898,69.38775510204081
19681_terrestrial,210,149,122,147,359,58.0952380952381,70
19682_terrestrial,233,144,142,163,377,60.94420600858369,69.95708154506438
19683_terrestrial,236,144,143,169,380,60.59322033898306,71.61016949152543
19684_terrestrial,238,134,145,175,372,60.924369747899156,73.52941176470588
19685_terrestrial,231,140,139,175,371,60.17316017316018,75.75757575757575
19686_terrestrial,220,137,136,164,357,61.81818181818181,74.54545454545455
19687_terrestrial,209,145,127,153,354,60.76555023923444,73.20574162679426
19688_terrestrial,204,140,121,151,344,59.31372549019608,74.01960784313727
19689_terrestrial,212,148,128,159,360,60.37735849056604,75
19690_terrestrial,253,161,151,196,414,59.683794466403164,77.4703557312253
19698_terrestrial,159,103,106,106,262,66.66666666666666,66.66666666666666
19699_terrestrial,124,87,82,81,211,66.12903225806451,65.32258064516128
19700_terrestrial,102,65,67,68,167,65.68627450980392,66.66666666666666
19701_terrestrial,97,67,59,62,164,60.824742268041234,63.91752577319587
19702_terrestrial,95,53,57,62,148,60,65.26315789473685
19703_terrestrial,95,48,57,62,143,60,65.26315789473685
19704_terrestrial,91,46,54,59,137,59.34065934065934,64.83516483516483
19705_terrestrial,89,43,54,57,132,60.67415730337079,64.04494382022472
19706_terrestrial,84,41,50,54,125,59.523809523809526,64.28571428571429
19707_terrestrial,83,41,49,54,124,59.036144578313255,65.06024096385542
19708_terrestrial,81,37,49,53,118,60.49382716049383,65.4320987654321
19709_terrestrial,80,37,49,52,117,61.25000000000001,65
19710_terrestrial,85,40,52,55,125,61.1764705882353,64.70588235294117
19711_terrestrial,85,47,53,51,132,62.35294117647059,60
19712_terrestrial,91,47,57,56,138,62.637362637362635,61.53846153846154
19713_terrestrial,100,51,63,62,151,63,62
19714_terrestrial,109,60,68,69,169,62.38532110091744,63.30275229357798
19715_terrestrial,119,71,75,79,190,63.02521008403361,66.38655462184873
19716_terrestrial,130,83,80,89,213,61.53846153846154,68.46153846153847
19717_terrestrial,135,99,81,96,234,60,71.11111111111111
19718_terrestrial,150,105,88,106,255,58.666666666666664,70.66666666666667
19719_terrestrial,163,109,92,117,272,56.44171779141104,71.77914110429448
19720_terrestrial,175,129,101,126,304,57.714285714285715,72
19981_terrestrial,232,155,138,156,387,59.48275862068966,67.24137931034483
19982_terrestrial,208,148,126,137,356,60.57692307692307,65.86538461538461
19983_terrestrial,197,138,115,127,335,58.37563451776649,64.46700507614213
19984_terrestrial,197,139,113,125,336,57.360406091370564,63.45177664974619
19985_terrestrial,191,139,108,121,330,56.54450261780105,63.35078534031413
19986_terrestrial,208,143,116,133,351,55.769230769230774,63.942307692307686
19987_terrestrial,208,146,121,131,354,58.17307692307693,62.980769230769226
19988_terrestrial,218,148,128,139,366,58.71559633027523,63.76146788990825
19989_terrestrial,238,147,141,154,385,59.2436974789916,64.70588235294117
19990_terrestrial,277,145,172,188,422,62.093862815884485,67.87003610108303
19991_terrestrial,490,224,378,191,714,77.14285714285715,38.9795918367347
19992_terrestrial,295,112,256,57,407,86.77966101694915,19.322033898305087
20018_terrestrial,198,136,123,145,334,62.121212121212125,73.23232323232324
20019_terrestrial,138,110,74,100,248,53.62318840579711,72.46376811594203
20020_terrestrial,137,83,72,104,220,52.55474452554745,75.91240875912408
20022_terrestrial,158,86,97,115,244,61.39240506329114,72.78481012658227
20023_terrestrial,166,79,101,120,245,60.8433734939759,72.28915662650603
20035_terrestrial,146,91,89,99,237,60.95890410958904,67.8082191780822
20036_terrestrial,138,89,85,94,227,61.59420289855072,68.11594202898551
20037_terrestrial,141,94,89,99,235,63.12056737588653,70.2127659574468
20038_terrestrial,150,103,93,103,253,62,68.66666666666667
20039_terrestrial,154,124,93,105,278,60.3896103896104,68.18181818181817
20040_terrestrial,168,135,99,114,303,58.92857142857143,67.85714285714286
20041_terrestrial,197,144,112,135,341,56.852791878172596,68.52791878172589
20042_terrestrial,205,131,120,147,336,58.536585365853654,71.70731707317073
20043_terrestrial,204,130,122,149,334,59.80392156862745,73.0392156862745
20044_terrestrial,196,123,120,145,319,61.224489795918366,73.9795918367347
20045_terrestrial,191,118,118,143,309,61.78010471204188,74.86910994764398
20046_terrestrial,187,119,114,139,306,60.962566844919785,74.33155080213903
20047_terrestrial,186,114,111,132,300,59.67741935483871,70.96774193548387
20048_terrestrial,203,125,122,142,328,60.09852216748769,69.95073891625616
20058_terrestrial,170,107,116,118,277,68.23529411764706,69.41176470588235
20059_terrestrial,149,89,96,97,238,64.42953020134227,65.1006711409396
20060_terrestrial,113,57,71,76,170,62.83185840707964,67.2566371681416
20061_terrestrial,98,55,61,66,153,62.244897959183675,67.3469387755102
20062_terrestrial,90,43,56,58,133,62.22222222222222,64.44444444444444
20063_terrestrial,87,34,56,57,121,64.36781609195403,65.51724137931035
20064_terrestrial,87,34,56,57,121,64.36781609195403,65.51724137931035
20065_terrestrial,85,35,53,56,120,62.35294117647059,65.88235294117646
20066_terrestrial,84,36,52,55,120,61.904761904761905,65.47619047619048
20067_terrestrial,79,36,49,51,115,62.0253164556962,64.55696202531645
20068_terrestrial,78,38,48,50,116,61.53846153846154,64.1025641025641
20069_terrestrial,79,36,49,51,115,62.0253164556962,64.55696202531645
20070_terrestrial,84,40,54,50,124,64.28571428571429,59.523809523809526
20071_terrestrial,84,41,54,50,125,64.28571428571429,59.523809523809526
20072_terrestrial,92,42,59,58,134,64.13043478260869,63.04347826086957
20073_terrestrial,99,52,64,60,151,64.64646464646465,60.60606060606061
20074_terrestrial,105,58,66,68,163,62.857142857142854,64.76190476190476
20075_terrestrial,120,64,74,81,184,61.66666666666667,67.5
20076_terrestrial,125,89,77,86,214,61.6,68.8
20077_terrestrial,136,109,87,95,245,63.970588235294116,69.85294117647058
20078_terrestrial,157,122,95,110,279,60.509554140127385,70.06369426751591
20079_terrestrial,174,132,103,121,306,59.195402298850574,69.54022988505747
20080_terrestrial,176,122,104,127,298,59.09090909090909,72.1590909090909
20081_terrestrial,207,146,123,152,353,59.42028985507246,73.42995169082126
20121_terrestrial,499,218,330,223,717,66.13226452905812,44.68937875751503
20332_terrestrial,485,234,390,186,719,80.41237113402062,38.35051546391753
20333_terrestrial,533,246,418,218,779,78.42401500938087,40.90056285178236
20340_terrestrial,194,133,115,118,327,59.27835051546392,60.824742268041234
20341_terrestrial,193,126,110,116,319,56.994818652849744,60.10362694300518
20342_terrestrial,186,126,104,109,312,55.91397849462365,58.602150537634415
20343_terrestrial,181,119,100,108,300,55.24861878453039,59.66850828729282
20344_terrestrial,171,118,90,102,289,52.63157894736842,59.64912280701754
20345_terrestrial,160,103,85,98,263,53.125,61.25000000000001
20346_terrestrial,157,103,89,94,260,56.68789808917197,59.87261146496815
20347_terrestrial,144,100,81,86,244,56.25,59.72222222222222
20348_terrestrial,170,111,95,107,281,55.88235294117647,62.94117647058823
20349_terrestrial,212,119,119,142,331,56.132075471698116,66.98113207547169
20350_terrestrial,273,139,173,182,412,63.369963369963365,66.66666666666666
20351_terrestrial,496,226,386,197,722,77.82258064516128,39.71774193548387
20352_terrestrial,466,197,368,173,663,78.96995708154506,37.1244635193133
20378_terrestrial,162,114,87,114,276,53.70370370370371,70.37037037037037
20379_terrestrial,115,86,61,82,201,53.04347826086957,71.30434782608695
20380_terrestrial,106,67,53,74,173,50,69.81132075471697
20381_terrestrial,108,63,58,76,171,53.70370370370371,70.37037037037037
20382_terrestrial,131,72,73,94,203,55.72519083969466,71.7557251908397
20383_terrestrial,183,84,116,133,267,63.387978142076506,72.6775956284153
20384_terrestrial,222,89,149,170,311,67.11711711711712,76.57657657657657
20385_terrestrial,249,101,169,190,350,67.8714859437751,76.30522088353415
20393_terrestrial,151,109,85,105,260,56.29139072847682,69.5364238410596
20394_terrestrial,145,91,86,97,236,59.310344827586206,66.89655172413794
20395_terrestrial,134,85,76,86,219,56.71641791044776,64.17910447761194
20396_terrestrial,130,80,76,84,210,58.46153846153847,64.61538461538461
20397_terrestrial,126,91,75,85,217,59.523809523809526,67.46031746031747
20398_terrestrial,131,98,80,92,229,61.06870229007634,70.22900763358778
20399_terrestrial,142,111,89,100,253,62.676056338028175,70.4225352112676
20400_terrestrial,157,117,96,107,274,61.146496815286625,68.15286624203821
20401_terrestrial,183,123,110,126,306,60.10928961748634,68.85245901639344
20402_terrestrial,185,126,112,134,311,60.54054054054055,72.43243243243244
20406_terrestrial,171,93,99,126,264,57.89473684210527,73.68421052631578
20419_terrestrial,173,104,113,114,277,65.3179190751445,65.89595375722543
20420_terrestrial,135,73,89,90,208,65.92592592592592,66.66666666666666
20421_terrestrial,106,51,69,73,157,65.09433962264151,68.86792452830188
20422_terrestrial,92,46,58,64,138,63.04347826086957,69.56521739130434
20423_terrestrial,86,37,55,58,123,63.95348837209303,67.44186046511628
20424_terrestrial,81,37,50,53,118,61.72839506172839,65.4320987654321
20425_terrestrial,79,37,50,51,116,63.29113924050633,64.55696202531645
20426_terrestrial,76,37,46,48,113,60.526315789473685,63.1578947368421
20427_terrestrial,79,34,50,50,113,63.29113924050633,63.29113924050633
20428_terrestrial,78,33,48,50,111,61.53846153846154,64.1025641025641
20429_terrestrial,77,34,47,49,111,61.038961038961034,63.63636363636363
20430_terrestrial,78,37,48,50,115,61.53846153846154,64.1025641025641
20431_terrestrial,90,42,59,53,132,65.55555555555556,58.88888888888889
20432_terrestrial,92,43,58,57,135,63.04347826086957,61.95652173913043
20433_terrestrial,99,48,62,63,147,62.62626262626263,63.63636363636363
20434_terrestrial,117,59,76,75,176,64.95726495726495,64.1025641025641
20435_terrestrial,126,71,80,85,197,63.49206349206349,67.46031746031747
20436_terrestrial,134,95,85,91,229,63.43283582089553,67.91044776119402
20437_terrestrial,162,135,98,108,297,60.49382716049383,66.66666666666666
20438_terrestrial,183,144,115,121,327,62.841530054644814,66.12021857923497
20439_terrestrial,186,137,117,127,323,62.903225806451616,68.27956989247312
20480_terrestrial,467,187,292,263,654,62.526766595289075,56.3169164882227
20582_terrestrial,337,188,242,146,525,71.81008902077151,43.32344213649852
20636_terrestrial,252,91,186,99,343,73.80952380952381,39.285714285714285
20700_terrestrial,180,128,98,104,308,54.44444444444444,57.77777777777777
20701_terrestrial,175,117,94,100,292,53.714285714285715,57.14285714285714
20702_terrestrial,158,100,83,91,258,52.53164556962025,57.59493670886076
20703_terrestrial,129,82,69,73,211,53.48837209302325,56.58914728682171
20704_terrestrial,126,79,67,75,205,53.17460317460318,59.523809523809526
20705_terrestrial,127,80,69,78,207,54.330708661417326,61.417322834645674
20706_terrestrial,131,73,74,81,204,56.48854961832062,61.832061068702295
20707_terrestrial,122,67,68,73,189,55.73770491803278,59.83606557377049
20708_terrestrial,114,64,63,68,178,55.26315789473685,59.64912280701754
20709_terrestrial,134,79,74,85,213,55.223880597014926,63.43283582089553
20710_terrestrial,162,94,93,103,256,57.407407407407405,63.580246913580254
20711_terrestrial,202,102,122,130,304,60.396039603960396,64.35643564356435
20712_terrestrial,228,105,143,141,333,62.71929824561403,61.8421052631579
20713_terrestrial,433,187,342,157,620,78.9838337182448,36.25866050808314
20714_terrestrial,430,180,342,153,610,79.53488372093022,35.581395348837205
20715_terrestrial,415,161,332,141,576,80,33.97590361445783
20716_terrestrial,385,143,313,122,528,81.2987012987013,31.68831168831169
20720_terrestrial,376,148,303,120,524,80.58510638297872,31.914893617021278
20721_terrestrial,405,164,318,142,569,78.51851851851852,35.06172839506173
20722_terrestrial,390,166,310,137,556,79.48717948717949,35.128205128205124
20723_terrestrial,384,165,305,132,549,79.42708333333334,34.375
20724_terrestrial,378,158,299,130,536,79.1005291005291,34.39153439153439
20725_terrestrial,355,138,282,114,493,79.43661971830987,32.11267605633803
20738_terrestrial,165,109,94,117,274,56.96969696969697,70.9090909090909
20739_terrestrial,112,74,63,79,186,56.25,70.53571428571429
20740_terrestrial,99,63,53,67,162,53.535353535353536,67.67676767676768
20741_terrestrial,95,60,50,64,155,52.63157894736842,67.36842105263158
20742_terrestrial,92,54,50,62,146,54.347826086956516,67.3913043478261
20743_terrestrial,140,65,90,100,205,64.28571428571429,71.42857142857143
20744_terrestrial,217,79,145,164,296,66.82027649769586,75.57603686635944
20745_terrestrial,238,85,161,176,323,67.64705882352942,73.94957983193278
20746_terrestrial,250,92,164,188,342,65.60000000000001,75.2
20754_terrestrial,149,94,89,98,243,59.73154362416108,65.77181208053692
20755_terrestrial,129,90,77,83,219,59.68992248062015,64.34108527131784
20756_terrestrial,120,88,69,75,208,57.49999999999999,62.5
20757_terrestrial,123,92,70,77,215,56.91056910569105,62.601626016260155
20758_terrestrial,124,90,74,82,214,59.67741935483871,66.12903225806451
20759_terrestrial,133,102,80,94,235,60.150375939849624,70.67669172932331
20760_terrestrial,146,116,88,100,262,60.273972602739725,68.4931506849315
20761_terrestrial,179,121,114,122,300,63.687150837988824,68.15642458100558
20780_terrestrial,147,88,96,105,235,65.3061224489796,71.42857142857143
20781_terrestrial,110,66,70,82,176,63.63636363636363,74.54545454545455
20782_terrestrial,96,53,62,69,149,64.58333333333334,71.875
20783_terrestrial,88,45,57,61,133,64.77272727272727,69.31818181818183
20784_terrestrial,81,40,51,55,121,62.96296296296296,67.90123456790124
20785_terrestrial,78,36,48,52,114,61.53846153846154,66.66666666666666
20786_terrestrial,75,35,46,50,110,61.33333333333333,66.66666666666666
20787_terrestrial,77,35,48,50,112,62.33766233766234,64.93506493506493
20788_terrestrial,77,36,48,50,113,62.33766233766234,64.93506493506493
20789_terrestrial,79,35,50,50,114,63.29113924050633,63.29113924050633
20790_terrestrial,78,38,48,51,116,61.53846153846154,65.38461538461539
20791_terrestrial,82,36,50,53,118,60.97560975609756,64.63414634146342
20792_terrestrial,95,46,61,57,141,64.21052631578948,60
20793_terrestrial,107,52,67,69,159,62.616822429906534,64.48598130841121
20794_terrestrial,116,63,72,76,179,62.06896551724138,65.51724137931035
20795_terrestrial,133,82,80,91,215,60.150375939849624,68.42105263157895
20796_terrestrial,149,118,86,106,267,57.71812080536913,71.14093959731544
21058_terrestrial,161,111,96,94,272,59.62732919254658,58.38509316770186
21059_terrestrial,155,99,88,89,254,56.774193548387096,57.41935483870968
21060_terrestrial,131,85,72,70,216,54.961832061068705,53.43511450381679
21061_terrestrial,116,71,61,61,187,52.58620689655172,52.58620689655172
21062_terrestrial,108,65,55,59,173,50.92592592592593,54.629629629629626
21063_terrestrial,106,63,56,64,169,52.83018867924528,60.37735849056604
21064_terrestrial,105,59,55,62,164,52.38095238095239,59.04761904761905
21065_terrestrial,100,62,52,58,162,52,57.99999999999999
21066_terrestrial,102,58,57,64,160,55.88235294117647,62.745098039215684
21067_terrestrial,90,44,46,52,134,51.11111111111111,57.77777777777777
21068_terrestrial,84,43,45,48,127,53.57142857142857,57.14285714285714
21069_terrestrial,79,39,41,44,118,51.89873417721519,55.69620253164557
21070_terrestrial,94,56,48,52,150,51.06382978723404,55.319148936170215
21071_terrestrial,111,68,54,67,179,48.64864864864865,60.36036036036037
21072_terrestrial,116,72,60,74,188,51.724137931034484,63.793103448275865
21073_terrestrial,134,85,74,82,219,55.223880597014926,61.19402985074627
21074_terrestrial,157,84,92,100,241,58.59872611464968,63.69426751592356
21075_terrestrial,182,80,112,114,262,61.53846153846154,62.637362637362635
21076_terrestrial,390,146,316,128,536,81.02564102564102,32.82051282051282
21077_terrestrial,344,130,290,95,474,84.30232558139535,27.61627906976744
21078_terrestrial,327,124,276,82,451,84.40366972477065,25.076452599388375
21080_terrestrial,382,152,306,124,534,80.10471204188482,32.460732984293195
21081_terrestrial,405,171,316,140,576,78.02469135802468,34.5679012345679
21082_terrestrial,154,79,91,103,233,59.09090909090909,66.88311688311688
21083_terrestrial,151,81,89,101,232,58.94039735099338,66.88741721854305
21084_terrestrial,168,79,101,109,247,60.11904761904761,64.88095238095238
21085_terrestrial,371,149,291,123,520,78.4366576819407,33.153638814016176
21086_terrestrial,360,148,287,115,508,79.72222222222223,31.944444444444443
21087_terrestrial,342,149,272,110,491,79.53216374269006,32.16374269005848
21088_terrestrial,358,146,282,117,504,78.77094972067039,32.68156424581006
21099_terrestrial,116,73,58,82,189,50,70.6896551724138
21100_terrestrial,100,68,51,69,168,51,69
21101_terrestrial,92,55,48,61,147,52.17391304347826,66.30434782608695
21102_terrestrial,85,49,43,59,134,50.588235294117645,69.41176470588235
21103_terrestrial,83,51,44,56,134,53.01204819277109,67.46987951807229
21104_terrestrial,165,59,105,120,224,63.63636363636363,72.72727272727273
21105_terrestrial,207,75,134,154,282,64.73429951690821,74.39613526570048
21106_terrestrial,226,83,147,169,309,65.04424778761062,74.77876106194691
21107_terrestrial,249,99,157,185,348,63.05220883534136,74.29718875502009
21115_terrestrial,143,92,89,94,235,62.23776223776224,65.73426573426573
21116_terrestrial,127,85,77,80,212,60.629921259842526,62.99212598425197
21117_terrestrial,122,93,69,75,215,56.557377049180324,61.47540983606557
21118_terrestrial,126,89,74,84,215,58.730158730158735,66.66666666666666
21119_terrestrial,128,101,78,89,229,60.9375,69.53125
21120_terrestrial,148,120,95,103,268,64.1891891891892,69.5945945945946
21141_terrestrial,140,75,86,106,215,61.42857142857143,75.71428571428571
21142_terrestrial,119,61,76,84,180,63.86554621848739,70.58823529411765
21143_terrestrial,100,49,63,69,149,63,69
21144_terrestrial,92,42,57,63,134,61.95652173913043,68.47826086956522
21145_terrestrial,86,39,53,60,125,61.627906976744185,69.76744186046511
21146_terrestrial,86,36,55,59,122,63.95348837209303,68.6046511627907
21147_terrestrial,85,36,54,58,121,63.52941176470588,68.23529411764706
21148_terrestrial,85,37,54,58,122,63.52941176470588,68.23529411764706
21149_terrestrial,84,36,52,57,120,61.904761904761905,67.85714285714286
21150_terrestrial,86,37,54,58,123,62.7906976744186,67.44186046511628
21151_terrestrial,95,36,61,63,131,64.21052631578948,66.3157894736842
21152_terrestrial,103,43,64,71,146,62.13592233009708,68.93203883495146
21153_terrestrial,117,49,70,85,166,59.82905982905983,72.64957264957265
21154_terrestrial,129,66,74,93,195,57.36434108527132,72.09302325581395
21155_terrestrial,142,88,78,108,230,54.929577464788736,76.05633802816901
21417_terrestrial,134,104,76,79,238,56.71641791044776,58.95522388059702
21418_terrestrial,134,95,74,73,229,55.223880597014926,54.47761194029851
21419_terrestrial,126,77,70,67,203,55.55555555555556,53.17460317460318
21420_terrestrial,106,58,58,54,164,54.71698113207547,50.943396226415096
21421_terrestrial,86,50,46,45,136,53.48837209302325,52.32558139534884
21422_terrestrial,85,52,47,46,137,55.294117647058826,54.11764705882353
21423_terrestrial,100,60,56,60,160,56.00000000000001,60
21424_terrestrial,96,54,52,56,150,54.166666666666664,58.333333333333336
21425_terrestrial,85,49,46,47,134,54.11764705882353,55.294117647058826
21426_terrestrial,82,43,41,46,125,50,56.09756097560976
21427_terrestrial,77,36,42,44,113,54.54545454545454,57.14285714285714
21428_terrestrial,71,31,38,40,102,53.52112676056338,56.33802816901409
21429_terrestrial,71,33,36,39,104,50.70422535211267,54.929577464788736
21430_terrestrial,78,38,41,40,116,52.56410256410257,51.28205128205128
21431_terrestrial,80,48,42,39,128,52.5,48.75
21432_terrestrial,75,48,37,38,123,49.333333333333336,50.66666666666667
21433_terrestrial,81,45,41,42,126,50.617283950617285,51.85185185185185
21434_terrestrial,84,46,44,47,130,52.38095238095239,55.952380952380956
21435_terrestrial,101,48,59,61,149,58.415841584158414,60.396039603960396
21436_terrestrial,138,65,92,83,203,66.66666666666666,60.14492753623188
21437_terrestrial,135,65,87,82,200,64.44444444444444,60.74074074074074
21438_terrestrial,333,131,278,87,464,83.48348348348348,26.126126126126124
21439_terrestrial,339,134,277,88,473,81.71091445427729,25.958702064896755
21440_terrestrial,357,145,290,99,502,81.23249299719888,27.73109243697479
21441_terrestrial,369,145,299,113,514,81.02981029810297,30.62330623306233
21442_terrestrial,92,46,49,55,138,53.2608695652174,59.78260869565217
21443_terrestrial,78,42,39,42,120,50,53.84615384615385
21444_terrestrial,84,45,43,47,129,51.19047619047619,55.952380952380956
21445_terrestrial,105,48,61,62,153,58.0952380952381,59.04761904761905
21446_terrestrial,124,59,73,77,183,58.87096774193549,62.096774193548384
21447_terrestrial,147,80,89,92,227,60.544217687074834,62.585034013605444
21448_terrestrial,178,89,107,109,267,60.1123595505618,61.23595505617978
21457_terrestrial,156,96,70,106,252,44.871794871794876,67.94871794871796
21458_terrestrial,106,66,49,73,172,46.22641509433962,68.86792452830188
21459_terrestrial,104,64,49,71,168,47.11538461538461,68.26923076923077
21460_terrestrial,104,67,50,72,171,48.07692307692308,69.23076923076923
21461_terrestrial,99,55,49,67,154,49.494949494949495,67.67676767676768
21462_terrestrial,87,50,43,59,137,49.42528735632184,67.81609195402298
21463_terrestrial,81,49,41,54,130,50.617283950617285,66.66666666666666
21464_terrestrial,85,51,46,57,136,54.11764705882353,67.05882352941175
21465_terrestrial,118,56,72,80,174,61.016949152542374,67.79661016949152
21466_terrestrial,198,75,129,144,273,65.15151515151516,72.72727272727273
21467_terrestrial,246,103,154,179,349,62.601626016260155,72.76422764227642
21478_terrestrial,138,97,82,90,235,59.42028985507246,65.21739130434783
21479_terrestrial,137,96,86,92,233,62.77372262773723,67.15328467153284
21504_terrestrial,135,63,84,98,198,62.22222222222222,72.5925925925926
21505_terrestrial,114,52,69,82,166,60.526315789473685,71.9298245614035
21506_terrestrial,104,42,63,75,146,60.57692307692307,72.11538461538461
21507_terrestrial,103,45,65,72,148,63.10679611650486,69.90291262135922
21508_terrestrial,98,46,61,69,144,62.244897959183675,70.40816326530613
21509_terrestrial,100,45,60,72,145,60,72
21510_terrestrial,106,48,64,74,154,60.37735849056604,69.81132075471697
21511_terrestrial,116,62,68,83,178,58.620689655172406,71.55172413793103
21512_terrestrial,133,74,79,96,207,59.3984962406015,72.18045112781954
21513_terrestrial,147,75,88,109,222,59.863945578231295,74.14965986394559
21514_terrestrial,180,98,108,126,278,60,70
21515_terrestrial,231,138,137,168,369,59.307359307359306,72.72727272727273
21662_terrestrial,156,77,132,42,233,84.61538461538461,26.923076923076923
21692_terrestrial,472,238,278,264,710,58.89830508474576,55.932203389830505
21767_terrestrial,340,143,297,86,483,87.3529411764706,25.294117647058822
21775_terrestrial,122,89,59,66,211,48.36065573770492,54.09836065573771
21776_terrestrial,101,75,45,54,176,44.554455445544555,53.46534653465347
21777_terrestrial,92,66,48,54,158,52.17391304347826,58.69565217391305
21778_terrestrial,102,71,56,57,173,54.90196078431373,55.88235294117647
21779_terrestrial,97,65,50,52,162,51.546391752577314,53.608247422680414
21780_terrestrial,92,49,47,48,141,51.08695652173913,52.17391304347826
21781_terrestrial,87,46,48,46,133,55.172413793103445,52.87356321839081
21782_terrestrial,83,47,44,47,130,53.01204819277109,56.62650602409639
21783_terrestrial,83,50,43,45,133,51.80722891566265,54.21686746987952
21784_terrestrial,79,46,41,43,125,51.89873417721519,54.43037974683544
21785_terrestrial,77,40,42,42,117,54.54545454545454,54.54545454545454
21786_terrestrial,76,38,38,43,114,50,56.57894736842105
21787_terrestrial,74,33,38,41,107,51.35135135135135,55.4054054054054
21788_terrestrial,72,31,36,40,103,50,55.55555555555556
21789_terrestrial,73,32,37,41,105,50.68493150684932,56.16438356164384
21790_terrestrial,74,34,38,40,108,51.35135135135135,54.054054054054056
21791_terrestrial,65,31,33,36,96,50.76923076923077,55.38461538461539
21792_terrestrial,61,31,30,32,92,49.18032786885246,52.459016393442624
21793_terrestrial,62,36,32,31,98,51.61290322580645,50
21794_terrestrial,63,40,32,33,103,50.79365079365079,52.38095238095239
21795_terrestrial,73,44,37,39,117,50.68493150684932,53.42465753424658
21796_terrestrial,84,52,46,43,136,54.761904761904766,51.19047619047619
21797_terrestrial,86,53,47,46,139,54.65116279069767,53.48837209302325
21798_terrestrial,89,48,50,53,137,56.17977528089888,59.55056179775281
21799_terrestrial,117,60,70,65,177,59.82905982905983,55.55555555555556
21800_terrestrial,123,66,75,69,189,60.97560975609756,56.09756097560976
21801_terrestrial,114,52,69,67,166,60.526315789473685,58.77192982456141
21802_terrestrial,78,42,39,41,120,50,52.56410256410257
21803_terrestrial,68,34,33,32,102,48.529411764705884,47.05882352941176
21804_terrestrial,74,34,36,36,108,48.64864864864865,48.64864864864865
21805_terrestrial,83,35,46,47,118,55.42168674698795,56.62650602409639
21806_terrestrial,100,50,58,61,150,57.99999999999999,61
21807_terrestrial,90,49,51,54,139,56.666666666666664,60
21808_terrestrial,84,49,45,48,133,53.57142857142857,57.14285714285714
21809_terrestrial,99,60,52,57,159,52.52525252525253,57.57575757575758
21813_terrestrial,801,349,529,446,1150,66.04244694132333,55.68039950062422
21814_terrestrial,670,325,429,363,995,64.02985074626866,54.179104477611936
21815_terrestrial,723,356,453,406,1079,62.655601659751035,56.15491009681881
21816_terrestrial,247,145,130,166,392,52.63157894736842,67.20647773279353
21817_terrestrial,143,93,68,102,236,47.55244755244755,71.32867132867133
21818_terrestrial,114,65,55,81,179,48.24561403508772,71.05263157894737
21819_terrestrial,114,63,59,81,177,51.75438596491229,71.05263157894737
21820_terrestrial,110,62,55,77,172,50,70
21821_terrestrial,104,61,51,73,165,49.03846153846153,70.1923076923077
21822_terrestrial,98,55,47,68,153,47.95918367346938,69.38775510204081
21823_terrestrial,94,54,48,63,148,51.06382978723404,67.02127659574468
21824_terrestrial,90,54,49,62,144,54.44444444444444,68.88888888888889
21825_terrestrial,93,55,51,63,148,54.83870967741935,67.74193548387096
21826_terrestrial,101,61,56,68,162,55.44554455445545,67.32673267326733
21827_terrestrial,174,80,101,120,254,58.04597701149425,68.96551724137932
21828_terrestrial,486,221,343,245,707,70.57613168724279,50.41152263374485
21838_terrestrial,168,107,98,115,275,58.333333333333336,68.45238095238095
21839_terrestrial,164,109,95,111,273,57.92682926829268,67.6829268292683
21866_terrestrial,168,80,111,111,248,66.07142857142857,66.07142857142857
21867_terrestrial,138,63,86,98,201,62.31884057971014,71.01449275362319
21868_terrestrial,142,67,87,102,209,61.267605633802816,71.83098591549296
21869_terrestrial,143,69,88,103,212,61.53846153846154,72.02797202797203
21870_terrestrial,150,79,95,106,229,63.33333333333333,70.66666666666667
21871_terrestrial,162,92,102,115,254,62.96296296296296,70.98765432098766
21872_terrestrial,165,92,106,118,257,64.24242424242425,71.51515151515152
21873_terrestrial,192,100,120,140,292,62.5,72.91666666666666
21874_terrestrial,263,135,162,183,398,61.59695817490495,69.58174904942965
22022_terrestrial,149,75,127,37,224,85.23489932885906,24.832214765100673
22025_terrestrial,287,211,227,90,498,79.09407665505228,31.3588850174216
22133_terrestrial,106,71,51,58,177,48.113207547169814,54.71698113207547
22134_terrestrial,89,60,39,46,149,43.82022471910113,51.68539325842697
22135_terrestrial,79,48,36,43,127,45.56962025316456,54.43037974683544
22136_terrestrial,73,45,33,38,118,45.20547945205479,52.054794520547944
22137_terrestrial,74,40,33,41,114,44.5945945945946,55.4054054054054
22138_terrestrial,71,41,33,40,112,46.478873239436616,56.33802816901409
22139_terrestrial,74,42,35,43,116,47.2972972972973,58.108108108108105
22140_terrestrial,77,40,41,44,117,53.246753246753244,57.14285714285714
22141_terrestrial,74,40,40,42,114,54.054054054054056,56.75675675675676
22142_terrestrial,73,44,39,43,117,53.42465753424658,58.9041095890411
22143_terrestrial,71,43,36,41,114,50.70422535211267,57.74647887323944
22144_terrestrial,75,36,40,41,111,53.333333333333336,54.666666666666664
22145_terrestrial,78,36,41,44,114,52.56410256410257,56.41025641025641
22146_terrestrial,76,33,39,42,109,51.31578947368421,55.26315789473685
22147_terrestrial,74,30,38,39,104,51.35135135135135,52.702702702702695
22148_terrestrial,74,29,39,40,103,52.702702702702695,54.054054054054056
22149_terrestrial,72,29,38,39,101,52.77777777777778,54.166666666666664
22150_terrestrial,70,25,36,37,95,51.42857142857142,52.85714285714286
22151_terrestrial,60,23,32,32,83,53.333333333333336,53.333333333333336
22152_terrestrial,56,25,29,31,81,51.78571428571429,55.35714285714286
22153_terrestrial,55,27,28,30,82,50.90909090909091,54.54545454545454
22154_terrestrial,57,35,29,31,92,50.877192982456144,54.385964912280706
22155_terrestrial,64,39,32,36,103,50,56.25
22156_terrestrial,66,43,33,36,109,50,54.54545454545454
22157_terrestrial,62,36,30,33,98,48.38709677419355,53.2258064516129
22158_terrestrial,59,36,31,31,95,52.54237288135594,52.54237288135594
22159_terrestrial,62,35,32,32,97,51.61290322580645,51.61290322580645
22160_terrestrial,66,35,34,35,101,51.515151515151516,53.03030303030303
22161_terrestrial,65,34,33,34,99,50.76923076923077,52.307692307692314
22162_terrestrial,63,32,31,33,95,49.2063492063492,52.38095238095239
22163_terrestrial,63,29,30,35,92,47.61904761904761,55.55555555555556
22164_terrestrial,63,26,30,35,89,47.61904761904761,55.55555555555556
22165_terrestrial,62,27,33,37,89,53.2258064516129,59.67741935483871
22166_terrestrial,74,33,39,43,107,52.702702702702695,58.108108108108105
22167_terrestrial,70,33,38,42,103,54.285714285714285,60
22168_terrestrial,74,32,37,43,106,50,58.108108108108105
22173_terrestrial,689,292,453,371,981,65.74746008708273,53.84615384615385
22174_terrestrial,728,345,470,407,1073,64.56043956043956,55.90659340659341
22175_terrestrial,710,342,460,388,1052,64.7887323943662,54.647887323943664
22176_terrestrial,673,303,436,365,976,64.78454680534918,54.23476968796434
22177_terrestrial,165,90,89,116,255,53.939393939393945,70.3030303030303
22178_terrestrial,123,67,61,90,190,49.59349593495935,73.17073170731707
22179_terrestrial,109,62,53,80,171,48.62385321100918,73.39449541284404
22180_terrestrial,103,66,51,74,169,49.51456310679612,71.84466019417476
22181_terrestrial,100,60,47,72,160,47,72
22182_terrestrial,100,67,47,72,167,47,72
22183_terrestrial,97,65,44,70,162,45.36082474226804,72.16494845360825
22184_terrestrial,97,61,47,66,158,48.45360824742268,68.04123711340206
22185_terrestrial,96,56,53,69,152,55.208333333333336,71.875
22186_terrestrial,101,55,54,73,156,53.46534653465347,72.27722772277228
22187_terrestrial,131,63,74,92,194,56.48854961832062,70.22900763358778
22188_terrestrial,180,81,106,131,261,58.88888888888889,72.77777777777777
22189_terrestrial,419,192,296,195,611,70.64439140811456,46.53937947494033
22228_terrestrial,265,145,170,185,410,64.15094339622641,69.81132075471697
22231_terrestrial,246,137,154,178,383,62.601626016260155,72.35772357723577
22385_terrestrial,416,300,267,202,716,64.1826923076923,48.55769230769231
22386_terrestrial,450,336,286,219,786,63.55555555555556,48.66666666666667
22387_terrestrial,452,360,278,224,812,61.504424778761056,49.557522123893804
22404_terrestrial,472,215,276,274,687,58.47457627118644,58.05084745762712
22482_terrestrial,331,154,292,76,485,88.21752265861026,22.9607250755287
22483_terrestrial,333,152,294,76,485,88.28828828828829,22.822822822822822
22491_terrestrial,110,69,53,66,179,48.18181818181818,60
22492_terrestrial,89,60,43,54,149,48.31460674157304,60.67415730337079
22493_terrestrial,79,51,35,46,130,44.303797468354425,58.22784810126582
22494_terrestrial,70,42,32,39,112,45.714285714285715,55.714285714285715
22495_terrestrial,63,34,29,35,97,46.03174603174603,55.55555555555556
22496_terrestrial,60,31,30,36,91,50,60
22497_terrestrial,60,28,28,36,88,46.666666666666664,60
22498_terrestrial,62,28,30,37,90,48.38709677419355,59.67741935483871
22499_terrestrial,67,29,33,39,96,49.25373134328358,58.2089552238806
22500_terrestrial,65,30,31,39,95,47.69230769230769,60
22501_terrestrial,68,36,33,41,104,48.529411764705884,60.29411764705882
22502_terrestrial,70,40,36,41,110,51.42857142857142,58.57142857142858
22503_terrestrial,71,38,36,39,109,50.70422535211267,54.929577464788736
22504_terrestrial,76,36,39,42,112,51.31578947368421,55.26315789473685
22505_terrestrial,75,36,38,41,111,50.66666666666667,54.666666666666664
22506_terrestrial,77,37,37,40,114,48.05194805194805,51.94805194805194
22507_terrestrial,81,33,39,40,114,48.148148148148145,49.382716049382715
22508_terrestrial,74,33,38,40,107,51.35135135135135,54.054054054054056
22509_terrestrial,73,35,36,40,108,49.31506849315068,54.794520547945204
22510_terrestrial,69,33,32,36,102,46.3768115942029,52.17391304347826
22511_terrestrial,60,22,31,31,82,51.66666666666667,51.66666666666667
22512_terrestrial,61,27,31,32,88,50.81967213114754,52.459016393442624
22513_terrestrial,59,32,27,30,91,45.76271186440678,50.847457627118644
22514_terrestrial,70,43,35,38,113,50,54.285714285714285
22515_terrestrial,71,44,35,39,115,49.29577464788733,54.929577464788736
22516_terrestrial,65,43,31,35,108,47.69230769230769,53.84615384615385
22517_terrestrial,59,32,30,30,91,50.847457627118644,50.847457627118644
22518_terrestrial,59,30,30,30,89,50.847457627118644,50.847457627118644
22519_terrestrial,56,30,29,29,86,51.78571428571429,51.78571428571429
22520_terrestrial,57,31,29,33,88,50.877192982456144,57.89473684210527
22521_terrestrial,60,28,29,36,88,48.333333333333336,60
22522_terrestrial,60,28,30,36,88,50,60
22523_terrestrial,63,27,34,38,90,53.96825396825397,60.317460317460316
22524_terrestrial,57,24,30,34,81,52.63157894736842,59.64912280701754
22525_terrestrial,54,21,28,31,75,51.85185185185185,57.407407407407405
22526_terrestrial,57,23,29,33,80,50.877192982456144,57.89473684210527
22527_terrestrial,57,25,30,33,82,52.63157894736842,57.89473684210527
22528_terrestrial,82,28,43,46,110,52.4390243902439,56.09756097560976
22530_terrestrial,106,46,63,70,152,59.43396226415094,66.0377358490566
22533_terrestrial,222,82,139,136,304,62.612612612612615,61.261261261261254
22534_terrestrial,735,329,485,398,1064,65.98639455782312,54.14965986394557
22535_terrestrial,643,313,419,341,956,65.16329704510109,53.03265940902022
22536_terrestrial,632,287,410,336,919,64.87341772151899,53.16455696202531
22537_terrestrial,146,80,74,97,226,50.68493150684932,66.43835616438356
22538_terrestrial,121,79,59,86,200,48.760330578512395,71.07438016528926
22539_terrestrial,106,72,50,75,178,47.16981132075472,70.75471698113208
22540_terrestrial,98,66,45,67,164,45.91836734693878,68.36734693877551
22541_terrestrial,90,62,40,63,152,44.44444444444444,70
22542_terrestrial,91,60,42,64,151,46.15384615384615,70.32967032967034
22543_terrestrial,91,63,41,61,154,45.05494505494506,67.03296703296702
22544_terrestrial,87,61,38,57,148,43.67816091954023,65.51724137931035
22545_terrestrial,86,59,40,59,145,46.51162790697674,68.6046511627907
22546_terrestrial,91,57,42,65,148,46.15384615384615,71.42857142857143
22547_terrestrial,90,54,46,63,144,51.11111111111111,70
22548_terrestrial,121,68,63,92,189,52.066115702479344,76.03305785123968
22549_terrestrial,384,173,266,172,557,69.27083333333334,44.79166666666667
22550_terrestrial,386,178,268,175,564,69.43005181347151,45.33678756476684
22746_terrestrial,172,146,61,141,318,35.46511627906977,81.97674418604652
22747_terrestrial,454,343,284,223,797,62.55506607929515,49.118942731277535
22846_terrestrial,386,173,322,97,559,83.41968911917098,25.129533678756477
22849_terrestrial,108,65,50,65,173,46.2962962962963,60.18518518518518
22850_terrestrial,92,57,44,56,149,47.82608695652174,60.86956521739131
22851_terrestrial,79,54,36,44,133,45.56962025316456,55.69620253164557
22852_terrestrial,75,44,32,43,119,42.66666666666667,57.333333333333336
22853_terrestrial,71,36,31,40,107,43.66197183098591,56.33802816901409
22854_terrestrial,61,29,29,35,90,47.540983606557376,57.377049180327866
22855_terrestrial,59,29,28,34,88,47.45762711864407,57.6271186440678
22856_terrestrial,52,26,24,30,78,46.15384615384615,57.692307692307686
22857_terrestrial,53,26,25,31,79,47.16981132075472,58.490566037735846
22858_terrestrial,54,25,25,31,79,46.2962962962963,57.407407407407405
22859_terrestrial,60,26,28,35,86,46.666666666666664,58.333333333333336
22860_terrestrial,63,27,29,40,90,46.03174603174603,63.49206349206349
22861_terrestrial,66,33,30,42,99,45.45454545454545,63.63636363636363
22862_terrestrial,66,39,31,40,105,46.96969696969697,60.60606060606061
22863_terrestrial,72,37,35,41,109,48.61111111111111,56.94444444444444
22864_terrestrial,74,45,36,43,119,48.64864864864865,58.108108108108105
22865_terrestrial,74,51,36,40,125,48.64864864864865,54.054054054054056
22866_terrestrial,80,53,37,41,133,46.25,51.24999999999999
22867_terrestrial,81,49,39,41,130,48.148148148148145,50.617283950617285
22868_terrestrial,80,46,40,41,126,50,51.24999999999999
22869_terrestrial,79,46,38,40,125,48.10126582278481,50.63291139240506
22870_terrestrial,75,43,33,36,118,44,48
22871_terrestrial,66,32,27,32,98,40.909090909090914,48.484848484848484
22872_terrestrial,62,32,29,33,94,46.774193548387096,53.2258064516129
22873_terrestrial,61,34,28,30,95,45.90163934426229,49.18032786885246
22874_terrestrial,70,41,36,39,111,51.42857142857142,55.714285714285715
22875_terrestrial,70,42,36,40,112,51.42857142857142,57.14285714285714
22876_terrestrial,65,41,33,36,106,50.76923076923077,55.38461538461539
22877_terrestrial,57,29,27,31,86,47.368421052631575,54.385964912280706
22878_terrestrial,56,29,27,31,85,48.214285714285715,55.35714285714286
22879_terrestrial,55,26,26,31,81,47.27272727272727,56.36363636363636
22880_terrestrial,55,22,26,32,77,47.27272727272727,58.18181818181818
22881_terrestrial,59,23,28,36,82,47.45762711864407,61.016949152542374
22882_terrestrial,61,24,29,38,85,47.540983606557376,62.295081967213115
22883_terrestrial,62,25,30,38,87,48.38709677419355,61.29032258064516
22884_terrestrial,57,23,28,35,80,49.122807017543856,61.40350877192983
22885_terrestrial,53,20,26,31,73,49.056603773584904,58.490566037735846
22886_terrestrial,51,20,26,29,71,50.98039215686274,56.86274509803921
22887_terrestrial,56,24,28,32,80,50,57.14285714285714
22888_terrestrial,76,29,40,45,105,52.63157894736842,59.210526315789465
22890_terrestrial,91,40,52,58,131,57.14285714285714,63.73626373626373
22891_terrestrial,213,70,131,139,283,61.502347417840376,65.25821596244131
22894_terrestrial,732,296,486,400,1028,66.39344262295081,54.644808743169406
22895_terrestrial,649,272,425,354,921,65.48536209553158,54.54545454545454
22896_terrestrial,605,265,394,323,870,65.12396694214875,53.388429752066116
22897_terrestrial,625,283,408,332,908,65.28,53.12
22898_terrestrial,135,78,70,89,213,51.85185185185185,65.92592592592592
22899_terrestrial,114,75,52,80,189,45.614035087719294,70.17543859649122
22900_terrestrial,103,69,48,70,172,46.601941747572816,67.96116504854369
22901_terrestrial,96,65,43,61,161,44.79166666666667,63.541666666666664
22902_terrestrial,85,63,38,57,148,44.70588235294118,67.05882352941175
22903_terrestrial,83,61,38,54,144,45.78313253012048,65.06024096385542
22904_terrestrial,86,59,39,55,145,45.348837209302324,63.95348837209303
22905_terrestrial,84,59,36,56,143,42.857142857142854,66.66666666666666
22906_terrestrial,87,63,39,59,150,44.827586206896555,67.81609195402298
22907_terrestrial,98,63,46,66,161,46.93877551020408,67.3469387755102
22908_terrestrial,104,65,49,75,169,47.11538461538461,72.11538461538461
22909_terrestrial,137,69,70,104,206,51.09489051094891,75.91240875912408
22912_terrestrial,378,172,276,158,550,73.01587301587301,41.7989417989418
23003_terrestrial,596,142,380,368,738,63.758389261744966,61.74496644295302
23108_terrestrial,472,396,302,222,868,63.983050847457626,47.03389830508475
23110_terrestrial,501,439,317,227,940,63.27345309381237,45.309381237524946
23206_terrestrial,392,168,320,101,560,81.63265306122449,25.765306122448976
23207_terrestrial,127,67,67,79,194,52.75590551181102,62.20472440944882
23208_terrestrial,101,64,46,60,165,45.54455445544555,59.4059405940594
23209_terrestrial,96,52,44,58,148,45.83333333333333,60.416666666666664
23210_terrestrial,79,50,35,49,129,44.303797468354425,62.0253164556962
23211_terrestrial,74,42,31,43,116,41.891891891891895,58.108108108108105
23212_terrestrial,68,36,30,37,104,44.11764705882353,54.41176470588235
23213_terrestrial,61,29,28,35,90,45.90163934426229,57.377049180327866
23214_terrestrial,59,31,27,33,90,45.76271186440678,55.932203389830505
23215_terrestrial,58,31,26,33,89,44.827586206896555,56.896551724137936
23216_terrestrial,54,26,24,32,80,44.44444444444444,59.25925925925925
23217_terrestrial,54,25,24,32,79,44.44444444444444,59.25925925925925
23218_terrestrial,56,25,25,34,81,44.642857142857146,60.71428571428571
23219_terrestrial,59,25,24,36,84,40.67796610169492,61.016949152542374
23220_terrestrial,59,26,24,35,85,40.67796610169492,59.32203389830508
23221_terrestrial,63,31,27,39,94,42.857142857142854,61.904761904761905
23222_terrestrial,66,33,29,39,99,43.93939393939394,59.09090909090909
23223_terrestrial,70,33,32,40,103,45.714285714285715,57.14285714285714
23224_terrestrial,71,47,33,41,118,46.478873239436616,57.74647887323944
23225_terrestrial,76,57,34,40,133,44.73684210526316,52.63157894736842
23226_terrestrial,82,58,37,41,140,45.1219512195122,50
23227_terrestrial,82,54,38,41,136,46.34146341463415,50
23228_terrestrial,82,59,37,41,141,45.1219512195122,50
23229_terrestrial,79,59,36,40,138,45.56962025316456,50.63291139240506
23230_terrestrial,80,58,37,40,138,46.25,50
23232_terrestrial,68,34,31,36,102,45.588235294117645,52.94117647058824
23233_terrestrial,58,31,26,28,89,44.827586206896555,48.275862068965516
23234_terrestrial,61,34,29,34,95,47.540983606557376,55.73770491803278
23235_terrestrial,59,34,29,34,93,49.152542372881356,57.6271186440678
23236_terrestrial,58,33,28,33,91,48.275862068965516,56.896551724137936
23237_terrestrial,58,27,26,33,85,44.827586206896555,56.896551724137936
23238_terrestrial,55,27,24,31,82,43.63636363636363,56.36363636363636
23239_terrestrial,54,24,24,31,78,44.44444444444444,57.407407407407405
23240_terrestrial,53,20,23,31,73,43.39622641509434,58.490566037735846
23241_terrestrial,58,22,27,35,80,46.55172413793103,60.3448275862069
23242_terrestrial,60,22,29,36,82,48.333333333333336,60
23243_terrestrial,57,21,27,33,78,47.368421052631575,57.89473684210527
23244_terrestrial,52,21,25,30,73,48.07692307692308,57.692307692307686
23245_terrestrial,51,19,25,28,70,49.01960784313725,54.90196078431373
23246_terrestrial,52,19,25,29,71,48.07692307692308,55.769230769230774
23247_terrestrial,53,18,26,30,71,49.056603773584904,56.60377358490566
23248_terrestrial,67,27,34,39,94,50.74626865671642,58.2089552238806
23251_terrestrial,123,53,73,84,176,59.34959349593496,68.29268292682927
23255_terrestrial,682,267,452,358,949,66.27565982404691,52.49266862170088
23257_terrestrial,615,272,409,323,887,66.5040650406504,52.52032520325203
23258_terrestrial,629,281,413,331,910,65.65977742448331,52.62321144674086
23259_terrestrial,134,75,67,92,209,50,68.65671641791045
23260_terrestrial,114,67,50,78,181,43.859649122807014,68.42105263157895
23261_terrestrial,100,62,46,63,162,46,63
23262_terrestrial,88,57,37,58,145,42.04545454545455,65.9090909090909
23263_terrestrial,80,55,36,54,135,45,67.5
23264_terrestrial,77,54,36,52,131,46.75324675324675,67.53246753246754
23265_terrestrial,85,57,37,56,142,43.529411764705884,65.88235294117646
23266_terrestrial,105,62,53,73,167,50.476190476190474,69.52380952380952
23267_terrestrial,109,75,56,77,184,51.37614678899083,70.64220183486239
23268_terrestrial,107,68,54,73,175,50.467289719626166,68.22429906542055
23269_terrestrial,103,69,50,76,172,48.54368932038835,73.7864077669903
23272_terrestrial,402,185,291,173,587,72.38805970149254,43.03482587064676
23276_terrestrial,497,251,358,240,748,72.03219315895373,48.2897384305835
23277_terrestrial,584,307,431,261,891,73.8013698630137,44.69178082191781
23468_terrestrial,493,409,325,226,902,65.92292089249493,45.84178498985801
23469_terrestrial,503,418,328,232,921,65.20874751491054,46.12326043737575
23470_terrestrial,554,509,360,249,1063,64.98194945848375,44.94584837545126
23471_terrestrial,501,448,318,235,949,63.47305389221557,46.9061876247505
23499_terrestrial,562,311,357,287,873,63.52313167259786,51.06761565836299
23565_terrestrial,388,166,321,105,554,82.73195876288659,27.061855670103093
23566_terrestrial,388,178,317,102,566,81.70103092783505,26.288659793814436
23567_terrestrial,98,59,46,55,157,46.93877551020408,56.12244897959183
23568_terrestrial,89,51,40,50,140,44.9438202247191,56.17977528089888
23569_terrestrial,74,50,33,44,124,44.5945945945946,59.45945945945946
23570_terrestrial,70,40,29,41,110,41.42857142857143,58.57142857142858
23571_terrestrial,66,31,28,37,97,42.42424242424242,56.060606060606055
23572_terrestrial,61,32,28,35,93,45.90163934426229,57.377049180327866
23573_terrestrial,58,29,27,33,87,46.55172413793103,56.896551724137936
23574_terrestrial,58,27,28,33,85,48.275862068965516,56.896551724137936
23575_terrestrial,58,28,28,33,86,48.275862068965516,56.896551724137936
23576_terrestrial,54,25,26,30,79,48.148148148148145,55.55555555555556
23577_terrestrial,51,25,23,30,76,45.09803921568628,58.82352941176471
23578_terrestrial,55,24,23,33,79,41.81818181818181,60
23579_terrestrial,57,25,24,35,82,42.10526315789473,61.40350877192983
23580_terrestrial,59,25,24,35,84,40.67796610169492,59.32203389830508
23581_terrestrial,66,31,25,38,97,37.878787878787875,57.57575757575758
23582_terrestrial,69,31,29,40,100,42.028985507246375,57.971014492753625
23583_terrestrial,72,36,32,41,108,44.44444444444444,56.94444444444444
23584_terrestrial,76,47,36,41,123,47.368421052631575,53.94736842105263
23585_terrestrial,79,54,35,39,133,44.303797468354425,49.36708860759494
23586_terrestrial,85,60,40,45,145,47.05882352941176,52.94117647058824
23587_terrestrial,85,63,41,46,148,48.23529411764706,54.11764705882353
23588_terrestrial,79,62,37,41,141,46.835443037974684,51.89873417721519
23589_terrestrial,79,62,36,41,141,45.56962025316456,51.89873417721519
23590_terrestrial,82,62,38,45,144,46.34146341463415,54.87804878048781
23592_terrestrial,69,39,31,36,108,44.927536231884055,52.17391304347826
23593_terrestrial,54,25,23,26,79,42.592592592592595,48.148148148148145
23594_terrestrial,51,25,21,28,76,41.17647058823529,54.90196078431373
23595_terrestrial,54,30,25,30,84,46.2962962962963,55.55555555555556
23596_terrestrial,53,26,24,29,79,45.28301886792453,54.71698113207547
23597_terrestrial,51,23,23,28,74,45.09803921568628,54.90196078431373
23598_terrestrial,54,21,24,31,75,44.44444444444444,57.407407407407405
23599_terrestrial,58,20,25,33,78,43.103448275862064,56.896551724137936
23600_terrestrial,54,18,23,30,72,42.592592592592595,55.55555555555556
23601_terrestrial,53,18,23,31,71,43.39622641509434,58.490566037735846
23602_terrestrial,55,18,25,33,73,45.45454545454545,60
23603_terrestrial,60,20,29,36,80,48.333333333333336,60
23604_terrestrial,59,20,28,35,79,47.45762711864407,59.32203389830508
23605_terrestrial,54,20,26,28,74,48.148148148148145,51.85185185185185
23606_terrestrial,53,19,26,28,72,49.056603773584904,52.83018867924528
23607_terrestrial,52,19,26,27,71,50,51.92307692307693
23608_terrestrial,59,24,29,30,83,49.152542372881356,50.847457627118644
23609_terrestrial,71,31,37,41,102,52.112676056338024,57.74647887323944
23612_terrestrial,133,51,74,93,184,55.639097744360896,69.92481203007519
23615_terrestrial,669,265,447,352,934,66.81614349775785,52.615844544095665
23616_terrestrial,669,273,446,345,942,66.66666666666666,51.569506726457405
23618_terrestrial,631,278,414,334,909,65.61014263074485,52.931854199683045
23619_terrestrial,628,275,407,338,903,64.80891719745223,53.82165605095541
23620_terrestrial,130,79,62,92,209,47.69230769230769,70.76923076923077
23621_terrestrial,97,69,45,63,166,46.391752577319586,64.94845360824742
23622_terrestrial,88,58,42,58,146,47.72727272727273,65.9090909090909
23623_terrestrial,77,52,34,53,129,44.15584415584416,68.83116883116884
23624_terrestrial,77,57,35,53,134,45.45454545454545,68.83116883116884
23625_terrestrial,85,57,37,59,142,43.529411764705884,69.41176470588235
23626_terrestrial,100,68,47,71,168,47,71
23627_terrestrial,107,75,54,76,182,50.467289719626166,71.02803738317756
23629_terrestrial,95,73,45,68,168,47.368421052631575,71.57894736842105
23630_terrestrial,123,72,68,88,195,55.28455284552846,71.54471544715447
23631_terrestrial,407,194,293,173,601,71.99017199017199,42.50614250614251
23632_terrestrial,444,204,323,206,648,72.74774774774775,46.3963963963964
23633_terrestrial,438,207,319,205,645,72.8310502283105,46.80365296803653
23634_terrestrial,439,206,323,206,645,73.57630979498862,46.924829157175395
23635_terrestrial,482,226,344,238,708,71.36929460580913,49.37759336099585
23636_terrestrial,486,235,345,238,721,70.98765432098766,48.971193415637856
23637_terrestrial,566,284,409,259,850,72.26148409893993,45.75971731448763
23638_terrestrial,492,255,367,201,747,74.59349593495935,40.853658536585364
23924_terrestrial,379,155,321,96,534,84.69656992084433,25.32981530343008
23925_terrestrial,399,177,330,110,576,82.70676691729322,27.56892230576441
23926_terrestrial,115,67,63,70,182,54.78260869565217,60.86956521739131
23927_terrestrial,89,55,45,48,144,50.56179775280899,53.93258426966292
23928_terrestrial,77,52,36,46,129,46.75324675324675,59.74025974025974
23929_terrestrial,75,46,34,47,121,45.33333333333333,62.66666666666667
23930_terrestrial,70,33,30,41,103,42.857142857142854,58.57142857142858
23931_terrestrial,64,30,30,38,94,46.875,59.375
23932_terrestrial,62,32,30,36,94,48.38709677419355,58.06451612903226
23933_terrestrial,62,30,30,36,92,48.38709677419355,58.06451612903226
23934_terrestrial,56,26,29,32,82,51.78571428571429,57.14285714285714
23935_terrestrial,55,23,28,31,78,50.90909090909091,56.36363636363636
23936_terrestrial,57,22,27,33,79,47.368421052631575,57.89473684210527
23937_terrestrial,57,23,27,33,80,47.368421052631575,57.89473684210527
23938_terrestrial,58,25,26,34,83,44.827586206896555,58.620689655172406
23939_terrestrial,58,26,24,35,84,41.37931034482759,60.3448275862069
23940_terrestrial,61,25,26,37,86,42.62295081967213,60.65573770491803
23941_terrestrial,64,28,26,38,92,40.625,59.375
23942_terrestrial,65,30,27,38,95,41.53846153846154,58.46153846153847
23943_terrestrial,72,34,32,38,106,44.44444444444444,52.77777777777778
23944_terrestrial,75,44,36,41,119,48,54.666666666666664
23945_terrestrial,88,59,41,48,147,46.590909090909086,54.54545454545454
23946_terrestrial,93,69,46,53,162,49.46236559139785,56.98924731182796
23947_terrestrial,90,67,44,51,157,48.888888888888886,56.666666666666664
23948_terrestrial,84,61,41,43,145,48.80952380952381,51.19047619047619
23949_terrestrial,78,58,36,39,136,46.15384615384615,50
23950_terrestrial,78,59,35,40,137,44.871794871794876,51.28205128205128
23951_terrestrial,71,50,34,39,121,47.88732394366197,54.929577464788736
23952_terrestrial,70,38,32,35,108,45.714285714285715,50
23953_terrestrial,56,25,23,28,81,41.07142857142857,50
23954_terrestrial,49,20,21,27,69,42.857142857142854,55.10204081632652
23955_terrestrial,48,18,21,27,66,43.75,56.25
23956_terrestrial,49,18,23,27,67,46.93877551020408,55.10204081632652
23957_terrestrial,47,18,21,27,65,44.680851063829785,57.446808510638306
23958_terrestrial,50,19,23,30,69,46,60
23959_terrestrial,57,21,28,31,78,49.122807017543856,54.385964912280706
23960_terrestrial,55,21,26,29,76,47.27272727272727,52.72727272727272
23961_terrestrial,53,18,23,30,71,43.39622641509434,56.60377358490566
23962_terrestrial,53,18,24,32,71,45.28301886792453,60.37735849056604
23963_terrestrial,57,20,26,34,77,45.614035087719294,59.64912280701754
23964_terrestrial,57,18,27,33,75,47.368421052631575,57.89473684210527
23965_terrestrial,55,19,26,29,74,47.27272727272727,52.72727272727272
23966_terrestrial,52,16,26,27,68,50,51.92307692307693
23967_terrestrial,53,17,26,28,70,49.056603773584904,52.83018867924528
23968_terrestrial,56,20,28,30,76,50,53.57142857142857
23969_terrestrial,61,30,29,32,91,47.540983606557376,52.459016393442624
23970_terrestrial,76,32,40,44,108,52.63157894736842,57.89473684210527
23971_terrestrial,101,37,57,68,138,56.43564356435643,67.32673267326733
23975_terrestrial,192,76,124,107,268,64.58333333333334,55.729166666666664
23976_terrestrial,689,292,466,352,981,67.63425253991292,51.088534107402026
23979_terrestrial,635,285,417,336,920,65.66929133858268,52.91338582677165
23980_terrestrial,146,95,76,98,241,52.054794520547944,67.12328767123287
23981_terrestrial,109,79,51,74,188,46.788990825688074,67.88990825688074
23982_terrestrial,94,63,43,63,157,45.744680851063826,67.02127659574468
23983_terrestrial,79,52,36,52,131,45.56962025316456,65.82278481012658
23984_terrestrial,76,51,34,52,127,44.73684210526316,68.42105263157895
23985_terrestrial,81,57,36,57,138,44.44444444444444,70.37037037037037
23986_terrestrial,89,55,40,61,144,44.9438202247191,68.53932584269663
23987_terrestrial,100,56,47,67,156,47,67
23988_terrestrial,93,60,43,64,153,46.236559139784944,68.81720430107528
23989_terrestrial,83,62,41,57,145,49.39759036144578,68.67469879518072
23990_terrestrial,83,64,42,57,147,50.602409638554214,68.67469879518072
23991_terrestrial,99,64,51,72,163,51.515151515151516,72.72727272727273
23992_terrestrial,399,189,289,172,588,72.4310776942356,43.10776942355889
23993_terrestrial,415,195,303,188,610,73.01204819277109,45.30120481927711
23994_terrestrial,162,72,102,123,234,62.96296296296296,75.92592592592592
23995_terrestrial,161,82,101,122,243,62.732919254658384,75.77639751552795
23996_terrestrial,163,110,96,119,273,58.895705521472394,73.00613496932516
23997_terrestrial,181,109,106,130,290,58.5635359116022,71.8232044198895
23998_terrestrial,550,284,399,239,834,72.54545454545455,43.45454545454545
23999_terrestrial,576,295,419,237,871,72.74305555555556,41.14583333333333
24000_terrestrial,540,278,395,217,818,73.14814814814815,40.18518518518518
24196_terrestrial,359,547,95,298,906,26.46239554317549,83.008356545961007
24228_terrestrial,428,243,263,240,671,61.44859813084113,56.074766355140184
24284_terrestrial,393,169,329,101,562,83.7150127226463,25.699745547073793
24285_terrestrial,133,67,80,79,200,60.150375939849624,59.3984962406015
24286_terrestrial,91,53,46,57,144,50.54945054945055,62.637362637362635
24287_terrestrial,80,56,37,49,136,46.25,61.25000000000001
24288_terrestrial,82,53,37,51,135,45.1219512195122,62.19512195121951
24289_terrestrial,77,44,33,49,121,42.857142857142854,63.63636363636363
24290_terrestrial,70,34,32,41,104,45.714285714285715,58.57142857142858
24291_terrestrial,67,31,31,41,98,46.26865671641791,61.19402985074627
24292_terrestrial,60,27,29,35,87,48.333333333333336,58.333333333333336
24293_terrestrial,59,25,29,35,84,49.152542372881356,59.32203389830508
24294_terrestrial,58,24,29,34,82,50,58.620689655172406
24295_terrestrial,57,22,27,33,79,47.368421052631575,57.89473684210527
24296_terrestrial,58,22,27,34,80,46.55172413793103,58.620689655172406
24297_terrestrial,60,23,27,35,83,45,58.333333333333336
24298_terrestrial,59,24,27,34,83,45.76271186440678,57.6271186440678
24299_terrestrial,64,23,28,39,87,43.75,60.9375
24300_terrestrial,64,24,27,39,88,42.1875,60.9375
24301_terrestrial,65,26,26,39,91,40,60
24302_terrestrial,69,28,28,40,97,40.57971014492754,57.971014492753625
24303_terrestrial,69,31,29,38,100,42.028985507246375,55.072463768115945
24304_terrestrial,71,39,33,39,110,46.478873239436616,54.929577464788736
24305_terrestrial,88,52,41,49,140,46.590909090909086,55.68181818181818
24306_terrestrial,92,68,45,52,160,48.91304347826087,56.52173913043478
24307_terrestrial,87,68,40,46,155,45.97701149425287,52.87356321839081
24308_terrestrial,80,61,37,39,141,46.25,48.75
24309_terrestrial,74,58,34,36,132,45.94594594594595,48.64864864864865
24310_terrestrial,69,54,30,37,123,43.47826086956522,53.62318840579711
24311_terrestrial,66,45,29,36,111,43.93939393939394,54.54545454545454
24312_terrestrial,61,39,26,31,100,42.62295081967213,50.81967213114754
24313_terrestrial,53,28,22,27,81,41.509433962264154,50.943396226415096
24314_terrestrial,49,21,22,27,70,44.89795918367347,55.10204081632652
24315_terrestrial,51,19,24,26,70,47.05882352941176,50.98039215686274
24316_terrestrial,56,27,25,28,83,44.642857142857146,50
24317_terrestrial,57,24,24,31,81,42.10526315789473,54.385964912280706
24318_terrestrial,56,27,23,31,83,41.07142857142857,55.35714285714286
24319_terrestrial,55,23,24,28,78,43.63636363636363,50.90909090909091
24320_terrestrial,53,22,25,28,75,47.16981132075472,52.83018867924528
24321_terrestrial,51,20,22,30,71,43.13725490196079,58.82352941176471
24322_terrestrial,52,20,24,31,72,46.15384615384615,59.61538461538461
24323_terrestrial,53,20,24,31,73,45.28301886792453,58.490566037735846
24324_terrestrial,54,17,25,30,71,46.2962962962963,55.55555555555556
24325_terrestrial,60,21,27,29,81,45,48.333333333333336
24326_terrestrial,63,23,28,31,86,44.44444444444444,49.2063492063492
24327_terrestrial,59,17,27,31,76,45.76271186440678,52.54237288135594
24328_terrestrial,55,18,26,30,73,47.27272727272727,54.54545454545454
24329_terrestrial,60,26,31,35,86,51.66666666666667,58.333333333333336
24330_terrestrial,82,30,47,46,112,57.3170731707317,56.09756097560976
24331_terrestrial,158,48,97,93,206,61.39240506329114,58.86075949367089
24335_terrestrial,177,66,113,93,243,63.84180790960452,52.54237288135594
24336_terrestrial,651,274,423,351,925,64.97695852534562,53.91705069124424
24337_terrestrial,650,276,424,347,926,65.23076923076923,53.38461538461539
24339_terrestrial,623,278,413,327,901,66.29213483146067,52.487961476725516
24340_terrestrial,659,315,427,353,974,64.79514415781486,53.566009104704094
24341_terrestrial,142,105,73,91,247,51.40845070422535,64.08450704225352
24342_terrestrial,107,79,52,74,186,48.598130841121495,69.1588785046729
24343_terrestrial,99,66,46,66,165,46.464646464646464,66.66666666666666
24344_terrestrial,81,54,34,58,135,41.9753086419753,71.60493827160494
24345_terrestrial,76,50,34,53,126,44.73684210526316,69.73684210526315
24346_terrestrial,78,49,36,52,127,46.15384615384615,66.66666666666666
24347_terrestrial,80,46,38,54,126,47.5,67.5
24348_terrestrial,76,53,37,50,129,48.68421052631579,65.78947368421053
24349_terrestrial,73,51,35,49,124,47.94520547945205,67.12328767123287
24350_terrestrial,72,46,35,47,118,48.61111111111111,65.27777777777779
24351_terrestrial,72,47,39,49,119,54.166666666666664,68.05555555555556
24352_terrestrial,79,55,45,57,134,56.9620253164557,72.15189873417721
24353_terrestrial,91,61,56,66,152,61.53846153846154,72.52747252747253
24354_terrestrial,96,63,58,71,159,60.416666666666664,73.95833333333334
24355_terrestrial,100,57,58,74,157,57.99999999999999,74
24356_terrestrial,98,74,56,72,172,57.14285714285714,73.46938775510205
24357_terrestrial,122,95,62,89,217,50.81967213114754,72.95081967213115
24358_terrestrial,150,104,80,107,254,53.333333333333336,71.33333333333334
24359_terrestrial,169,108,96,117,277,56.80473372781065,69.23076923076923
24360_terrestrial,591,296,428,241,887,72.41962774957699,40.77834179357022
24554_terrestrial,358,296,264,130,654,73.74301675977654,36.312849162011176
24643_terrestrial,409,162,342,114,571,83.61858190709046,27.87286063569682
24644_terrestrial,430,184,355,123,614,82.55813953488372,28.604651162790695
24645_terrestrial,141,66,85,84,207,60.28368794326241,59.57446808510638
24646_terrestrial,88,48,43,53,136,48.86363636363637,60.22727272727273
24648_terrestrial,91,57,42,56,148,46.15384615384615,61.53846153846154
24649_terrestrial,79,45,33,48,124,41.77215189873418,60.75949367088608
24650_terrestrial,69,35,33,41,104,47.82608695652174,59.42028985507246
24651_terrestrial,67,30,32,40,97,47.76119402985074,59.70149253731343
24652_terrestrial,60,25,29,36,85,48.333333333333336,60
24653_terrestrial,61,26,29,36,87,47.540983606557376,59.01639344262295
24654_terrestrial,59,26,29,34,85,49.152542372881356,57.6271186440678
24655_terrestrial,60,27,28,35,87,46.666666666666664,58.333333333333336
24656_terrestrial,60,25,27,35,85,45,58.333333333333336
24657_terrestrial,61,25,27,36,86,44.26229508196721,59.01639344262295
24658_terrestrial,61,23,27,36,84,44.26229508196721,59.01639344262295
24659_terrestrial,66,24,27,39,90,40.909090909090914,59.09090909090909
24660_terrestrial,69,27,30,41,96,43.47826086956522,59.42028985507246
24661_terrestrial,75,32,31,45,107,41.333333333333336,60
24662_terrestrial,74,32,30,45,106,40.54054054054054,60.810810810810814
24663_terrestrial,69,34,28,40,103,40.57971014492754,57.971014492753625
24664_terrestrial,70,36,29,40,106,41.42857142857143,57.14285714285714
24665_terrestrial,78,45,35,42,123,44.871794871794876,53.84615384615385
24666_terrestrial,83,54,37,43,137,44.57831325301205,51.80722891566265
24667_terrestrial,77,54,34,38,131,44.15584415584416,49.35064935064935
24668_terrestrial,72,54,33,38,126,45.83333333333333,52.77777777777778
24669_terrestrial,74,49,32,42,123,43.24324324324324,56.75675675675676
24670_terrestrial,67,49,28,38,116,41.7910447761194,56.71641791044776
24671_terrestrial,61,41,23,34,102,37.704918032786885,55.73770491803278
24674_terrestrial,51,21,23,28,72,45.09803921568628,54.90196078431373
24675_terrestrial,50,26,23,27,76,46,54
24676_terrestrial,59,31,28,29,90,47.45762711864407,49.152542372881356
24677_terrestrial,66,29,30,33,95,45.45454545454545,50
24678_terrestrial,64,31,28,34,95,43.75,53.125
24679_terrestrial,62,26,26,31,88,41.935483870967744,50
24680_terrestrial,61,25,26,30,86,42.62295081967213,49.18032786885246
24681_terrestrial,51,19,21,29,70,41.17647058823529,56.86274509803921
24682_terrestrial,50,20,22,30,70,44,60
24683_terrestrial,52,19,22,31,71,42.30769230769231,59.61538461538461
24684_terrestrial,55,16,24,29,71,43.63636363636363,52.72727272727272
24685_terrestrial,62,21,27,31,83,43.54838709677419,50
24686_terrestrial,63,21,28,32,84,44.44444444444444,50.79365079365079
24687_terrestrial,57,18,26,29,75,45.614035087719294,50.877192982456144
24688_terrestrial,57,17,26,29,74,45.614035087719294,50.877192982456144
24689_terrestrial,63,25,34,35,88,53.96825396825397,55.55555555555556
24690_terrestrial,114,36,69,62,150,60.526315789473685,54.385964912280706
24693_terrestrial,182,54,113,107,236,62.08791208791209,58.791208791208796
24694_terrestrial,128,50,72,80,178,56.25,62.5
24695_terrestrial,119,60,65,77,179,54.621848739495796,64.70588235294117
24696_terrestrial,149,70,86,94,219,57.71812080536913,63.08724832214765
24697_terrestrial,656,273,427,353,929,65.09146341463415,53.8109756097561
24698_terrestrial,653,270,430,344,923,65.84992343032158,52.67993874425727
24699_terrestrial,628,282,412,335,910,65.60509554140127,53.34394904458599
24700_terrestrial,661,327,428,357,988,64.75037821482601,54.0090771558245
24701_terrestrial,163,125,82,110,288,50.306748466257666,67.48466257668711
24702_terrestrial,135,109,63,95,244,46.666666666666664,70.37037037037037
24703_terrestrial,103,85,46,70,188,44.66019417475729,67.96116504854369
24704_terrestrial,87,60,38,54,147,43.67816091954023,62.06896551724138
24705_terrestrial,75,54,35,52,129,46.666666666666664,69.33333333333334
24706_terrestrial,73,52,34,49,125,46.57534246575342,67.12328767123287
24707_terrestrial,69,49,31,48,118,44.927536231884055,69.56521739130434
24708_terrestrial,67,46,31,47,113,46.26865671641791,70.1492537313433
24709_terrestrial,64,45,31,42,109,48.4375,65.625
24710_terrestrial,65,43,34,43,108,52.307692307692314,66.15384615384615
24711_terrestrial,65,40,34,42,105,52.307692307692314,64.61538461538461
24712_terrestrial,69,43,37,45,112,53.62318840579711,65.21739130434783
24713_terrestrial,67,41,35,45,108,52.23880597014925,67.16417910447761
24714_terrestrial,67,42,36,46,109,53.73134328358209,68.65671641791045
24715_terrestrial,71,43,38,49,114,53.52112676056338,69.01408450704226
24716_terrestrial,82,56,45,58,138,54.87804878048781,70.73170731707317
24717_terrestrial,105,73,53,74,178,50.476190476190474,70.47619047619048
24718_terrestrial,134,81,68,99,215,50.74626865671642,73.88059701492537
24719_terrestrial,570,272,394,252,842,69.12280701754386,44.21052631578947
24720_terrestrial,553,263,390,236,816,70.5244122965642,42.67631103074141
24948_terrestrial,437,272,284,227,709,64.98855835240275,51.94508009153318
25003_terrestrial,404,165,336,111,569,83.16831683168317,27.475247524752476
25004_terrestrial,444,196,369,129,640,83.1081081081081,29.054054054054053
25005_terrestrial,162,71,100,97,233,61.72839506172839,59.876543209876544
25006_terrestrial,118,66,65,66,184,55.08474576271186,55.932203389830505
25009_terrestrial,81,53,36,48,134,44.44444444444444,59.25925925925925
25010_terrestrial,73,36,36,43,109,49.31506849315068,58.9041095890411
25011_terrestrial,65,34,32,39,99,49.23076923076923,60
25012_terrestrial,64,29,29,39,93,45.3125,60.9375
25013_terrestrial,63,26,29,38,89,46.03174603174603,60.317460317460316
25014_terrestrial,59,26,28,35,85,47.45762711864407,59.32203389830508
25015_terrestrial,59,25,27,35,84,45.76271186440678,59.32203389830508
25016_terrestrial,60,25,27,36,85,45,60
25017_terrestrial,63,26,28,38,89,44.44444444444444,60.317460317460316
25018_terrestrial,67,25,30,41,92,44.776119402985074,61.19402985074627
25019_terrestrial,68,26,31,40,94,45.588235294117645,58.82352941176471
25020_terrestrial,68,28,31,41,96,45.588235294117645,60.29411764705882
25023_terrestrial,77,46,33,44,123,42.857142857142854,57.14285714285714
25024_terrestrial,72,44,29,42,116,40.27777777777778,58.333333333333336
25025_terrestrial,73,43,30,39,116,41.0958904109589,53.42465753424658
25026_terrestrial,73,42,30,39,115,41.0958904109589,53.42465753424658
25027_terrestrial,69,43,29,39,112,42.028985507246375,56.52173913043478
25031_terrestrial,69,40,27,37,109,39.130434782608695,53.62318840579711
25034_terrestrial,51,27,23,29,78,45.09803921568628,56.86274509803921
25035_terrestrial,51,26,23,28,77,45.09803921568628,54.90196078431373
25036_terrestrial,59,28,26,30,87,44.06779661016949,50.847457627118644
25037_terrestrial,70,35,30,36,105,42.857142857142854,51.42857142857142
25038_terrestrial,70,36,29,37,106,41.42857142857143,52.85714285714286
25039_terrestrial,66,31,28,36,97,42.42424242424242,54.54545454545454
25040_terrestrial,66,26,28,36,92,42.42424242424242,54.54545454545454
25041_terrestrial,55,21,24,31,76,43.63636363636363,56.36363636363636
25042_terrestrial,56,19,23,30,75,41.07142857142857,53.57142857142857
25043_terrestrial,54,22,23,29,76,42.592592592592595,53.70370370370371
25044_terrestrial,56,19,24,32,75,42.857142857142854,57.14285714285714
25045_terrestrial,55,17,23,31,72,41.81818181818181,56.36363636363636
25046_terrestrial,55,19,25,31,74,45.45454545454545,56.36363636363636
25047_terrestrial,56,18,25,32,74,44.642857142857146,57.14285714285714
25048_terrestrial,61,19,27,34,80,44.26229508196721,55.73770491803278
25049_terrestrial,72,27,37,42,99,51.388888888888886,58.333333333333336
25053_terrestrial,161,52,99,96,213,61.49068322981367,59.62732919254658
25054_terrestrial,154,53,93,95,207,60.3896103896104,61.68831168831169
25055_terrestrial,140,48,81,87,188,57.85714285714286,62.142857142857146
25056_terrestrial,129,58,75,79,187,58.139534883720934,61.240310077519375
25057_terrestrial,178,93,106,109,271,59.55056179775281,61.23595505617978
25058_terrestrial,659,285,425,357,944,64.4916540212443,54.17298937784521
25060_terrestrial,652,308,420,346,960,64.41717791411043,53.06748466257669
25061_terrestrial,668,323,421,366,991,63.02395209580839,54.79041916167665
25062_terrestrial,180,131,89,122,311,49.44444444444444,67.77777777777779
25063_terrestrial,128,104,56,89,232,43.75,69.53125
25064_terrestrial,96,72,42,62,168,43.75,64.58333333333334
25065_terrestrial,84,54,40,54,138,47.61904761904761,64.28571428571429
25066_terrestrial,73,52,33,50,125,45.20547945205479,68.4931506849315
25067_terrestrial,70,48,29,50,118,41.42857142857143,71.42857142857143
25068_terrestrial,63,42,27,44,105,42.857142857142854,69.84126984126983
25069_terrestrial,55,41,26,38,96,47.27272727272727,69.0909090909091
25070_terrestrial,58,39,29,38,97,50,65.51724137931035
25071_terrestrial,62,39,32,40,101,51.61290322580645,64.51612903225806
25072_terrestrial,65,41,33,42,106,50.76923076923077,64.61538461538461
25073_terrestrial,63,39,31,42,102,49.2063492063492,66.66666666666666
25074_terrestrial,64,39,31,42,103,48.4375,65.625
25075_terrestrial,70,42,35,46,112,50,65.71428571428571
25076_terrestrial,91,53,45,61,144,49.45054945054945,67.03296703296702
25077_terrestrial,123,62,65,90,185,52.84552845528455,73.17073170731707
25078_terrestrial,593,279,421,261,872,70.99494097807757,44.01349072512647
25079_terrestrial,590,286,415,253,876,70.33898305084746,42.88135593220339
25142_terrestrial,950,392,598,553,1342,62.94736842105263,58.21052631578948
25143_terrestrial,941,377,591,548,1318,62.805526036131774,58.23591923485654
25307_terrestrial,468,339,305,244,807,65.17094017094017,52.13675213675214
25364_terrestrial,466,189,380,139,655,81.54506437768241,29.82832618025751
25365_terrestrial,186,77,117,111,263,62.903225806451616,59.67741935483871
25366_terrestrial,136,74,81,77,210,59.55882352941176,56.61764705882353
25367_terrestrial,108,68,55,63,176,50.92592592592593,58.333333333333336
25368_terrestrial,102,60,51,59,162,50,57.84313725490197
25369_terrestrial,86,56,41,49,142,47.674418604651166,56.97674418604651
25370_terrestrial,76,47,34,48,123,44.73684210526316,63.1578947368421
25371_terrestrial,68,41,33,41,109,48.529411764705884,60.29411764705882
25372_terrestrial,68,38,33,40,106,48.529411764705884,58.82352941176471
25373_terrestrial,68,39,33,41,107,48.529411764705884,60.29411764705882
25374_terrestrial,68,35,32,42,103,47.05882352941176,61.76470588235294
25375_terrestrial,68,36,32,42,104,47.05882352941176,61.76470588235294
25376_terrestrial,67,35,32,41,102,47.76119402985074,61.19402985074627
25377_terrestrial,68,35,33,42,103,48.529411764705884,61.76470588235294
25378_terrestrial,73,35,35,45,108,47.94520547945205,61.64383561643836
25379_terrestrial,77,36,39,46,113,50.649350649350644,59.74025974025974
25380_terrestrial,91,43,44,52,134,48.35164835164835,57.14285714285714
25383_terrestrial,91,60,42,53,151,46.15384615384615,58.24175824175825
25384_terrestrial,77,50,33,47,127,42.857142857142854,61.038961038961034
25385_terrestrial,78,46,34,46,124,43.58974358974359,58.97435897435898
25386_terrestrial,81,47,36,50,128,44.44444444444444,61.72839506172839
25387_terrestrial,85,58,35,53,143,41.17647058823529,62.35294117647059
25392_terrestrial,67,45,26,40,112,38.80597014925373,59.70149253731343
25393_terrestrial,60,39,27,36,99,45,60
25394_terrestrial,57,32,25,35,89,43.859649122807014,61.40350877192983
25395_terrestrial,55,30,22,32,85,40,58.18181818181818
25396_terrestrial,56,27,23,31,83,41.07142857142857,55.35714285714286
25397_terrestrial,67,32,26,34,99,38.80597014925373,50.74626865671642
25398_terrestrial,71,37,29,36,108,40.845070422535215,50.70422535211267
25399_terrestrial,70,35,28,38,105,40,54.285714285714285
25400_terrestrial,68,29,29,36,97,42.64705882352941,52.94117647058824
25401_terrestrial,58,25,23,32,83,39.6551724137931,55.172413793103445
25402_terrestrial,62,23,25,36,85,40.32258064516129,58.06451612903226
25403_terrestrial,65,19,27,36,84,41.53846153846154,55.38461538461539
25404_terrestrial,62,21,27,34,83,43.54838709677419,54.83870967741935
25405_terrestrial,66,22,32,38,88,48.484848484848484,57.57575757575758
25406_terrestrial,58,20,27,36,78,46.55172413793103,62.06896551724138
25407_terrestrial,60,23,28,36,83,46.666666666666664,60
25408_terrestrial,64,23,32,38,87,50,59.375
25409_terrestrial,73,28,39,46,101,53.42465753424658,63.013698630136986
25412_terrestrial,199,62,122,123,261,61.30653266331658,61.80904522613066
25416_terrestrial,151,68,85,97,219,56.29139072847682,64.23841059602648
25417_terrestrial,204,112,116,134,316,56.86274509803921,65.68627450980392
25418_terrestrial,691,301,440,381,992,63.67583212735166,55.137481910274964
25421_terrestrial,655,309,420,349,964,64.12213740458014,53.282442748091604
25424_terrestrial,115,93,49,78,208,42.608695652173914,67.82608695652173
25425_terrestrial,92,62,40,59,154,43.47826086956522,64.13043478260869
25426_terrestrial,81,48,38,54,129,46.913580246913575,66.66666666666666
25427_terrestrial,72,44,32,53,116,44.44444444444444,73.61111111111111
25428_terrestrial,58,42,26,41,100,44.827586206896555,70.6896551724138
25429_terrestrial,59,42,28,42,101,47.45762711864407,71.1864406779661
25430_terrestrial,61,43,31,42,104,50.81967213114754,68.85245901639344
25431_terrestrial,65,43,33,42,108,50.76923076923077,64.61538461538461
25432_terrestrial,68,42,35,44,110,51.470588235294116,64.70588235294117
25433_terrestrial,68,47,35,44,115,51.470588235294116,64.70588235294117
25434_terrestrial,73,50,35,50,123,47.94520547945205,68.4931506849315
25435_terrestrial,92,57,46,62,149,50,67.3913043478261
25436_terrestrial,108,63,51,75,171,47.22222222222222,69.44444444444444
25437_terrestrial,143,72,79,96,215,55.24475524475524,67.13286713286713
25438_terrestrial,596,268,425,264,864,71.30872483221476,44.29530201342282
25502_terrestrial,1167,482,741,689,1649,63.49614395886889,59.04027420736932
25629_terrestrial,167,96,142,45,263,85.02994011976048,26.94610778443114
25630_terrestrial,168,92,143,45,260,85.11904761904762,26.785714285714285
25662_terrestrial,460,335,289,247,795,62.82608695652174,53.69565217391305
25724_terrestrial,496,198,389,160,694,78.42741935483872,32.25806451612903
25725_terrestrial,219,93,123,137,312,56.16438356164384,62.55707762557078
25726_terrestrial,158,78,90,93,236,56.9620253164557,58.86075949367089
25727_terrestrial,125,64,61,79,189,48.8,63.2
25728_terrestrial,118,69,60,73,187,50.847457627118644,61.86440677966102
25729_terrestrial,100,65,52,56,165,52,56.00000000000001
25730_terrestrial,87,58,44,51,145,50.57471264367817,58.620689655172406
25731_terrestrial,86,53,42,52,139,48.837209302325576,60.46511627906976
25732_terrestrial,78,58,37,47,136,47.43589743589743,60.256410256410255
25733_terrestrial,79,54,36,49,133,45.56962025316456,62.0253164556962
25734_terrestrial,80,47,38,48,127,47.5,60
25735_terrestrial,80,43,39,48,123,48.75,60
25736_terrestrial,88,43,44,54,131,50,61.36363636363637
25737_terrestrial,97,43,49,63,140,50.51546391752577,64.94845360824742
25738_terrestrial,105,48,56,67,153,53.333333333333336,63.8095238095238
25739_terrestrial,116,55,64,70,171,55.172413793103445,60.3448275862069
25740_terrestrial,148,62,85,81,210,57.432432432432435,54.729729729729726
25741_terrestrial,155,63,81,91,218,52.25806451612903,58.70967741935483
25742_terrestrial,126,71,59,83,197,46.82539682539682,65.87301587301587
25743_terrestrial,115,66,55,73,181,47.82608695652174,63.47826086956522
25744_terrestrial,97,59,46,61,156,47.42268041237113,62.88659793814433
25745_terrestrial,94,56,44,59,150,46.808510638297875,62.76595744680851
25746_terrestrial,103,57,45,66,160,43.689320388349515,64.07766990291263
25752_terrestrial,74,54,29,45,128,39.189189189189186,60.810810810810814
25753_terrestrial,70,50,29,42,120,41.42857142857143,60
25754_terrestrial,65,41,27,41,106,41.53846153846154,63.07692307692307
25755_terrestrial,61,34,25,37,95,40.98360655737705,60.65573770491803
25756_terrestrial,58,29,25,35,87,43.103448275862064,60.3448275862069
25757_terrestrial,64,30,28,37,94,43.75,57.8125
25758_terrestrial,66,34,30,39,100,45.45454545454545,59.09090909090909
25759_terrestrial,70,34,32,42,104,45.714285714285715,60
25760_terrestrial,71,35,35,43,106,49.29577464788733,60.56338028169014
25761_terrestrial,74,37,35,46,111,47.2972972972973,62.16216216216216
25762_terrestrial,87,40,39,57,127,44.827586206896555,65.51724137931035
25763_terrestrial,89,31,39,59,120,43.82022471910113,66.29213483146067
25764_terrestrial,83,29,40,56,112,48.19277108433735,67.46987951807229
25765_terrestrial,77,30,40,51,107,51.94805194805194,66.23376623376623
25766_terrestrial,72,23,37,47,95,51.388888888888886,65.27777777777779
25767_terrestrial,70,24,34,47,94,48.57142857142857,67.14285714285714
25768_terrestrial,76,25,38,48,101,50,63.1578947368421
25769_terrestrial,87,31,46,57,118,52.87356321839081,65.51724137931035
25770_terrestrial,151,47,89,91,198,58.94039735099338,60.264900662251655
25776_terrestrial,169,83,94,108,252,55.62130177514793,63.905325443786985
25777_terrestrial,218,115,125,139,333,57.3394495412844,63.76146788990825
25778_terrestrial,725,319,457,404,1044,63.03448275862069,55.72413793103448
25779_terrestrial,728,321,465,399,1049,63.873626373626365,54.807692307692314
25784_terrestrial,159,114,72,115,273,45.28301886792453,72.32704402515722
25785_terrestrial,104,74,49,69,178,47.11538461538461,66.34615384615384
25786_terrestrial,87,53,40,57,140,45.97701149425287,65.51724137931035
25787_terrestrial,67,44,28,48,111,41.7910447761194,71.64179104477611
25788_terrestrial,64,42,29,45,106,45.3125,70.3125
25789_terrestrial,63,44,30,44,107,47.61904761904761,69.84126984126983
25790_terrestrial,66,45,32,44,111,48.484848484848484,66.66666666666666
25791_terrestrial,70,44,33,45,114,47.14285714285714,64.28571428571429
25792_terrestrial,71,44,34,46,115,47.88732394366197,64.7887323943662
25793_terrestrial,82,54,42,55,136,51.21951219512195,67.07317073170732
25794_terrestrial,108,70,53,72,178,49.074074074074076,66.66666666666666
25795_terrestrial,129,80,61,92,209,47.286821705426355,71.31782945736434
25796_terrestrial,143,81,76,95,224,53.14685314685315,66.43356643356644
25797_terrestrial,614,281,429,279,895,69.86970684039088,45.43973941368078
25798_terrestrial,582,258,417,260,840,71.64948453608247,44.67353951890035
25886_terrestrial,542,154,365,329,696,67.34317343173431,60.70110701107011
26039_terrestrial,412,301,281,210,713,68.20388349514563,50.970873786407765
26084_terrestrial,594,227,439,235,821,73.9057239057239,39.56228956228956
26092_terrestrial,125,70,69,77,195,55.2,61.6
26093_terrestrial,121,72,65,76,193,53.71900826446281,62.8099173553719
26094_terrestrial,122,71,65,77,193,53.278688524590166,63.114754098360656
26095_terrestrial,134,70,74,87,204,55.223880597014926,64.92537313432835
26096_terrestrial,205,83,123,123,288,60,60
26097_terrestrial,256,97,151,154,353,58.984375,60.15625
26098_terrestrial,295,101,165,188,396,55.932203389830505,63.72881355932203
26099_terrestrial,309,106,170,197,415,55.016181229773466,63.75404530744336
26100_terrestrial,303,111,163,193,414,53.79537953795379,63.6963696369637
26101_terrestrial,265,96,147,163,361,55.471698113207545,61.50943396226415
26102_terrestrial,205,83,112,131,288,54.63414634146342,63.90243902439025
26103_terrestrial,161,79,81,108,240,50.31055900621118,67.08074534161491
26104_terrestrial,134,71,66,88,205,49.25373134328358,65.67164179104478
26112_terrestrial,97,60,47,57,157,48.45360824742268,58.76288659793815
26113_terrestrial,90,54,44,53,144,48.888888888888886,58.88888888888889
26114_terrestrial,85,46,41,54,131,48.23529411764706,63.52941176470588
26115_terrestrial,77,42,37,48,119,48.05194805194805,62.33766233766234
26116_terrestrial,72,39,35,44,111,48.61111111111111,61.111111111111114
26117_terrestrial,82,40,40,49,122,48.78048780487805,59.756097560975604
26118_terrestrial,87,45,42,52,132,48.275862068965516,59.77011494252874
26119_terrestrial,90,52,43,55,142,47.77777777777778,61.111111111111114
26120_terrestrial,102,50,50,62,152,49.01960784313725,60.78431372549019
26121_terrestrial,110,55,52,68,165,47.27272727272727,61.81818181818181
26124_terrestrial,114,49,53,79,163,46.49122807017544,69.2982456140351
26125_terrestrial,102,40,52,66,142,50.98039215686274,64.70588235294117
26126_terrestrial,95,35,52,61,130,54.736842105263165,64.21052631578948
26127_terrestrial,94,31,49,60,125,52.12765957446809,63.829787234042556
26128_terrestrial,99,37,50,65,136,50.505050505050505,65.65656565656566
26129_terrestrial,109,40,59,73,149,54.12844036697248,66.97247706422019
26130_terrestrial,151,53,92,94,204,60.9271523178808,62.251655629139066
26133_terrestrial,237,94,138,158,331,58.22784810126582,66.66666666666666
26137_terrestrial,204,107,112,141,311,54.90196078431373,69.11764705882352
26138_terrestrial,267,138,145,181,405,54.30711610486891,67.79026217228464
26139_terrestrial,796,347,480,462,1143,60.30150753768844,58.040201005025125
26140_terrestrial,738,310,455,420,1048,61.65311653116531,56.91056910569105
26142_terrestrial,662,314,426,354,976,64.35045317220543,53.47432024169184
26143_terrestrial,718,357,452,398,1075,62.95264623955432,55.43175487465181
26144_terrestrial,204,147,105,144,351,51.470588235294116,70.58823529411765
26145_terrestrial,124,95,60,83,219,48.38709677419355,66.93548387096774
26146_terrestrial,89,58,44,59,147,49.43820224719101,66.29213483146067
26147_terrestrial,75,47,37,50,122,49.333333333333336,66.66666666666666
26148_terrestrial,72,44,33,49,116,45.83333333333333,68.05555555555556
26149_terrestrial,71,47,32,47,118,45.07042253521127,66.19718309859155
26150_terrestrial,73,55,33,48,128,45.20547945205479,65.75342465753424
26151_terrestrial,80,55,38,52,135,47.5,65
26152_terrestrial,97,69,49,65,166,50.51546391752577,67.0103092783505
26153_terrestrial,121,90,64,82,211,52.892561983471076,67.76859504132231
26154_terrestrial,167,102,88,107,269,52.69461077844312,64.07185628742515
26155_terrestrial,644,295,436,310,939,67.70186335403726,48.13664596273292
26156_terrestrial,642,286,445,300,928,69.31464174454828,46.728971962616825
26157_terrestrial,128,70,72,83,198,56.25,64.84375
26399_terrestrial,450,359,297,236,809,66,52.44444444444445
26474_terrestrial,108,60,52,71,168,48.148148148148145,65.74074074074075
26475_terrestrial,113,58,59,72,171,52.21238938053098,63.716814159292035
26476_terrestrial,114,52,60,72,166,52.63157894736842,63.1578947368421
26477_terrestrial,117,52,64,71,169,54.700854700854705,60.68376068376068
26478_terrestrial,117,54,59,75,171,50.427350427350426,64.1025641025641
26479_terrestrial,129,62,64,83,191,49.6124031007752,64.34108527131784
26480_terrestrial,142,64,68,93,206,47.88732394366197,65.49295774647888
26481_terrestrial,149,70,72,98,219,48.322147651006716,65.77181208053692
26484_terrestrial,148,65,72,100,213,48.64864864864865,67.56756756756756
26485_terrestrial,136,64,71,91,200,52.20588235294118,66.91176470588235
26486_terrestrial,131,57,67,88,188,51.14503816793893,67.17557251908397
26487_terrestrial,134,56,72,88,190,53.73134328358209,65.67164179104478
26488_terrestrial,135,62,71,89,197,52.59259259259259,65.92592592592592
26489_terrestrial,137,56,75,93,193,54.74452554744526,67.88321167883211
26490_terrestrial,164,67,85,116,231,51.829268292682926,70.73170731707317
26499_terrestrial,407,205,173,297,612,42.50614250614251,72.97297297297297
26500_terrestrial,870,385,501,518,1255,57.58620689655173,59.54022988505747
26501_terrestrial,545,234,362,277,779,66.42201834862385,50.825688073394495
26502_terrestrial,569,249,381,286,818,66.95957820738137,50.26362038664324
26503_terrestrial,702,343,447,387,1045,63.67521367521367,55.12820512820513
26504_terrestrial,206,143,98,147,349,47.57281553398058,71.35922330097088
26505_terrestrial,147,119,63,108,266,42.857142857142854,73.46938775510205
26506_terrestrial,106,67,50,70,173,47.16981132075472,66.0377358490566
26507_terrestrial,85,57,43,57,142,50.588235294117645,67.05882352941175
26508_terrestrial,86,62,42,56,148,48.837209302325576,65.11627906976744
26509_terrestrial,95,69,45,65,164,47.368421052631575,68.42105263157895
26510_terrestrial,105,77,51,74,182,48.57142857142857,70.47619047619048
26511_terrestrial,107,80,51,75,187,47.66355140186916,70.09345794392523
26512_terrestrial,139,89,79,85,228,56.83453237410072,61.15107913669065
26513_terrestrial,600,277,414,280,877,69,46.666666666666664
26514_terrestrial,636,291,439,293,927,69.0251572327044,46.069182389937104
26515_terrestrial,609,266,423,290,875,69.45812807881774,47.61904761904761
26606_terrestrial,552,171,365,340,723,66.12318840579711,61.59420289855072
26836_terrestrial,161,78,82,112,239,50.931677018633536,69.56521739130434
26837_terrestrial,162,76,83,110,238,51.23456790123457,67.90123456790124
26838_terrestrial,171,81,84,115,252,49.122807017543856,67.2514619883041
26839_terrestrial,173,88,83,118,261,47.97687861271676,68.20809248554913
26840_terrestrial,184,93,89,125,277,48.369565217391305,67.93478260869566
26841_terrestrial,188,96,89,132,284,47.340425531914896,70.2127659574468
26842_terrestrial,194,88,91,139,282,46.90721649484536,71.64948453608247
26843_terrestrial,187,85,89,135,272,47.593582887700535,72.19251336898395
26844_terrestrial,190,87,90,136,277,47.368421052631575,71.57894736842105
26845_terrestrial,179,84,83,129,263,46.36871508379888,72.06703910614524
26846_terrestrial,177,82,83,127,259,46.89265536723164,71.75141242937853
26847_terrestrial,175,88,85,126,263,48.57142857142857,72
26848_terrestrial,182,84,90,132,266,49.45054945054945,72.52747252747253
26861_terrestrial,799,357,497,451,1156,62.20275344180225,56.44555694618273
26863_terrestrial,697,328,447,379,1025,64.13199426111909,54.375896700143464
26864_terrestrial,215,159,105,152,374,48.837209302325576,70.69767441860465
26865_terrestrial,176,136,81,126,312,46.02272727272727,71.5909090909091
26866_terrestrial,121,104,58,79,225,47.93388429752066,65.28925619834712
26867_terrestrial,99,84,49,66,183,49.494949494949495,66.66666666666666
26868_terrestrial,106,92,55,73,198,51.886792452830186,68.86792452830188
26869_terrestrial,120,91,62,85,211,51.66666666666667,70.83333333333334
26870_terrestrial,134,88,74,87,222,55.223880597014926,64.92537313432835
26871_terrestrial,614,266,422,306,880,68.72964169381108,49.8371335504886
26872_terrestrial,606,266,417,294,872,68.8118811881188,48.51485148514851
26873_terrestrial,578,256,401,274,834,69.37716262975778,47.40484429065744
26966_terrestrial,646,202,424,404,848,65.63467492260062,62.538699690402474
27119_terrestrial,433,306,283,221,739,65.35796766743648,51.03926096997691
27120_terrestrial,441,302,289,225,743,65.5328798185941,51.02040816326531
27199_terrestrial,231,104,107,170,335,46.320346320346324,73.59307359307358
27200_terrestrial,232,106,107,171,338,46.12068965517241,73.70689655172413
27201_terrestrial,235,109,107,175,344,45.53191489361702,74.46808510638297
27202_terrestrial,241,112,111,175,353,46.058091286307054,72.61410788381743
27203_terrestrial,239,103,110,177,342,46.02510460251046,74.05857740585773
27204_terrestrial,226,117,103,171,343,45.57522123893805,75.66371681415929
27205_terrestrial,234,118,107,180,352,45.72649572649573,76.92307692307693
27206_terrestrial,233,119,108,179,352,46.3519313304721,76.82403433476395
27221_terrestrial,821,372,496,480,1193,60.41412911084044,58.465286236297196
27222_terrestrial,728,317,465,404,1045,63.873626373626365,55.494505494505496
27223_terrestrial,692,321,446,372,1013,64.45086705202311,53.75722543352601
27224_terrestrial,732,361,457,408,1093,62.431693989071036,55.73770491803278
27225_terrestrial,181,150,82,133,331,45.30386740331492,73.48066298342542
27226_terrestrial,151,127,77,108,278,50.993377483443716,71.52317880794702
27227_terrestrial,140,115,72,99,255,51.42857142857142,70.71428571428572
27228_terrestrial,679,285,455,352,964,67.0103092783505,51.840942562592055
27229_terrestrial,686,273,467,350,959,68.07580174927114,51.02040816326531
27230_terrestrial,665,267,455,332,932,68.42105263157895,49.92481203007519
27231_terrestrial,629,262,436,312,891,69.31637519872814,49.60254372019078
27326_terrestrial,683,216,451,432,899,66.03221083455344,63.250366032210835
27479_terrestrial,417,320,276,211,737,66.18705035971223,50.59952038369304
27480_terrestrial,107,80,54,84,187,50.467289719626166,78.50467289719626
27481_terrestrial,433,246,286,224,679,66.05080831408776,51.73210161662818
27582_terrestrial,756,336,482,418,1092,63.75661375661375,55.29100529100529
27583_terrestrial,770,338,492,427,1108,63.896103896103895,55.45454545454545
27584_terrestrial,724,352,459,390,1076,63.39779005524861,53.86740331491713
27585_terrestrial,207,158,105,138,365,50.72463768115942,66.66666666666666
27586_terrestrial,734,327,489,392,1061,66.62125340599455,53.40599455040872
27587_terrestrial,699,294,472,368,993,67.52503576537912,52.64663805436338
27588_terrestrial,677,276,458,348,953,67.65140324963073,51.40324963072378
27589_terrestrial,651,253,446,327,904,68.50998463901689,50.23041474654379
27839_terrestrial,433,321,293,209,754,67.6674364896074,48.26789838337183
27943_terrestrial,799,361,504,436,1160,63.07884856070088,54.56821026282853
27944_terrestrial,920,455,603,486,1375,65.54347826086956,52.826086956521735
27945_terrestrial,728,317,491,380,1045,67.44505494505495,52.197802197802204
27946_terrestrial,689,292,469,362,981,68.06966618287373,52.5399129172714
27954_terrestrial,573,218,411,303,791,71.72774869109948,52.879581151832454
27955_terrestrial,559,212,399,300,771,71.37745974955277,53.66726296958855
28303_terrestrial,855,366,549,472,1221,64.21052631578948,55.2046783625731
28304_terrestrial,852,364,545,468,1216,63.96713615023474,54.929577464788736
28308_terrestrial,718,294,480,374,1012,66.85236768802228,52.089136490250695
28309_terrestrial,722,305,484,372,1027,67.03601108033241,51.52354570637119
28310_terrestrial,710,295,478,363,1005,67.32394366197182,51.12676056338028
28311_terrestrial,731,298,505,369,1029,69.08344733242134,50.47879616963065
28312_terrestrial,722,274,508,370,996,70.3601108033241,51.24653739612188
28333_terrestrial,532,106,387,290,638,72.74436090225564,54.51127819548872
28427_terrestrial,571,169,364,360,740,63.74781085814361,63.04728546409807
28664_terrestrial,885,381,534,517,1266,60.33898305084746,58.4180790960452
28665_terrestrial,859,390,525,494,1249,61.11757857974389,57.50873108265425
28666_terrestrial,834,389,520,468,1223,62.35011990407674,56.11510791366906
28667_terrestrial,773,351,501,413,1124,64.8124191461837,53.42820181112549
28668_terrestrial,739,320,488,392,1059,66.03518267929634,53.044654939106906
28669_terrestrial,196,137,98,130,333,50,66.3265306122449
28670_terrestrial,182,125,91,118,307,50,64.83516483516483
28671_terrestrial,686,279,481,363,965,70.11661807580175,52.91545189504373
28672_terrestrial,670,257,479,340,927,71.49253731343283,50.74626865671642
29024_terrestrial,387,248,166,285,635,42.89405684754522,73.64341085271317
29025_terrestrial,331,221,146,247,552,44.10876132930513,74.62235649546828
29026_terrestrial,295,220,131,214,515,44.40677966101695,72.54237288135593
29027_terrestrial,228,166,100,167,394,43.859649122807014,73.24561403508771
29028_terrestrial,164,126,73,120,290,44.51219512195122,73.17073170731707
29029_terrestrial,146,122,64,107,268,43.83561643835616,73.28767123287672
29030_terrestrial,155,118,80,100,273,51.61290322580645,64.51612903225806
29031_terrestrial,685,276,478,354,961,69.78102189781022,51.67883211678832
29119_terrestrial,693,226,454,433,919,65.51226551226551,62.48196248196248
29384_terrestrial,297,192,124,216,489,41.75084175084175,72.72727272727273
29385_terrestrial,264,171,113,196,435,42.803030303030305,74.24242424242425
29386_terrestrial,227,154,99,167,381,43.61233480176212,73.568281938326
29387_terrestrial,194,143,88,139,337,45.36082474226804,71.64948453608247
29388_terrestrial,160,122,75,111,282,46.875,69.375
29389_terrestrial,148,132,71,101,280,47.97297297297297,68.24324324324324
29390_terrestrial,685,287,468,362,972,68.32116788321167,52.846715328467155
29391_terrestrial,675,276,473,347,951,70.07407407407408,51.40740740740741
29414_terrestrial,665,164,433,386,829,65.11278195488723,58.04511278195489
29743_terrestrial,282,177,132,201,459,46.808510638297875,71.27659574468085
29744_terrestrial,244,133,115,174,377,47.13114754098361,71.31147540983606
29745_terrestrial,227,127,106,160,354,46.69603524229075,70.48458149779736
29746_terrestrial,199,118,88,142,317,44.221105527638194,71.35678391959799
29747_terrestrial,176,112,77,121,288,43.75,68.75
29748_terrestrial,156,114,72,105,270,46.15384615384615,67.3076923076923
29749_terrestrial,156,121,83,95,277,53.205128205128204,60.89743589743589
29750_terrestrial,663,276,461,341,939,69.53242835595776,51.432880844645545
29835_terrestrial,910,333,543,597,1243,59.67032967032967,65.6043956043956
29852_terrestrial,667,208,444,403,875,66.56671664167916,60.41979010494752
29869_terrestrial,634,183,403,399,817,63.56466876971609,62.93375394321766
29872_terrestrial,642,189,414,394,831,64.48598130841121,61.37071651090342
30102_terrestrial,330,201,143,246,531,43.333333333333336,74.54545454545455
30103_terrestrial,270,162,119,196,432,44.074074074074076,72.5925925925926
30104_terrestrial,250,142,117,172,392,46.800000000000004,68.8
30105_terrestrial,229,129,107,158,358,46.724890829694324,68.99563318777294
30106_terrestrial,202,126,95,137,328,47.02970297029702,67.82178217821783
30107_terrestrial,167,120,74,114,287,44.31137724550898,68.26347305389223
30108_terrestrial,143,113,72,95,256,50.349650349650354,66.43356643356644
30109_terrestrial,151,106,94,79,257,62.251655629139066,52.317880794701985
30110_terrestrial,659,268,463,336,927,70.25796661608497,50.986342943854325
30219_terrestrial,685,231,451,412,916,65.83941605839416,60.14598540145985
30230_terrestrial,635,186,407,396,821,64.09448818897637,62.36220472440945
30232_terrestrial,613,177,391,374,790,63.78466557911908,61.011419249592166
30461_terrestrial,356,238,149,261,594,41.853932584269664,73.31460674157303
30462_terrestrial,309,196,126,234,505,40.77669902912621,75.72815533980582
30463_terrestrial,285,168,123,204,453,43.15789473684211,71.57894736842105
30464_terrestrial,255,142,113,178,397,44.31372549019608,69.80392156862744
30465_terrestrial,258,139,113,185,397,43.798449612403104,71.70542635658916
30466_terrestrial,240,141,103,170,381,42.916666666666664,70.83333333333334
30467_terrestrial,159,127,66,113,286,41.509433962264154,71.0691823899371
30468_terrestrial,148,111,76,94,259,51.35135135135135,63.51351351351351
30469_terrestrial,689,277,481,354,966,69.81132075471697,51.37880986937591
30583_terrestrial,643,194,425,387,837,66.09642301710731,60.186625194401245
30590_terrestrial,635,186,407,396,821,64.09448818897637,62.36220472440945
30821_terrestrial,335,225,136,245,560,40.59701492537313,73.13432835820896
30822_terrestrial,333,202,129,247,535,38.73873873873874,74.17417417417418
30823_terrestrial,314,194,128,230,508,40.76433121019109,73.24840764331209
30824_terrestrial,243,149,106,174,392,43.62139917695473,71.60493827160494
30825_terrestrial,243,152,97,186,395,39.91769547325103,76.5432098765432
30826_terrestrial,248,177,96,183,425,38.70967741935484,73.79032258064517
30827_terrestrial,200,145,86,139,345,43,69.5
30828_terrestrial,182,120,107,99,302,58.791208791208796,54.395604395604394
30829_terrestrial,141,96,86,75,237,60.99290780141844,53.191489361702125
30981_terrestrial,404,110,283,238,514,70.04950495049505,58.91089108910891
31181_terrestrial,304,187,131,226,491,43.09210526315789,74.3421052631579
31182_terrestrial,311,196,124,232,507,39.87138263665595,74.59807073954984
31183_terrestrial,292,188,107,221,480,36.64383561643836,75.68493150684932
31184_terrestrial,232,161,89,178,393,38.362068965517246,76.72413793103449
31185_terrestrial,243,167,94,185,410,38.68312757201646,76.13168724279835
31187_terrestrial,813,345,509,471,1158,62.60762607626076,57.93357933579336
31188_terrestrial,732,285,486,401,1017,66.39344262295081,54.78142076502732
31214_terrestrial,629,159,403,366,788,64.06995230524643,58.18759936406995
31266_terrestrial,1095,433,678,661,1528,61.917808219178085,60.36529680365297
31272_terrestrial,655,182,419,407,837,63.969465648854964,62.13740458015267
31313_terrestrial,547,147,378,330,694,69.10420475319927,60.3290676416819
31343_terrestrial,419,113,294,247,532,70.16706443914082,58.94988066825776
31541_terrestrial,275,172,124,199,447,45.09090909090909,72.36363636363636
31547_terrestrial,810,347,509,469,1157,62.839506172839506,57.90123456790124
31609_terrestrial,831,298,546,455,1129,65.70397111913357,54.75330926594465
31626_terrestrial,1050,411,652,623,1461,62.095238095238095,59.333333333333336
31703_terrestrial,419,113,294,247,532,70.16706443914082,58.94988066825776
31868_terrestrial,273,142,223,74,415,81.68498168498168,27.106227106227106
31900_terrestrial,319,193,158,217,512,49.52978056426332,68.02507836990596
31901_terrestrial,272,155,130,191,427,47.794117647058826,70.22058823529412
32033_terrestrial,548,150,378,330,698,68.97810218978103,60.21897810218978
32034_terrestrial,548,150,378,330,698,68.97810218978103,60.21897810218978
32129_terrestrial,225,154,177,74,379,78.66666666666666,32.88888888888889
32171_terrestrial,491,355,280,266,846,57.0264765784114,54.17515274949084
32260_terrestrial,364,233,181,240,597,49.72527472527473,65.93406593406593
32393_terrestrial,540,147,370,329,687,68.51851851851852,60.92592592592593
32394_terrestrial,548,149,378,330,697,68.97810218978103,60.21897810218978
32489_terrestrial,343,226,242,141,569,70.55393586005832,41.10787172011662
32490_terrestrial,352,224,249,150,576,70.73863636363636,42.61363636363637
32491_terrestrial,328,201,236,131,529,71.95121951219512,39.9390243902439
32620_terrestrial,400,270,191,264,670,47.75,66
32686_terrestrial,725,287,512,339,1012,70.62068965517241,46.758620689655174
32747_terrestrial,531,140,363,320,671,68.36158192090396,60.263653483992464
32750_terrestrial,534,139,365,325,673,68.35205992509363,60.86142322097379
32755_terrestrial,547,152,379,328,699,69.28702010968921,59.96343692870201
32849_terrestrial,331,195,234,136,526,70.69486404833837,41.08761329305136
32850_terrestrial,323,189,232,127,512,71.8266253869969,39.318885448916404
33065_terrestrial,1119,490,662,700,1609,59.15996425379804,62.55585344057194
33066_terrestrial,1156,520,697,701,1676,60.29411764705882,60.6401384083045
33067_terrestrial,1109,486,661,685,1595,59.60324616771867,61.76735798016231
33090_terrestrial,921,369,550,577,1290,59.71769815418024,62.64929424538545
33115_terrestrial,547,152,379,328,699,69.28702010968921,59.96343692870201
33129_terrestrial,515,130,347,309,645,67.37864077669903,60
33342_terrestrial,710,281,483,378,991,68.02816901408451,53.239436619718305
33425_terrestrial,1102,473,651,692,1575,59.07441016333939,62.794918330308526
33426_terrestrial,1113,478,667,683,1591,59.928122192273136,61.36567834681043
33427_terrestrial,1113,482,667,683,1595,59.928122192273136,61.36567834681043
33428_terrestrial,1040,449,623,634,1489,59.90384615384615,60.96153846153847
33450_terrestrial,965,411,568,614,1376,58.86010362694301,63.626943005181346
33453_terrestrial,974,391,585,602,1365,60.06160164271047,61.80698151950719
33489_terrestrial,513,129,345,310,642,67.2514619883041,60.42884990253411
33579_terrestrial,317,191,224,110,508,70.66246056782335,34.70031545741325
33771_terrestrial,450,369,264,308,819,58.666666666666664,68.44444444444444
33777_terrestrial,1191,612,766,691,1803,64.31570109151973,58.01847187237615
33846_terrestrial,481,127,326,296,608,67.77546777546777,61.53846153846154
33848_terrestrial,507,129,337,311,636,66.46942800788955,61.34122287968442
33849_terrestrial,498,124,329,311,622,66.06425702811245,62.44979919678715
33865_terrestrial,344,87,245,198,431,71.22093023255815,57.55813953488372
33866_terrestrial,344,92,245,198,436,71.22093023255815,57.55813953488372
34136_terrestrial,1152,576,737,675,1728,63.97569444444444,58.59375
34137_terrestrial,290,172,159,218,462,54.82758620689655,75.17241379310344
34167_terrestrial,106,104,53,73,210,50,68.86792452830188
34225_terrestrial,363,99,260,213,462,71.62534435261708,58.67768595041323
34299_terrestrial,386,318,257,155,704,66.58031088082902,40.15544041450777
34493_terrestrial,1002,359,653,574,1361,65.16966067864271,57.28542914171657
34505_terrestrial,1010,407,606,618,1417,60,61.18811881188119
34659_terrestrial,362,270,240,147,632,66.29834254143645,40.607734806629836
34660_terrestrial,379,310,245,161,689,64.64379947229551,42.480211081794195
34865_terrestrial,1004,405,600,615,1409,59.76095617529881,61.254980079681275
35086_terrestrial,140,67,121,39,207,86.42857142857143,27.857142857142858
35173_terrestrial,533,123,361,310,656,67.7298311444653,58.16135084427767
35221_terrestrial,1105,442,662,683,1547,59.90950226244344,61.80995475113122
35226_terrestrial,1114,485,669,696,1599,60.05385996409336,62.47755834829444
35227_terrestrial,1112,487,668,694,1599,60.07194244604317,62.410071942446045
35228_terrestrial,1045,423,626,647,1468,59.90430622009569,61.91387559808612
35229_terrestrial,1014,409,610,626,1423,60.15779092702169,61.735700197238664
35230_terrestrial,1028,421,622,633,1449,60.505836575875485,61.57587548638133
35288_terrestrial,463,124,314,291,587,67.81857451403887,62.850971922246224
35320_terrestrial,338,137,235,184,475,69.5266272189349,54.437869822485204
35321_terrestrial,340,137,236,186,477,69.41176470588235,54.70588235294118
35473_terrestrial,234,95,217,29,329,92.73504273504274,12.393162393162394
35589_terrestrial,1032,419,618,646,1451,59.883720930232556,62.5968992248062
35590_terrestrial,1010,408,614,620,1418,60.79207920792079,61.386138613861384
35591_terrestrial,1013,404,623,611,1417,61.5004935834156,60.315893385982235
35649_terrestrial,464,119,317,287,583,68.31896551724138,61.853448275862064
35680_terrestrial,343,137,240,184,480,69.97084548104957,53.64431486880466
35681_terrestrial,348,138,243,186,486,69.82758620689656,53.44827586206896
35682_terrestrial,349,137,244,186,486,69.91404011461319,53.29512893982808
36041_terrestrial,340,137,237,184,477,69.70588235294117,54.11764705882353
36042_terrestrial,339,133,236,184,472,69.6165191740413,54.27728613569322
36145_terrestrial,317,169,253,106,486,79.81072555205047,33.4384858044164
36286_terrestrial,583,148,377,374,731,64.6655231560892,64.15094339622641
36302_terrestrial,1026,412,626,638,1438,61.01364522417154,62.1832358674464
36303_terrestrial,1066,429,649,662,1495,60.88180112570356,62.10131332082551
36313_terrestrial,521,344,344,240,865,66.02687140115164,46.06525911708253
36346_terrestrial,759,303,468,468,1062,61.6600790513834,61.6600790513834
36347_terrestrial,759,303,468,468,1062,61.6600790513834,61.6600790513834
36389_terrestrial,387,110,265,233,497,68.47545219638242,60.20671834625323
36584_terrestrial,628,234,425,357,862,67.67515923566879,56.847133757961785
36671_terrestrial,630,455,387,318,1085,61.42857142857143,50.476190476190474
36700_terrestrial,97,74,58,59,171,59.79381443298969,60.824742268041234
36701_terrestrial,893,348,526,569,1241,58.902575587905936,63.71780515117581
36707_terrestrial,750,290,462,464,1040,61.6,61.86666666666667
36944_terrestrial,625,229,427,349,854,68.32000000000001,55.84
36945_terrestrial,627,232,427,356,859,68.10207336523126,56.77830940988836
36946_terrestrial,628,221,423,357,849,67.35668789808918,56.847133757961785
36997_terrestrial,499,119,342,300,618,68.5370741482966,60.120240480961925
37024_terrestrial,747,262,491,420,1009,65.72958500669344,56.22489959839358
37078_terrestrial,596,210,400,361,806,67.11409395973155,60.570469798657726
37084_terrestrial,591,190,371,372,781,62.77495769881557,62.944162436548226
37088_terrestrial,661,256,424,397,917,64.14523449319213,60.06051437216339
37089_terrestrial,655,253,419,396,908,63.969465648854964,60.45801526717557
37428_terrestrial,799,325,487,500,1124,60.95118898623279,62.57822277847309
37442_terrestrial,574,192,362,358,766,63.06620209059234,62.36933797909408
37449_terrestrial,650,253,412,397,903,63.38461538461539,61.07692307692307
37450_terrestrial,629,235,406,382,864,64.54689984101749,60.73131955484896
37544_terrestrial,286,226,196,113,512,68.53146853146853,39.51048951048951
37757_terrestrial,477,365,310,213,842,64.98951781970649,44.65408805031446
37787_terrestrial,814,357,497,508,1171,61.056511056511056,62.40786240786241
37788_terrestrial,821,360,503,510,1181,61.26674786845311,62.119366626065776
37789_terrestrial,82,76,55,46,158,67.07317073170732,56.09756097560976
37835_terrestrial,470,133,318,287,603,67.65957446808511,61.06382978723405
37975_terrestrial,127,63,116,24,190,91.33858267716536,18.89763779527559
38147_terrestrial,818,360,498,511,1178,60.880195599022,62.469437652811735
38148_terrestrial,836,368,515,513,1204,61.602870813397125,61.36363636363637
38149_terrestrial,814,338,496,507,1152,60.93366093366094,62.285012285012286
38161_terrestrial,787,320,498,478,1107,63.27827191867853,60.736975857687426
38189_terrestrial,525,163,341,323,688,64.95238095238095,61.523809523809526
38195_terrestrial,470,133,318,287,603,67.65957446808511,61.06382978723405
38197_terrestrial,462,127,312,283,589,67.53246753246754,61.25541125541125
38198_terrestrial,444,109,298,272,553,67.11711711711712,61.261261261261254
38266_terrestrial,102,71,46,75,173,45.09803921568628,73.52941176470588
38335_terrestrial,122,62,112,24,184,91.80327868852459,19.672131147540984
38508_terrestrial,814,347,497,507,1161,61.056511056511056,62.285012285012286
38509_terrestrial,810,338,493,507,1148,60.864197530864196,62.59259259259259
38519_terrestrial,806,337,510,489,1143,63.27543424317618,60.66997518610422
38520_terrestrial,814,358,516,493,1172,63.39066339066339,60.56511056511057
38521_terrestrial,745,273,464,455,1018,62.281879194630875,61.07382550335571
38522_terrestrial,744,272,463,456,1016,62.23118279569893,61.29032258064516
38551_terrestrial,535,167,348,333,702,65.04672897196262,62.24299065420561
38560_terrestrial,454,122,312,275,576,68.72246696035242,60.57268722466961
38869_terrestrial,804,343,491,508,1147,61.06965174129353,63.18407960199005
38878_terrestrial,810,344,514,492,1154,63.456790123456784,60.74074074074074
38879_terrestrial,814,350,518,492,1164,63.63636363636363,60.44226044226044
38880_terrestrial,805,345,509,488,1150,63.22981366459627,60.62111801242236
38881_terrestrial,738,271,457,456,1009,61.92411924119241,61.78861788617886
38882_terrestrial,729,273,449,456,1002,61.59122085048011,62.55144032921811
38886_terrestrial,707,234,439,436,941,62.0933521923621,61.669024045261665
38887_terrestrial,707,234,439,436,941,62.0933521923621,61.669024045261665
38891_terrestrial,36,18,30,15,54,83.33333333333334,41.66666666666667
38920_terrestrial,456,122,314,275,578,68.85964912280701,60.30701754385965
38923_terrestrial,426,110,288,267,536,67.6056338028169,62.676056338028175
38924_terrestrial,433,111,295,267,544,68.12933025404158,61.662817551963045
39229_terrestrial,769,320,465,495,1089,60.46814044213264,64.36931079323797
39230_terrestrial,774,325,470,496,1099,60.72351421188631,64.08268733850129
39238_terrestrial,795,343,501,488,1138,63.0188679245283,61.38364779874214
39239_terrestrial,812,351,515,493,1163,63.42364532019704,60.71428571428571
39240_terrestrial,785,322,491,483,1107,62.54777070063694,61.52866242038216
39241_terrestrial,722,255,443,452,977,61.35734072022161,62.603878116343495
39242_terrestrial,715,252,439,449,967,61.39860139860139,62.7972027972028
39251_terrestrial,487,135,333,297,622,68.37782340862422,60.98562628336756
39350_terrestrial,200,193,138,75,393,69,37.5
39580_terrestrial,613,183,387,388,796,63.132137030995104,63.2952691680261
39590_terrestrial,770,320,466,496,1090,60.51948051948052,64.41558441558442
39598_terrestrial,778,319,484,479,1097,62.2107969151671,61.5681233933162
39599_terrestrial,790,329,496,482,1119,62.78481012658228,61.01265822784811
39602_terrestrial,631,221,405,390,852,64.18383518225039,61.806656101426306
39642_terrestrial,434,115,292,271,549,67.2811059907834,62.44239631336406
39710_terrestrial,185,178,131,61,363,70.8108108108108,32.972972972972975
39896_terrestrial,685,352,460,369,1037,67.15328467153284,53.86861313868613
39897_terrestrial,826,487,514,492,1313,62.227602905569015,59.56416464891041
39898_terrestrial,815,499,509,488,1314,62.45398773006134,59.87730061349693
39899_terrestrial,822,478,513,486,1300,62.40875912408759,59.12408759124088
39945_terrestrial,900,463,554,544,1363,61.55555555555555,60.44444444444444
39946_terrestrial,895,438,549,545,1333,61.340782122905026,60.893854748603346
39947_terrestrial,797,348,496,488,1145,62.23337515683814,61.22961104140528
39948_terrestrial,784,348,485,481,1132,61.86224489795919,61.35204081632652
39950_terrestrial,762,321,461,491,1083,60.498687664041995,64.43569553805774
39965_terrestrial,680,228,435,414,908,63.970588235294116,60.882352941176464
39966_terrestrial,675,225,431,413,900,63.85185185185185,61.18518518518519
39981_terrestrial,422,120,283,262,542,67.06161137440758,62.08530805687204
40070_terrestrial,177,167,125,61,344,70.62146892655367,34.463276836158194
40071_terrestrial,66,73,25,59,139,37.878787878787875,89.39393939393939
40254_terrestrial,754,391,462,456,1145,61.273209549071616,60.47745358090185
40255_terrestrial,806,454,498,483,1260,61.78660049627791,59.92555831265509
40256_terrestrial,817,496,509,477,1313,62.30110159118727,58.3843329253366
40257_terrestrial,816,496,500,494,1312,61.274509803921575,60.5392156862745
40258_terrestrial,226,228,77,193,454,34.070796460176986,85.39823008849558
40259_terrestrial,222,229,73,194,451,32.88288288288289,87.38738738738738
40260_terrestrial,204,214,64,179,418,31.372549019607842,87.74509803921569
40261_terrestrial,173,205,40,165,378,23.121387283236995,95.37572254335261
40262_terrestrial,159,167,34,150,326,21.38364779874214,94.33962264150944
40263_terrestrial,140,150,33,131,290,23.57142857142857,93.57142857142857
40264_terrestrial,119,129,28,111,248,23.52941176470588,93.27731092436974
40265_terrestrial,115,114,29,107,229,25.217391304347824,93.04347826086956
40266_terrestrial,122,114,30,113,236,24.59016393442623,92.62295081967213
40267_terrestrial,137,117,40,125,254,29.1970802919708,91.24087591240875
40268_terrestrial,141,124,41,127,265,29.078014184397162,90.0709219858156
40305_terrestrial,898,435,551,545,1333,61.358574610244986,60.69042316258352
40306_terrestrial,905,460,557,549,1365,61.546961325966855,60.66298342541436
40307_terrestrial,899,463,553,547,1362,61.512791991101224,60.84538375973304
40308_terrestrial,787,359,488,481,1146,62.00762388818297,61.11817026683609
40309_terrestrial,777,342,479,478,1119,61.64736164736164,61.518661518661524
40315_terrestrial,104,36,94,11,140,90.38461538461539,10.576923076923077
40430_terrestrial,177,144,126,61,321,71.1864406779661,34.463276836158194
40431_terrestrial,54,67,21,52,121,38.88888888888889,96.29629629629629
40614_terrestrial,789,433,484,469,1222,61.34347275031685,59.442332065906214
40615_terrestrial,820,459,504,485,1279,61.46341463414634,59.14634146341463
40616_terrestrial,207,211,62,177,418,29.951690821256037,85.5072463768116
40617_terrestrial,199,205,56,177,404,28.14070351758794,88.94472361809045
40618_terrestrial,180,210,41,170,390,22.77777777777778,94.44444444444444
40619_terrestrial,177,220,42,165,397,23.728813559322035,93.22033898305084
40620_terrestrial,175,222,40,162,397,22.857142857142858,92.57142857142857
40621_terrestrial,170,213,36,160,383,21.176470588235293,94.11764705882352
40622_terrestrial,151,183,31,143,334,20.52980132450331,94.70198675496688
40623_terrestrial,138,166,31,130,304,22.463768115942027,94.20289855072464
40624_terrestrial,127,144,28,119,271,22.04724409448819,93.7007874015748
40625_terrestrial,117,125,25,109,242,21.367521367521366,93.16239316239316
40626_terrestrial,116,127,25,107,243,21.551724137931032,92.24137931034483
40627_terrestrial,116,127,27,107,243,23.275862068965516,92.24137931034483
40628_terrestrial,119,131,27,110,250,22.689075630252102,92.43697478991596
40629_terrestrial,124,137,28,115,261,22.58064516129032,92.74193548387096
40667_terrestrial,900,465,552,549,1365,61.33333333333333,61
40668_terrestrial,895,454,549,546,1349,61.340782122905026,61.00558659217877
40790_terrestrial,179,166,128,64,345,71.50837988826815,35.754189944134076
40791_terrestrial,56,59,24,51,115,42.857142857142854,91.07142857142857
40792_terrestrial,67,85,29,53,152,43.28358208955223,79.1044776119403
40974_terrestrial,761,430,459,462,1191,60.31537450722734,60.7095926412615
40975_terrestrial,214,196,67,187,410,31.308411214953267,87.38317757009347
40976_terrestrial,184,200,47,165,384,25.543478260869566,89.67391304347827
40977_terrestrial,160,197,34,150,357,21.25,93.75
40978_terrestrial,161,204,35,152,365,21.73913043478261,94.40993788819875
40979_terrestrial,170,208,40,157,378,23.52941176470588,92.3529411764706
40980_terrestrial,175,223,41,162,398,23.42857142857143,92.57142857142857
40981_terrestrial,166,198,35,155,364,21.084337349397593,93.37349397590361
40982_terrestrial,152,180,31,144,332,20.394736842105264,94.73684210526315
40983_terrestrial,140,159,29,132,299,20.714285714285715,94.28571428571428
40984_terrestrial,134,146,27,126,280,20.149253731343283,94.02985074626866
40985_terrestrial,125,146,26,116,271,20.8,92.80000000000001
40986_terrestrial,119,143,24,110,262,20.168067226890756,92.43697478991596
40987_terrestrial,117,134,23,108,251,19.65811965811966,92.3076923076923
40988_terrestrial,115,139,22,106,254,19.130434782608695,92.17391304347827
40989_terrestrial,126,151,24,117,277,19.047619047619047,92.85714285714286
40990_terrestrial,134,152,25,125,286,18.65671641791045,93.28358208955224
40991_terrestrial,151,161,31,142,312,20.52980132450331,94.03973509933775
41092_terrestrial,265,106,198,140,371,74.71698113207546,52.83018867924528
41150_terrestrial,181,158,132,64,339,72.92817679558011,35.35911602209944
41151_terrestrial,62,60,28,53,122,45.16129032258064,85.48387096774194
41334_terrestrial,701,429,420,409,1130,59.91440798858774,58.345221112696144
41335_terrestrial,206,199,68,177,405,33.00970873786408,85.92233009708737
41336_terrestrial,162,173,36,151,335,22.22222222222222,93.20987654320987
41337_terrestrial,157,164,31,148,321,19.745222929936308,94.26751592356688
41338_terrestrial,158,160,33,149,318,20.88607594936709,94.30379746835443
41339_terrestrial,163,176,33,153,339,20.245398773006134,93.86503067484662
41340_terrestrial,169,179,38,158,348,22.485207100591715,93.49112426035504
41341_terrestrial,161,180,33,151,341,20.496894409937887,93.7888198757764
41342_terrestrial,148,168,28,140,316,18.91891891891892,94.5945945945946
41343_terrestrial,135,161,26,127,296,19.25925925925926,94.07407407407408
41344_terrestrial,130,151,26,121,281,20,93.07692307692308
41345_terrestrial,124,149,24,115,273,19.35483870967742,92.74193548387096
41346_terrestrial,116,148,24,107,264,20.689655172413794,92.24137931034483
41347_terrestrial,120,144,24,111,264,20,92.5
41348_terrestrial,119,150,21,110,269,17.647058823529413,92.43697478991596
41349_terrestrial,125,157,22,116,282,17.599999999999998,92.80000000000001
41350_terrestrial,132,157,24,121,289,18.181818181818183,91.66666666666666
41351_terrestrial,145,165,27,134,310,18.620689655172416,92.41379310344827
41352_terrestrial,158,181,31,148,339,19.62025316455696,93.67088607594937
41374_terrestrial,786,464,456,469,1250,58.01526717557252,59.66921119592875
41510_terrestrial,183,161,125,75,344,68.30601092896174,40.98360655737705
41511_terrestrial,71,62,30,61,133,42.25352112676056,85.91549295774648
41693_terrestrial,549,315,343,294,864,62.47723132969034,53.551912568306015
41694_terrestrial,679,444,405,393,1123,59.64653902798233,57.87923416789397
41695_terrestrial,669,435,393,389,1104,58.744394618834086,58.14648729446936
41696_terrestrial,177,169,42,163,346,23.728813559322035,92.09039548022598
41697_terrestrial,168,143,35,159,311,20.833333333333336,94.64285714285714
41698_terrestrial,163,148,34,154,311,20.858895705521473,94.47852760736197
41699_terrestrial,161,157,36,152,318,22.36024844720497,94.40993788819875
41700_terrestrial,158,167,32,149,325,20.253164556962027,94.30379746835443
41701_terrestrial,153,178,28,144,331,18.30065359477124,94.11764705882352
41702_terrestrial,144,171,26,135,315,18.055555555555554,93.75
41703_terrestrial,133,158,26,124,291,19.548872180451127,93.23308270676691
41704_terrestrial,126,152,26,117,278,20.634920634920633,92.85714285714286
41705_terrestrial,123,149,24,114,272,19.51219512195122,92.6829268292683
41706_terrestrial,120,151,23,111,271,19.166666666666668,92.5
41707_terrestrial,118,147,24,109,265,20.33898305084746,92.37288135593221
41708_terrestrial,115,141,21,106,256,18.26086956521739,92.17391304347827
41709_terrestrial,124,153,23,115,277,18.548387096774192,92.74193548387096
41710_terrestrial,126,164,21,115,290,16.666666666666664,91.26984126984127
41711_terrestrial,136,169,26,127,305,19.11764705882353,93.38235294117648
41712_terrestrial,145,170,27,136,315,18.620689655172416,93.79310344827586
41713_terrestrial,159,172,31,149,331,19.49685534591195,93.71069182389937
41870_terrestrial,180,182,117,82,362,65,45.55555555555556
41871_terrestrial,74,74,31,64,148,41.891891891891895,86.48648648648648
42054_terrestrial,672,433,401,383,1105,59.672619047619044,56.99404761904761
42055_terrestrial,672,434,394,390,1106,58.63095238095239,58.03571428571429
42056_terrestrial,186,159,48,170,345,25.806451612903224,91.39784946236558
42057_terrestrial,166,143,37,156,309,22.289156626506024,93.97590361445783
42058_terrestrial,162,146,35,152,308,21.604938271604937,93.82716049382715
42059_terrestrial,160,144,33,150,304,20.625,93.75
42060_terrestrial,157,154,30,148,311,19.10828025477707,94.26751592356688
42061_terrestrial,151,164,27,142,315,17.880794701986755,94.03973509933775
42062_terrestrial,138,161,26,129,299,18.84057971014493,93.47826086956522
42063_terrestrial,133,156,24,124,289,18.045112781954884,93.23308270676691
42064_terrestrial,128,153,25,119,281,19.53125,92.96875
42065_terrestrial,119,150,23,110,269,19.327731092436977,92.43697478991596
42066_terrestrial,111,149,21,102,260,18.91891891891892,91.8918918918919
42067_terrestrial,110,147,22,101,257,20,91.81818181818183
42068_terrestrial,111,146,22,102,257,19.81981981981982,91.8918918918919
42069_terrestrial,115,144,21,106,259,18.26086956521739,92.17391304347827
42070_terrestrial,124,150,24,113,274,19.35483870967742,91.12903225806451
42071_terrestrial,132,155,25,121,287,18.939393939393938,91.66666666666666
42072_terrestrial,134,152,23,125,286,17.16417910447761,93.28358208955224
42073_terrestrial,144,159,25,135,303,17.36111111111111,93.75
42074_terrestrial,154,168,29,144,322,18.83116883116883,93.5064935064935
42075_terrestrial,159,175,29,149,334,18.238993710691823,93.71069182389937
42191_terrestrial,121,73,94,46,194,77.68595041322314,38.01652892561984
42229_terrestrial,175,191,116,78,366,66.28571428571428,44.57142857142857
42230_terrestrial,190,194,124,88,384,65.26315789473685,46.31578947368421
42414_terrestrial,586,374,341,339,960,58.19112627986348,57.84982935153583
42415_terrestrial,598,414,341,350,1012,57.02341137123745,58.52842809364549
42416_terrestrial,199,175,53,182,374,26.633165829145728,91.4572864321608
42417_terrestrial,177,152,42,164,329,23.728813559322035,92.65536723163842
42418_terrestrial,169,150,40,158,319,23.668639053254438,93.49112426035504
42419_terrestrial,158,151,36,148,309,22.78481012658228,93.67088607594937
42420_terrestrial,146,153,29,137,299,19.863013698630137,93.83561643835617
42421_terrestrial,140,166,28,131,306,20,93.57142857142857
42422_terrestrial,135,164,26,126,299,19.25925925925926,93.33333333333333
42423_terrestrial,129,168,26,120,297,20.155038759689923,93.02325581395348
42424_terrestrial,127,160,24,118,287,18.89763779527559,92.91338582677166
42425_terrestrial,118,155,23,109,273,19.491525423728813,92.37288135593221
42426_terrestrial,114,146,21,105,260,18.421052631578945,92.10526315789474
42427_terrestrial,109,146,20,100,255,18.34862385321101,91.74311926605505
42428_terrestrial,110,132,20,101,242,18.181818181818183,91.81818181818183
42429_terrestrial,111,134,18,102,245,16.216216216216218,91.8918918918919
42430_terrestrial,114,136,20,103,250,17.543859649122805,90.35087719298247
42431_terrestrial,118,139,19,109,257,16.101694915254235,92.37288135593221
42432_terrestrial,126,136,20,117,262,15.873015873015872,92.85714285714286
42433_terrestrial,137,140,23,128,277,16.78832116788321,93.43065693430657
42434_terrestrial,146,156,28,136,302,19.17808219178082,93.15068493150685
42435_terrestrial,158,164,31,148,322,19.62025316455696,93.67088607594937
42436_terrestrial,160,161,32,150,321,20,93.75
42589_terrestrial,188,214,122,89,402,64.8936170212766,47.340425531914896
42590_terrestrial,103,115,42,87,218,40.77669902912621,84.46601941747572
42775_terrestrial,568,387,327,327,955,57.570422535211264,57.570422535211264
42776_terrestrial,198,191,56,178,389,28.28282828282828,89.8989898989899
42777_terrestrial,179,172,41,167,351,22.905027932960895,93.29608938547486
42778_terrestrial,176,159,41,164,335,23.295454545454543,93.18181818181817
42779_terrestrial,157,161,33,148,318,21.019108280254777,94.26751592356688
42780_terrestrial,142,158,26,133,300,18.30985915492958,93.66197183098592
42781_terrestrial,142,168,28,131,310,19.718309859154928,92.25352112676056
42782_terrestrial,139,170,29,128,309,20.863309352517987,92.08633093525181
42783_terrestrial,133,166,28,122,299,21.052631578947366,91.72932330827066
42784_terrestrial,129,166,26,118,295,20.155038759689923,91.47286821705426
42785_terrestrial,116,158,24,105,274,20.689655172413794,90.51724137931035
42786_terrestrial,110,150,18,101,260,16.363636363636363,91.81818181818183
42787_terrestrial,101,131,16,92,232,15.841584158415841,91.0891089108911
42788_terrestrial,101,120,16,92,221,15.841584158415841,91.0891089108911
42789_terrestrial,104,123,15,95,227,14.423076923076922,91.34615384615384
42790_terrestrial,107,123,13,100,230,12.149532710280374,93.45794392523365
42791_terrestrial,109,117,14,102,226,12.844036697247708,93.57798165137615
42792_terrestrial,115,124,17,106,239,14.782608695652174,92.17391304347827
42793_terrestrial,120,120,17,111,240,14.166666666666666,92.5
42794_terrestrial,134,134,23,125,268,17.16417910447761,93.28358208955224
42795_terrestrial,158,144,30,148,302,18.9873417721519,93.67088607594937
42796_terrestrial,166,150,36,155,316,21.686746987951807,93.37349397590361
42797_terrestrial,170,147,43,158,317,25.294117647058822,92.94117647058823
42949_terrestrial,198,222,124,96,420,62.62626262626263,48.484848484848484
43135_terrestrial,574,382,332,329,956,57.8397212543554,57.3170731707317
43136_terrestrial,217,205,68,189,422,31.336405529953915,87.09677419354838
43137_terrestrial,189,191,45,175,380,23.809523809523807,92.5925925925926
43138_terrestrial,180,164,40,169,344,22.22222222222222,93.88888888888889
43139_terrestrial,165,160,33,156,325,20,94.54545454545455
43140_terrestrial,151,168,27,142,319,17.880794701986755,94.03973509933775
43141_terrestrial,148,178,28,136,326,18.91891891891892,91.8918918918919
43142_terrestrial,146,175,33,134,321,22.602739726027394,91.78082191780823
43143_terrestrial,140,165,29,129,305,20.714285714285715,92.14285714285714
43144_terrestrial,127,165,25,116,292,19.68503937007874,91.33858267716536
43145_terrestrial,119,152,24,108,271,20.168067226890756,90.75630252100841
43146_terrestrial,110,135,20,99,245,18.181818181818183,90
43147_terrestrial,96,125,16,87,221,16.666666666666664,90.625
43148_terrestrial,101,118,18,90,219,17.82178217821782,89.10891089108911
43149_terrestrial,102,118,14,93,220,13.725490196078432,91.17647058823529
43150_terrestrial,106,117,14,97,223,13.20754716981132,91.50943396226415
43151_terrestrial,109,119,14,100,228,12.844036697247708,91.74311926605505
43152_terrestrial,112,124,15,103,236,13.392857142857142,91.96428571428571
43153_terrestrial,117,122,18,106,239,15.384615384615385,90.5982905982906
43154_terrestrial,124,121,21,115,245,16.93548387096774,92.74193548387096
43155_terrestrial,146,144,28,135,290,19.17808219178082,92.46575342465754
43156_terrestrial,169,143,39,156,312,23.076923076923077,92.3076923076923
43157_terrestrial,179,140,45,164,319,25.139664804469277,91.62011173184358
43158_terrestrial,182,149,44,167,331,24.175824175824175,91.75824175824175
43188_terrestrial,232,123,170,108,355,73.27586206896551,46.55172413793103
43495_terrestrial,490,339,288,265,829,58.77551020408164,54.08163265306123
43496_terrestrial,546,407,321,306,953,58.791208791208796,56.043956043956044
43497_terrestrial,209,190,62,194,399,29.665071770334926,92.82296650717703
43498_terrestrial,182,162,44,169,344,24.175824175824175,92.85714285714286
43499_terrestrial,173,164,38,163,337,21.965317919075144,94.21965317919076
43500_terrestrial,162,171,32,153,333,19.753086419753085,94.44444444444444
43501_terrestrial,160,176,33,147,336,20.625,91.875
43502_terrestrial,147,176,32,134,323,21.768707482993197,91.15646258503402
43503_terrestrial,138,174,31,125,312,22.463768115942027,90.57971014492753
43504_terrestrial,127,168,26,116,295,20.47244094488189,91.33858267716536
43505_terrestrial,116,148,23,105,264,19.82758620689655,90.51724137931035
43506_terrestrial,106,122,20,95,228,18.867924528301888,89.62264150943396
43507_terrestrial,96,109,14,87,205,14.583333333333334,90.625
43508_terrestrial,88,101,12,79,189,13.636363636363635,89.77272727272727
43509_terrestrial,96,101,16,84,197,16.666666666666664,87.5
43510_terrestrial,105,108,18,93,213,17.142857142857142,88.57142857142857
43511_terrestrial,117,125,22,104,242,18.803418803418804,88.88888888888889
43512_terrestrial,119,138,21,109,257,17.647058823529413,91.59663865546219
43513_terrestrial,134,143,24,124,277,17.91044776119403,92.53731343283582
43514_terrestrial,139,141,26,127,280,18.705035971223023,91.36690647482014
43515_terrestrial,148,152,31,136,300,20.945945945945947,91.8918918918919
43516_terrestrial,175,162,43,160,337,24.571428571428573,91.42857142857143
43517_terrestrial,185,169,48,168,354,25.945945945945947,90.81081081081082
43518_terrestrial,198,167,51,179,365,25.757575757575758,90.40404040404042
43519_terrestrial,198,178,50,181,376,25.252525252525253,91.41414141414141
43856_terrestrial,545,445,316,310,990,57.98165137614679,56.88073394495413
43857_terrestrial,233,213,72,208,446,30.90128755364807,89.27038626609442
43858_terrestrial,187,165,44,173,352,23.52941176470588,92.51336898395722
43859_terrestrial,176,166,39,163,342,22.15909090909091,92.61363636363636
43860_terrestrial,166,170,36,157,336,21.686746987951807,94.57831325301204
43861_terrestrial,158,174,33,147,332,20.88607594936709,93.0379746835443
43862_terrestrial,150,171,31,139,321,20.666666666666668,92.66666666666666
43863_terrestrial,140,162,31,127,302,22.142857142857142,90.71428571428571
43864_terrestrial,129,153,27,117,282,20.930232558139537,90.69767441860465
43865_terrestrial,128,132,28,115,260,21.875,89.84375
43866_terrestrial,128,110,29,113,238,22.65625,88.28125
43867_terrestrial,137,106,38,117,243,27.73722627737226,85.40145985401459
43868_terrestrial,128,101,32,109,229,25,85.15625
43869_terrestrial,274,312,153,126,586,55.839416058394164,45.98540145985402
43870_terrestrial,266,313,152,117,579,57.14285714285714,43.984962406015036
43871_terrestrial,277,323,153,129,600,55.23465703971119,46.57039711191336
43872_terrestrial,289,347,158,142,636,54.67128027681662,49.13494809688581
43873_terrestrial,329,367,170,179,696,51.671732522796354,54.40729483282675
43874_terrestrial,183,163,53,158,346,28.96174863387978,86.33879781420765
43875_terrestrial,192,171,51,173,363,26.5625,90.10416666666666
43876_terrestrial,190,174,45,172,364,23.684210526315788,90.52631578947368
43877_terrestrial,194,182,49,176,376,25.257731958762886,90.72164948453609
43878_terrestrial,220,199,58,199,419,26.36363636363636,90.45454545454545
43879_terrestrial,224,186,57,205,410,25.44642857142857,91.51785714285714
43880_terrestrial,203,178,48,185,381,23.645320197044335,91.13300492610837
44216_terrestrial,531,453,313,301,984,58.94538606403014,56.685499058380415
44217_terrestrial,226,216,76,200,442,33.6283185840708,88.49557522123894
44218_terrestrial,184,182,47,169,366,25.543478260869566,91.84782608695652
44219_terrestrial,172,163,40,158,335,23.25581395348837,91.86046511627907
44220_terrestrial,173,175,40,159,348,23.121387283236995,91.90751445086705
44221_terrestrial,170,169,45,158,339,26.47058823529412,92.94117647058823
44222_terrestrial,163,166,43,150,329,26.380368098159508,92.02453987730061
44223_terrestrial,161,160,39,148,321,24.22360248447205,91.92546583850931
44224_terrestrial,154,150,34,143,304,22.07792207792208,92.85714285714286
44225_terrestrial,320,361,167,169,681,52.1875,52.81249999999999
44226_terrestrial,292,312,155,144,604,53.082191780821915,49.31506849315068
44227_terrestrial,300,324,166,147,624,55.333333333333336,49
44228_terrestrial,292,317,164,139,609,56.16438356164384,47.6027397260274
44229_terrestrial,259,296,147,115,555,56.75675675675676,44.4015444015444
44233_terrestrial,306,323,165,157,629,53.92156862745098,51.307189542483655
44234_terrestrial,347,365,183,191,712,52.73775216138329,55.04322766570605
44235_terrestrial,382,411,189,219,793,49.47643979057592,57.32984293193717
44236_terrestrial,209,180,54,185,389,25.837320574162682,88.51674641148325
44237_terrestrial,220,178,63,195,398,28.636363636363637,88.63636363636364
44241_terrestrial,212,170,53,191,382,25,90.09433962264151
44242_terrestrial,212,166,56,191,378,26.41509433962264,90.09433962264151
44243_terrestrial,211,165,55,188,376,26.066350710900476,89.0995260663507
44382_terrestrial,68,68,60,12,136,88.23529411764706,17.647058823529413
44575_terrestrial,375,360,211,189,735,56.266666666666666,50.4
44576_terrestrial,432,413,248,231,845,57.407407407407405,53.47222222222222
44577_terrestrial,205,193,63,182,398,30.73170731707317,88.78048780487805
44578_terrestrial,187,173,47,171,360,25.13368983957219,91.44385026737967
44579_terrestrial,188,180,49,169,368,26.063829787234045,89.8936170212766
44580_terrestrial,369,409,187,211,778,50.67750677506775,57.18157181571816
44581_terrestrial,366,406,189,206,772,51.63934426229508,56.284153005464475
44582_terrestrial,361,393,195,199,754,54.016620498614955,55.124653739612185
44583_terrestrial,352,395,191,192,747,54.26136363636363,54.54545454545454
44584_terrestrial,349,382,186,190,731,53.29512893982808,54.44126074498568
44585_terrestrial,314,326,170,161,640,54.14012738853503,51.27388535031847
44595_terrestrial,366,383,183,208,749,50,56.830601092896174
44596_terrestrial,387,402,190,223,789,49.09560723514212,57.622739018087856
44597_terrestrial,403,424,194,238,827,48.13895781637717,59.05707196029777
44603_terrestrial,234,177,61,211,411,26.06837606837607,90.17094017094017
44604_terrestrial,234,160,61,210,394,26.06837606837607,89.74358974358975
44605_terrestrial,229,165,59,204,394,25.76419213973799,89.08296943231441
44935_terrestrial,353,352,196,181,705,55.524079320113316,51.27478753541076
44936_terrestrial,382,395,215,201,777,56.282722513089,52.617801047120416
44937_terrestrial,369,405,193,209,774,52.30352303523035,56.639566395663955
44938_terrestrial,376,414,195,217,790,51.86170212765957,57.71276595744681
44939_terrestrial,381,426,200,216,807,52.493438320209975,56.69291338582677
44940_terrestrial,366,398,191,202,764,52.18579234972678,55.19125683060109
44956_terrestrial,385,388,196,211,773,50.90909090909091,54.8051948051948
45297_terrestrial,352,367,190,191,719,53.97727272727273,54.26136363636363
45298_terrestrial,369,377,201,202,746,54.47154471544715,54.74254742547425
45299_terrestrial,359,360,194,198,719,54.038997214484674,55.15320334261838
45677_terrestrial,321,335,164,166,656,51.09034267912772,51.71339563862928
45678_terrestrial,329,333,172,168,662,52.27963525835866,51.06382978723404
46559_terrestrial,156,178,115,65,334,73.71794871794873,41.66666666666667
47266_terrestrial,145,192,89,77,337,61.37931034482759,53.103448275862064
47626_terrestrial,145,186,90,79,331,62.06896551724138,54.48275862068965
47627_terrestrial,145,193,87,77,338,60,53.103448275862064
47637_terrestrial,193,223,123,98,416,63.730569948186535,50.77720207253886
47884_terrestrial,127,162,109,39,289,85.8267716535433,30.708661417322837
47986_terrestrial,142,204,85,75,346,59.859154929577464,52.816901408450704
47987_terrestrial,154,222,91,82,376,59.09090909090909,53.246753246753244
48244_terrestrial,129,163,111,40,292,86.04651162790698,31.007751937984494
48345_terrestrial,92,123,65,37,215,70.65217391304348,40.21739130434783
48346_terrestrial,109,143,70,48,252,64.22018348623854,44.03669724770643
48347_terrestrial,127,192,80,61,319,62.99212598425197,48.031496062992126
48348_terrestrial,138,208,87,62,346,63.04347826086957,44.927536231884055
48355_terrestrial,170,181,107,83,351,62.94117647058823,48.8235294117647
48705_terrestrial,109,153,67,49,262,61.46788990825688,44.95412844036697
48706_terrestrial,116,162,71,52,278,61.206896551724135,44.827586206896555
48707_terrestrial,127,202,80,61,329,62.99212598425197,48.031496062992126
48708_terrestrial,134,206,84,61,340,62.68656716417911,45.52238805970149
48712_terrestrial,83,105,38,64,188,45.78313253012048,77.10843373493977
48713_terrestrial,164,209,103,79,373,62.80487804878049,48.170731707317074
48714_terrestrial,161,186,102,78,347,63.35403726708074,48.4472049689441
48715_terrestrial,92,84,45,68,176,48.91304347826087,73.91304347826086
49065_terrestrial,119,181,74,52,300,62.18487394957983,43.69747899159664
49066_terrestrial,123,172,77,55,295,62.601626016260155,44.71544715447154
49067_terrestrial,131,187,82,58,318,62.59541984732825,44.274809160305345
49068_terrestrial,82,140,40,60,222,48.78048780487805,73.17073170731707
49069_terrestrial,89,158,37,68,247,41.57303370786517,76.40449438202246
49070_terrestrial,83,123,34,65,206,40.963855421686745,78.3132530120482
49071_terrestrial,76,109,32,57,185,42.10526315789473,75
49072_terrestrial,83,103,36,63,186,43.373493975903614,75.90361445783132
49073_terrestrial,158,175,96,77,333,60.75949367088608,48.734177215189874
49074_terrestrial,148,149,92,76,297,62.16216216216216,51.35135135135135
49178_terrestrial,57,79,52,12,136,91.22807017543859,21.052631578947366
49192_terrestrial,55,80,49,12,135,89.0909090909091,21.818181818181817
49425_terrestrial,96,123,61,45,219,63.541666666666664,46.875
49426_terrestrial,117,165,74,52,282,63.24786324786324,44.44444444444444
49427_terrestrial,130,170,79,59,300,60.76923076923077,45.38461538461539
49428_terrestrial,83,131,38,62,214,45.78313253012048,74.69879518072288
49429_terrestrial,88,146,37,67,234,42.04545454545455,76.13636363636364
49430_terrestrial,80,110,33,63,190,41.25,78.75
49431_terrestrial,76,95,32,60,171,42.10526315789473,78.94736842105263
49432_terrestrial,74,98,31,58,172,41.891891891891895,78.37837837837837
49433_terrestrial,86,90,39,66,176,45.348837209302324,76.74418604651163
49434_terrestrial,154,158,95,77,312,61.68831168831169,50
49435_terrestrial,146,168,90,76,314,61.64383561643836,52.054794520547944
49785_terrestrial,103,141,66,45,244,64.07766990291263,43.689320388349515
49786_terrestrial,117,163,74,52,280,63.24786324786324,44.44444444444444
49787_terrestrial,118,162,70,56,280,59.32203389830508,47.45762711864407
49788_terrestrial,83,133,39,62,216,46.98795180722892,74.69879518072288
49789_terrestrial,87,124,37,66,211,42.5287356321839,75.86206896551724
49790_terrestrial,75,99,32,58,174,42.66666666666667,77.33333333333333
49791_terrestrial,77,94,33,60,171,42.857142857142854,77.92207792207793
49792_terrestrial,79,86,35,61,165,44.303797468354425,77.21518987341773
49793_terrestrial,145,168,88,75,313,60.689655172413794,51.724137931034484
49794_terrestrial,146,180,88,76,326,60.273972602739725,52.054794520547944
49795_terrestrial,140,142,86,74,282,61.42857142857143,52.85714285714286
49929_terrestrial,56,94,49,13,150,87.5,23.214285714285715
49930_terrestrial,54,94,49,13,148,90.74074074074075,24.074074074074073
50145_terrestrial,102,138,65,46,240,63.725490196078425,45.09803921568628
50146_terrestrial,113,171,70,53,284,61.94690265486725,46.902654867256636
50147_terrestrial,127,177,76,61,304,59.84251968503938,48.031496062992126
50148_terrestrial,82,125,37,61,207,45.1219512195122,74.39024390243902
50149_terrestrial,83,115,35,64,198,42.168674698795186,77.10843373493977
50150_terrestrial,73,100,31,57,173,42.465753424657535,78.08219178082192
50151_terrestrial,83,97,38,63,180,45.78313253012048,75.90361445783132
50152_terrestrial,138,171,80,76,309,57.971014492753625,55.072463768115945
50153_terrestrial,146,155,89,77,301,60.95890410958904,52.73972602739726
50289_terrestrial,54,94,49,13,148,90.74074074074075,24.074074074074073
50290_terrestrial,54,94,49,13,148,90.74074074074075,24.074074074074073
50291_terrestrial,54,94,49,13,148,90.74074074074075,24.074074074074073
50505_terrestrial,99,142,63,44,241,63.63636363636363,44.44444444444444
50506_terrestrial,116,163,71,54,279,61.206896551724135,46.55172413793103
50507_terrestrial,132,181,77,66,313,58.333333333333336,50
50508_terrestrial,84,124,39,64,208,46.42857142857143,76.19047619047619
50509_terrestrial,84,112,35,65,196,41.66666666666667,77.38095238095238
50510_terrestrial,73,97,31,56,170,42.465753424657535,76.71232876712328
50511_terrestrial,142,164,84,75,306,59.154929577464785,52.816901408450704
50512_terrestrial,144,175,87,74,319,60.416666666666664,51.388888888888886
50513_terrestrial,82,60,40,64,142,48.78048780487805,78.04878048780488
50746_terrestrial,71,115,57,21,186,80.28169014084507,29.577464788732392
50747_terrestrial,73,116,59,21,189,80.82191780821918,28.767123287671232
50865_terrestrial,102,137,64,49,239,62.745098039215684,48.03921568627451
50866_terrestrial,111,162,67,53,273,60.36036036036037,47.74774774774775
50867_terrestrial,135,191,80,67,326,59.25925925925925,49.629629629629626
50868_terrestrial,136,207,81,71,343,59.55882352941176,52.20588235294118
50869_terrestrial,89,119,40,68,208,44.9438202247191,76.40449438202246
50870_terrestrial,80,104,34,62,184,42.5,77.5
50871_terrestrial,139,171,82,74,310,58.992805755395686,53.23741007194245
50872_terrestrial,130,137,75,71,267,57.692307692307686,54.61538461538461
50879_terrestrial,85,99,62,39,184,72.94117647058823,45.88235294117647
50880_terrestrial,92,102,66,40,194,71.73913043478261,43.47826086956522
50881_terrestrial,96,108,69,43,204,71.875,44.79166666666667
50882_terrestrial,92,103,66,41,195,71.73913043478261,44.565217391304344
50883_terrestrial,91,100,65,40,191,71.42857142857143,43.956043956043956
51225_terrestrial,85,104,49,48,189,57.647058823529406,56.470588235294116
51226_terrestrial,104,152,64,51,256,61.53846153846154,49.03846153846153
51227_terrestrial,117,162,67,57,279,57.26495726495726,48.717948717948715
51228_terrestrial,136,198,80,70,334,58.82352941176471,51.470588235294116
51229_terrestrial,144,200,82,79,344,56.94444444444444,54.861111111111114
51230_terrestrial,144,193,79,80,337,54.861111111111114,55.55555555555556
51231_terrestrial,145,192,84,77,337,57.931034482758626,53.103448275862064
51232_terrestrial,143,174,83,74,317,58.04195804195804,51.74825174825175
51240_terrestrial,93,99,67,40,192,72.04301075268818,43.01075268817204
51241_terrestrial,91,101,64,41,192,70.32967032967034,45.05494505494506
51242_terrestrial,93,105,67,40,198,72.04301075268818,43.01075268817204
51374_terrestrial,40,70,35,12,110,87.5,30
51470_terrestrial,76,119,65,23,195,85.52631578947368,30.263157894736842
51586_terrestrial,101,111,61,51,212,60.396039603960396,50.495049504950494
51587_terrestrial,113,155,65,57,268,57.52212389380531,50.442477876106196
51588_terrestrial,119,162,66,61,281,55.46218487394958,51.26050420168067
51589_terrestrial,132,194,76,69,326,57.57575757575758,52.27272727272727
51590_terrestrial,143,195,79,79,338,55.24475524475524,55.24475524475524
51591_terrestrial,128,169,73,73,297,57.03125,57.03125
51592_terrestrial,132,159,78,72,291,59.09090909090909,54.54545454545454
51593_terrestrial,122,138,73,64,260,59.83606557377049,52.459016393442624
51623_terrestrial,49,77,42,15,126,85.71428571428571,30.612244897959183
51734_terrestrial,42,70,35,12,112,83.33333333333334,28.57142857142857
51947_terrestrial,53,59,23,48,112,43.39622641509434,90.56603773584906
51948_terrestrial,100,136,58,53,236,57.99999999999999,53
51949_terrestrial,111,157,65,54,268,58.55855855855856,48.64864864864865
51950_terrestrial,123,169,70,65,292,56.91056910569105,52.84552845528455
51951_terrestrial,124,156,70,67,280,56.451612903225815,54.03225806451613
51952_terrestrial,133,165,75,72,298,56.390977443609025,54.13533834586466
51953_terrestrial,136,155,80,72,291,58.82352941176471,52.94117647058824
51954_terrestrial,127,149,74,66,276,58.26771653543307,51.96850393700787
51955_terrestrial,117,143,72,59,260,61.53846153846154,50.427350427350426
51956_terrestrial,100,127,66,48,227,66,48
51957_terrestrial,94,121,63,47,215,67.02127659574468,50
51982_terrestrial,47,76,40,15,123,85.1063829787234,31.914893617021278
51983_terrestrial,49,76,42,15,125,85.71428571428571,30.612244897959183
51984_terrestrial,47,74,40,14,121,85.1063829787234,29.78723404255319
51985_terrestrial,46,74,39,14,120,84.78260869565217,30.434782608695656
52179_terrestrial,70,88,60,23,158,85.71428571428571,32.857142857142854
52310_terrestrial,102,134,61,52,236,59.80392156862745,50.98039215686274
52311_terrestrial,108,127,64,55,235,59.25925925925925,50.92592592592593
52312_terrestrial,111,147,67,57,258,60.36036036036037,51.35135135135135
52313_terrestrial,107,142,67,57,249,62.616822429906534,53.271028037383175
52314_terrestrial,119,134,72,62,253,60.50420168067227,52.10084033613446
53434_terrestrial,35,57,28,11,92,80,31.428571428571427
54135_terrestrial,35,62,26,13,97,74.28571428571429,37.142857142857146
54482_terrestrial,36,59,26,15,95,72.22222222222221,41.66666666666667
54483_terrestrial,37,61,27,15,98,72.97297297297297,40.54054054054054
54485_terrestrial,38,59,28,15,97,73.68421052631578,39.473684210526315
54486_terrestrial,38,63,28,15,101,73.68421052631578,39.473684210526315
54838_terrestrial,36,55,27,14,91,75,38.88888888888889
54839_terrestrial,37,59,27,15,96,72.97297297297297,40.54054054054054
54840_terrestrial,37,60,27,15,97,72.97297297297297,40.54054054054054
54841_terrestrial,37,60,27,15,97,72.97297297297297,40.54054054054054
54842_terrestrial,37,61,27,15,98,72.97297297297297,40.54054054054054
54843_terrestrial,37,61,27,15,98,72.97297297297297,40.54054054054054
54844_terrestrial,28,45,21,11,73,75,39.285714285714285
55198_terrestrial,36,53,27,14,89,75,38.88888888888889
55199_terrestrial,31,45,23,12,76,74.19354838709677,38.70967741935484
55200_terrestrial,35,59,25,15,94,71.42857142857143,42.857142857142854
55201_terrestrial,30,48,23,11,78,76.66666666666667,36.666666666666664
55202_terrestrial,30,50,23,11,80,76.66666666666667,36.666666666666664
55203_terrestrial,30,50,23,11,80,76.66666666666667,36.666666666666664
55204_terrestrial,29,50,22,11,79,75.86206896551724,37.93103448275862
55205_terrestrial,31,49,23,13,80,74.19354838709677,41.935483870967744
55556_terrestrial,34,46,24,14,80,70.58823529411765,41.17647058823529
55557_terrestrial,34,49,24,14,83,70.58823529411765,41.17647058823529
55558_terrestrial,33,48,24,13,81,72.72727272727273,39.39393939393939
55559_terrestrial,31,48,23,12,79,74.19354838709677,38.70967741935484
55560_terrestrial,31,47,24,11,78,77.41935483870968,35.483870967741936
55561_terrestrial,27,45,21,10,72,77.77777777777779,37.03703703703704
55562_terrestrial,26,45,20,10,71,76.92307692307693,38.46153846153847
55563_terrestrial,29,45,21,13,74,72.41379310344827,44.827586206896555
55564_terrestrial,28,45,20,12,73,71.42857142857143,42.857142857142854
55914_terrestrial,24,33,19,7,57,79.16666666666666,29.166666666666668
55915_terrestrial,28,36,23,7,64,82.14285714285714,25
55916_terrestrial,26,39,21,7,65,80.76923076923077,26.923076923076923
55917_terrestrial,30,41,22,11,71,73.33333333333333,36.666666666666664
55918_terrestrial,25,35,19,8,60,76,32
55919_terrestrial,26,38,20,9,64,76.92307692307693,34.61538461538461
55920_terrestrial,20,32,16,6,52,80,30
56033_terrestrial,3,0,1,2,3,33.33333333333333,66.66666666666666
56034_terrestrial,18,28,11,7,46,61.111111111111114,38.88888888888889
56035_terrestrial,18,28,11,7,46,61.111111111111114,38.88888888888889
56036_terrestrial,1,0,1,0,1,100,0
56073_terrestrial,16,26,11,5,42,68.75,31.25
56081_terrestrial,17,27,11,6,44,64.70588235294117,35.294117647058826
56082_terrestrial,18,27,11,7,45,61.111111111111114,38.88888888888889
56083_terrestrial,18,27,11,7,45,61.111111111111114,38.88888888888889
56084_terrestrial,17,27,11,6,44,64.70588235294117,35.294117647058826
56085_terrestrial,1,1,1,0,2,100,0
56092_terrestrial,3,0,1,2,3,33.33333333333333,66.66666666666666
56093_terrestrial,17,26,11,6,43,64.70588235294117,35.294117647058826
56094_terrestrial,2,0,1,1,2,50,50
56272_terrestrial,21,32,17,5,53,80.95238095238095,23.809523809523807
56273_terrestrial,22,34,17,6,56,77.27272727272727,27.27272727272727
56274_terrestrial,23,35,18,6,58,78.26086956521739,26.08695652173913
56275_terrestrial,24,33,19,7,57,79.16666666666666,29.166666666666668
56276_terrestrial,23,35,18,7,58,78.26086956521739,30.434782608695656
56277_terrestrial,19,32,15,5,51,78.94736842105263,26.31578947368421
56278_terrestrial,20,32,16,6,52,80,30
56279_terrestrial,20,32,16,6,52,80,30
56280_terrestrial,19,34,15,5,53,78.94736842105263,26.31578947368421
56389_terrestrial,16,29,11,5,45,68.75,31.25
56390_terrestrial,4,0,3,1,4,75,25
56391_terrestrial,16,28,11,5,44,68.75,31.25
56392_terrestrial,18,28,11,7,46,61.111111111111114,38.88888888888889
56393_terrestrial,3,0,1,2,3,33.33333333333333,66.66666666666666
56394_terrestrial,2,0,0,2,2,0,100
56395_terrestrial,1,0,0,1,1,0,100
56396_terrestrial,3,0,3,0,3,100,0
56397_terrestrial,15,28,11,4,43,73.33333333333333,26.666666666666668
56426_terrestrial,15,27,10,5,42,66.66666666666666,33.33333333333333
56427_terrestrial,15,26,10,5,41,66.66666666666666,33.33333333333333
56428_terrestrial,15,26,10,5,41,66.66666666666666,33.33333333333333
56429_terrestrial,2,0,1,1,2,50,50
56430_terrestrial,13,26,9,4,39,69.23076923076923,30.76923076923077
56431_terrestrial,14,26,9,5,40,64.28571428571429,35.714285714285715
56432_terrestrial,17,26,11,6,43,64.70588235294117,35.294117647058826
56433_terrestrial,17,26,11,6,43,64.70588235294117,35.294117647058826
56434_terrestrial,15,26,11,4,41,73.33333333333333,26.666666666666668
56435_terrestrial,15,26,11,4,41,73.33333333333333,26.666666666666668
56436_terrestrial,15,27,11,4,42,73.33333333333333,26.666666666666668
56437_terrestrial,16,28,11,5,44,68.75,31.25
56438_terrestrial,16,27,11,5,43,68.75,31.25
56439_terrestrial,16,27,11,5,43,68.75,31.25
56440_terrestrial,3,1,3,0,4,100,0
56441_terrestrial,15,27,11,4,42,73.33333333333333,26.666666666666668
56442_terrestrial,17,29,11,6,46,64.70588235294117,35.294117647058826
56443_terrestrial,1,1,0,1,2,0,100
56444_terrestrial,3,1,3,0,4,100,0
56445_terrestrial,3,1,3,0,4,100,0
56446_terrestrial,3,1,3,0,4,100,0
56447_terrestrial,13,27,9,4,40,69.23076923076923,30.76923076923077
56448_terrestrial,13,27,9,4,40,69.23076923076923,30.76923076923077
56449_terrestrial,13,27,9,4,40,69.23076923076923,30.76923076923077
56450_terrestrial,13,26,9,4,39,69.23076923076923,30.76923076923077
56451_terrestrial,18,26,11,7,44,61.111111111111114,38.88888888888889
56452_terrestrial,2,0,0,2,2,0,100
56453_terrestrial,1,0,0,1,1,0,100
56455_terrestrial,15,26,11,4,41,73.33333333333333,26.666666666666668
56456_terrestrial,1,0,1,0,1,100,0
56460_terrestrial,1,0,1,0,1,100,0
56461_terrestrial,1,0,1,0,1,100,0
56462_terrestrial,13,26,9,4,39,69.23076923076923,30.76923076923077
56463_terrestrial,15,26,11,4,41,73.33333333333333,26.666666666666668
56464_terrestrial,15,26,11,4,41,73.33333333333333,26.666666666666668
56465_terrestrial,15,26,11,4,41,73.33333333333333,26.666666666666668
56466_terrestrial,15,26,11,4,41,73.33333333333333,26.666666666666668
56467_terrestrial,3,0,3,0,3,100,0
56468_terrestrial,3,0,3,0,3,100,0
56470_terrestrial,15,26,11,4,41,73.33333333333333,26.666666666666668
56471_terrestrial,3,0,3,0,3,100,0
56472_terrestrial,3,0,3,0,3,100,0
56473_terrestrial,16,26,12,4,42,75,25
56474_terrestrial,16,26,12,4,42,75,25
56475_terrestrial,2,0,2,0,2,100,0
56476_terrestrial,3,0,2,1,3,66.66666666666666,33.33333333333333
56477_terrestrial,15,26,10,5,41,66.66666666666666,33.33333333333333
56478_terrestrial,15,27,10,5,42,66.66666666666666,33.33333333333333
56479_terrestrial,14,27,10,4,41,71.42857142857143,28.57142857142857
56480_terrestrial,3,1,2,1,4,66.66666666666666,33.33333333333333
56481_terrestrial,18,27,12,6,45,66.66666666666666,33.33333333333333
56482_terrestrial,17,27,12,5,44,70.58823529411765,29.411764705882355
56483_terrestrial,17,27,12,5,44,70.58823529411765,29.411764705882355
56484_terrestrial,17,26,12,5,43,70.58823529411765,29.411764705882355
56503_terrestrial,20,36,13,7,56,65,35
56504_terrestrial,20,36,13,7,56,65,35
56631_terrestrial,19,32,15,4,51,78.94736842105263,21.052631578947366
56632_terrestrial,20,35,16,4,55,80,20
56633_terrestrial,20,35,16,4,55,80,20
56634_terrestrial,18,34,15,3,52,83.33333333333334,16.666666666666664
56635_terrestrial,18,30,15,4,48,83.33333333333334,22.22222222222222
56636_terrestrial,18,30,15,4,48,83.33333333333334,22.22222222222222
56744_terrestrial,13,26,10,3,39,76.92307692307693,23.076923076923077
56745_terrestrial,14,26,10,4,40,71.42857142857143,28.57142857142857
56746_terrestrial,14,26,10,4,40,71.42857142857143,28.57142857142857
56747_terrestrial,14,28,10,4,42,71.42857142857143,28.57142857142857
56748_terrestrial,14,28,10,4,42,71.42857142857143,28.57142857142857
56749_terrestrial,14,28,10,4,42,71.42857142857143,28.57142857142857
56750_terrestrial,15,28,11,4,43,73.33333333333333,26.666666666666668
56751_terrestrial,14,28,10,4,42,71.42857142857143,28.57142857142857
56752_terrestrial,12,28,8,4,40,66.66666666666666,33.33333333333333
56757_terrestrial,12,26,8,4,38,66.66666666666666,33.33333333333333
56758_terrestrial,15,26,10,5,41,66.66666666666666,33.33333333333333
56759_terrestrial,15,26,10,5,41,66.66666666666666,33.33333333333333
56760_terrestrial,16,26,10,6,42,62.5,37.5
56761_terrestrial,13,26,8,5,39,61.53846153846154,38.46153846153847
56762_terrestrial,15,26,10,5,41,66.66666666666666,33.33333333333333
56763_terrestrial,17,26,10,7,43,58.82352941176471,41.17647058823529
56764_terrestrial,17,26,10,7,43,58.82352941176471,41.17647058823529
56765_terrestrial,18,26,10,8,44,55.55555555555556,44.44444444444444
56766_terrestrial,17,26,10,7,43,58.82352941176471,41.17647058823529
56767_terrestrial,16,26,10,6,42,62.5,37.5
56768_terrestrial,15,26,10,5,41,66.66666666666666,33.33333333333333
56769_terrestrial,17,26,11,6,43,64.70588235294117,35.294117647058826
56770_terrestrial,17,26,11,6,43,64.70588235294117,35.294117647058826
56781_terrestrial,15,26,10,5,41,66.66666666666666,33.33333333333333
56782_terrestrial,15,26,10,5,41,66.66666666666666,33.33333333333333
56783_terrestrial,13,26,8,5,39,61.53846153846154,38.46153846153847
56784_terrestrial,12,26,8,4,38,66.66666666666666,33.33333333333333
56785_terrestrial,14,26,10,4,40,71.42857142857143,28.57142857142857
56786_terrestrial,14,26,10,4,40,71.42857142857143,28.57142857142857
56787_terrestrial,14,26,10,4,40,71.42857142857143,28.57142857142857
56788_terrestrial,3,0,2,1,3,66.66666666666666,33.33333333333333
56789_terrestrial,1,0,0,1,1,0,100
56814_terrestrial,1,0,1,0,1,100,0
56815_terrestrial,1,0,1,0,1,100,0
56816_terrestrial,1,0,1,0,1,100,0
56817_terrestrial,1,0,1,0,1,100,0
56818_terrestrial,1,0,1,0,1,100,0
56819_terrestrial,1,0,1,0,1,100,0
56820_terrestrial,1,0,1,0,1,100,0
56821_terrestrial,1,0,1,0,1,100,0
56822_terrestrial,1,0,1,0,1,100,0
56828_terrestrial,3,0,3,0,3,100,0
56829_terrestrial,3,0,3,0,3,100,0
56830_terrestrial,15,26,11,4,41,73.33333333333333,26.666666666666668
56841_terrestrial,2,1,0,2,3,0,100
56842_terrestrial,1,1,0,1,2,0,100
56843_terrestrial,15,28,10,5,43,66.66666666666666,33.33333333333333
56844_terrestrial,17,26,12,5,43,70.58823529411765,29.411764705882355
56845_terrestrial,16,26,12,4,42,75,25
56846_terrestrial,17,26,12,5,43,70.58823529411765,29.411764705882355
56847_terrestrial,15,26,10,5,41,66.66666666666666,33.33333333333333
56865_terrestrial,20,35,13,7,55,65,35
56970_terrestrial,17,29,11,6,46,64.70588235294117,35.294117647058826
56988_terrestrial,14,27,11,3,41,78.57142857142857,21.428571428571427
56989_terrestrial,15,27,11,4,42,73.33333333333333,26.666666666666668
56990_terrestrial,15,27,11,4,42,73.33333333333333,26.666666666666668
56993_terrestrial,15,30,12,3,45,80,20
56994_terrestrial,15,31,12,3,46,80,20
56995_terrestrial,17,28,14,3,45,82.35294117647058,17.647058823529413
56996_terrestrial,17,28,14,3,45,82.35294117647058,17.647058823529413
56997_terrestrial,16,28,13,3,44,81.25,18.75
56998_terrestrial,14,27,11,3,41,78.57142857142857,21.428571428571427
56999_terrestrial,13,27,9,4,40,69.23076923076923,30.76923076923077
57000_terrestrial,16,27,12,4,43,75,25
57093_terrestrial,13,26,10,3,39,76.92307692307693,23.076923076923077
57094_terrestrial,14,26,10,4,40,71.42857142857143,28.57142857142857
57095_terrestrial,1,0,0,1,1,0,100
57100_terrestrial,1,2,0,1,3,0,100
57101_terrestrial,15,26,10,5,41,66.66666666666666,33.33333333333333
57102_terrestrial,2,2,0,2,4,0,100
57103_terrestrial,14,26,10,4,40,71.42857142857143,28.57142857142857
57104_terrestrial,14,26,10,4,40,71.42857142857143,28.57142857142857
57105_terrestrial,12,26,8,4,38,66.66666666666666,33.33333333333333
57106_terrestrial,1,0,0,1,1,0,100
57107_terrestrial,1,0,0,1,1,0,100
57108_terrestrial,1,0,0,1,1,0,100
57122_terrestrial,1,0,0,1,1,0,100
57123_terrestrial,1,0,0,1,1,0,100
57124_terrestrial,1,0,0,1,1,0,100
57125_terrestrial,1,0,0,1,1,0,100
57126_terrestrial,2,0,0,2,2,0,100
57127_terrestrial,2,0,0,2,2,0,100
57128_terrestrial,1,0,0,1,1,0,100
57129_terrestrial,2,0,0,2,2,0,100
57130_terrestrial,14,26,10,4,40,71.42857142857143,28.57142857142857
57138_terrestrial,14,26,10,4,40,71.42857142857143,28.57142857142857
57139_terrestrial,13,26,8,5,39,61.53846153846154,38.46153846153847
57140_terrestrial,13,26,8,5,39,61.53846153846154,38.46153846153847
57141_terrestrial,13,26,8,5,39,61.53846153846154,38.46153846153847
57142_terrestrial,1,0,0,1,1,0,100
57143_terrestrial,1,0,0,1,1,0,100
57206_terrestrial,1,0,0,1,1,0,100
57207_terrestrial,3,0,2,1,3,66.66666666666666,33.33333333333333
57208_terrestrial,14,24,9,5,38,64.28571428571429,35.714285714285715
57209_terrestrial,3,0,2,1,3,66.66666666666666,33.33333333333333
57210_terrestrial,17,26,12,5,43,70.58823529411765,29.411764705882355
57211_terrestrial,17,26,12,5,43,70.58823529411765,29.411764705882355
57212_terrestrial,17,26,12,5,43,70.58823529411765,29.411764705882355
57213_terrestrial,4,2,4,0,6,100,0
57214_terrestrial,16,26,12,4,42,75,25
57215_terrestrial,16,26,12,4,42,75,25
57216_terrestrial,16,26,12,4,42,75,25
57345_terrestrial,15,27,11,4,42,73.33333333333333,26.666666666666668
57346_terrestrial,15,27,11,4,42,73.33333333333333,26.666666666666668
57348_terrestrial,15,29,11,4,44,73.33333333333333,26.666666666666668
57349_terrestrial,15,29,11,4,44,73.33333333333333,26.666666666666668
57350_terrestrial,15,27,11,4,42,73.33333333333333,26.666666666666668
57351_terrestrial,14,27,11,3,41,78.57142857142857,21.428571428571427
57352_terrestrial,14,29,11,3,43,78.57142857142857,21.428571428571427
57353_terrestrial,14,27,11,3,41,78.57142857142857,21.428571428571427
57354_terrestrial,14,27,11,3,41,78.57142857142857,21.428571428571427
57357_terrestrial,15,28,12,3,43,80,20
57358_terrestrial,16,29,12,4,45,75,25
57359_terrestrial,15,29,11,4,44,73.33333333333333,26.666666666666668
57436_terrestrial,13,26,10,3,39,76.92307692307693,23.076923076923077
57437_terrestrial,13,26,10,3,39,76.92307692307693,23.076923076923077
57453_terrestrial,13,26,10,3,39,76.92307692307693,23.076923076923077
57454_terrestrial,14,26,10,4,40,71.42857142857143,28.57142857142857
57455_terrestrial,1,0,0,1,1,0,100
57458_terrestrial,13,26,10,3,39,76.92307692307693,23.076923076923077
57459_terrestrial,13,26,10,3,39,76.92307692307693,23.076923076923077
57460_terrestrial,14,26,10,4,40,71.42857142857143,28.57142857142857
57461_terrestrial,1,0,0,1,1,0,100
57462_terrestrial,1,0,0,1,1,0,100
57489_terrestrial,12,26,10,2,38,83.33333333333334,16.666666666666664
57490_terrestrial,12,26,10,2,38,83.33333333333334,16.666666666666664
57494_terrestrial,12,26,10,2,38,83.33333333333334,16.666666666666664
57495_terrestrial,13,26,10,3,39,76.92307692307693,23.076923076923077
57496_terrestrial,14,26,9,5,40,64.28571428571429,35.714285714285715
57497_terrestrial,15,26,9,6,41,60,40
57498_terrestrial,18,26,11,7,44,61.111111111111114,38.88888888888889
57499_terrestrial,13,26,8,5,39,61.53846153846154,38.46153846153847
57500_terrestrial,1,0,0,1,1,0,100
57570_terrestrial,1,0,0,1,1,0,100
57571_terrestrial,1,0,0,1,1,0,100
57572_terrestrial,1,0,0,1,1,0,100
57575_terrestrial,14,26,10,4,40,71.42857142857143,28.57142857142857
57576_terrestrial,16,26,12,4,42,75,25
57577_terrestrial,16,26,12,4,42,75,25
57578_terrestrial,16,26,12,4,42,75,25
57579_terrestrial,17,26,12,5,43,70.58823529411765,29.411764705882355
57580_terrestrial,18,26,12,6,44,66.66666666666666,33.33333333333333
57581_terrestrial,18,26,12,6,44,66.66666666666666,33.33333333333333
57704_terrestrial,14,28,11,3,42,78.57142857142857,21.428571428571427
57705_terrestrial,15,29,11,4,44,73.33333333333333,26.666666666666668
57706_terrestrial,14,29,11,3,43,78.57142857142857,21.428571428571427
57707_terrestrial,14,26,11,3,40,78.57142857142857,21.428571428571427
57709_terrestrial,14,29,11,3,43,78.57142857142857,21.428571428571427
57710_terrestrial,14,27,11,3,41,78.57142857142857,21.428571428571427
57711_terrestrial,14,27,11,3,41,78.57142857142857,21.428571428571427
57712_terrestrial,14,29,11,3,43,78.57142857142857,21.428571428571427
57713_terrestrial,14,28,11,3,42,78.57142857142857,21.428571428571427
57718_terrestrial,15,28,11,4,43,73.33333333333333,26.666666666666668
57719_terrestrial,15,27,11,4,42,73.33333333333333,26.666666666666668
57720_terrestrial,15,25,11,4,40,73.33333333333333,26.666666666666668
57771_terrestrial,1,0,1,0,1,100,0
57773_terrestrial,16,25,12,4,41,75,25
57774_terrestrial,16,27,12,4,43,75,25
57775_terrestrial,16,27,12,4,43,75,25
57777_terrestrial,16,25,12,4,41,75,25
57778_terrestrial,16,25,12,4,41,75,25
57781_terrestrial,13,26,10,3,39,76.92307692307693,23.076923076923077
57782_terrestrial,14,27,11,3,41,78.57142857142857,21.428571428571427
57783_terrestrial,13,26,10,3,39,76.92307692307693,23.076923076923077
57784_terrestrial,13,26,10,3,39,76.92307692307693,23.076923076923077
57785_terrestrial,13,26,10,3,39,76.92307692307693,23.076923076923077
57793_terrestrial,14,26,10,4,40,71.42857142857143,28.57142857142857
57794_terrestrial,15,26,10,5,41,66.66666666666666,33.33333333333333
57795_terrestrial,13,25,8,5,38,61.53846153846154,38.46153846153847
57796_terrestrial,14,26,10,4,40,71.42857142857143,28.57142857142857
57797_terrestrial,14,26,10,4,40,71.42857142857143,28.57142857142857
57798_terrestrial,1,0,0,1,1,0,100
57799_terrestrial,12,26,8,4,38,66.66666666666666,33.33333333333333
57800_terrestrial,12,26,8,4,38,66.66666666666666,33.33333333333333
57802_terrestrial,13,26,10,3,39,76.92307692307693,23.076923076923077
57803_terrestrial,13,26,10,3,39,76.92307692307693,23.076923076923077
57804_terrestrial,13,26,10,3,39,76.92307692307693,23.076923076923077
57805_terrestrial,13,26,10,3,39,76.92307692307693,23.076923076923077
57806_terrestrial,13,26,10,3,39,76.92307692307693,23.076923076923077
57807_terrestrial,13,26,10,3,39,76.92307692307693,23.076923076923077
57819_terrestrial,11,26,8,3,37,72.72727272727273,27.27272727272727
57849_terrestrial,12,25,10,2,37,83.33333333333334,16.666666666666664
57850_terrestrial,12,25,10,2,37,83.33333333333334,16.666666666666664
57852_terrestrial,12,25,10,2,37,83.33333333333334,16.666666666666664
57853_terrestrial,12,27,10,2,39,83.33333333333334,16.666666666666664
57854_terrestrial,10,27,8,2,37,80,20
57855_terrestrial,1,1,0,1,2,0,100
57856_terrestrial,1,0,0,1,1,0,100
57939_terrestrial,1,0,0,1,1,0,100
57940_terrestrial,3,0,1,2,3,33.33333333333333,66.66666666666666
57941_terrestrial,18,26,12,6,44,66.66666666666666,33.33333333333333
57942_terrestrial,16,25,10,6,41,62.5,37.5
57943_terrestrial,17,25,12,5,42,70.58823529411765,29.411764705882355
57944_terrestrial,17,25,12,5,42,70.58823529411765,29.411764705882355
57945_terrestrial,18,25,12,6,43,66.66666666666666,33.33333333333333
57946_terrestrial,18,25,12,6,43,66.66666666666666,33.33333333333333
57947_terrestrial,18,25,12,6,43,66.66666666666666,33.33333333333333
57948_terrestrial,18,25,12,6,43,66.66666666666666,33.33333333333333
58038_terrestrial,4,4,3,1,8,75,25
58039_terrestrial,4,2,3,1,6,75,25
58040_terrestrial,13,25,10,3,38,76.92307692307693,23.076923076923077
58041_terrestrial,13,25,10,3,38,76.92307692307693,23.076923076923077
58042_terrestrial,14,27,11,3,41,78.57142857142857,21.428571428571427
58043_terrestrial,14,27,11,3,41,78.57142857142857,21.428571428571427
58044_terrestrial,14,27,11,3,41,78.57142857142857,21.428571428571427
58064_terrestrial,12,28,9,3,40,75,25
58065_terrestrial,16,28,11,5,44,68.75,31.25
58066_terrestrial,16,28,11,5,44,68.75,31.25
58067_terrestrial,14,26,11,3,40,78.57142857142857,21.428571428571427
58068_terrestrial,14,26,11,3,40,78.57142857142857,21.428571428571427
58069_terrestrial,14,26,11,3,40,78.57142857142857,21.428571428571427
58070_terrestrial,14,26,11,3,40,78.57142857142857,21.428571428571427
58071_terrestrial,2,2,2,0,4,100,0
58072_terrestrial,14,25,11,3,39,78.57142857142857,21.428571428571427
58073_terrestrial,14,25,11,3,39,78.57142857142857,21.428571428571427
58074_terrestrial,13,25,10,3,38,76.92307692307693,23.076923076923077
58079_terrestrial,15,27,11,4,42,73.33333333333333,26.666666666666668
58080_terrestrial,15,25,11,4,40,73.33333333333333,26.666666666666668
58128_terrestrial,16,25,12,4,41,75,25
58129_terrestrial,16,25,12,4,41,75,25
58130_terrestrial,15,25,12,3,40,80,20
58131_terrestrial,1,0,1,0,1,100,0
58132_terrestrial,15,25,12,3,40,80,20
58133_terrestrial,16,25,12,4,41,75,25
58134_terrestrial,16,25,12,4,41,75,25
58135_terrestrial,15,25,12,3,40,80,20
58136_terrestrial,3,2,3,0,5,100,0
58137_terrestrial,15,25,12,3,40,80,20
58138_terrestrial,16,25,12,4,41,75,25
58139_terrestrial,13,25,10,3,38,76.92307692307693,23.076923076923077
58140_terrestrial,13,25,10,3,38,76.92307692307693,23.076923076923077
58141_terrestrial,3,2,2,1,5,66.66666666666666,33.33333333333333
58142_terrestrial,13,26,10,3,39,76.92307692307693,23.076923076923077
58212_terrestrial,12,25,10,2,37,83.33333333333334,16.666666666666664
58213_terrestrial,10,26,8,2,36,80,20
58303_terrestrial,3,0,2,1,3,66.66666666666666,33.33333333333333
58304_terrestrial,1,0,0,1,1,0,100
58305_terrestrial,2,0,0,2,2,0,100
58306_terrestrial,2,0,0,2,2,0,100
58307_terrestrial,1,0,0,1,1,0,100
58308_terrestrial,17,25,12,5,42,70.58823529411765,29.411764705882355
58309_terrestrial,15,26,10,5,41,66.66666666666666,33.33333333333333
58310_terrestrial,18,26,12,6,44,66.66666666666666,33.33333333333333
58311_terrestrial,19,25,12,7,44,63.1578947368421,36.84210526315789
58395_terrestrial,12,25,10,2,37,83.33333333333334,16.666666666666664
58396_terrestrial,13,25,10,3,38,76.92307692307693,23.076923076923077
58397_terrestrial,13,25,10,3,38,76.92307692307693,23.076923076923077
58398_terrestrial,14,25,10,4,39,71.42857142857143,28.57142857142857
58399_terrestrial,14,25,10,4,39,71.42857142857143,28.57142857142857
58400_terrestrial,13,25,10,3,38,76.92307692307693,23.076923076923077
58401_terrestrial,13,25,10,3,38,76.92307692307693,23.076923076923077
58402_terrestrial,14,25,11,3,39,78.57142857142857,21.428571428571427
58403_terrestrial,14,25,11,3,39,78.57142857142857,21.428571428571427
58404_terrestrial,14,27,11,3,41,78.57142857142857,21.428571428571427
58405_terrestrial,14,27,11,3,41,78.57142857142857,21.428571428571427
58406_terrestrial,13,27,10,3,40,76.92307692307693,23.076923076923077
58407_terrestrial,13,27,10,3,40,76.92307692307693,23.076923076923077
58409_terrestrial,14,27,11,3,41,78.57142857142857,21.428571428571427
58410_terrestrial,14,27,11,3,41,78.57142857142857,21.428571428571427
58411_terrestrial,14,27,11,3,41,78.57142857142857,21.428571428571427
58412_terrestrial,14,27,11,3,41,78.57142857142857,21.428571428571427
58420_terrestrial,14,25,11,3,39,78.57142857142857,21.428571428571427
58425_terrestrial,13,25,10,3,38,76.92307692307693,23.076923076923077
58426_terrestrial,15,25,11,4,40,73.33333333333333,26.666666666666668
58427_terrestrial,14,25,11,3,39,78.57142857142857,21.428571428571427
58428_terrestrial,14,26,11,3,40,78.57142857142857,21.428571428571427
58429_terrestrial,14,26,11,3,40,78.57142857142857,21.428571428571427
58430_terrestrial,14,26,11,3,40,78.57142857142857,21.428571428571427
58431_terrestrial,13,25,10,3,38,76.92307692307693,23.076923076923077
58432_terrestrial,13,25,10,3,38,76.92307692307693,23.076923076923077
58433_terrestrial,13,25,10,3,38,76.92307692307693,23.076923076923077
58434_terrestrial,13,25,10,3,38,76.92307692307693,23.076923076923077
58439_terrestrial,14,27,11,3,41,78.57142857142857,21.428571428571427
58440_terrestrial,13,27,10,3,40,76.92307692307693,23.076923076923077
58484_terrestrial,14,25,11,3,39,78.57142857142857,21.428571428571427
58486_terrestrial,14,25,11,3,39,78.57142857142857,21.428571428571427
58487_terrestrial,14,25,11,3,39,78.57142857142857,21.428571428571427
58488_terrestrial,15,25,12,3,40,80,20
58489_terrestrial,13,25,10,3,38,76.92307692307693,23.076923076923077
58490_terrestrial,1,0,1,0,1,100,0
58667_terrestrial,1,0,1,0,1,100,0
58669_terrestrial,2,0,1,1,2,50,50
58670_terrestrial,18,24,11,7,42,61.111111111111114,38.88888888888889
58671_terrestrial,19,24,11,8,43,57.89473684210527,42.10526315789473
58733_terrestrial,13,25,10,3,38,76.92307692307693,23.076923076923077
58734_terrestrial,13,25,10,3,38,76.92307692307693,23.076923076923077
58735_terrestrial,13,25,10,3,38,76.92307692307693,23.076923076923077
58736_terrestrial,13,25,10,3,38,76.92307692307693,23.076923076923077
58737_terrestrial,13,25,10,3,38,76.92307692307693,23.076923076923077
58738_terrestrial,13,25,10,3,38,76.92307692307693,23.076923076923077
58739_terrestrial,1,3,1,0,4,100,0
58740_terrestrial,3,3,3,0,6,100,0
58741_terrestrial,13,25,10,3,38,76.92307692307693,23.076923076923077
58742_terrestrial,1,3,1,0,4,100,0
58744_terrestrial,12,25,10,2,37,83.33333333333334,16.666666666666664
58746_terrestrial,12,25,10,2,37,83.33333333333334,16.666666666666664
58755_terrestrial,10,25,8,2,35,80,20
58756_terrestrial,12,25,10,2,37,83.33333333333334,16.666666666666664
58758_terrestrial,13,25,10,3,38,76.92307692307693,23.076923076923077
58759_terrestrial,13,25,10,3,38,76.92307692307693,23.076923076923077
58760_terrestrial,13,25,10,3,38,76.92307692307693,23.076923076923077
58761_terrestrial,13,25,10,3,38,76.92307692307693,23.076923076923077
58762_terrestrial,13,25,10,3,38,76.92307692307693,23.076923076923077
58763_terrestrial,13,25,10,3,38,76.92307692307693,23.076923076923077
58764_terrestrial,13,25,10,3,38,76.92307692307693,23.076923076923077
58765_terrestrial,13,25,10,3,38,76.92307692307693,23.076923076923077
58767_terrestrial,13,25,10,3,38,76.92307692307693,23.076923076923077
58768_terrestrial,13,25,10,3,38,76.92307692307693,23.076923076923077
58769_terrestrial,13,25,10,3,38,76.92307692307693,23.076923076923077
58770_terrestrial,13,27,10,3,40,76.92307692307693,23.076923076923077
58771_terrestrial,14,27,11,3,41,78.57142857142857,21.428571428571427
58772_terrestrial,14,27,11,3,41,78.57142857142857,21.428571428571427
58774_terrestrial,1,0,1,0,1,100,0
58775_terrestrial,14,25,11,3,39,78.57142857142857,21.428571428571427
58778_terrestrial,13,25,10,3,38,76.92307692307693,23.076923076923077
58779_terrestrial,14,25,11,3,39,78.57142857142857,21.428571428571427
58780_terrestrial,14,25,11,3,39,78.57142857142857,21.428571428571427
58781_terrestrial,14,25,11,3,39,78.57142857142857,21.428571428571427
58782_terrestrial,13,25,10,3,38,76.92307692307693,23.076923076923077
58783_terrestrial,13,25,10,3,38,76.92307692307693,23.076923076923077
58784_terrestrial,13,25,10,3,38,76.92307692307693,23.076923076923077
58785_terrestrial,13,25,10,3,38,76.92307692307693,23.076923076923077
58786_terrestrial,13,25,10,3,38,76.92307692307693,23.076923076923077
58787_terrestrial,13,25,10,3,38,76.92307692307693,23.076923076923077
58788_terrestrial,13,25,10,3,38,76.92307692307693,23.076923076923077
58789_terrestrial,13,25,10,3,38,76.92307692307693,23.076923076923077
58790_terrestrial,13,25,10,3,38,76.92307692307693,23.076923076923077
58791_terrestrial,13,25,10,3,38,76.92307692307693,23.076923076923077
58800_terrestrial,12,27,9,3,39,75,25
58839_terrestrial,11,25,8,3,36,72.72727272727273,27.27272727272727
58840_terrestrial,12,25,9,3,37,75,25
58844_terrestrial,3,0,3,0,3,100,0
58845_terrestrial,3,0,3,0,3,100,0
58846_terrestrial,3,0,3,0,3,100,0
58847_terrestrial,3,0,3,0,3,100,0
59025_terrestrial,2,0,1,1,2,50,50
59026_terrestrial,2,0,1,1,2,50,50
59027_terrestrial,2,0,1,1,2,50,50
59028_terrestrial,5,0,3,2,5,60,40
59029_terrestrial,3,0,1,2,3,33.33333333333333,66.66666666666666
59030_terrestrial,15,24,9,6,39,60,40
59084_terrestrial,1,0,0,1,1,0,100
59085_terrestrial,1,0,0,1,1,0,100
59086_terrestrial,11,25,8,3,36,72.72727272727273,27.27272727272727
59087_terrestrial,13,25,10,3,38,76.92307692307693,23.076923076923077
59088_terrestrial,13,25,10,3,38,76.92307692307693,23.076923076923077
59089_terrestrial,13,25,10,3,38,76.92307692307693,23.076923076923077
59090_terrestrial,1,4,1,0,5,100,0
59091_terrestrial,13,25,10,3,38,76.92307692307693,23.076923076923077
59092_terrestrial,13,25,10,3,38,76.92307692307693,23.076923076923077
59093_terrestrial,13,25,10,3,38,76.92307692307693,23.076923076923077
59094_terrestrial,11,25,8,3,36,72.72727272727273,27.27272727272727
59095_terrestrial,13,25,10,3,38,76.92307692307693,23.076923076923077
59096_terrestrial,13,25,10,3,38,76.92307692307693,23.076923076923077
59097_terrestrial,13,25,10,3,38,76.92307692307693,23.076923076923077
59098_terrestrial,13,25,10,3,38,76.92307692307693,23.076923076923077
59099_terrestrial,13,25,10,3,38,76.92307692307693,23.076923076923077
59100_terrestrial,3,3,3,0,6,100,0
59101_terrestrial,13,25,10,3,38,76.92307692307693,23.076923076923077
59102_terrestrial,12,25,10,2,37,83.33333333333334,16.666666666666664
59103_terrestrial,12,25,10,2,37,83.33333333333334,16.666666666666664
59104_terrestrial,12,25,10,2,37,83.33333333333334,16.666666666666664
59105_terrestrial,12,25,10,2,37,83.33333333333334,16.666666666666664
59106_terrestrial,12,25,10,2,37,83.33333333333334,16.666666666666664
59107_terrestrial,12,25,10,2,37,83.33333333333334,16.666666666666664
59108_terrestrial,12,25,10,2,37,83.33333333333334,16.666666666666664
59109_terrestrial,12,25,10,2,37,83.33333333333334,16.666666666666664
59119_terrestrial,12,25,10,2,37,83.33333333333334,16.666666666666664
59120_terrestrial,12,25,10,2,37,83.33333333333334,16.666666666666664
59158_terrestrial,8,23,7,1,31,87.5,12.5
59159_terrestrial,8,24,7,1,32,87.5,12.5
59160_terrestrial,8,24,7,1,32,87.5,12.5
59198_terrestrial,11,25,8,3,36,72.72727272727273,27.27272727272727
59199_terrestrial,11,25,8,3,36,72.72727272727273,27.27272727272727
59200_terrestrial,12,25,8,4,37,66.66666666666666,33.33333333333333
59382_terrestrial,1,1,0,1,2,0,100
59383_terrestrial,9,24,5,4,33,55.55555555555556,44.44444444444444
59384_terrestrial,11,24,7,4,35,63.63636363636363,36.36363636363637
59385_terrestrial,11,26,7,4,37,63.63636363636363,36.36363636363637
59386_terrestrial,11,25,7,4,36,63.63636363636363,36.36363636363637
59434_terrestrial,11,25,8,3,36,72.72727272727273,27.27272727272727
59435_terrestrial,11,25,8,3,36,72.72727272727273,27.27272727272727
59436_terrestrial,11,25,8,3,36,72.72727272727273,27.27272727272727
59437_terrestrial,11,25,8,3,36,72.72727272727273,27.27272727272727
59438_terrestrial,11,25,8,3,36,72.72727272727273,27.27272727272727
59439_terrestrial,9,25,6,3,34,66.66666666666666,33.33333333333333
59440_terrestrial,11,25,8,3,36,72.72727272727273,27.27272727272727
59441_terrestrial,13,25,10,3,38,76.92307692307693,23.076923076923077
59442_terrestrial,11,25,8,3,36,72.72727272727273,27.27272727272727
59443_terrestrial,11,25,8,3,36,72.72727272727273,27.27272727272727
59444_terrestrial,1,0,0,1,1,0,100
59479_terrestrial,12,25,10,2,37,83.33333333333334,16.666666666666664
59514_terrestrial,7,19,6,1,26,85.71428571428571,14.285714285714285
59515_terrestrial,7,19,6,1,26,85.71428571428571,14.285714285714285
59516_terrestrial,7,19,6,1,26,85.71428571428571,14.285714285714285
59517_terrestrial,7,19,6,1,26,85.71428571428571,14.285714285714285
59554_terrestrial,9,26,6,3,35,66.66666666666666,33.33333333333333
59555_terrestrial,10,26,6,4,36,60,40
59556_terrestrial,3,1,2,1,4,66.66666666666666,33.33333333333333
59557_terrestrial,3,1,2,1,4,66.66666666666666,33.33333333333333
59741_terrestrial,1,0,1,0,1,100,0
59742_terrestrial,2,1,1,1,3,50,50
59743_terrestrial,11,26,7,4,37,63.63636363636363,36.36363636363637
59790_terrestrial,9,25,7,2,34,77.77777777777779,22.22222222222222
59791_terrestrial,9,25,7,2,34,77.77777777777779,22.22222222222222
59792_terrestrial,9,25,7,2,34,77.77777777777779,22.22222222222222
59793_terrestrial,8,25,6,2,33,75,25
59794_terrestrial,9,25,6,3,34,66.66666666666666,33.33333333333333
59795_terrestrial,8,25,6,2,33,75,25
59859_terrestrial,1,19,0,1,20,0,100
59860_terrestrial,1,19,0,1,20,0,100
59861_terrestrial,1,19,0,1,20,0,100
59862_terrestrial,3,19,2,1,22,66.66666666666666,33.33333333333333
59863_terrestrial,3,19,2,1,22,66.66666666666666,33.33333333333333
59864_terrestrial,3,19,2,1,22,66.66666666666666,33.33333333333333
59871_terrestrial,5,19,4,1,24,80,20
59874_terrestrial,7,19,6,1,26,85.71428571428571,14.285714285714285
59909_terrestrial,4,24,2,2,28,50,50
59910_terrestrial,7,24,4,3,31,57.14285714285714,42.857142857142854
59911_terrestrial,7,24,4,3,31,57.14285714285714,42.857142857142854
59912_terrestrial,7,25,4,3,32,57.14285714285714,42.857142857142854
59914_terrestrial,9,25,6,3,34,66.66666666666666,33.33333333333333
59915_terrestrial,3,0,2,1,3,66.66666666666666,33.33333333333333
59916_terrestrial,3,0,2,1,3,66.66666666666666,33.33333333333333
60102_terrestrial,1,0,0,1,1,0,100
60103_terrestrial,10,22,6,4,32,60,40
60142_terrestrial,9,24,7,2,33,77.77777777777779,22.22222222222222
60143_terrestrial,9,24,7,2,33,77.77777777777779,22.22222222222222
60144_terrestrial,9,24,7,2,33,77.77777777777779,22.22222222222222
60145_terrestrial,10,23,7,3,33,70,30
60146_terrestrial,10,25,7,3,35,70,30
60147_terrestrial,10,25,7,3,35,70,30
60148_terrestrial,9,25,7,2,34,77.77777777777779,22.22222222222222
60149_terrestrial,9,25,7,2,34,77.77777777777779,22.22222222222222
60150_terrestrial,9,25,7,2,34,77.77777777777779,22.22222222222222
60151_terrestrial,9,25,7,2,34,77.77777777777779,22.22222222222222
60152_terrestrial,9,25,7,2,34,77.77777777777779,22.22222222222222
60153_terrestrial,8,25,6,2,33,75,25
60154_terrestrial,8,25,6,2,33,75,25
60155_terrestrial,8,25,6,2,33,75,25
60217_terrestrial,1,19,0,1,20,0,100
60218_terrestrial,1,19,0,1,20,0,100
60219_terrestrial,3,19,2,1,22,66.66666666666666,33.33333333333333
60220_terrestrial,3,19,2,1,22,66.66666666666666,33.33333333333333
60221_terrestrial,3,19,2,1,22,66.66666666666666,33.33333333333333
60222_terrestrial,3,19,2,1,22,66.66666666666666,33.33333333333333
60223_terrestrial,3,19,2,1,22,66.66666666666666,33.33333333333333
60224_terrestrial,3,19,2,1,22,66.66666666666666,33.33333333333333
60225_terrestrial,3,19,2,1,22,66.66666666666666,33.33333333333333
60226_terrestrial,3,18,2,1,21,66.66666666666666,33.33333333333333
60227_terrestrial,3,18,2,1,21,66.66666666666666,33.33333333333333
60252_terrestrial,3,0,2,1,3,66.66666666666666,33.33333333333333
60253_terrestrial,4,20,2,2,24,50,50
60254_terrestrial,4,20,2,2,24,50,50
60255_terrestrial,3,20,2,1,23,66.66666666666666,33.33333333333333
60256_terrestrial,3,20,2,1,23,66.66666666666666,33.33333333333333
60266_terrestrial,5,20,2,3,25,40,60
60267_terrestrial,5,23,2,3,28,40,60
60268_terrestrial,5,24,2,3,29,40,60
60269_terrestrial,5,24,2,3,29,40,60
60270_terrestrial,5,24,2,3,29,40,60
60271_terrestrial,1,0,0,1,1,0,100
60272_terrestrial,1,0,0,1,1,0,100
60462_terrestrial,1,0,0,1,1,0,100
60463_terrestrial,10,21,6,4,31,60,40
60464_terrestrial,10,21,6,4,31,60,40
60465_terrestrial,7,21,3,4,28,42.857142857142854,57.14285714285714
60467_terrestrial,10,21,5,5,31,50,50
60468_terrestrial,10,21,5,5,31,50,50
60469_terrestrial,10,21,5,5,31,50,50
60470_terrestrial,8,21,3,5,29,37.5,62.5
60496_terrestrial,5,19,4,1,24,80,20
60497_terrestrial,6,21,5,1,27,83.33333333333334,16.666666666666664
60498_terrestrial,6,21,5,1,27,83.33333333333334,16.666666666666664
60499_terrestrial,1,3,1,0,4,100,0
60502_terrestrial,8,23,6,2,31,75,25
60503_terrestrial,7,23,5,2,30,71.42857142857143,28.57142857142857
60504_terrestrial,8,23,6,2,31,75,25
60505_terrestrial,3,0,3,0,3,100,0
60506_terrestrial,3,0,3,0,3,100,0
60507_terrestrial,3,0,3,0,3,100,0
60578_terrestrial,3,19,2,1,22,66.66666666666666,33.33333333333333
60579_terrestrial,1,19,0,1,20,0,100
60580_terrestrial,3,19,2,1,22,66.66666666666666,33.33333333333333
60581_terrestrial,3,18,2,1,21,66.66666666666666,33.33333333333333
60582_terrestrial,3,18,2,1,21,66.66666666666666,33.33333333333333
60583_terrestrial,3,18,2,1,21,66.66666666666666,33.33333333333333
60585_terrestrial,3,18,2,1,21,66.66666666666666,33.33333333333333
60586_terrestrial,3,18,2,1,21,66.66666666666666,33.33333333333333
60587_terrestrial,3,18,2,1,21,66.66666666666666,33.33333333333333
60589_terrestrial,1,18,0,1,19,0,100
60590_terrestrial,1,18,0,1,19,0,100
60591_terrestrial,1,18,0,1,19,0,100
60592_terrestrial,3,18,2,1,21,66.66666666666666,33.33333333333333
60593_terrestrial,3,18,2,1,21,66.66666666666666,33.33333333333333
60594_terrestrial,3,18,2,1,21,66.66666666666666,33.33333333333333
60611_terrestrial,3,0,2,1,3,66.66666666666666,33.33333333333333
60612_terrestrial,4,18,2,2,22,50,50
60613_terrestrial,4,18,2,2,22,50,50
60614_terrestrial,2,18,0,2,20,0,100
60615_terrestrial,3,20,2,1,23,66.66666666666666,33.33333333333333
60616_terrestrial,3,20,2,1,23,66.66666666666666,33.33333333333333
60617_terrestrial,3,18,2,1,21,66.66666666666666,33.33333333333333
60822_terrestrial,3,0,3,0,3,100,0
60823_terrestrial,7,19,5,2,26,71.42857142857143,28.57142857142857
60824_terrestrial,9,21,5,4,30,55.55555555555556,44.44444444444444
60825_terrestrial,9,21,5,4,30,55.55555555555556,44.44444444444444
60826_terrestrial,8,21,5,3,29,62.5,37.5
60827_terrestrial,8,21,5,3,29,62.5,37.5
60828_terrestrial,9,21,5,4,30,55.55555555555556,44.44444444444444
60856_terrestrial,6,19,5,1,25,83.33333333333334,16.666666666666664
60857_terrestrial,6,19,5,1,25,83.33333333333334,16.666666666666664
60859_terrestrial,1,3,1,0,4,100,0
60860_terrestrial,4,19,3,1,23,75,25
60861_terrestrial,4,19,3,1,23,75,25
60862_terrestrial,3,17,2,1,20,66.66666666666666,33.33333333333333
60865_terrestrial,6,17,5,1,23,83.33333333333334,16.666666666666664
60866_terrestrial,6,17,5,1,23,83.33333333333334,16.666666666666664
60867_terrestrial,3,17,2,1,20,66.66666666666666,33.33333333333333
60868_terrestrial,3,0,3,0,3,100,0
60869_terrestrial,3,0,3,0,3,100,0
60870_terrestrial,3,0,3,0,3,100,0
60871_terrestrial,3,0,3,0,3,100,0
60872_terrestrial,3,0,3,0,3,100,0
60873_terrestrial,3,0,3,0,3,100,0
60939_terrestrial,3,18,2,1,21,66.66666666666666,33.33333333333333
60940_terrestrial,3,18,2,1,21,66.66666666666666,33.33333333333333
60941_terrestrial,3,18,2,1,21,66.66666666666666,33.33333333333333
60942_terrestrial,3,18,2,1,21,66.66666666666666,33.33333333333333
60943_terrestrial,1,18,0,1,19,0,100
60944_terrestrial,3,18,2,1,21,66.66666666666666,33.33333333333333
60949_terrestrial,3,18,2,1,21,66.66666666666666,33.33333333333333
60950_terrestrial,3,18,2,1,21,66.66666666666666,33.33333333333333
60951_terrestrial,3,18,2,1,21,66.66666666666666,33.33333333333333
60952_terrestrial,3,18,2,1,21,66.66666666666666,33.33333333333333
60953_terrestrial,3,18,2,1,21,66.66666666666666,33.33333333333333
60954_terrestrial,3,18,2,1,21,66.66666666666666,33.33333333333333
60955_terrestrial,3,18,2,1,21,66.66666666666666,33.33333333333333
60959_terrestrial,1,18,0,1,19,0,100
60960_terrestrial,3,18,2,1,21,66.66666666666666,33.33333333333333
60961_terrestrial,3,18,2,1,21,66.66666666666666,33.33333333333333
60974_terrestrial,1,18,0,1,19,0,100
60975_terrestrial,1,18,0,1,19,0,100
60976_terrestrial,3,18,2,1,21,66.66666666666666,33.33333333333333
60977_terrestrial,3,18,2,1,21,66.66666666666666,33.33333333333333
60978_terrestrial,3,18,2,1,21,66.66666666666666,33.33333333333333
60984_terrestrial,3,18,2,1,21,66.66666666666666,33.33333333333333
60985_terrestrial,3,18,2,1,21,66.66666666666666,33.33333333333333
60986_terrestrial,3,18,2,1,21,66.66666666666666,33.33333333333333
60987_terrestrial,3,18,2,1,21,66.66666666666666,33.33333333333333
60988_terrestrial,3,18,2,1,21,66.66666666666666,33.33333333333333
60989_terrestrial,3,18,2,1,21,66.66666666666666,33.33333333333333
60990_terrestrial,3,20,2,1,23,66.66666666666666,33.33333333333333
60991_terrestrial,3,18,2,1,21,66.66666666666666,33.33333333333333
61180_terrestrial,4,12,3,1,16,75,25
61181_terrestrial,6,17,5,1,23,83.33333333333334,16.666666666666664
61182_terrestrial,3,0,3,0,3,100,0
61226_terrestrial,4,17,3,1,21,75,25
61227_terrestrial,4,17,3,1,21,75,25
61229_terrestrial,4,17,3,1,21,75,25
61230_terrestrial,4,17,3,1,21,75,25
61231_terrestrial,4,17,3,1,21,75,25
61232_terrestrial,4,17,3,1,21,75,25
61233_terrestrial,4,17,3,1,21,75,25
61234_terrestrial,3,17,2,1,20,66.66666666666666,33.33333333333333
61235_terrestrial,3,17,2,1,20,66.66666666666666,33.33333333333333
61301_terrestrial,1,18,0,1,19,0,100
61302_terrestrial,3,18,2,1,21,66.66666666666666,33.33333333333333
61303_terrestrial,1,18,0,1,19,0,100
61304_terrestrial,3,18,2,1,21,66.66666666666666,33.33333333333333
61305_terrestrial,1,18,0,1,19,0,100
61308_terrestrial,3,18,2,1,21,66.66666666666666,33.33333333333333
61309_terrestrial,3,18,2,1,21,66.66666666666666,33.33333333333333
61310_terrestrial,3,18,2,1,21,66.66666666666666,33.33333333333333
61314_terrestrial,3,18,2,1,21,66.66666666666666,33.33333333333333
61315_terrestrial,3,18,2,1,21,66.66666666666666,33.33333333333333
61316_terrestrial,3,18,2,1,21,66.66666666666666,33.33333333333333
61317_terrestrial,3,18,2,1,21,66.66666666666666,33.33333333333333
61319_terrestrial,3,18,2,1,21,66.66666666666666,33.33333333333333
61320_terrestrial,3,18,2,1,21,66.66666666666666,33.33333333333333
61321_terrestrial,3,18,2,1,21,66.66666666666666,33.33333333333333
61326_terrestrial,1,18,0,1,19,0,100
61327_terrestrial,3,18,2,1,21,66.66666666666666,33.33333333333333
61328_terrestrial,3,18,2,1,21,66.66666666666666,33.33333333333333
61329_terrestrial,1,18,0,1,19,0,100
61330_terrestrial,3,18,2,1,21,66.66666666666666,33.33333333333333
61331_terrestrial,3,18,2,1,21,66.66666666666666,33.33333333333333
61336_terrestrial,3,18,2,1,21,66.66666666666666,33.33333333333333
61337_terrestrial,3,18,2,1,21,66.66666666666666,33.33333333333333
61341_terrestrial,3,18,2,1,21,66.66666666666666,33.33333333333333
61342_terrestrial,3,18,2,1,21,66.66666666666666,33.33333333333333
61349_terrestrial,3,18,2,1,21,66.66666666666666,33.33333333333333
61350_terrestrial,3,18,2,1,21,66.66666666666666,33.33333333333333
61539_terrestrial,3,0,3,0,3,100,0
61540_terrestrial,4,17,3,1,21,75,25
61541_terrestrial,4,17,3,1,21,75,25
61577_terrestrial,4,17,3,1,21,75,25
61578_terrestrial,3,17,2,1,20,66.66666666666666,33.33333333333333
61579_terrestrial,3,17,2,1,20,66.66666666666666,33.33333333333333
61580_terrestrial,4,17,3,1,21,75,25
61582_terrestrial,4,17,3,1,21,75,25
61583_terrestrial,4,17,3,1,21,75,25
61584_terrestrial,4,17,3,1,21,75,25
61585_terrestrial,4,17,3,1,21,75,25
61586_terrestrial,4,17,3,1,21,75,25
61587_terrestrial,4,17,3,1,21,75,25
61588_terrestrial,4,17,3,1,21,75,25
61589_terrestrial,4,17,3,1,21,75,25
61590_terrestrial,4,17,3,1,21,75,25
61591_terrestrial,3,0,3,0,3,100,0
61592_terrestrial,3,0,3,0,3,100,0
61668_terrestrial,3,18,2,1,21,66.66666666666666,33.33333333333333
61669_terrestrial,3,18,2,1,21,66.66666666666666,33.33333333333333
61670_terrestrial,3,18,2,1,21,66.66666666666666,33.33333333333333
61671_terrestrial,3,18,2,1,21,66.66666666666666,33.33333333333333
61672_terrestrial,3,18,2,1,21,66.66666666666666,33.33333333333333
61673_terrestrial,3,18,2,1,21,66.66666666666666,33.33333333333333
61674_terrestrial,3,18,2,1,21,66.66666666666666,33.33333333333333
61675_terrestrial,3,18,2,1,21,66.66666666666666,33.33333333333333
61676_terrestrial,3,18,2,1,21,66.66666666666666,33.33333333333333
61677_terrestrial,3,18,2,1,21,66.66666666666666,33.33333333333333
61678_terrestrial,3,18,2,1,21,66.66666666666666,33.33333333333333
61699_terrestrial,3,18,2,1,21,66.66666666666666,33.33333333333333
61700_terrestrial,3,18,2,1,21,66.66666666666666,33.33333333333333
61701_terrestrial,3,18,2,1,21,66.66666666666666,33.33333333333333
61702_terrestrial,3,18,2,1,21,66.66666666666666,33.33333333333333
61901_terrestrial,4,17,3,1,21,75,25
61902_terrestrial,4,17,3,1,21,75,25
61903_terrestrial,4,18,3,1,22,75,25
61904_terrestrial,2,17,1,1,19,50,50
61926_terrestrial,3,17,2,1,20,66.66666666666666,33.33333333333333
61927_terrestrial,4,17,3,1,21,75,25
61928_terrestrial,4,17,3,1,21,75,25
61929_terrestrial,4,17,3,1,21,75,25
61930_terrestrial,4,16,3,1,20,75,25
61937_terrestrial,4,16,3,1,20,75,25
61938_terrestrial,4,16,3,1,20,75,25
61939_terrestrial,4,16,3,1,20,75,25
61942_terrestrial,4,17,3,1,21,75,25
61943_terrestrial,4,17,3,1,21,75,25
61945_terrestrial,4,16,3,1,20,75,25
61946_terrestrial,4,16,3,1,20,75,25
61947_terrestrial,4,16,3,1,20,75,25
61948_terrestrial,3,0,3,0,3,100,0
62029_terrestrial,1,18,0,1,19,0,100
62030_terrestrial,1,18,0,1,19,0,100
62031_terrestrial,1,18,0,1,19,0,100
62032_terrestrial,1,18,0,1,19,0,100
62033_terrestrial,1,18,0,1,19,0,100
62034_terrestrial,1,18,0,1,19,0,100
62035_terrestrial,1,18,0,1,19,0,100
62036_terrestrial,1,18,0,1,19,0,100
62037_terrestrial,1,18,0,1,19,0,100
62038_terrestrial,1,18,0,1,19,0,100
62039_terrestrial,3,18,2,1,21,66.66666666666666,33.33333333333333
62040_terrestrial,3,18,2,1,21,66.66666666666666,33.33333333333333
62261_terrestrial,1,0,1,0,1,100,0
62262_terrestrial,2,18,1,1,20,50,50
62263_terrestrial,2,18,1,1,20,50,50
62264_terrestrial,2,18,1,1,20,50,50
62265_terrestrial,4,17,3,1,21,75,25
62266_terrestrial,4,17,3,1,21,75,25
62267_terrestrial,4,17,3,1,21,75,25
62268_terrestrial,4,17,3,1,21,75,25
62269_terrestrial,4,16,3,1,20,75,25
62287_terrestrial,3,16,2,1,19,66.66666666666666,33.33333333333333
62288_terrestrial,3,16,2,1,19,66.66666666666666,33.33333333333333
62289_terrestrial,4,16,3,1,20,75,25
62290_terrestrial,4,16,3,1,20,75,25
62291_terrestrial,4,16,3,1,20,75,25
62292_terrestrial,4,16,3,1,20,75,25
62293_terrestrial,4,16,3,1,20,75,25
62294_terrestrial,3,16,2,1,19,66.66666666666666,33.33333333333333
62295_terrestrial,4,16,3,1,20,75,25
62296_terrestrial,4,16,3,1,20,75,25
62297_terrestrial,4,16,3,1,20,75,25
62298_terrestrial,4,16,3,1,20,75,25
62299_terrestrial,4,16,3,1,20,75,25
62300_terrestrial,4,16,3,1,20,75,25
62301_terrestrial,4,16,3,1,20,75,25
62302_terrestrial,4,16,3,1,20,75,25
62303_terrestrial,4,16,3,1,20,75,25
62304_terrestrial,4,16,3,1,20,75,25
62305_terrestrial,4,16,3,1,20,75,25
62306_terrestrial,3,16,2,1,19,66.66666666666666,33.33333333333333
62307_terrestrial,3,16,2,1,19,66.66666666666666,33.33333333333333
62308_terrestrial,3,16,2,1,19,66.66666666666666,33.33333333333333
62627_terrestrial,2,16,1,1,18,50,50
62628_terrestrial,4,16,3,1,20,75,25
62629_terrestrial,4,16,3,1,20,75,25
62630_terrestrial,2,16,1,1,18,50,50
62631_terrestrial,4,16,3,1,20,75,25
62632_terrestrial,4,16,3,1,20,75,25
62633_terrestrial,4,16,3,1,20,75,25
62634_terrestrial,4,16,3,1,20,75,25
62635_terrestrial,4,16,3,1,20,75,25
62636_terrestrial,4,16,3,1,20,75,25
62637_terrestrial,3,16,2,1,19,66.66666666666666,33.33333333333333
62641_terrestrial,4,15,3,1,19,75,25
62642_terrestrial,4,15,3,1,19,75,25
62643_terrestrial,3,0,3,0,3,100,0
62644_terrestrial,3,0,3,0,3,100,0
62645_terrestrial,2,16,1,1,18,50,50
62646_terrestrial,1,16,0,1,17,0,100
62647_terrestrial,1,16,0,1,17,0,100
62648_terrestrial,3,16,2,1,19,66.66666666666666,33.33333333333333
62649_terrestrial,3,16,2,1,19,66.66666666666666,33.33333333333333
62650_terrestrial,3,16,2,1,19,66.66666666666666,33.33333333333333
62651_terrestrial,3,16,2,1,19,66.66666666666666,33.33333333333333
62652_terrestrial,4,16,3,1,20,75,25
62653_terrestrial,4,16,3,1,20,75,25
62654_terrestrial,4,16,3,1,20,75,25
62655_terrestrial,4,16,3,1,20,75,25
62656_terrestrial,4,16,3,1,20,75,25
62657_terrestrial,4,16,3,1,20,75,25
62658_terrestrial,4,16,3,1,20,75,25
62659_terrestrial,4,16,3,1,20,75,25
62660_terrestrial,4,16,3,1,20,75,25
62661_terrestrial,4,16,3,1,20,75,25
62662_terrestrial,4,16,3,1,20,75,25
62663_terrestrial,4,16,3,1,20,75,25
62664_terrestrial,4,16,3,1,20,75,25
62665_terrestrial,4,16,3,1,20,75,25
62666_terrestrial,3,16,2,1,19,66.66666666666666,33.33333333333333
62667_terrestrial,3,16,2,1,19,66.66666666666666,33.33333333333333
62668_terrestrial,3,16,2,1,19,66.66666666666666,33.33333333333333
62669_terrestrial,3,16,2,1,19,66.66666666666666,33.33333333333333
62670_terrestrial,3,16,2,1,19,66.66666666666666,33.33333333333333
62671_terrestrial,3,16,2,1,19,66.66666666666666,33.33333333333333
62672_terrestrial,3,16,2,1,19,66.66666666666666,33.33333333333333
62673_terrestrial,3,16,2,1,19,66.66666666666666,33.33333333333333
62674_terrestrial,3,16,2,1,19,66.66666666666666,33.33333333333333
62675_terrestrial,3,16,2,1,19,66.66666666666666,33.33333333333333
62676_terrestrial,3,16,2,1,19,66.66666666666666,33.33333333333333
62677_terrestrial,3,16,2,1,19,66.66666666666666,33.33333333333333
62996_terrestrial,1,16,0,1,17,0,100
62997_terrestrial,3,16,2,1,19,66.66666666666666,33.33333333333333
62998_terrestrial,4,16,3,1,20,75,25
62999_terrestrial,4,16,3,1,20,75,25
63000_terrestrial,4,16,3,1,20,75,25
63014_terrestrial,1,16,0,1,17,0,100
63015_terrestrial,3,16,2,1,19,66.66666666666666,33.33333333333333
63016_terrestrial,3,16,2,1,19,66.66666666666666,33.33333333333333
63017_terrestrial,3,16,2,1,19,66.66666666666666,33.33333333333333
63018_terrestrial,3,16,2,1,19,66.66666666666666,33.33333333333333
63019_terrestrial,3,16,2,1,19,66.66666666666666,33.33333333333333
63020_terrestrial,3,16,2,1,19,66.66666666666666,33.33333333333333
63021_terrestrial,3,16,2,1,19,66.66666666666666,33.33333333333333
63022_terrestrial,3,16,2,1,19,66.66666666666666,33.33333333333333
63023_terrestrial,3,16,2,1,19,66.66666666666666,33.33333333333333
63024_terrestrial,3,16,2,1,19,66.66666666666666,33.33333333333333
63025_terrestrial,3,16,2,1,19,66.66666666666666,33.33333333333333
63026_terrestrial,3,16,2,1,19,66.66666666666666,33.33333333333333
63027_terrestrial,3,16,2,1,19,66.66666666666666,33.33333333333333
63028_terrestrial,3,16,2,1,19,66.66666666666666,33.33333333333333
63029_terrestrial,3,16,2,1,19,66.66666666666666,33.33333333333333
63030_terrestrial,3,16,2,1,19,66.66666666666666,33.33333333333333
63031_terrestrial,3,16,2,1,19,66.66666666666666,33.33333333333333
63032_terrestrial,3,16,2,1,19,66.66666666666666,33.33333333333333
63033_terrestrial,3,16,2,1,19,66.66666666666666,33.33333333333333
63034_terrestrial,3,16,2,1,19,66.66666666666666,33.33333333333333
63035_terrestrial,3,16,2,1,19,66.66666666666666,33.33333333333333
63036_terrestrial,3,16,2,1,19,66.66666666666666,33.33333333333333
63037_terrestrial,3,16,2,1,19,66.66666666666666,33.33333333333333
63038_terrestrial,3,16,2,1,19,66.66666666666666,33.33333333333333
63039_terrestrial,3,16,2,1,19,66.66666666666666,33.33333333333333
63040_terrestrial,3,16,2,1,19,66.66666666666666,33.33333333333333
63041_terrestrial,3,16,2,1,19,66.66666666666666,33.33333333333333
63042_terrestrial,3,16,2,1,19,66.66666666666666,33.33333333333333
63043_terrestrial,1,16,0,1,17,0,100
1441_marine,3,2,3,0,5,100,0
1442_marine,3,2,3,0,5,100,0
1443_marine,3,2,3,0,5,100,0
1800_marine,3,2,3,0,5,100,0
1801_marine,3,3,3,0,6,100,0
1802_marine,3,3,3,0,6,100,0
1803_marine,3,3,3,0,6,100,0
1804_marine,3,3,3,0,6,100,0
1805_marine,3,3,3,0,6,100,0
1806_marine,3,3,3,0,6,100,0
1807_marine,3,3,3,0,6,100,0
1808_marine,3,3,3,0,6,100,0
1809_marine,3,3,3,0,6,100,0
1810_marine,3,3,3,0,6,100,0
1811_marine,3,3,3,0,6,100,0
1812_marine,3,3,3,0,6,100,0
1813_marine,3,3,3,0,6,100,0
1814_marine,3,3,3,0,6,100,0
1815_marine,3,3,3,0,6,100,0
1816_marine,3,3,3,0,6,100,0
1817_marine,3,3,3,0,6,100,0
1925_marine,3,5,3,0,8,100,0
1926_marine,3,5,3,0,8,100,0
1927_marine,3,5,3,0,8,100,0
1928_marine,3,5,3,0,8,100,0
1929_marine,3,5,3,0,8,100,0
1930_marine,3,5,3,0,8,100,0
1931_marine,3,5,3,0,8,100,0
1932_marine,3,5,3,0,8,100,0
1933_marine,3,5,3,0,8,100,0
1934_marine,3,5,3,0,8,100,0
1935_marine,3,5,3,0,8,100,0
1936_marine,3,5,3,0,8,100,0
1937_marine,3,5,3,0,8,100,0
1938_marine,3,5,3,0,8,100,0
1939_marine,3,5,3,0,8,100,0
1940_marine,3,5,3,0,8,100,0
1941_marine,3,5,3,0,8,100,0
1942_marine,3,5,3,0,8,100,0
1943_marine,3,5,3,0,8,100,0
1944_marine,3,5,3,0,8,100,0
1945_marine,3,5,3,0,8,100,0
1946_marine,3,5,3,0,8,100,0
1947_marine,3,5,3,0,8,100,0
1948_marine,3,5,3,0,8,100,0
1949_marine,3,5,3,0,8,100,0
1950_marine,3,6,3,0,9,100,0
1951_marine,3,6,3,0,9,100,0
1952_marine,3,6,3,0,9,100,0
1953_marine,3,6,3,0,9,100,0
1954_marine,3,6,3,0,9,100,0
1955_marine,3,6,3,0,9,100,0
1956_marine,3,6,3,0,9,100,0
1957_marine,3,5,3,0,8,100,0
1958_marine,3,5,3,0,8,100,0
1959_marine,3,5,3,0,8,100,0
1960_marine,3,5,3,0,8,100,0
1961_marine,3,5,3,0,8,100,0
1962_marine,3,5,3,0,8,100,0
1963_marine,3,5,3,0,8,100,0
1964_marine,3,5,3,0,8,100,0
1965_marine,3,3,3,0,6,100,0
1966_marine,3,3,3,0,6,100,0
1967_marine,3,3,3,0,6,100,0
1968_marine,3,3,3,0,6,100,0
2133_marine,3,2,3,0,5,100,0
2134_marine,3,2,3,0,5,100,0
2135_marine,3,2,3,0,5,100,0
2136_marine,3,2,3,0,5,100,0
2137_marine,3,2,3,0,5,100,0
2138_marine,3,2,3,0,5,100,0
2139_marine,3,2,3,0,5,100,0
2140_marine,3,2,3,0,5,100,0
2141_marine,3,2,3,0,5,100,0
2142_marine,3,2,3,0,5,100,0
2143_marine,3,2,3,0,5,100,0
2144_marine,3,2,3,0,5,100,0
2145_marine,3,2,3,0,5,100,0
2146_marine,3,2,3,0,5,100,0
2147_marine,3,2,3,0,5,100,0
2148_marine,3,2,3,0,5,100,0
2149_marine,3,2,3,0,5,100,0
2150_marine,3,2,3,0,5,100,0
2151_marine,3,2,3,0,5,100,0
2152_marine,3,2,3,0,5,100,0
2153_marine,3,2,3,0,5,100,0
2154_marine,3,2,3,0,5,100,0
2155_marine,3,2,3,0,5,100,0
2156_marine,3,2,3,0,5,100,0
2157_marine,3,2,3,0,5,100,0
2158_marine,3,2,3,0,5,100,0
2159_marine,3,2,3,0,5,100,0
2160_marine,3,2,3,0,5,100,0
2161_marine,3,3,3,0,6,100,0
2162_marine,3,3,3,0,6,100,0
2163_marine,3,3,3,0,6,100,0
2164_marine,3,3,3,0,6,100,0
2165_marine,3,3,3,0,6,100,0
2166_marine,3,3,3,0,6,100,0
2167_marine,3,3,3,0,6,100,0
2168_marine,3,3,3,0,6,100,0
2169_marine,3,3,3,0,6,100,0
2170_marine,3,3,3,0,6,100,0
2171_marine,3,3,3,0,6,100,0
2172_marine,5,3,5,0,8,100,0
2173_marine,5,3,5,0,8,100,0
2174_marine,5,3,5,0,8,100,0
2175_marine,5,3,5,0,8,100,0
2176_marine,5,3,5,0,8,100,0
2177_marine,5,3,5,0,8,100,0
2178_marine,5,3,5,0,8,100,0
2179_marine,5,3,5,0,8,100,0
2180_marine,5,3,5,0,8,100,0
2181_marine,5,3,5,0,8,100,0
2182_marine,3,3,3,0,6,100,0
2183_marine,3,3,3,0,6,100,0
2263_marine,30,9,18,14,39,60,46.666666666666664
2264_marine,30,9,18,14,39,60,46.666666666666664
2265_marine,30,9,18,14,39,60,46.666666666666664
2266_marine,30,9,18,14,39,60,46.666666666666664
2267_marine,28,9,16,14,37,57.14285714285714,50
2268_marine,28,9,16,14,37,57.14285714285714,50
2269_marine,29,9,17,14,38,58.620689655172406,48.275862068965516
2270_marine,28,9,16,14,37,57.14285714285714,50
2271_marine,28,9,16,14,37,57.14285714285714,50
2272_marine,28,9,16,14,37,57.14285714285714,50
2275_marine,5,6,5,0,11,100,0
2276_marine,5,6,5,0,11,100,0
2277_marine,5,6,5,0,11,100,0
2278_marine,3,6,3,0,9,100,0
2279_marine,3,6,3,0,9,100,0
2280_marine,3,5,3,0,8,100,0
2281_marine,3,5,3,0,8,100,0
2282_marine,3,5,3,0,8,100,0
2283_marine,3,5,3,0,8,100,0
2284_marine,3,5,3,0,8,100,0
2285_marine,3,5,3,0,8,100,0
2286_marine,3,5,3,0,8,100,0
2287_marine,3,5,3,0,8,100,0
2288_marine,3,5,3,0,8,100,0
2289_marine,3,5,3,0,8,100,0
2290_marine,3,5,3,0,8,100,0
2291_marine,3,5,3,0,8,100,0
2292_marine,3,5,3,0,8,100,0
2293_marine,3,5,3,0,8,100,0
2294_marine,7,10,6,4,17,85.71428571428571,57.14285714285714
2295_marine,18,10,11,4,28,61.111111111111114,22.22222222222222
2296_marine,18,10,11,4,28,61.111111111111114,22.22222222222222
2297_marine,18,10,11,4,28,61.111111111111114,22.22222222222222
2298_marine,18,10,11,4,28,61.111111111111114,22.22222222222222
2299_marine,18,10,11,4,28,61.111111111111114,22.22222222222222
2300_marine,8,8,7,4,16,87.5,50
2301_marine,8,8,7,4,16,87.5,50
2302_marine,17,10,11,4,27,64.70588235294117,23.52941176470588
2303_marine,17,10,11,4,27,64.70588235294117,23.52941176470588
2304_marine,17,10,11,4,27,64.70588235294117,23.52941176470588
2305_marine,17,10,11,4,27,64.70588235294117,23.52941176470588
2306_marine,17,10,11,4,27,64.70588235294117,23.52941176470588
2307_marine,17,10,11,4,27,64.70588235294117,23.52941176470588
2308_marine,17,10,11,4,27,64.70588235294117,23.52941176470588
2309_marine,17,11,11,4,28,64.70588235294117,23.52941176470588
2310_marine,17,11,11,4,28,64.70588235294117,23.52941176470588
2311_marine,18,11,12,4,29,66.66666666666666,22.22222222222222
2312_marine,18,11,12,4,29,66.66666666666666,22.22222222222222
2313_marine,18,11,12,4,29,66.66666666666666,22.22222222222222
2314_marine,18,11,12,4,29,66.66666666666666,22.22222222222222
2315_marine,18,11,12,4,29,66.66666666666666,22.22222222222222
2316_marine,18,11,12,4,29,66.66666666666666,22.22222222222222
2317_marine,3,6,3,0,9,100,0
2318_marine,3,6,3,0,9,100,0
2319_marine,3,6,3,0,9,100,0
2320_marine,3,6,3,0,9,100,0
2321_marine,3,5,3,0,8,100,0
2322_marine,3,5,3,0,8,100,0
2323_marine,3,5,3,0,8,100,0
2324_marine,3,5,3,0,8,100,0
2325_marine,3,5,3,0,8,100,0
2326_marine,3,5,3,0,8,100,0
2327_marine,3,5,3,0,8,100,0
2328_marine,3,5,3,0,8,100,0
2329_marine,3,5,3,0,8,100,0
2330_marine,3,3,3,0,6,100,0
2331_marine,3,3,3,0,6,100,0
2332_marine,3,3,3,0,6,100,0
2333_marine,3,5,3,0,8,100,0
2334_marine,5,5,5,0,10,100,0
2335_marine,5,5,5,0,10,100,0
2336_marine,5,7,5,0,12,100,0
2337_marine,5,7,5,0,12,100,0
2338_marine,5,7,5,0,12,100,0
2339_marine,5,7,5,0,12,100,0
2340_marine,5,7,5,0,12,100,0
2341_marine,5,7,5,0,12,100,0
2342_marine,5,7,5,0,12,100,0
2343_marine,5,5,5,0,10,100,0
2344_marine,5,7,5,0,12,100,0
2345_marine,5,7,5,0,12,100,0
2346_marine,5,7,5,0,12,100,0
2347_marine,5,5,5,0,10,100,0
2348_marine,5,5,5,0,10,100,0
2349_marine,7,5,7,0,12,100,0
2350_marine,7,5,7,0,12,100,0
2351_marine,7,5,7,0,12,100,0
2352_marine,7,5,7,0,12,100,0
2353_marine,7,5,7,0,12,100,0
2354_marine,7,7,7,0,14,100,0
2381_marine,11,5,11,0,16,100,0
2382_marine,11,5,11,0,16,100,0
2383_marine,11,5,11,0,16,100,0
2384_marine,11,5,11,0,16,100,0
2385_marine,11,5,11,0,16,100,0
2386_marine,11,5,11,0,16,100,0
2387_marine,11,5,11,0,16,100,0
2388_marine,11,5,11,0,16,100,0
2389_marine,9,5,9,0,14,100,0
2390_marine,9,5,9,0,14,100,0
2391_marine,9,5,9,0,14,100,0
2392_marine,9,5,9,0,14,100,0
2393_marine,7,5,7,0,12,100,0
2394_marine,7,5,7,0,12,100,0
2395_marine,7,5,7,0,12,100,0
2396_marine,7,5,7,0,12,100,0
2397_marine,7,5,7,0,12,100,0
2398_marine,8,5,8,0,13,100,0
2399_marine,8,5,8,0,13,100,0
2400_marine,8,5,8,0,13,100,0
2401_marine,8,5,8,0,13,100,0
2402_marine,8,5,8,0,13,100,0
2403_marine,8,5,8,0,13,100,0
2404_marine,8,5,8,0,13,100,0
2405_marine,7,5,7,0,12,100,0
2406_marine,7,5,7,0,12,100,0
2407_marine,7,5,7,0,12,100,0
2485_marine,3,3,3,0,6,100,0
2486_marine,3,3,3,0,6,100,0
2487_marine,3,3,3,0,6,100,0
2488_marine,3,3,3,0,6,100,0
2489_marine,3,3,3,0,6,100,0
2490_marine,3,3,3,0,6,100,0
2491_marine,3,3,3,0,6,100,0
2492_marine,3,3,3,0,6,100,0
2493_marine,3,3,3,0,6,100,0
2494_marine,3,3,3,0,6,100,0
2495_marine,3,3,3,0,6,100,0
2496_marine,3,3,3,0,6,100,0
2497_marine,3,3,3,0,6,100,0
2498_marine,3,3,3,0,6,100,0
2499_marine,3,3,3,0,6,100,0
2500_marine,3,3,3,0,6,100,0
2501_marine,3,3,3,0,6,100,0
2502_marine,3,3,3,0,6,100,0
2503_marine,3,3,3,0,6,100,0
2504_marine,3,3,3,0,6,100,0
2505_marine,3,3,3,0,6,100,0
2506_marine,3,3,3,0,6,100,0
2507_marine,3,3,3,0,6,100,0
2508_marine,3,3,3,0,6,100,0
2509_marine,3,3,3,0,6,100,0
2510_marine,3,3,3,0,6,100,0
2511_marine,3,3,3,0,6,100,0
2512_marine,3,3,3,0,6,100,0
2513_marine,3,3,3,0,6,100,0
2514_marine,3,3,3,0,6,100,0
2515_marine,3,3,3,0,6,100,0
2516_marine,3,3,3,0,6,100,0
2517_marine,3,3,3,0,6,100,0
2518_marine,3,3,3,0,6,100,0
2519_marine,3,3,3,0,6,100,0
2520_marine,3,3,3,0,6,100,0
2521_marine,3,3,3,0,6,100,0
2522_marine,3,3,3,0,6,100,0
2523_marine,3,3,3,0,6,100,0
2524_marine,3,3,3,0,6,100,0
2525_marine,3,3,3,0,6,100,0
2526_marine,3,3,3,0,6,100,0
2527_marine,3,3,3,0,6,100,0
2528_marine,3,3,3,0,6,100,0
2529_marine,3,3,3,0,6,100,0
2530_marine,3,3,3,0,6,100,0
2531_marine,5,3,5,0,8,100,0
2532_marine,5,3,5,0,8,100,0
2533_marine,5,3,5,0,8,100,0
2534_marine,5,3,5,0,8,100,0
2535_marine,5,3,5,0,8,100,0
2536_marine,5,3,5,0,8,100,0
2537_marine,5,3,5,0,8,100,0
2538_marine,5,3,5,0,8,100,0
2539_marine,5,3,5,0,8,100,0
2540_marine,5,3,5,0,8,100,0
2541_marine,5,3,5,0,8,100,0
2542_marine,5,3,5,0,8,100,0
2543_marine,3,3,3,0,6,100,0
2544_marine,3,3,3,0,6,100,0
2545_marine,3,3,3,0,6,100,0
2546_marine,3,5,3,0,8,100,0
2608_marine,3,4,3,0,7,100,0
2609_marine,3,4,3,0,7,100,0
2610_marine,3,4,3,0,7,100,0
2611_marine,3,4,3,0,7,100,0
2612_marine,33,7,19,14,40,57.57575757575758,42.42424242424242
2613_marine,33,7,19,14,40,57.57575757575758,42.42424242424242
2614_marine,33,7,19,14,40,57.57575757575758,42.42424242424242
2615_marine,31,7,19,14,38,61.29032258064516,45.16129032258064
2616_marine,31,7,19,14,38,61.29032258064516,45.16129032258064
2617_marine,31,7,19,14,38,61.29032258064516,45.16129032258064
2618_marine,30,7,18,14,37,60,46.666666666666664
2619_marine,30,7,18,14,37,60,46.666666666666664
2620_marine,30,7,18,14,37,60,46.666666666666664
2621_marine,30,7,18,14,37,60,46.666666666666664
2622_marine,30,7,18,14,37,60,46.666666666666664
2623_marine,30,9,18,14,39,60,46.666666666666664
2624_marine,30,9,18,14,39,60,46.666666666666664
2625_marine,30,9,18,14,39,60,46.666666666666664
2626_marine,30,7,18,14,37,60,46.666666666666664
2627_marine,30,9,18,14,39,60,46.666666666666664
2628_marine,28,7,16,14,35,57.14285714285714,50
2629_marine,28,7,16,14,35,57.14285714285714,50
2632_marine,30,7,18,14,37,60,46.666666666666664
2633_marine,31,9,19,14,40,61.29032258064516,45.16129032258064
2634_marine,31,9,19,14,40,61.29032258064516,45.16129032258064
2635_marine,31,9,19,14,40,61.29032258064516,45.16129032258064
2636_marine,31,9,19,14,40,61.29032258064516,45.16129032258064
2637_marine,32,9,19,15,41,59.375,46.875
2638_marine,32,11,19,15,43,59.375,46.875
2639_marine,32,11,19,15,43,59.375,46.875
2640_marine,5,6,5,0,11,100,0
2641_marine,16,10,9,4,26,56.25,25
2642_marine,16,10,9,4,26,56.25,25
2643_marine,3,8,3,0,11,100,0
2644_marine,18,10,11,4,28,61.111111111111114,22.22222222222222
2645_marine,18,10,11,4,28,61.111111111111114,22.22222222222222
2646_marine,18,10,11,4,28,61.111111111111114,22.22222222222222
2647_marine,18,10,11,4,28,61.111111111111114,22.22222222222222
2648_marine,18,10,11,4,28,61.111111111111114,22.22222222222222
2649_marine,18,10,11,4,28,61.111111111111114,22.22222222222222
2650_marine,18,10,11,4,28,61.111111111111114,22.22222222222222
2651_marine,18,10,11,4,28,61.111111111111114,22.22222222222222
2652_marine,18,10,11,4,28,61.111111111111114,22.22222222222222
2653_marine,18,10,11,4,28,61.111111111111114,22.22222222222222
2654_marine,18,10,11,4,28,61.111111111111114,22.22222222222222
2655_marine,18,10,11,4,28,61.111111111111114,22.22222222222222
2656_marine,18,10,11,4,28,61.111111111111114,22.22222222222222
2657_marine,18,10,11,4,28,61.111111111111114,22.22222222222222
2658_marine,18,10,11,4,28,61.111111111111114,22.22222222222222
2659_marine,18,10,11,4,28,61.111111111111114,22.22222222222222
2662_marine,15,5,9,4,20,60,26.666666666666668
2668_marine,17,8,11,4,25,64.70588235294117,23.52941176470588
2669_marine,17,8,11,4,25,64.70588235294117,23.52941176470588
2671_marine,18,10,12,4,28,66.66666666666666,22.22222222222222
2672_marine,18,10,12,4,28,66.66666666666666,22.22222222222222
2673_marine,18,10,12,4,28,66.66666666666666,22.22222222222222
2674_marine,18,10,12,4,28,66.66666666666666,22.22222222222222
2675_marine,18,10,12,4,28,66.66666666666666,22.22222222222222
2676_marine,18,11,12,4,29,66.66666666666666,22.22222222222222
2677_marine,19,11,13,5,30,68.42105263157895,26.31578947368421
2678_marine,18,11,12,4,29,66.66666666666666,22.22222222222222
2679_marine,19,11,13,5,30,68.42105263157895,26.31578947368421
2680_marine,3,6,3,0,9,100,0
2681_marine,8,8,7,4,16,87.5,50
2682_marine,8,5,7,4,13,87.5,50
2683_marine,7,5,6,3,12,85.71428571428571,42.857142857142854
2684_marine,3,5,3,0,8,100,0
2685_marine,3,5,3,0,8,100,0
2686_marine,3,5,3,0,8,100,0
2687_marine,3,5,3,0,8,100,0
2688_marine,7,5,7,0,12,100,0
2689_marine,7,5,7,0,12,100,0
2690_marine,7,7,7,0,14,100,0
2691_marine,7,7,7,0,14,100,0
2692_marine,11,5,11,0,16,100,0
2693_marine,9,5,9,0,14,100,0
2694_marine,7,5,7,0,12,100,0
2695_marine,7,7,7,0,14,100,0
2696_marine,7,7,7,0,14,100,0
2697_marine,7,7,7,0,14,100,0
2698_marine,7,7,7,0,14,100,0
2699_marine,7,7,7,0,14,100,0
2700_marine,7,7,7,0,14,100,0
2701_marine,7,5,7,0,12,100,0
2702_marine,7,5,7,0,12,100,0
2703_marine,7,7,7,0,14,100,0
2704_marine,7,7,7,0,14,100,0
2705_marine,7,7,7,0,14,100,0
2706_marine,9,7,9,0,16,100,0
2707_marine,9,7,9,0,16,100,0
2708_marine,9,7,9,0,16,100,0
2709_marine,9,7,9,0,16,100,0
2710_marine,9,7,9,0,16,100,0
2711_marine,11,7,11,0,18,100,0
2712_marine,11,7,11,0,18,100,0
2713_marine,11,7,11,0,18,100,0
2714_marine,11,7,11,0,18,100,0
2715_marine,12,7,12,1,19,100,8.333333333333332
2716_marine,12,7,12,1,19,100,8.333333333333332
2717_marine,14,7,14,1,21,100,7.142857142857142
2718_marine,14,9,14,1,23,100,7.142857142857142
2719_marine,15,9,15,1,24,100,6.666666666666667
2720_marine,15,7,15,1,22,100,6.666666666666667
2721_marine,15,7,15,1,22,100,6.666666666666667
2722_marine,15,7,15,1,22,100,6.666666666666667
2723_marine,15,7,15,1,22,100,6.666666666666667
2724_marine,15,7,15,1,22,100,6.666666666666667
2725_marine,15,5,15,1,20,100,6.666666666666667
2726_marine,15,5,15,1,20,100,6.666666666666667
2727_marine,15,5,15,1,20,100,6.666666666666667
2728_marine,15,5,15,1,20,100,6.666666666666667
2729_marine,13,5,13,1,18,100,7.6923076923076925
2730_marine,13,5,13,1,18,100,7.6923076923076925
2731_marine,13,5,13,1,18,100,7.6923076923076925
2732_marine,13,5,13,1,18,100,7.6923076923076925
2733_marine,13,5,13,1,18,100,7.6923076923076925
2734_marine,12,5,12,1,17,100,8.333333333333332
2735_marine,12,5,12,1,17,100,8.333333333333332
2736_marine,12,5,12,1,17,100,8.333333333333332
2737_marine,12,5,12,1,17,100,8.333333333333332
2738_marine,12,5,12,1,17,100,8.333333333333332
2739_marine,12,5,12,1,17,100,8.333333333333332
2740_marine,12,5,12,1,17,100,8.333333333333332
2741_marine,13,5,13,1,18,100,7.6923076923076925
2742_marine,13,5,13,1,18,100,7.6923076923076925
2743_marine,13,5,13,1,18,100,7.6923076923076925
2744_marine,13,5,13,1,18,100,7.6923076923076925
2745_marine,13,5,13,1,18,100,7.6923076923076925
2746_marine,13,5,13,1,18,100,7.6923076923076925
2747_marine,12,5,12,0,17,100,0
2748_marine,12,5,12,0,17,100,0
2749_marine,12,5,12,0,17,100,0
2750_marine,12,5,12,0,17,100,0
2751_marine,12,5,12,0,17,100,0
2752_marine,12,7,12,0,19,100,0
2753_marine,12,7,12,0,19,100,0
2754_marine,12,7,12,0,19,100,0
2755_marine,13,7,13,0,20,100,0
2756_marine,13,8,13,0,21,100,0
2757_marine,13,8,13,0,21,100,0
2758_marine,14,8,13,1,22,92.85714285714286,7.142857142857142
2759_marine,14,8,13,1,22,92.85714285714286,7.142857142857142
2760_marine,14,8,13,1,22,92.85714285714286,7.142857142857142
2761_marine,13,8,13,0,21,100,0
2762_marine,13,8,13,0,21,100,0
2763_marine,13,8,13,0,21,100,0
2764_marine,13,8,13,0,21,100,0
2765_marine,13,7,13,0,20,100,0
2766_marine,13,7,13,0,20,100,0
2767_marine,13,7,13,0,20,100,0
2768_marine,13,7,13,0,20,100,0
2769_marine,13,7,13,0,20,100,0
2770_marine,12,7,12,0,19,100,0
2771_marine,10,5,10,0,15,100,0
2772_marine,10,5,10,0,15,100,0
2773_marine,10,5,10,0,15,100,0
2774_marine,10,5,10,0,15,100,0
2775_marine,10,5,10,0,15,100,0
2776_marine,10,5,10,0,15,100,0
2777_marine,10,5,10,0,15,100,0
2778_marine,10,5,10,0,15,100,0
2779_marine,10,5,10,0,15,100,0
2780_marine,10,3,10,0,13,100,0
2781_marine,7,3,7,0,10,100,0
2782_marine,7,3,7,0,10,100,0
2840_marine,3,3,3,0,6,100,0
2841_marine,3,3,3,0,6,100,0
2842_marine,3,3,3,0,6,100,0
2843_marine,3,3,3,0,6,100,0
2844_marine,3,3,3,0,6,100,0
2845_marine,3,3,3,0,6,100,0
2846_marine,3,3,3,0,6,100,0
2847_marine,3,3,3,0,6,100,0
2848_marine,3,3,3,0,6,100,0
2849_marine,3,3,3,0,6,100,0
2850_marine,3,3,3,0,6,100,0
2851_marine,3,3,3,0,6,100,0
2852_marine,3,3,3,0,6,100,0
2853_marine,3,3,3,0,6,100,0
2854_marine,3,3,3,0,6,100,0
2855_marine,3,3,3,0,6,100,0
2856_marine,3,3,3,0,6,100,0
2857_marine,3,3,3,0,6,100,0
2858_marine,3,3,3,0,6,100,0
2859_marine,3,3,3,0,6,100,0
2860_marine,3,3,3,0,6,100,0
2861_marine,3,3,3,0,6,100,0
2862_marine,3,3,3,0,6,100,0
2863_marine,3,3,3,0,6,100,0
2864_marine,3,3,3,0,6,100,0
2865_marine,3,3,3,0,6,100,0
2866_marine,3,3,3,0,6,100,0
2867_marine,3,3,3,0,6,100,0
2868_marine,3,3,3,0,6,100,0
2869_marine,3,3,3,0,6,100,0
2870_marine,3,3,3,0,6,100,0
2871_marine,3,3,3,0,6,100,0
2872_marine,3,3,3,0,6,100,0
2873_marine,3,3,3,0,6,100,0
2874_marine,3,3,3,0,6,100,0
2875_marine,3,3,3,0,6,100,0
2876_marine,3,3,3,0,6,100,0
2877_marine,3,3,3,0,6,100,0
2878_marine,3,3,3,0,6,100,0
2879_marine,3,3,3,0,6,100,0
2880_marine,3,3,3,0,6,100,0
2881_marine,3,3,3,0,6,100,0
2882_marine,3,3,3,0,6,100,0
2883_marine,3,3,3,0,6,100,0
2884_marine,3,3,3,0,6,100,0
2885_marine,3,3,3,0,6,100,0
2886_marine,3,3,3,0,6,100,0
2887_marine,3,3,3,0,6,100,0
2888_marine,3,3,3,0,6,100,0
2889_marine,3,3,3,0,6,100,0
2890_marine,5,3,5,0,8,100,0
2891_marine,5,3,5,0,8,100,0
2892_marine,5,3,5,0,8,100,0
2893_marine,5,3,5,0,8,100,0
2894_marine,5,3,5,0,8,100,0
2895_marine,5,3,5,0,8,100,0
2896_marine,5,3,5,0,8,100,0
2897_marine,5,3,5,0,8,100,0
2898_marine,5,3,5,0,8,100,0
2899_marine,5,3,5,0,8,100,0
2900_marine,5,3,5,0,8,100,0
2901_marine,5,5,5,0,10,100,0
2902_marine,5,5,5,0,10,100,0
2903_marine,5,5,5,0,10,100,0
2904_marine,3,5,3,0,8,100,0
2905_marine,3,5,3,0,8,100,0
2906_marine,3,5,3,0,8,100,0
2907_marine,3,5,3,0,8,100,0
2908_marine,3,5,3,0,8,100,0
2909_marine,3,5,3,0,8,100,0
2910_marine,3,5,3,0,8,100,0
2964_marine,5,4,5,0,9,100,0
2965_marine,29,9,18,14,38,62.06896551724138,48.275862068965516
2966_marine,31,9,20,14,40,64.51612903225806,45.16129032258064
2967_marine,31,9,20,14,40,64.51612903225806,45.16129032258064
2968_marine,32,9,21,15,41,65.625,46.875
2969_marine,42,9,25,15,51,59.523809523809526,35.714285714285715
2970_marine,35,7,21,14,42,60,40
2971_marine,35,7,21,14,42,60,40
2972_marine,36,7,21,15,43,58.333333333333336,41.66666666666667
2973_marine,36,7,21,15,43,58.333333333333336,41.66666666666667
2974_marine,36,7,21,15,43,58.333333333333336,41.66666666666667
2975_marine,35,7,20,15,42,57.14285714285714,42.857142857142854
2976_marine,35,7,20,15,42,57.14285714285714,42.857142857142854
2977_marine,35,7,20,15,42,57.14285714285714,42.857142857142854
2980_marine,30,6,18,14,36,60,46.666666666666664
2981_marine,33,7,20,15,40,60.60606060606061,45.45454545454545
2982_marine,33,9,20,15,42,60.60606060606061,45.45454545454545
2983_marine,33,7,20,15,40,60.60606060606061,45.45454545454545
2984_marine,31,6,18,15,37,58.06451612903226,48.38709677419355
2992_marine,34,12,21,15,46,61.76470588235294,44.11764705882353
2993_marine,34,12,21,15,46,61.76470588235294,44.11764705882353
2994_marine,34,12,21,15,46,61.76470588235294,44.11764705882353
2995_marine,34,12,21,15,46,61.76470588235294,44.11764705882353
2996_marine,34,15,21,15,49,61.76470588235294,44.11764705882353
2997_marine,49,16,27,22,65,55.10204081632652,44.89795918367347
2998_marine,39,14,24,19,53,61.53846153846154,48.717948717948715
2999_marine,22,13,14,5,35,63.63636363636363,22.727272727272727
3000_marine,18,10,11,4,28,61.111111111111114,22.22222222222222
3001_marine,16,10,9,4,26,56.25,25
3002_marine,16,8,9,4,24,56.25,25
3003_marine,16,8,9,4,24,56.25,25
3004_marine,16,8,9,4,24,56.25,25
3007_marine,18,8,11,4,26,61.111111111111114,22.22222222222222
3008_marine,18,8,11,4,26,61.111111111111114,22.22222222222222
3009_marine,18,10,11,4,28,61.111111111111114,22.22222222222222
3010_marine,18,8,11,4,26,61.111111111111114,22.22222222222222
3011_marine,18,8,11,4,26,61.111111111111114,22.22222222222222
3014_marine,18,10,11,4,28,61.111111111111114,22.22222222222222
3015_marine,16,10,9,4,26,56.25,25
3016_marine,16,8,9,4,24,56.25,25
3031_marine,18,10,12,4,28,66.66666666666666,22.22222222222222
3032_marine,3,6,3,0,9,100,0
3035_marine,17,5,11,4,22,64.70588235294117,23.52941176470588
3036_marine,18,10,12,4,28,66.66666666666666,22.22222222222222
3037_marine,19,10,13,5,29,68.42105263157895,26.31578947368421
3038_marine,18,10,12,4,28,66.66666666666666,22.22222222222222
3039_marine,19,10,13,5,29,68.42105263157895,26.31578947368421
3040_marine,20,10,14,5,30,70,25
3041_marine,17,10,11,4,27,64.70588235294117,23.52941176470588
3042_marine,16,10,10,4,26,62.5,25
3043_marine,15,10,9,4,25,60,26.666666666666668
3044_marine,15,10,9,4,25,60,26.666666666666668
3045_marine,13,10,7,3,23,53.84615384615385,23.076923076923077
3046_marine,25,14,19,4,39,76,16
3047_marine,26,15,20,4,41,76.92307692307693,15.384615384615385
3048_marine,26,15,20,4,41,76.92307692307693,15.384615384615385
3049_marine,24,14,18,3,38,75,12.5
3050_marine,13,7,13,0,20,100,0
3051_marine,13,9,13,0,22,100,0
3052_marine,13,9,13,0,22,100,0
3053_marine,13,7,13,0,20,100,0
3054_marine,13,7,13,0,20,100,0
3055_marine,11,7,11,0,18,100,0
3056_marine,11,5,11,0,16,100,0
3057_marine,9,7,9,0,16,100,0
3058_marine,9,7,9,0,16,100,0
3059_marine,9,7,9,0,16,100,0
3060_marine,9,7,9,0,16,100,0
3061_marine,9,7,9,0,16,100,0
3062_marine,9,7,9,0,16,100,0
3063_marine,9,7,9,0,16,100,0
3064_marine,9,7,9,0,16,100,0
3065_marine,9,7,9,0,16,100,0
3066_marine,11,7,11,0,18,100,0
3067_marine,11,7,11,0,18,100,0
3068_marine,11,9,11,0,20,100,0
3069_marine,13,9,13,0,22,100,0
3070_marine,17,9,17,0,26,100,0
3071_marine,17,9,16,2,26,94.11764705882352,11.76470588235294
3072_marine,18,11,17,2,29,94.44444444444444,11.11111111111111
3073_marine,18,11,17,2,29,94.44444444444444,11.11111111111111
3074_marine,17,11,17,1,28,100,5.88235294117647
3075_marine,17,11,17,1,28,100,5.88235294117647
3076_marine,17,11,17,1,28,100,5.88235294117647
3077_marine,17,11,17,1,28,100,5.88235294117647
3078_marine,17,11,17,1,28,100,5.88235294117647
3079_marine,17,11,17,1,28,100,5.88235294117647
3080_marine,20,11,20,1,31,100,5
3081_marine,20,11,20,1,31,100,5
3082_marine,20,11,20,1,31,100,5
3083_marine,19,11,19,1,30,100,5.263157894736842
3084_marine,19,11,19,1,30,100,5.263157894736842
3085_marine,19,11,19,1,30,100,5.263157894736842
3086_marine,19,11,19,1,30,100,5.263157894736842
3087_marine,19,11,19,1,30,100,5.263157894736842
3088_marine,17,11,17,1,28,100,5.88235294117647
3089_marine,15,9,15,1,24,100,6.666666666666667
3090_marine,17,9,17,1,26,100,5.88235294117647
3091_marine,18,9,18,1,27,100,5.555555555555555
3092_marine,18,7,18,1,25,100,5.555555555555555
3093_marine,18,7,18,1,25,100,5.555555555555555
3094_marine,18,7,18,1,25,100,5.555555555555555
3095_marine,16,7,16,1,23,100,6.25
3096_marine,13,7,13,1,20,100,7.6923076923076925
3097_marine,13,7,13,1,20,100,7.6923076923076925
3098_marine,13,7,13,1,20,100,7.6923076923076925
3099_marine,13,7,13,1,20,100,7.6923076923076925
3100_marine,13,7,13,1,20,100,7.6923076923076925
3101_marine,13,7,13,1,20,100,7.6923076923076925
3102_marine,13,7,13,1,20,100,7.6923076923076925
3103_marine,14,7,14,1,21,100,7.142857142857142
3104_marine,15,7,15,2,22,100,13.333333333333334
3105_marine,15,7,15,2,22,100,13.333333333333334
3106_marine,16,7,15,3,23,93.75,18.75
3107_marine,16,7,15,3,23,93.75,18.75
3108_marine,17,7,15,4,24,88.23529411764706,23.52941176470588
3109_marine,16,7,14,3,23,87.5,18.75
3110_marine,16,7,14,3,23,87.5,18.75
3111_marine,19,11,15,5,30,78.94736842105263,26.31578947368421
3112_marine,19,10,15,5,29,78.94736842105263,26.31578947368421
3113_marine,16,7,14,3,23,87.5,18.75
3114_marine,16,7,14,3,23,87.5,18.75
3115_marine,20,10,16,6,30,80,30
3116_marine,18,10,15,5,28,83.33333333333334,27.77777777777778
3117_marine,19,10,16,6,29,84.21052631578947,31.57894736842105
3118_marine,19,10,16,6,29,84.21052631578947,31.57894736842105
3119_marine,18,10,15,5,28,83.33333333333334,27.77777777777778
3120_marine,17,10,14,4,27,82.35294117647058,23.52941176470588
3121_marine,16,10,13,3,26,81.25,18.75
3122_marine,16,10,13,3,26,81.25,18.75
3123_marine,16,10,13,3,26,81.25,18.75
3124_marine,16,10,13,3,26,81.25,18.75
3125_marine,17,10,13,3,27,76.47058823529412,17.647058823529413
3126_marine,18,10,14,4,28,77.77777777777779,22.22222222222222
3127_marine,14,7,13,2,21,92.85714285714286,14.285714285714285
3128_marine,13,7,13,1,20,100,7.6923076923076925
3129_marine,14,7,14,1,21,100,7.142857142857142
3130_marine,14,7,14,1,21,100,7.142857142857142
3131_marine,12,7,12,0,19,100,0
3132_marine,12,7,12,0,19,100,0
3133_marine,12,5,12,0,17,100,0
3134_marine,12,5,12,0,17,100,0
3135_marine,12,5,12,0,17,100,0
3136_marine,10,5,10,0,15,100,0
3137_marine,10,5,10,0,15,100,0
3138_marine,10,5,10,0,15,100,0
3139_marine,10,5,10,0,15,100,0
3140_marine,10,5,10,0,15,100,0
3141_marine,10,5,10,0,15,100,0
3142_marine,10,5,10,0,15,100,0
3143_marine,10,5,10,0,15,100,0
3144_marine,10,5,10,0,15,100,0
3145_marine,10,5,10,0,15,100,0
3146_marine,10,5,10,0,15,100,0
3147_marine,9,5,9,0,14,100,0
3148_marine,10,5,10,1,15,100,10
3149_marine,13,5,13,1,18,100,7.6923076923076925
3150_marine,16,6,15,4,22,93.75,25
3151_marine,17,8,16,5,25,94.11764705882352,29.411764705882355
3152_marine,18,8,17,6,26,94.44444444444444,33.33333333333333
3153_marine,13,6,13,1,19,100,7.6923076923076925
3154_marine,19,8,18,6,27,94.73684210526315,31.57894736842105
3155_marine,12,6,12,1,18,100,8.333333333333332
3156_marine,20,7,17,6,27,85,30
3157_marine,20,9,17,6,29,85,30
3158_marine,12,6,12,1,18,100,8.333333333333332
3159_marine,10,4,10,1,14,100,10
3160_marine,10,4,10,1,14,100,10
3161_marine,10,3,10,1,13,100,10
3199_marine,3,3,3,0,6,100,0
3200_marine,3,3,3,0,6,100,0
3201_marine,3,3,3,0,6,100,0
3202_marine,3,3,3,0,6,100,0
3203_marine,3,3,3,0,6,100,0
3204_marine,3,3,3,0,6,100,0
3205_marine,3,3,3,0,6,100,0
3206_marine,3,3,3,0,6,100,0
3207_marine,3,3,3,0,6,100,0
3208_marine,3,3,3,0,6,100,0
3209_marine,3,3,3,0,6,100,0
3210_marine,3,3,3,0,6,100,0
3211_marine,3,3,3,0,6,100,0
3212_marine,3,3,3,0,6,100,0
3213_marine,3,3,3,0,6,100,0
3214_marine,3,3,3,0,6,100,0
3215_marine,3,3,3,0,6,100,0
3216_marine,3,3,3,0,6,100,0
3217_marine,3,3,3,0,6,100,0
3218_marine,3,3,3,0,6,100,0
3219_marine,3,3,3,0,6,100,0
3220_marine,3,3,3,0,6,100,0
3221_marine,3,3,3,0,6,100,0
3222_marine,3,3,3,0,6,100,0
3223_marine,3,3,3,0,6,100,0
3224_marine,3,3,3,0,6,100,0
3225_marine,3,3,3,0,6,100,0
3226_marine,3,3,3,0,6,100,0
3227_marine,3,3,3,0,6,100,0
3228_marine,3,3,3,0,6,100,0
3229_marine,3,3,3,0,6,100,0
3230_marine,3,3,3,0,6,100,0
3231_marine,3,3,3,0,6,100,0
3232_marine,3,3,3,0,6,100,0
3233_marine,3,3,3,0,6,100,0
3234_marine,3,3,3,0,6,100,0
3235_marine,3,3,3,0,6,100,0
3236_marine,3,3,3,0,6,100,0
3237_marine,3,3,3,0,6,100,0
3238_marine,3,3,3,0,6,100,0
3239_marine,3,3,3,0,6,100,0
3240_marine,3,3,3,0,6,100,0
3241_marine,3,3,3,0,6,100,0
3242_marine,3,3,3,0,6,100,0
3243_marine,3,3,3,0,6,100,0
3244_marine,3,3,3,0,6,100,0
3245_marine,3,3,3,0,6,100,0
3246_marine,3,3,3,0,6,100,0
3247_marine,3,3,3,0,6,100,0
3248_marine,3,3,3,0,6,100,0
3249_marine,5,3,5,0,8,100,0
3250_marine,5,3,5,0,8,100,0
3251_marine,5,3,5,0,8,100,0
3252_marine,5,3,5,0,8,100,0
3253_marine,5,3,5,0,8,100,0
3254_marine,5,3,5,0,8,100,0
3255_marine,5,3,5,0,8,100,0
3256_marine,5,3,5,0,8,100,0
3257_marine,5,3,5,0,8,100,0
3258_marine,5,3,5,0,8,100,0
3259_marine,5,5,5,0,10,100,0
3260_marine,5,5,5,0,10,100,0
3261_marine,5,5,5,0,10,100,0
3262_marine,5,5,5,0,10,100,0
3263_marine,5,5,5,0,10,100,0
3264_marine,5,5,5,0,10,100,0
3265_marine,3,5,3,0,8,100,0
3266_marine,3,5,3,0,8,100,0
3267_marine,3,5,3,0,8,100,0
3268_marine,3,5,3,0,8,100,0
3269_marine,3,5,3,0,8,100,0
3270_marine,3,5,3,0,8,100,0
3271_marine,3,5,3,0,8,100,0
3272_marine,3,5,3,0,8,100,0
3273_marine,3,5,3,0,8,100,0
3320_marine,21,6,14,10,27,66.66666666666666,47.61904761904761
3321_marine,21,6,14,10,27,66.66666666666666,47.61904761904761
3322_marine,22,6,15,10,28,68.18181818181817,45.45454545454545
3323_marine,5,4,5,0,9,100,0
3324_marine,31,10,20,14,41,64.51612903225806,45.16129032258064
3325_marine,31,10,20,14,41,64.51612903225806,45.16129032258064
3326_marine,31,10,20,14,41,64.51612903225806,45.16129032258064
3327_marine,5,4,5,0,9,100,0
3329_marine,31,9,20,14,40,64.51612903225806,45.16129032258064
3330_marine,31,9,20,14,40,64.51612903225806,45.16129032258064
3331_marine,42,9,25,15,51,59.523809523809526,35.714285714285715
3332_marine,42,9,25,15,51,59.523809523809526,35.714285714285715
3333_marine,42,9,25,15,51,59.523809523809526,35.714285714285715
3334_marine,36,7,21,15,43,58.333333333333336,41.66666666666667
3335_marine,36,7,21,15,43,58.333333333333336,41.66666666666667
3336_marine,36,7,21,15,43,58.333333333333336,41.66666666666667
3337_marine,36,7,21,15,43,58.333333333333336,41.66666666666667
3338_marine,36,7,21,15,43,58.333333333333336,41.66666666666667
3339_marine,35,7,20,15,42,57.14285714285714,42.857142857142854
3340_marine,35,7,20,15,42,57.14285714285714,42.857142857142854
3341_marine,33,7,20,15,40,60.60606060606061,45.45454545454545
3342_marine,33,9,20,15,42,60.60606060606061,45.45454545454545
3343_marine,33,9,20,15,42,60.60606060606061,45.45454545454545
3344_marine,33,6,20,15,39,60.60606060606061,45.45454545454545
3348_marine,31,4,18,15,35,58.06451612903226,48.38709677419355
3349_marine,36,14,23,15,50,63.888888888888886,41.66666666666667
3350_marine,36,14,23,15,50,63.888888888888886,41.66666666666667
3351_marine,37,14,24,15,51,64.86486486486487,40.54054054054054
3352_marine,37,14,24,15,51,64.86486486486487,40.54054054054054
3353_marine,52,20,31,22,72,59.61538461538461,42.30769230769231
3354_marine,52,20,31,23,72,59.61538461538461,44.230769230769226
3355_marine,31,16,20,12,47,64.51612903225806,38.70967741935484
3356_marine,31,16,20,12,47,64.51612903225806,38.70967741935484
3357_marine,27,11,17,10,38,62.96296296296296,37.03703703703704
3397_marine,18,11,12,4,29,66.66666666666666,22.22222222222222
3398_marine,18,10,12,4,28,66.66666666666666,22.22222222222222
3400_marine,29,13,23,5,42,79.3103448275862,17.24137931034483
3401_marine,29,13,23,5,42,79.3103448275862,17.24137931034483
3402_marine,29,13,23,5,42,79.3103448275862,17.24137931034483
3403_marine,28,13,22,5,41,78.57142857142857,17.857142857142858
3404_marine,28,15,22,5,43,78.57142857142857,17.857142857142858
3405_marine,31,16,25,5,47,80.64516129032258,16.129032258064516
3406_marine,31,17,25,5,48,80.64516129032258,16.129032258064516
3407_marine,20,10,19,4,30,95,20
3408_marine,15,8,15,0,23,100,0
3409_marine,15,8,15,0,23,100,0
3410_marine,15,8,15,0,23,100,0
3411_marine,15,7,15,0,22,100,0
3412_marine,15,7,15,0,22,100,0
3413_marine,15,7,15,0,22,100,0
3414_marine,15,7,15,0,22,100,0
3415_marine,15,7,15,0,22,100,0
3416_marine,13,7,13,0,20,100,0
3417_marine,11,7,11,0,18,100,0
3418_marine,11,7,11,0,18,100,0
3419_marine,11,9,11,0,20,100,0
3420_marine,11,9,11,0,20,100,0
3421_marine,12,9,11,1,21,91.66666666666666,8.333333333333332
3422_marine,14,9,13,1,23,92.85714285714286,7.142857142857142
3423_marine,14,9,13,1,23,92.85714285714286,7.142857142857142
3424_marine,14,9,13,1,23,92.85714285714286,7.142857142857142
3425_marine,16,9,15,1,25,93.75,6.25
3426_marine,18,9,17,1,27,94.44444444444444,5.555555555555555
3427_marine,20,9,18,2,29,90,10
3428_marine,22,9,20,4,31,90.9090909090909,18.181818181818183
3429_marine,22,9,20,4,31,90.9090909090909,18.181818181818183
3430_marine,25,13,22,5,38,88,20
3431_marine,28,17,25,5,45,89.28571428571429,17.857142857142858
3432_marine,26,17,23,5,43,88.46153846153845,19.230769230769234
3433_marine,24,16,21,5,40,87.5,20.833333333333336
3434_marine,23,14,21,4,37,91.30434782608695,17.391304347826086
3435_marine,31,14,26,9,45,83.87096774193549,29.03225806451613
3436_marine,35,13,29,12,48,82.85714285714286,34.285714285714285
3437_marine,36,15,30,12,51,83.33333333333334,33.33333333333333
3438_marine,36,12,29,10,48,80.55555555555556,27.77777777777778
3439_marine,39,12,31,12,51,79.48717948717949,30.76923076923077
3440_marine,35,12,29,9,47,82.85714285714286,25.71428571428571
3441_marine,33,13,28,8,46,84.84848484848484,24.242424242424242
3442_marine,32,13,27,8,45,84.375,25
3443_marine,31,14,26,8,45,83.87096774193549,25.806451612903224
3444_marine,32,12,27,9,44,84.375,28.125
3445_marine,32,12,27,9,44,84.375,28.125
3446_marine,32,12,27,9,44,84.375,28.125
3447_marine,33,12,28,9,45,84.84848484848484,27.27272727272727
3448_marine,33,12,27,8,45,81.81818181818183,24.242424242424242
3449_marine,30,12,27,6,42,90,20
3450_marine,24,11,23,3,35,95.83333333333334,12.5
3451_marine,23,11,23,2,34,100,8.695652173913043
3452_marine,22,10,21,3,32,95.45454545454545,13.636363636363635
3453_marine,24,8,23,3,32,95.83333333333334,12.5
3454_marine,24,8,23,3,32,95.83333333333334,12.5
3455_marine,22,7,22,1,29,100,4.545454545454546
3456_marine,21,7,21,1,28,100,4.761904761904762
3457_marine,24,8,23,3,32,95.83333333333334,12.5
3458_marine,15,7,15,1,22,100,6.666666666666667
3459_marine,15,7,15,1,22,100,6.666666666666667
3460_marine,13,7,13,1,20,100,7.6923076923076925
3461_marine,13,7,13,1,20,100,7.6923076923076925
3462_marine,14,7,14,2,21,100,14.285714285714285
3463_marine,15,7,15,2,22,100,13.333333333333334
3464_marine,17,7,15,4,24,88.23529411764706,23.52941176470588
3465_marine,20,11,16,6,31,80,30
3466_marine,19,11,15,6,30,78.94736842105263,31.57894736842105
3467_marine,19,11,15,6,30,78.94736842105263,31.57894736842105
3468_marine,20,11,16,7,31,80,35
3469_marine,20,11,16,7,31,80,35
3470_marine,20,11,16,7,31,80,35
3471_marine,20,11,16,7,31,80,35
3472_marine,21,11,17,8,32,80.95238095238095,38.095238095238095
3473_marine,22,9,17,8,31,77.27272727272727,36.36363636363637
3474_marine,23,9,18,9,32,78.26086956521739,39.130434782608695
3475_marine,21,10,17,8,31,80.95238095238095,38.095238095238095
3476_marine,20,10,16,7,30,80,35
3477_marine,21,10,17,8,31,80.95238095238095,38.095238095238095
3478_marine,21,10,17,8,31,80.95238095238095,38.095238095238095
3479_marine,22,10,18,9,32,81.81818181818183,40.909090909090914
3480_marine,23,10,19,10,33,82.6086956521739,43.47826086956522
3481_marine,23,10,19,10,33,82.6086956521739,43.47826086956522
3482_marine,21,10,17,8,31,80.95238095238095,38.095238095238095
3483_marine,20,10,15,6,30,75,30
3484_marine,19,10,15,5,29,78.94736842105263,26.31578947368421
3485_marine,18,10,14,4,28,77.77777777777779,22.22222222222222
3486_marine,19,10,15,4,29,78.94736842105263,21.052631578947366
3487_marine,15,7,14,2,22,93.33333333333333,13.333333333333334
3488_marine,14,7,14,1,21,100,7.142857142857142
3489_marine,14,7,14,1,21,100,7.142857142857142
3490_marine,14,7,14,1,21,100,7.142857142857142
3491_marine,13,7,13,1,20,100,7.6923076923076925
3492_marine,13,7,13,1,20,100,7.6923076923076925
3493_marine,13,5,13,1,18,100,7.6923076923076925
3494_marine,13,5,13,1,18,100,7.6923076923076925
3495_marine,13,5,13,1,18,100,7.6923076923076925
3496_marine,13,5,13,1,18,100,7.6923076923076925
3497_marine,12,5,12,0,17,100,0
3498_marine,10,5,10,0,15,100,0
3499_marine,10,6,10,0,16,100,0
3500_marine,11,6,11,1,17,100,9.090909090909092
3501_marine,11,5,11,1,16,100,9.090909090909092
3502_marine,10,5,10,0,15,100,0
3503_marine,10,5,10,0,15,100,0
3504_marine,10,5,10,0,15,100,0
3505_marine,10,5,10,0,15,100,0
3506_marine,10,5,10,0,15,100,0
3507_marine,10,5,10,0,15,100,0
3508_marine,14,5,14,1,19,100,7.142857142857142
3509_marine,14,5,14,1,19,100,7.142857142857142
3510_marine,15,6,14,3,21,93.33333333333333,20
3511_marine,21,8,19,8,29,90.47619047619048,38.095238095238095
3512_marine,24,9,20,8,33,83.33333333333334,33.33333333333333
3513_marine,24,9,20,8,33,83.33333333333334,33.33333333333333
3514_marine,23,9,19,8,32,82.6086956521739,34.78260869565217
3515_marine,22,9,18,8,31,81.81818181818183,36.36363636363637
3516_marine,20,9,17,6,29,85,30
3517_marine,20,9,17,6,29,85,30
3518_marine,20,9,17,6,29,85,30
3519_marine,20,9,17,6,29,85,30
3520_marine,20,9,17,6,29,85,30
3521_marine,10,6,10,1,16,100,10
3522_marine,10,6,10,1,16,100,10
3523_marine,10,6,10,1,16,100,10
3524_marine,9,4,9,0,13,100,0
3558_marine,3,3,3,0,6,100,0
3559_marine,3,3,3,0,6,100,0
3560_marine,3,3,3,0,6,100,0
3561_marine,3,3,3,0,6,100,0
3562_marine,3,3,3,0,6,100,0
3563_marine,3,3,3,0,6,100,0
3564_marine,3,3,3,0,6,100,0
3565_marine,3,3,3,0,6,100,0
3566_marine,3,3,3,0,6,100,0
3567_marine,3,3,3,0,6,100,0
3568_marine,3,3,3,0,6,100,0
3569_marine,3,3,3,0,6,100,0
3570_marine,3,3,3,0,6,100,0
3571_marine,3,3,3,0,6,100,0
3572_marine,3,3,3,0,6,100,0
3573_marine,3,3,3,0,6,100,0
3574_marine,3,3,3,0,6,100,0
3575_marine,3,3,3,0,6,100,0
3576_marine,3,3,3,0,6,100,0
3577_marine,3,3,3,0,6,100,0
3578_marine,3,3,3,0,6,100,0
3579_marine,3,3,3,0,6,100,0
3580_marine,3,3,3,0,6,100,0
3581_marine,3,3,3,0,6,100,0
3582_marine,3,3,3,0,6,100,0
3583_marine,3,3,3,0,6,100,0
3584_marine,3,3,3,0,6,100,0
3585_marine,3,3,3,0,6,100,0
3586_marine,3,3,3,0,6,100,0
3587_marine,3,3,3,0,6,100,0
3588_marine,3,3,3,0,6,100,0
3589_marine,3,3,3,0,6,100,0
3590_marine,3,3,3,0,6,100,0
3591_marine,3,3,3,0,6,100,0
3592_marine,3,3,3,0,6,100,0
3593_marine,3,3,3,0,6,100,0
3594_marine,3,3,3,0,6,100,0
3595_marine,3,3,3,0,6,100,0
3596_marine,3,3,3,0,6,100,0
3597_marine,3,3,3,0,6,100,0
3598_marine,3,3,3,0,6,100,0
3599_marine,3,3,3,0,6,100,0
3600_marine,3,3,3,0,6,100,0
3601_marine,3,3,3,0,6,100,0
3602_marine,3,3,3,0,6,100,0
3603_marine,3,3,3,0,6,100,0
3604_marine,3,3,3,0,6,100,0
3605_marine,3,3,3,0,6,100,0
3606_marine,3,3,3,0,6,100,0
3607_marine,3,3,3,0,6,100,0
3608_marine,5,3,5,0,8,100,0
3609_marine,5,3,5,0,8,100,0
3610_marine,5,3,5,0,8,100,0
3611_marine,5,5,5,0,10,100,0
3612_marine,5,5,5,0,10,100,0
3613_marine,5,5,5,0,10,100,0
3614_marine,5,5,5,0,10,100,0
3615_marine,5,3,5,0,8,100,0
3616_marine,5,3,5,0,8,100,0
3617_marine,5,5,5,0,10,100,0
3618_marine,5,5,5,0,10,100,0
3619_marine,5,5,5,0,10,100,0
3620_marine,5,5,5,0,10,100,0
3621_marine,5,5,5,0,10,100,0
3622_marine,5,5,5,0,10,100,0
3623_marine,5,5,5,0,10,100,0
3624_marine,5,5,5,0,10,100,0
3625_marine,3,5,3,0,8,100,0
3626_marine,3,5,3,0,8,100,0
3627_marine,3,5,3,0,8,100,0
3628_marine,3,5,3,0,8,100,0
3629_marine,3,5,3,0,8,100,0
3630_marine,3,5,3,0,8,100,0
3631_marine,3,5,3,0,8,100,0
3632_marine,3,5,3,0,8,100,0
3633_marine,3,5,3,0,8,100,0
3634_marine,3,5,3,0,8,100,0
3635_marine,3,5,3,0,8,100,0
3636_marine,3,5,3,0,8,100,0
3637_marine,3,5,3,0,8,100,0
3675_marine,24,7,15,11,31,62.5,45.83333333333333
3676_marine,24,7,15,11,31,62.5,45.83333333333333
3677_marine,24,7,15,11,31,62.5,45.83333333333333
3678_marine,24,7,15,11,31,62.5,45.83333333333333
3679_marine,24,7,15,11,31,62.5,45.83333333333333
3680_marine,22,7,15,10,29,68.18181818181817,45.45454545454545
3681_marine,22,7,15,10,29,68.18181818181817,45.45454545454545
3682_marine,22,7,15,10,29,68.18181818181817,45.45454545454545
3683_marine,19,8,12,10,27,63.1578947368421,52.63157894736842
3684_marine,31,10,20,14,41,64.51612903225806,45.16129032258064
3685_marine,31,10,20,14,41,64.51612903225806,45.16129032258064
3686_marine,31,10,20,14,41,64.51612903225806,45.16129032258064
3687_marine,31,10,20,14,41,64.51612903225806,45.16129032258064
3688_marine,31,10,20,14,41,64.51612903225806,45.16129032258064
3689_marine,28,6,17,14,34,60.71428571428571,50
3692_marine,7,3,7,0,10,100,0
3693_marine,33,10,22,14,43,66.66666666666666,42.42424242424242
3694_marine,45,10,28,15,55,62.22222222222222,33.33333333333333
3695_marine,45,10,28,15,55,62.22222222222222,33.33333333333333
3696_marine,45,9,28,15,54,62.22222222222222,33.33333333333333
3697_marine,39,7,24,15,46,61.53846153846154,38.46153846153847
3698_marine,35,8,21,14,43,60,40
3699_marine,35,8,21,14,43,60,40
3700_marine,35,8,21,14,43,60,40
3702_marine,29,4,16,15,33,55.172413793103445,51.724137931034484
3703_marine,38,14,24,16,52,63.1578947368421,42.10526315789473
3704_marine,38,14,24,16,52,63.1578947368421,42.10526315789473
3705_marine,38,14,24,16,52,63.1578947368421,42.10526315789473
3706_marine,38,14,24,16,52,63.1578947368421,42.10526315789473
3707_marine,38,14,24,16,52,63.1578947368421,42.10526315789473
3708_marine,38,15,24,16,53,63.1578947368421,42.10526315789473
3709_marine,37,15,24,15,52,64.86486486486487,40.54054054054054
3710_marine,37,15,24,15,52,64.86486486486487,40.54054054054054
3711_marine,10,11,10,0,21,100,0
3712_marine,38,19,26,13,57,68.42105263157895,34.21052631578947
3713_marine,37,17,25,12,54,67.56756756756756,32.432432432432435
3714_marine,33,17,22,12,50,66.66666666666666,36.36363636363637
3715_marine,31,17,20,12,48,64.51612903225806,38.70967741935484
3716_marine,31,16,20,12,47,64.51612903225806,38.70967741935484
3760_marine,29,13,23,5,42,79.3103448275862,17.24137931034483
3761_marine,31,13,23,7,44,74.19354838709677,22.58064516129032
3762_marine,31,13,23,7,44,74.19354838709677,22.58064516129032
3763_marine,32,13,24,7,45,75,21.875
3764_marine,16,7,16,1,23,100,6.25
3765_marine,16,8,16,1,24,100,6.25
3766_marine,16,8,16,1,24,100,6.25
3767_marine,16,8,16,1,24,100,6.25
3768_marine,15,8,15,0,23,100,0
3769_marine,15,8,15,0,23,100,0
3770_marine,15,8,15,0,23,100,0
3771_marine,15,7,15,0,22,100,0
3772_marine,15,7,15,0,22,100,0
3773_marine,15,7,15,0,22,100,0
3774_marine,15,7,15,0,22,100,0
3775_marine,15,7,15,0,22,100,0
3776_marine,14,7,14,0,21,100,0
3777_marine,16,9,16,0,25,100,0
3778_marine,19,9,18,1,28,94.73684210526315,5.263157894736842
3779_marine,19,9,18,1,28,94.73684210526315,5.263157894736842
3780_marine,19,9,18,1,28,94.73684210526315,5.263157894736842
3781_marine,19,9,18,1,28,94.73684210526315,5.263157894736842
3782_marine,19,9,18,1,28,94.73684210526315,5.263157894736842
3783_marine,18,9,17,1,27,94.44444444444444,5.555555555555555
3784_marine,21,9,20,1,30,95.23809523809523,4.761904761904762
3785_marine,23,9,22,1,32,95.65217391304348,4.3478260869565215
3786_marine,24,9,23,2,33,95.83333333333334,8.333333333333332
3787_marine,25,9,23,3,34,92,12
3788_marine,26,9,24,4,35,92.3076923076923,15.384615384615385
3789_marine,35,11,31,6,46,88.57142857142857,17.142857142857142
3790_marine,35,17,31,6,52,88.57142857142857,17.142857142857142
3791_marine,58,21,45,20,79,77.58620689655173,34.48275862068966
3792_marine,53,20,40,19,73,75.47169811320755,35.84905660377358
3793_marine,46,20,35,18,66,76.08695652173914,39.130434782608695
3794_marine,42,17,34,15,59,80.95238095238095,35.714285714285715
3795_marine,38,12,30,13,50,78.94736842105263,34.21052631578947
3796_marine,37,13,29,13,50,78.37837837837837,35.13513513513514
3797_marine,35,13,28,12,48,80,34.285714285714285
3798_marine,32,12,26,8,44,81.25,25
3799_marine,37,12,29,9,49,78.37837837837837,24.324324324324326
3800_marine,34,12,27,8,46,79.41176470588235,23.52941176470588
3801_marine,30,12,24,8,42,80,26.666666666666668
3802_marine,28,12,23,7,40,82.14285714285714,25
3803_marine,29,12,24,7,41,82.75862068965517,24.137931034482758
3804_marine,20,13,19,2,33,95,10
3805_marine,31,14,26,7,45,83.87096774193549,22.58064516129032
3806_marine,32,14,27,8,46,84.375,25
3807_marine,26,13,25,3,39,96.15384615384616,11.538461538461538
3808_marine,32,12,30,6,44,93.75,18.75
3809_marine,28,11,27,3,39,96.42857142857143,10.714285714285714
3810_marine,27,11,26,3,38,96.29629629629629,11.11111111111111
3811_marine,28,12,27,4,40,96.42857142857143,14.285714285714285
3812_marine,25,9,25,1,34,100,4
3813_marine,25,7,25,1,32,100,4
3814_marine,23,7,23,1,30,100,4.3478260869565215
3815_marine,23,7,23,1,30,100,4.3478260869565215
3816_marine,22,7,22,1,29,100,4.545454545454546
3817_marine,22,7,22,1,29,100,4.545454545454546
3818_marine,20,7,20,1,27,100,5
3819_marine,22,7,22,1,29,100,4.545454545454546
3820_marine,19,7,19,1,26,100,5.263157894736842
3821_marine,19,9,19,1,28,100,5.263157894736842
3822_marine,17,9,17,1,26,100,5.88235294117647
3823_marine,17,9,17,1,26,100,5.88235294117647
3824_marine,18,9,18,2,27,100,11.11111111111111
3825_marine,20,9,19,3,29,95,15
3826_marine,21,9,19,4,30,90.47619047619048,19.047619047619047
3827_marine,21,9,19,4,30,90.47619047619048,19.047619047619047
3828_marine,21,9,19,4,30,90.47619047619048,19.047619047619047
3829_marine,21,9,19,4,30,90.47619047619048,19.047619047619047
3830_marine,21,11,19,4,32,90.47619047619048,19.047619047619047
3831_marine,23,11,19,7,34,82.6086956521739,30.434782608695656
3832_marine,23,11,19,7,34,82.6086956521739,30.434782608695656
3833_marine,19,7,17,4,26,89.47368421052632,21.052631578947366
3834_marine,19,7,17,4,26,89.47368421052632,21.052631578947366
3835_marine,19,7,17,4,26,89.47368421052632,21.052631578947366
3836_marine,19,8,17,4,27,89.47368421052632,21.052631578947366
3837_marine,19,8,17,4,27,89.47368421052632,21.052631578947366
3838_marine,19,8,17,4,27,89.47368421052632,21.052631578947366
3839_marine,22,10,18,8,32,81.81818181818183,36.36363636363637
3840_marine,22,10,18,8,32,81.81818181818183,36.36363636363637
3841_marine,22,9,18,8,31,81.81818181818183,36.36363636363637
3842_marine,17,8,15,4,25,88.23529411764706,23.52941176470588
3843_marine,15,7,15,2,22,100,13.333333333333334
3844_marine,15,7,15,2,22,100,13.333333333333334
3845_marine,15,7,15,2,22,100,13.333333333333334
3846_marine,15,7,15,2,22,100,13.333333333333334
3847_marine,14,7,14,2,21,100,14.285714285714285
3848_marine,13,7,13,1,20,100,7.6923076923076925
3849_marine,13,7,13,1,20,100,7.6923076923076925
3850_marine,13,7,13,1,20,100,7.6923076923076925
3851_marine,13,7,13,1,20,100,7.6923076923076925
3852_marine,13,7,13,1,20,100,7.6923076923076925
3853_marine,13,5,13,1,18,100,7.6923076923076925
3854_marine,13,5,13,1,18,100,7.6923076923076925
3855_marine,13,5,13,1,18,100,7.6923076923076925
3856_marine,13,5,13,1,18,100,7.6923076923076925
3857_marine,14,6,14,2,20,100,14.285714285714285
3858_marine,14,6,14,2,20,100,14.285714285714285
3859_marine,13,5,13,1,18,100,7.6923076923076925
3860_marine,10,5,10,0,15,100,0
3861_marine,10,5,10,0,15,100,0
3862_marine,10,5,10,0,15,100,0
3863_marine,10,5,10,0,15,100,0
3864_marine,10,5,10,0,15,100,0
3865_marine,10,5,10,0,15,100,0
3866_marine,10,5,10,0,15,100,0
3867_marine,10,5,10,0,15,100,0
3868_marine,14,5,14,1,19,100,7.142857142857142
3869_marine,15,5,15,2,20,100,13.333333333333334
3870_marine,16,6,15,3,22,93.75,18.75
3871_marine,22,8,20,8,30,90.9090909090909,36.36363636363637
3872_marine,21,9,19,8,30,90.47619047619048,38.095238095238095
3873_marine,23,9,19,8,32,82.6086956521739,34.78260869565217
3874_marine,23,9,19,8,32,82.6086956521739,34.78260869565217
3875_marine,23,9,19,8,32,82.6086956521739,34.78260869565217
3876_marine,21,9,18,7,30,85.71428571428571,33.33333333333333
3877_marine,21,9,18,7,30,85.71428571428571,33.33333333333333
3878_marine,20,9,17,6,29,85,30
3879_marine,20,9,17,6,29,85,30
3880_marine,20,9,17,6,29,85,30
3881_marine,20,11,17,6,31,85,30
3882_marine,22,11,19,6,33,86.36363636363636,27.27272727272727
3883_marine,20,11,17,6,31,85,30
3884_marine,19,11,16,5,30,84.21052631578947,26.31578947368421
3885_marine,19,11,16,5,30,84.21052631578947,26.31578947368421
3886_marine,9,6,9,0,15,100,0
3887_marine,9,4,9,0,13,100,0
3917_marine,3,3,3,0,6,100,0
3918_marine,3,3,3,0,6,100,0
3919_marine,3,3,3,0,6,100,0
3920_marine,3,3,3,0,6,100,0
3921_marine,3,3,3,0,6,100,0
3922_marine,3,3,3,0,6,100,0
3923_marine,3,3,3,0,6,100,0
3924_marine,3,3,3,0,6,100,0
3925_marine,3,3,3,0,6,100,0
3926_marine,3,3,3,0,6,100,0
3927_marine,3,3,3,0,6,100,0
3928_marine,3,3,3,0,6,100,0
3929_marine,3,3,3,0,6,100,0
3930_marine,3,3,3,0,6,100,0
3931_marine,5,3,5,0,8,100,0
3932_marine,5,3,5,0,8,100,0
3933_marine,5,3,5,0,8,100,0
3934_marine,5,3,5,0,8,100,0
3935_marine,5,3,5,0,8,100,0
3936_marine,5,3,5,0,8,100,0
3937_marine,5,3,5,0,8,100,0
3938_marine,5,3,5,0,8,100,0
3939_marine,5,3,5,0,8,100,0
3940_marine,5,3,5,0,8,100,0
3941_marine,3,3,3,0,6,100,0
3942_marine,3,3,3,0,6,100,0
3943_marine,3,3,3,0,6,100,0
3944_marine,3,3,3,0,6,100,0
3945_marine,3,3,3,0,6,100,0
3946_marine,3,3,3,0,6,100,0
3947_marine,3,3,3,0,6,100,0
3948_marine,3,3,3,0,6,100,0
3949_marine,3,3,3,0,6,100,0
3950_marine,3,3,3,0,6,100,0
3951_marine,3,3,3,0,6,100,0
3952_marine,3,3,3,0,6,100,0
3953_marine,3,3,3,0,6,100,0
3954_marine,3,3,3,0,6,100,0
3955_marine,3,3,3,0,6,100,0
3956_marine,3,3,3,0,6,100,0
3957_marine,3,3,3,0,6,100,0
3958_marine,3,3,3,0,6,100,0
3959_marine,3,3,3,0,6,100,0
3960_marine,3,3,3,0,6,100,0
3961_marine,3,3,3,0,6,100,0
3962_marine,3,3,3,0,6,100,0
3963_marine,3,3,3,0,6,100,0
3964_marine,3,3,3,0,6,100,0
3965_marine,3,3,3,0,6,100,0
3966_marine,3,3,3,0,6,100,0
3967_marine,5,3,5,0,8,100,0
3968_marine,5,3,5,0,8,100,0
3969_marine,5,3,5,0,8,100,0
3970_marine,5,5,5,0,10,100,0
3971_marine,5,5,5,0,10,100,0
3972_marine,5,5,5,0,10,100,0
3973_marine,5,5,5,0,10,100,0
3974_marine,5,5,5,0,10,100,0
3975_marine,5,5,5,0,10,100,0
3976_marine,5,7,5,0,12,100,0
3977_marine,5,7,5,0,12,100,0
3978_marine,5,7,5,0,12,100,0
3979_marine,5,7,5,0,12,100,0
3980_marine,5,7,5,0,12,100,0
3981_marine,5,5,5,0,10,100,0
3982_marine,5,5,5,0,10,100,0
3983_marine,5,7,5,0,12,100,0
3984_marine,5,5,5,0,10,100,0
3985_marine,5,5,5,0,10,100,0
3986_marine,3,5,3,0,8,100,0
3987_marine,3,5,3,0,8,100,0
3988_marine,3,5,3,0,8,100,0
3989_marine,3,5,3,0,8,100,0
3990_marine,3,5,3,0,8,100,0
3991_marine,3,5,3,0,8,100,0
3992_marine,3,5,3,0,8,100,0
3993_marine,3,5,3,0,8,100,0
3994_marine,3,5,3,0,8,100,0
3995_marine,3,5,3,0,8,100,0
3996_marine,3,5,3,0,8,100,0
3997_marine,3,5,3,0,8,100,0
3998_marine,3,5,3,0,8,100,0
3999_marine,3,5,3,0,8,100,0
4000_marine,3,5,3,0,8,100,0
4026_marine,23,7,17,10,30,73.91304347826086,43.47826086956522
4027_marine,25,7,17,10,32,68,40
4028_marine,27,7,19,10,34,70.37037037037037,37.03703703703704
4029_marine,27,7,19,10,34,70.37037037037037,37.03703703703704
4030_marine,27,7,19,10,34,70.37037037037037,37.03703703703704
4031_marine,27,7,19,10,34,70.37037037037037,37.03703703703704
4035_marine,24,7,15,11,31,62.5,45.83333333333333
4036_marine,24,7,15,11,31,62.5,45.83333333333333
4037_marine,24,7,15,11,31,62.5,45.83333333333333
4038_marine,25,7,16,11,32,64,44
4039_marine,25,7,16,11,32,64,44
4040_marine,25,7,16,11,32,64,44
4041_marine,25,7,16,11,32,64,44
4042_marine,29,8,20,13,37,68.96551724137932,44.827586206896555
4043_marine,28,8,19,11,36,67.85714285714286,39.285714285714285
4044_marine,28,8,19,11,36,67.85714285714286,39.285714285714285
4045_marine,28,8,19,11,36,67.85714285714286,39.285714285714285
4046_marine,34,10,23,15,44,67.64705882352942,44.11764705882353
4047_marine,31,10,20,14,41,64.51612903225806,45.16129032258064
4048_marine,31,10,20,14,41,64.51612903225806,45.16129032258064
4049_marine,32,10,21,15,42,65.625,46.875
4050_marine,34,10,23,15,44,67.64705882352942,44.11764705882353
4051_marine,35,10,24,16,45,68.57142857142857,45.714285714285715
4052_marine,34,10,23,15,44,67.64705882352942,44.11764705882353
4053_marine,45,10,28,15,55,62.22222222222222,33.33333333333333
4054_marine,45,10,28,15,55,62.22222222222222,33.33333333333333
4055_marine,39,8,24,15,47,61.53846153846154,38.46153846153847
4056_marine,39,8,24,15,47,61.53846153846154,38.46153846153847
4057_marine,39,7,24,15,46,61.53846153846154,38.46153846153847
4058_marine,39,7,24,15,46,61.53846153846154,38.46153846153847
4059_marine,39,7,24,15,46,61.53846153846154,38.46153846153847
4062_marine,29,4,16,15,33,55.172413793103445,51.724137931034484
4063_marine,37,12,23,16,49,62.16216216216216,43.24324324324324
4064_marine,40,12,26,16,52,65,40
4065_marine,43,14,29,16,57,67.44186046511628,37.2093023255814
4066_marine,43,14,29,16,57,67.44186046511628,37.2093023255814
4067_marine,43,18,30,14,61,69.76744186046511,32.55813953488372
4068_marine,44,19,32,13,63,72.72727272727273,29.545454545454547
4069_marine,39,17,27,12,56,69.23076923076923,30.76923076923077
4070_marine,40,17,28,13,57,70,32.5
4071_marine,38,18,26,13,56,68.42105263157895,34.21052631578947
4072_marine,38,16,26,13,54,68.42105263157895,34.21052631578947
4119_marine,33,12,25,8,45,75.75757575757575,24.242424242424242
4120_marine,36,13,27,11,49,75,30.555555555555557
4121_marine,35,13,27,10,48,77.14285714285715,28.57142857142857
4122_marine,27,8,23,9,35,85.18518518518519,33.33333333333333
4123_marine,28,13,25,8,41,89.28571428571429,28.57142857142857
4124_marine,20,10,18,3,30,90,15
4125_marine,18,8,18,1,26,100,5.555555555555555
4126_marine,18,8,18,1,26,100,5.555555555555555
4127_marine,18,8,18,1,26,100,5.555555555555555
4128_marine,18,8,18,1,26,100,5.555555555555555
4129_marine,19,8,19,0,27,100,0
4130_marine,19,8,19,0,27,100,0
4131_marine,19,8,19,0,27,100,0
4132_marine,19,7,19,0,26,100,0
4133_marine,18,7,18,0,25,100,0
4134_marine,20,9,20,0,29,100,0
4135_marine,20,9,20,0,29,100,0
4136_marine,18,9,18,0,27,100,0
4137_marine,19,9,18,1,28,94.73684210526315,5.263157894736842
4138_marine,19,9,18,1,28,94.73684210526315,5.263157894736842
4139_marine,19,9,18,1,28,94.73684210526315,5.263157894736842
4140_marine,22,9,21,1,31,95.45454545454545,4.545454545454546
4141_marine,22,9,21,1,31,95.45454545454545,4.545454545454546
4142_marine,22,9,21,1,31,95.45454545454545,4.545454545454546
4143_marine,22,9,21,1,31,95.45454545454545,4.545454545454546
4144_marine,23,9,22,1,32,95.65217391304348,4.3478260869565215
4145_marine,22,9,21,2,31,95.45454545454545,9.090909090909092
4146_marine,22,9,21,2,31,95.45454545454545,9.090909090909092
4147_marine,22,11,21,2,33,95.45454545454545,9.090909090909092
4148_marine,24,11,23,2,35,95.83333333333334,8.333333333333332
4149_marine,35,13,31,6,48,88.57142857142857,17.142857142857142
4150_marine,37,21,33,6,58,89.1891891891892,16.216216216216218
4151_marine,50,22,40,15,72,80,30
4152_marine,58,26,44,20,84,75.86206896551724,34.48275862068966
4153_marine,53,24,41,18,77,77.35849056603774,33.9622641509434
4154_marine,53,25,42,19,78,79.24528301886792,35.84905660377358
4155_marine,53,22,42,18,75,79.24528301886792,33.9622641509434
4156_marine,53,24,43,19,77,81.13207547169812,35.84905660377358
4157_marine,46,20,36,16,66,78.26086956521739,34.78260869565217
4158_marine,42,15,33,12,57,78.57142857142857,28.57142857142857
4159_marine,35,13,29,10,48,82.85714285714286,28.57142857142857
4160_marine,37,13,29,12,50,78.37837837837837,32.432432432432435
4161_marine,42,15,30,14,57,71.42857142857143,33.33333333333333
4162_marine,41,15,29,13,56,70.73170731707317,31.70731707317073
4163_marine,35,14,28,9,49,80,25.71428571428571
4164_marine,35,16,28,9,51,80,25.71428571428571
4165_marine,24,14,21,4,38,87.5,16.666666666666664
4166_marine,24,13,22,3,37,91.66666666666666,12.5
4167_marine,30,16,26,6,46,86.66666666666667,20
4168_marine,30,15,26,6,45,86.66666666666667,20
4169_marine,26,14,24,5,40,92.3076923076923,19.230769230769234
4170_marine,28,14,26,5,42,92.85714285714286,17.857142857142858
4171_marine,29,12,27,4,41,93.10344827586206,13.793103448275861
4172_marine,27,9,26,2,36,96.29629629629629,7.4074074074074066
4173_marine,29,11,28,2,40,96.55172413793103,6.896551724137931
4174_marine,28,9,28,1,37,100,3.571428571428571
4175_marine,25,9,25,1,34,100,4
4176_marine,25,9,25,1,34,100,4
4177_marine,25,9,25,1,34,100,4
4178_marine,25,9,25,1,34,100,4
4179_marine,24,9,24,1,33,100,4.166666666666666
4180_marine,24,9,24,1,33,100,4.166666666666666
4181_marine,24,9,24,1,33,100,4.166666666666666
4182_marine,22,9,22,1,31,100,4.545454545454546
4183_marine,22,9,22,1,31,100,4.545454545454546
4184_marine,20,9,20,1,29,100,5
4185_marine,18,9,18,1,27,100,5.555555555555555
4186_marine,17,9,17,1,26,100,5.88235294117647
4187_marine,17,9,17,1,26,100,5.88235294117647
4188_marine,17,9,17,1,26,100,5.88235294117647
4189_marine,17,9,17,1,26,100,5.88235294117647
4190_marine,17,9,17,1,26,100,5.88235294117647
4191_marine,17,9,17,1,26,100,5.88235294117647
4192_marine,17,7,17,1,24,100,5.88235294117647
4193_marine,17,7,17,1,24,100,5.88235294117647
4194_marine,17,7,17,1,24,100,5.88235294117647
4195_marine,15,7,15,1,22,100,6.666666666666667
4196_marine,15,7,15,1,22,100,6.666666666666667
4197_marine,15,7,15,1,22,100,6.666666666666667
4198_marine,15,7,15,1,22,100,6.666666666666667
4199_marine,15,7,15,1,22,100,6.666666666666667
4200_marine,13,7,13,1,20,100,7.6923076923076925
4201_marine,14,7,14,1,21,100,7.142857142857142
4202_marine,14,7,14,1,21,100,7.142857142857142
4203_marine,14,7,14,1,21,100,7.142857142857142
4204_marine,14,7,14,1,21,100,7.142857142857142
4205_marine,14,7,14,1,21,100,7.142857142857142
4206_marine,14,7,14,1,21,100,7.142857142857142
4207_marine,15,7,15,2,22,100,13.333333333333334
4208_marine,15,7,15,2,22,100,13.333333333333334
4209_marine,13,7,13,2,20,100,15.384615384615385
4210_marine,12,7,12,2,19,100,16.666666666666664
4211_marine,12,7,12,2,19,100,16.666666666666664
4212_marine,11,5,11,1,16,100,9.090909090909092
4213_marine,11,5,11,1,16,100,9.090909090909092
4214_marine,11,5,11,1,16,100,9.090909090909092
4215_marine,11,5,11,1,16,100,9.090909090909092
4216_marine,13,5,13,1,18,100,7.6923076923076925
4217_marine,13,5,13,1,18,100,7.6923076923076925
4218_marine,13,5,13,1,18,100,7.6923076923076925
4219_marine,13,5,13,1,18,100,7.6923076923076925
4220_marine,13,5,13,1,18,100,7.6923076923076925
4221_marine,11,5,11,1,16,100,9.090909090909092
4222_marine,11,5,11,1,16,100,9.090909090909092
4223_marine,11,5,11,1,16,100,9.090909090909092
4224_marine,11,5,11,1,16,100,9.090909090909092
4225_marine,11,5,11,1,16,100,9.090909090909092
4226_marine,11,5,11,1,16,100,9.090909090909092
4227_marine,11,5,11,1,16,100,9.090909090909092
4228_marine,11,5,11,1,16,100,9.090909090909092
4229_marine,13,5,13,1,18,100,7.6923076923076925
4230_marine,13,5,13,1,18,100,7.6923076923076925
4231_marine,15,6,15,2,21,100,13.333333333333334
4232_marine,15,6,15,2,21,100,13.333333333333334
4233_marine,15,6,15,2,21,100,13.333333333333334
4234_marine,18,8,17,5,26,94.44444444444444,27.77777777777778
4235_marine,15,6,15,2,21,100,13.333333333333334
4236_marine,22,9,19,7,31,86.36363636363636,31.818181818181817
4237_marine,21,9,18,7,30,85.71428571428571,33.33333333333333
4238_marine,21,9,18,7,30,85.71428571428571,33.33333333333333
4239_marine,21,9,18,7,30,85.71428571428571,33.33333333333333
4240_marine,21,11,18,7,32,85.71428571428571,33.33333333333333
4241_marine,23,11,20,7,34,86.95652173913044,30.434782608695656
4242_marine,22,11,19,6,33,86.36363636363636,27.27272727272727
4243_marine,22,11,19,6,33,86.36363636363636,27.27272727272727
4244_marine,20,11,17,6,31,85,30
4245_marine,20,11,17,6,31,85,30
4246_marine,19,11,16,5,30,84.21052631578947,26.31578947368421
4247_marine,16,8,14,5,24,87.5,31.25
4248_marine,15,8,13,5,23,86.66666666666667,33.33333333333333
4249_marine,9,6,9,1,15,100,11.11111111111111
4250_marine,9,5,9,1,14,100,11.11111111111111
4251_marine,9,3,9,1,12,100,11.11111111111111
4252_marine,9,3,9,1,12,100,11.11111111111111
4253_marine,9,3,9,1,12,100,11.11111111111111
4276_marine,3,5,3,0,8,100,0
4277_marine,3,5,3,0,8,100,0
4278_marine,3,5,3,0,8,100,0
4279_marine,3,5,3,0,8,100,0
4280_marine,3,5,3,0,8,100,0
4281_marine,3,5,3,0,8,100,0
4282_marine,3,5,3,0,8,100,0
4283_marine,3,5,3,0,8,100,0
4284_marine,3,5,3,0,8,100,0
4285_marine,3,5,3,0,8,100,0
4286_marine,3,5,3,0,8,100,0
4287_marine,3,5,3,0,8,100,0
4288_marine,3,5,3,0,8,100,0
4289_marine,5,5,5,0,10,100,0
4290_marine,5,5,5,0,10,100,0
4291_marine,5,5,5,0,10,100,0
4292_marine,5,5,5,0,10,100,0
4293_marine,5,5,5,0,10,100,0
4294_marine,5,5,5,0,10,100,0
4295_marine,5,5,5,0,10,100,0
4296_marine,5,5,5,0,10,100,0
4297_marine,5,5,5,0,10,100,0
4298_marine,5,5,5,0,10,100,0
4299_marine,5,3,5,0,8,100,0
4300_marine,5,3,5,0,8,100,0
4301_marine,5,3,5,0,8,100,0
4302_marine,5,3,5,0,8,100,0
4303_marine,5,3,5,0,8,100,0
4304_marine,3,3,3,0,6,100,0
4305_marine,3,3,3,0,6,100,0
4306_marine,3,3,3,0,6,100,0
4307_marine,3,3,3,0,6,100,0
4308_marine,3,3,3,0,6,100,0
4309_marine,3,3,3,0,6,100,0
4310_marine,3,3,3,0,6,100,0
4311_marine,3,3,3,0,6,100,0
4312_marine,3,3,3,0,6,100,0
4313_marine,3,3,3,0,6,100,0
4314_marine,3,3,3,0,6,100,0
4315_marine,3,3,3,0,6,100,0
4316_marine,3,3,3,0,6,100,0
4317_marine,3,3,3,0,6,100,0
4318_marine,3,3,3,0,6,100,0
4319_marine,3,3,3,0,6,100,0
4320_marine,3,3,3,0,6,100,0
4321_marine,3,3,3,0,6,100,0
4322_marine,3,3,3,0,6,100,0
4323_marine,4,3,4,0,7,100,0
4324_marine,4,3,4,0,7,100,0
4325_marine,4,3,4,0,7,100,0
4326_marine,6,3,6,0,9,100,0
4327_marine,6,3,6,0,9,100,0
4328_marine,6,3,6,0,9,100,0
4329_marine,6,3,6,0,9,100,0
4330_marine,6,5,6,0,11,100,0
4331_marine,6,5,6,0,11,100,0
4332_marine,5,5,5,0,10,100,0
4333_marine,5,5,5,0,10,100,0
4334_marine,5,5,5,0,10,100,0
4335_marine,5,7,5,0,12,100,0
4336_marine,5,7,5,0,12,100,0
4337_marine,5,7,5,0,12,100,0
4338_marine,5,7,5,0,12,100,0
4339_marine,5,7,5,0,12,100,0
4340_marine,5,7,5,0,12,100,0
4341_marine,5,7,5,0,12,100,0
4342_marine,5,7,5,0,12,100,0
4343_marine,5,7,5,0,12,100,0
4344_marine,5,7,5,0,12,100,0
4345_marine,5,5,5,0,10,100,0
4346_marine,5,5,5,0,10,100,0
4347_marine,3,5,3,0,8,100,0
4348_marine,3,5,3,0,8,100,0
4349_marine,3,5,3,0,8,100,0
4350_marine,3,5,3,0,8,100,0
4351_marine,3,5,3,0,8,100,0
4352_marine,3,5,3,0,8,100,0
4353_marine,3,5,3,0,8,100,0
4354_marine,3,5,3,0,8,100,0
4355_marine,3,5,3,0,8,100,0
4356_marine,3,5,3,0,8,100,0
4357_marine,3,5,3,0,8,100,0
4358_marine,3,5,3,0,8,100,0
4359_marine,3,5,3,0,8,100,0
4360_marine,3,5,3,0,8,100,0
4361_marine,3,5,3,0,8,100,0
4362_marine,3,5,3,0,8,100,0
4363_marine,3,5,3,0,8,100,0
4380_marine,29,9,18,12,38,62.06896551724138,41.37931034482759
4381_marine,29,9,18,12,38,62.06896551724138,41.37931034482759
4382_marine,29,9,18,12,38,62.06896551724138,41.37931034482759
4383_marine,29,9,18,12,38,62.06896551724138,41.37931034482759
4384_marine,29,9,18,12,38,62.06896551724138,41.37931034482759
4385_marine,31,10,20,12,41,64.51612903225806,38.70967741935484
4386_marine,21,7,15,10,28,71.42857142857143,47.61904761904761
4387_marine,32,8,23,13,40,71.875,40.625
4388_marine,25,7,17,10,32,68,40
4389_marine,25,7,17,10,32,68,40
4390_marine,25,7,17,10,32,68,40
4391_marine,25,7,17,10,32,68,40
4394_marine,23,9,14,10,32,60.86956521739131,43.47826086956522
4395_marine,23,9,14,10,32,60.86956521739131,43.47826086956522
4396_marine,24,9,15,10,33,62.5,41.66666666666667
4397_marine,18,9,11,10,27,61.111111111111114,55.55555555555556
4398_marine,20,7,13,10,27,65,50
4399_marine,20,7,13,10,27,65,50
4400_marine,25,7,16,11,32,64,44
4401_marine,25,7,16,11,32,64,44
4402_marine,25,7,16,11,32,64,44
4403_marine,32,10,21,14,42,65.625,43.75
4404_marine,38,10,26,16,48,68.42105263157895,42.10526315789473
4405_marine,38,10,26,16,48,68.42105263157895,42.10526315789473
4406_marine,25,8,17,11,33,68,44
4407_marine,25,9,17,11,34,68,44
4408_marine,7,4,7,0,11,100,0
4409_marine,29,8,21,13,37,72.41379310344827,44.827586206896555
4410_marine,31,8,23,13,39,74.19354838709677,41.935483870967744
4411_marine,32,8,24,13,40,75,40.625
4412_marine,43,8,26,16,51,60.46511627906976,37.2093023255814
4413_marine,41,8,24,16,49,58.536585365853654,39.02439024390244
4414_marine,41,8,24,16,49,58.536585365853654,39.02439024390244
4415_marine,41,8,24,16,49,58.536585365853654,39.02439024390244
4416_marine,41,8,24,16,49,58.536585365853654,39.02439024390244
4417_marine,41,8,24,16,49,58.536585365853654,39.02439024390244
4418_marine,44,12,28,16,56,63.63636363636363,36.36363636363637
4419_marine,48,12,30,17,60,62.5,35.41666666666667
4420_marine,49,14,31,17,63,63.26530612244898,34.69387755102041
4421_marine,50,14,32,17,64,64,34
4422_marine,50,14,32,17,64,64,34
4423_marine,46,14,30,16,60,65.21739130434783,34.78260869565217
4424_marine,44,14,30,16,58,68.18181818181817,36.36363636363637
4425_marine,43,14,29,16,57,67.44186046511628,37.2093023255814
4426_marine,15,11,15,0,26,100,0
4427_marine,17,14,16,1,31,94.11764705882352,5.88235294117647
4428_marine,47,21,34,15,68,72.3404255319149,31.914893617021278
4429_marine,50,20,36,18,70,72,36
4430_marine,51,20,37,17,71,72.54901960784314,33.33333333333333
4431_marine,50,20,36,16,70,72,32
4432_marine,48,20,34,16,68,70.83333333333334,33.33333333333333
4433_marine,44,20,31,15,64,70.45454545454545,34.090909090909086
4434_marine,44,20,31,15,64,70.45454545454545,34.090909090909086
4479_marine,36,12,27,11,48,75,30.555555555555557
4480_marine,39,12,30,12,51,76.92307692307693,30.76923076923077
4481_marine,39,12,30,12,51,76.92307692307693,30.76923076923077
4482_marine,41,12,32,12,53,78.04878048780488,29.268292682926827
4483_marine,33,10,29,10,43,87.87878787878788,30.303030303030305
4484_marine,28,8,26,6,36,92.85714285714286,21.428571428571427
4485_marine,24,8,24,2,32,100,8.333333333333332
4486_marine,23,8,23,2,31,100,8.695652173913043
4487_marine,23,8,23,2,31,100,8.695652173913043
4488_marine,20,8,20,1,28,100,5
4489_marine,20,8,20,1,28,100,5
4490_marine,17,8,17,0,25,100,0
4491_marine,20,8,20,0,28,100,0
4492_marine,20,10,20,0,30,100,0
4493_marine,20,9,20,0,29,100,0
4494_marine,20,9,20,0,29,100,0
4495_marine,20,9,20,0,29,100,0
4496_marine,20,9,20,0,29,100,0
4497_marine,22,9,21,1,31,95.45454545454545,4.545454545454546
4498_marine,22,9,21,1,31,95.45454545454545,4.545454545454546
4499_marine,22,7,21,1,29,95.45454545454545,4.545454545454546
4500_marine,22,7,21,1,29,95.45454545454545,4.545454545454546
4501_marine,22,7,21,1,29,95.45454545454545,4.545454545454546
4502_marine,20,7,19,1,27,95,5
4503_marine,20,9,19,1,29,95,5
4504_marine,21,11,20,2,32,95.23809523809523,9.523809523809524
4505_marine,21,11,20,2,32,95.23809523809523,9.523809523809524
4506_marine,23,11,22,2,34,95.65217391304348,8.695652173913043
4507_marine,23,11,22,2,34,95.65217391304348,8.695652173913043
4508_marine,21,11,20,2,32,95.23809523809523,9.523809523809524
4509_marine,27,15,26,2,42,96.29629629629629,7.4074074074074066
4510_marine,34,16,32,4,50,94.11764705882352,11.76470588235294
4511_marine,36,23,33,5,59,91.66666666666666,13.88888888888889
4512_marine,37,23,33,6,60,89.1891891891892,16.216216216216218
4513_marine,38,23,34,7,61,89.47368421052632,18.421052631578945
4514_marine,61,25,47,24,86,77.04918032786885,39.34426229508197
4515_marine,58,22,46,20,80,79.3103448275862,34.48275862068966
4516_marine,55,22,44,20,77,80,36.36363636363637
4517_marine,39,16,33,10,55,84.61538461538461,25.64102564102564
4518_marine,43,16,35,12,59,81.3953488372093,27.906976744186046
4519_marine,43,17,36,11,60,83.72093023255815,25.581395348837212
4520_marine,33,17,29,6,50,87.87878787878788,18.181818181818183
4521_marine,46,17,36,13,63,78.26086956521739,28.26086956521739
4522_marine,42,17,33,12,59,78.57142857142857,28.57142857142857
4523_marine,42,15,33,14,57,78.57142857142857,33.33333333333333
4524_marine,42,17,33,13,59,78.57142857142857,30.952380952380953
4525_marine,39,15,32,10,54,82.05128205128204,25.64102564102564
4526_marine,34,17,29,7,51,85.29411764705883,20.588235294117645
4527_marine,28,17,26,4,45,92.85714285714286,14.285714285714285
4528_marine,28,17,26,3,45,92.85714285714286,10.714285714285714
4529_marine,28,17,26,3,45,92.85714285714286,10.714285714285714
4530_marine,27,17,26,2,44,96.29629629629629,7.4074074074074066
4531_marine,27,15,26,2,42,96.29629629629629,7.4074074074074066
4532_marine,27,13,26,2,40,96.29629629629629,7.4074074074074066
4533_marine,27,13,26,2,40,96.29629629629629,7.4074074074074066
4534_marine,27,11,26,2,38,96.29629629629629,7.4074074074074066
4535_marine,28,9,27,2,37,96.42857142857143,7.142857142857142
4536_marine,26,9,25,2,35,96.15384615384616,7.6923076923076925
4537_marine,26,9,25,2,35,96.15384615384616,7.6923076923076925
4538_marine,26,9,25,2,35,96.15384615384616,7.6923076923076925
4539_marine,22,9,21,2,31,95.45454545454545,9.090909090909092
4540_marine,20,9,19,2,29,95,10
4541_marine,20,9,19,2,29,95,10
4542_marine,18,9,17,2,27,94.44444444444444,11.11111111111111
4543_marine,18,9,17,2,27,94.44444444444444,11.11111111111111
4544_marine,18,9,17,2,27,94.44444444444444,11.11111111111111
4545_marine,19,9,18,2,28,94.73684210526315,10.526315789473683
4546_marine,17,9,16,2,26,94.11764705882352,11.76470588235294
4547_marine,17,9,16,2,26,94.11764705882352,11.76470588235294
4548_marine,17,9,16,2,26,94.11764705882352,11.76470588235294
4549_marine,19,9,18,2,28,94.73684210526315,10.526315789473683
4550_marine,18,9,17,2,27,94.44444444444444,11.11111111111111
4551_marine,18,9,17,2,27,94.44444444444444,11.11111111111111
4552_marine,18,9,17,2,27,94.44444444444444,11.11111111111111
4553_marine,16,7,15,2,23,93.75,12.5
4554_marine,17,7,16,2,24,94.11764705882352,11.76470588235294
4555_marine,17,7,16,2,24,94.11764705882352,11.76470588235294
4556_marine,17,7,16,2,24,94.11764705882352,11.76470588235294
4557_marine,17,7,16,2,24,94.11764705882352,11.76470588235294
4558_marine,17,7,16,2,24,94.11764705882352,11.76470588235294
4559_marine,17,7,16,2,24,94.11764705882352,11.76470588235294
4560_marine,17,8,16,2,25,94.11764705882352,11.76470588235294
4561_marine,15,8,14,2,23,93.33333333333333,13.333333333333334
4562_marine,15,8,14,2,23,93.33333333333333,13.333333333333334
4563_marine,15,8,14,2,23,93.33333333333333,13.333333333333334
4564_marine,16,8,15,3,24,93.75,18.75
4565_marine,17,8,16,3,25,94.11764705882352,17.647058823529413
4566_marine,20,8,17,5,28,85,25
4567_marine,21,8,17,6,29,80.95238095238095,28.57142857142857
4568_marine,34,18,25,11,52,73.52941176470588,32.35294117647059
4569_marine,24,13,19,8,37,79.16666666666666,33.33333333333333
4570_marine,18,8,17,3,26,94.44444444444444,16.666666666666664
4571_marine,14,5,14,2,19,100,14.285714285714285
4572_marine,12,5,12,2,17,100,16.666666666666664
4573_marine,12,5,12,2,17,100,16.666666666666664
4574_marine,12,5,12,2,17,100,16.666666666666664
4575_marine,11,5,11,1,16,100,9.090909090909092
4576_marine,11,5,11,1,16,100,9.090909090909092
4577_marine,11,5,11,1,16,100,9.090909090909092
4578_marine,11,5,11,1,16,100,9.090909090909092
4579_marine,11,5,11,1,16,100,9.090909090909092
4580_marine,11,5,11,1,16,100,9.090909090909092
4581_marine,9,5,9,1,14,100,11.11111111111111
4582_marine,9,5,9,1,14,100,11.11111111111111
4583_marine,13,7,11,5,20,84.61538461538461,38.46153846153847
4584_marine,9,5,9,1,14,100,11.11111111111111
4585_marine,9,5,9,1,14,100,11.11111111111111
4586_marine,9,5,9,1,14,100,11.11111111111111
4587_marine,9,5,9,1,14,100,11.11111111111111
4588_marine,9,5,9,1,14,100,11.11111111111111
4589_marine,20,8,16,10,28,80,50
4590_marine,22,8,18,10,30,81.81818181818183,45.45454545454545
4591_marine,16,8,14,6,24,87.5,37.5
4592_marine,18,7,16,7,25,88.88888888888889,38.88888888888889
4593_marine,20,7,18,7,27,90,35
4594_marine,14,5,13,2,19,92.85714285714286,14.285714285714285
4595_marine,14,6,13,2,20,92.85714285714286,14.285714285714285
4596_marine,38,17,32,18,55,84.21052631578947,47.368421052631575
4597_marine,38,17,32,18,55,84.21052631578947,47.368421052631575
4598_marine,14,6,13,2,20,92.85714285714286,14.285714285714285
4599_marine,13,6,13,1,19,100,7.6923076923076925
4600_marine,23,11,19,7,34,82.6086956521739,30.434782608695656
4601_marine,29,18,24,9,47,82.75862068965517,31.03448275862069
4602_marine,35,20,28,16,55,80,45.714285714285715
4603_marine,36,20,29,17,56,80.55555555555556,47.22222222222222
4604_marine,52,23,36,21,75,69.23076923076923,40.38461538461539
4605_marine,49,24,33,21,73,67.3469387755102,42.857142857142854
4606_marine,50,24,34,21,74,68,42
4607_marine,51,24,35,21,75,68.62745098039215,41.17647058823529
4608_marine,53,24,37,23,77,69.81132075471697,43.39622641509434
4609_marine,20,14,18,6,34,90,30
4610_marine,12,6,11,4,18,91.66666666666666,33.33333333333333
4611_marine,12,6,11,4,18,91.66666666666666,33.33333333333333
4612_marine,12,6,11,4,18,91.66666666666666,33.33333333333333
4613_marine,12,6,11,4,18,91.66666666666666,33.33333333333333
4614_marine,11,6,10,3,17,90.9090909090909,27.27272727272727
4615_marine,10,3,10,2,13,100,20
4616_marine,9,3,9,1,12,100,11.11111111111111
4617_marine,9,3,9,1,12,100,11.11111111111111
4635_marine,7,5,7,1,12,100,14.285714285714285
4636_marine,8,5,8,1,13,100,12.5
4637_marine,8,5,8,1,13,100,12.5
4638_marine,8,5,8,1,13,100,12.5
4639_marine,8,5,8,1,13,100,12.5
4640_marine,8,6,8,1,14,100,12.5
4641_marine,8,6,8,1,14,100,12.5
4642_marine,6,6,6,1,12,100,16.666666666666664
4643_marine,6,5,6,1,11,100,16.666666666666664
4644_marine,6,5,6,1,11,100,16.666666666666664
4645_marine,6,5,6,1,11,100,16.666666666666664
4646_marine,6,5,6,1,11,100,16.666666666666664
4647_marine,8,5,8,1,13,100,12.5
4648_marine,8,6,8,1,14,100,12.5
4649_marine,7,6,7,0,13,100,0
4650_marine,7,6,7,0,13,100,0
4651_marine,5,6,5,0,11,100,0
4652_marine,5,5,5,0,10,100,0
4653_marine,5,5,5,0,10,100,0
4654_marine,5,5,5,0,10,100,0
4655_marine,5,5,5,0,10,100,0
4656_marine,5,5,5,0,10,100,0
4657_marine,8,6,7,1,14,87.5,12.5
4658_marine,6,5,6,0,11,100,0
4659_marine,6,5,6,0,11,100,0
4660_marine,6,5,6,0,11,100,0
4661_marine,6,5,6,0,11,100,0
4662_marine,6,3,6,0,9,100,0
4663_marine,6,3,6,0,9,100,0
4664_marine,6,3,6,0,9,100,0
4665_marine,6,3,6,0,9,100,0
4666_marine,5,3,5,0,8,100,0
4667_marine,5,3,5,0,8,100,0
4668_marine,3,3,3,0,6,100,0
4669_marine,3,3,3,0,6,100,0
4670_marine,3,3,3,0,6,100,0
4671_marine,3,3,3,0,6,100,0
4672_marine,3,3,3,0,6,100,0
4673_marine,3,3,3,0,6,100,0
4674_marine,3,3,3,0,6,100,0
4675_marine,3,3,3,0,6,100,0
4676_marine,3,3,3,0,6,100,0
4677_marine,3,3,3,0,6,100,0
4678_marine,3,3,3,0,6,100,0
4679_marine,3,3,3,0,6,100,0
4680_marine,3,3,3,0,6,100,0
4681_marine,4,3,4,0,7,100,0
4682_marine,4,3,4,0,7,100,0
4683_marine,4,3,4,0,7,100,0
4684_marine,4,3,4,0,7,100,0
4685_marine,6,3,6,0,9,100,0
4686_marine,6,3,6,0,9,100,0
4687_marine,6,3,6,0,9,100,0
4688_marine,6,3,6,0,9,100,0
4689_marine,7,5,7,0,12,100,0
4690_marine,7,5,7,0,12,100,0
4691_marine,7,5,7,0,12,100,0
4692_marine,7,5,7,0,12,100,0
4693_marine,7,5,7,0,12,100,0
4694_marine,7,7,7,0,14,100,0
4695_marine,7,7,7,0,14,100,0
4696_marine,7,7,7,0,14,100,0
4697_marine,7,7,7,0,14,100,0
4698_marine,7,7,7,0,14,100,0
4699_marine,7,7,7,0,14,100,0
4700_marine,7,7,7,0,14,100,0
4701_marine,7,7,7,0,14,100,0
4702_marine,7,7,7,0,14,100,0
4703_marine,7,7,7,0,14,100,0
4704_marine,7,7,7,0,14,100,0
4705_marine,6,5,6,0,11,100,0
4706_marine,6,5,6,0,11,100,0
4707_marine,6,5,6,0,11,100,0
4708_marine,4,5,4,0,9,100,0
4709_marine,3,5,3,0,8,100,0
4710_marine,3,5,3,0,8,100,0
4711_marine,3,5,3,0,8,100,0
4712_marine,3,5,3,0,8,100,0
4713_marine,3,5,3,0,8,100,0
4714_marine,3,5,3,0,8,100,0
4715_marine,3,5,3,0,8,100,0
4716_marine,3,5,3,0,8,100,0
4717_marine,3,5,3,0,8,100,0
4718_marine,3,5,3,0,8,100,0
4719_marine,3,5,3,0,8,100,0
4720_marine,3,5,3,0,8,100,0
4721_marine,3,5,3,0,8,100,0
4722_marine,3,5,3,0,8,100,0
4723_marine,3,5,3,0,8,100,0
4724_marine,3,5,3,0,8,100,0
4725_marine,3,5,3,0,8,100,0
4726_marine,3,5,3,0,8,100,0
4737_marine,27,11,16,12,38,59.25925925925925,44.44444444444444
4738_marine,29,11,18,12,40,62.06896551724138,41.37931034482759
4739_marine,29,11,18,12,40,62.06896551724138,41.37931034482759
4740_marine,29,11,18,12,40,62.06896551724138,41.37931034482759
4741_marine,29,11,18,12,40,62.06896551724138,41.37931034482759
4742_marine,32,11,20,13,43,62.5,40.625
4743_marine,32,12,20,13,44,62.5,40.625
4744_marine,39,12,22,16,51,56.41025641025641,41.02564102564102
4745_marine,39,10,22,16,49,56.41025641025641,41.02564102564102
4746_marine,35,10,20,16,45,57.14285714285714,45.714285714285715
4747_marine,37,10,22,16,47,59.45945945945946,43.24324324324324
4748_marine,38,10,23,17,48,60.526315789473685,44.73684210526316
4749_marine,35,10,20,16,45,57.14285714285714,45.714285714285715
4750_marine,36,11,20,17,47,55.55555555555556,47.22222222222222
4751_marine,36,11,20,17,47,55.55555555555556,47.22222222222222
4752_marine,36,11,20,17,47,55.55555555555556,47.22222222222222
4753_marine,40,11,23,19,51,57.49999999999999,47.5
4754_marine,42,11,24,19,53,57.14285714285714,45.23809523809524
4755_marine,42,11,24,19,53,57.14285714285714,45.23809523809524
4756_marine,24,10,16,12,34,66.66666666666666,50
4757_marine,24,10,16,12,34,66.66666666666666,50
4758_marine,34,10,23,15,44,67.64705882352942,44.11764705882353
4759_marine,33,10,22,15,43,66.66666666666666,45.45454545454545
4760_marine,34,10,23,16,44,67.64705882352942,47.05882352941176
4761_marine,35,10,23,17,45,65.71428571428571,48.57142857142857
4762_marine,33,10,21,16,43,63.63636363636363,48.484848484848484
4763_marine,39,14,26,19,53,66.66666666666666,48.717948717948715
4764_marine,37,13,25,17,50,67.56756756756756,45.94594594594595
4765_marine,36,13,24,16,49,66.66666666666666,44.44444444444444
4766_marine,37,13,24,17,50,64.86486486486487,45.94594594594595
4767_marine,37,13,24,17,50,64.86486486486487,45.94594594594595
4768_marine,37,13,24,17,50,64.86486486486487,45.94594594594595
4769_marine,39,11,26,18,50,66.66666666666666,46.15384615384615
4770_marine,45,12,32,19,57,71.11111111111111,42.22222222222222
4771_marine,54,12,35,18,66,64.81481481481481,33.33333333333333
4772_marine,46,10,28,18,56,60.86956521739131,39.130434782608695
4773_marine,45,10,27,17,55,60,37.77777777777778
4774_marine,44,10,26,17,54,59.09090909090909,38.63636363636363
4775_marine,44,10,26,17,54,59.09090909090909,38.63636363636363
4776_marine,44,10,26,17,54,59.09090909090909,38.63636363636363
4777_marine,44,10,26,17,54,59.09090909090909,38.63636363636363
4778_marine,48,10,29,18,58,60.416666666666664,37.5
4779_marine,51,14,32,19,65,62.745098039215684,37.254901960784316
4780_marine,52,16,33,19,68,63.46153846153846,36.53846153846153
4781_marine,51,16,33,18,67,64.70588235294117,35.294117647058826
4782_marine,52,16,34,18,68,65.38461538461539,34.61538461538461
4783_marine,51,16,33,18,67,64.70588235294117,35.294117647058826
4784_marine,16,12,16,1,28,100,6.25
4785_marine,16,11,15,1,27,93.75,6.25
4786_marine,16,12,15,1,28,93.75,6.25
4787_marine,33,16,27,12,49,81.81818181818183,36.36363636363637
4788_marine,38,18,31,15,56,81.57894736842105,39.473684210526315
4789_marine,54,21,38,20,75,70.37037037037037,37.03703703703704
4790_marine,54,21,37,21,75,68.51851851851852,38.88888888888889
4791_marine,56,21,39,21,77,69.64285714285714,37.5
4792_marine,55,20,40,19,75,72.72727272727273,34.54545454545455
4793_marine,51,19,36,18,70,70.58823529411765,35.294117647058826
4794_marine,52,20,37,19,72,71.15384615384616,36.53846153846153
4795_marine,51,20,36,19,71,70.58823529411765,37.254901960784316
4796_marine,49,20,34,19,69,69.38775510204081,38.775510204081634
4797_marine,49,20,34,19,69,69.38775510204081,38.775510204081634
4798_marine,48,22,33,19,70,68.75,39.58333333333333
4799_marine,45,22,32,18,67,71.11111111111111,40
4800_marine,45,21,32,18,66,71.11111111111111,40
4838_marine,38,12,29,11,50,76.31578947368422,28.947368421052634
4839_marine,39,12,30,11,51,76.92307692307693,28.205128205128204
4840_marine,41,12,32,11,53,78.04878048780488,26.82926829268293
4841_marine,44,14,35,11,58,79.54545454545455,25
4842_marine,44,14,35,11,58,79.54545454545455,25
4843_marine,28,7,26,5,35,92.85714285714286,17.857142857142858
4844_marine,28,8,26,5,36,92.85714285714286,17.857142857142858
4845_marine,26,8,26,3,34,100,11.538461538461538
4846_marine,26,8,26,3,34,100,11.538461538461538
4847_marine,25,8,25,2,33,100,8
4848_marine,22,10,22,2,32,100,9.090909090909092
4849_marine,23,10,23,2,33,100,8.695652173913043
4850_marine,22,10,22,1,32,100,4.545454545454546
4851_marine,21,10,21,0,31,100,0
4852_marine,21,10,21,0,31,100,0
4853_marine,23,9,23,0,32,100,0
4854_marine,23,9,23,0,32,100,0
4855_marine,23,9,23,0,32,100,0
4856_marine,22,9,21,1,31,95.45454545454545,4.545454545454546
4857_marine,22,9,21,1,31,95.45454545454545,4.545454545454546
4858_marine,22,9,21,1,31,95.45454545454545,4.545454545454546
4859_marine,22,9,21,1,31,95.45454545454545,4.545454545454546
4860_marine,20,9,19,1,29,95,5
4861_marine,20,11,19,1,31,95,5
4862_marine,20,11,19,1,31,95,5
4863_marine,21,11,20,2,32,95.23809523809523,9.523809523809524
4864_marine,21,11,20,2,32,95.23809523809523,9.523809523809524
4865_marine,21,11,20,2,32,95.23809523809523,9.523809523809524
4866_marine,23,11,22,2,34,95.65217391304348,8.695652173913043
4867_marine,23,11,22,2,34,95.65217391304348,8.695652173913043
4868_marine,21,11,20,2,32,95.23809523809523,9.523809523809524
4869_marine,25,13,24,2,38,96,8
4870_marine,28,12,26,3,40,92.85714285714286,10.714285714285714
4871_marine,30,18,28,3,48,93.33333333333333,10
4872_marine,32,20,30,3,52,93.75,9.375
4873_marine,34,22,31,5,56,91.17647058823529,14.705882352941178
4874_marine,40,23,35,7,63,87.5,17.5
4875_marine,40,23,35,7,63,87.5,17.5
4876_marine,54,26,42,16,80,77.77777777777779,29.629629629629626
4877_marine,55,24,42,17,79,76.36363636363637,30.909090909090907
4878_marine,54,22,43,15,76,79.62962962962963,27.77777777777778
4879_marine,37,19,33,6,56,89.1891891891892,16.216216216216218
4880_marine,31,19,29,4,50,93.54838709677419,12.903225806451612
4881_marine,32,20,29,4,52,90.625,12.5
4882_marine,43,21,37,10,64,86.04651162790698,23.25581395348837
4883_marine,32,20,29,5,52,90.625,15.625
4884_marine,33,20,30,5,53,90.9090909090909,15.151515151515152
4885_marine,36,17,31,8,53,86.11111111111111,22.22222222222222
4886_marine,36,16,31,8,52,86.11111111111111,22.22222222222222
4887_marine,32,17,30,4,49,93.75,12.5
4888_marine,31,17,29,4,48,93.54838709677419,12.903225806451612
4889_marine,28,17,26,3,45,92.85714285714286,10.714285714285714
4890_marine,28,17,26,3,45,92.85714285714286,10.714285714285714
4891_marine,28,15,26,3,43,92.85714285714286,10.714285714285714
4892_marine,28,13,26,3,41,92.85714285714286,10.714285714285714
4893_marine,28,13,26,3,41,92.85714285714286,10.714285714285714
4894_marine,30,13,28,3,43,93.33333333333333,10
4895_marine,29,13,27,3,42,93.10344827586206,10.344827586206897
4896_marine,29,13,27,3,42,93.10344827586206,10.344827586206897
4897_marine,25,13,23,3,38,92,12
4898_marine,23,13,21,3,36,91.30434782608695,13.043478260869565
4899_marine,22,13,21,2,35,95.45454545454545,9.090909090909092
4900_marine,20,13,19,2,33,95,10
4901_marine,20,13,19,2,33,95,10
4902_marine,18,13,17,2,31,94.44444444444444,11.11111111111111
4903_marine,18,13,17,2,31,94.44444444444444,11.11111111111111
4904_marine,18,11,17,2,29,94.44444444444444,11.11111111111111
4905_marine,18,11,17,2,29,94.44444444444444,11.11111111111111
4906_marine,18,9,17,2,27,94.44444444444444,11.11111111111111
4907_marine,18,9,17,2,27,94.44444444444444,11.11111111111111
4908_marine,17,9,16,2,26,94.11764705882352,11.76470588235294
4909_marine,18,9,17,2,27,94.44444444444444,11.11111111111111
4910_marine,18,9,17,2,27,94.44444444444444,11.11111111111111
4911_marine,20,9,19,2,29,95,10
4912_marine,20,9,19,2,29,95,10
4913_marine,19,7,18,2,26,94.73684210526315,10.526315789473683
4914_marine,17,7,16,2,24,94.11764705882352,11.76470588235294
4915_marine,17,7,16,2,24,94.11764705882352,11.76470588235294
4916_marine,17,7,16,2,24,94.11764705882352,11.76470588235294
4917_marine,18,8,16,3,26,88.88888888888889,16.666666666666664
4918_marine,21,8,19,5,29,90.47619047619048,23.809523809523807
4919_marine,27,9,22,9,36,81.48148148148148,33.33333333333333
4920_marine,33,12,25,13,45,75.75757575757575,39.39393939393939
4921_marine,35,18,25,13,53,71.42857142857143,37.142857142857146
4922_marine,34,18,24,12,52,70.58823529411765,35.294117647058826
4923_marine,34,19,24,12,53,70.58823529411765,35.294117647058826
4924_marine,32,18,23,11,50,71.875,34.375
4925_marine,33,18,24,11,51,72.72727272727273,33.33333333333333
4926_marine,34,19,25,12,53,73.52941176470588,35.294117647058826
4927_marine,32,19,23,11,51,71.875,34.375
4928_marine,33,19,24,11,52,72.72727272727273,33.33333333333333
4929_marine,34,20,26,11,54,76.47058823529412,32.35294117647059
4930_marine,26,15,21,4,41,80.76923076923077,15.384615384615385
4931_marine,13,5,13,1,18,100,7.6923076923076925
4932_marine,11,5,11,1,16,100,9.090909090909092
4933_marine,11,5,11,1,16,100,9.090909090909092
4934_marine,12,5,12,2,17,100,16.666666666666664
4935_marine,12,5,12,2,17,100,16.666666666666664
4936_marine,11,5,11,1,16,100,9.090909090909092
4937_marine,11,5,11,1,16,100,9.090909090909092
4938_marine,11,5,11,1,16,100,9.090909090909092
4939_marine,10,5,10,1,15,100,10
4940_marine,10,5,10,1,15,100,10
4941_marine,10,5,10,1,15,100,10
4942_marine,8,5,8,1,13,100,12.5
4943_marine,8,5,8,1,13,100,12.5
4944_marine,8,5,8,1,13,100,12.5
4945_marine,8,5,8,1,13,100,12.5
4946_marine,8,5,8,1,13,100,12.5
4947_marine,9,5,9,2,14,100,22.22222222222222
4948_marine,9,5,9,2,14,100,22.22222222222222
4949_marine,17,5,14,8,22,82.35294117647058,47.05882352941176
4950_marine,17,5,14,8,22,82.35294117647058,47.05882352941176
4951_marine,12,5,11,3,17,91.66666666666666,25
4952_marine,18,13,16,5,31,88.88888888888889,27.77777777777778
4953_marine,51,22,34,23,73,66.66666666666666,45.09803921568628
4954_marine,52,24,35,24,76,67.3076923076923,46.15384615384615
4955_marine,52,24,35,24,76,67.3076923076923,46.15384615384615
4956_marine,50,24,33,22,74,66,44
4957_marine,50,24,33,22,74,66,44
4958_marine,50,24,33,22,74,66,44
4959_marine,50,24,33,22,74,66,44
4960_marine,51,24,34,23,75,66.66666666666666,45.09803921568628
4961_marine,50,24,34,22,74,68,44
4962_marine,49,24,33,21,73,67.3469387755102,42.857142857142854
4966_marine,8,6,7,2,14,87.5,25
4967_marine,50,24,34,22,74,68,44
4968_marine,52,24,35,24,76,67.3076923076923,46.15384615384615
4969_marine,53,24,36,25,77,67.9245283018868,47.16981132075472
4970_marine,53,24,36,25,77,67.9245283018868,47.16981132075472
4971_marine,52,24,35,24,76,67.3076923076923,46.15384615384615
4972_marine,52,24,35,24,76,67.3076923076923,46.15384615384615
4973_marine,53,24,36,25,77,67.9245283018868,47.16981132075472
4974_marine,55,24,38,25,79,69.0909090909091,45.45454545454545
4975_marine,12,6,11,4,18,91.66666666666666,33.33333333333333
4976_marine,9,5,9,1,14,100,11.11111111111111
4977_marine,9,5,9,1,14,100,11.11111111111111
4978_marine,9,5,9,1,14,100,11.11111111111111
4979_marine,9,3,9,1,12,100,11.11111111111111
4980_marine,9,3,9,1,12,100,11.11111111111111
4981_marine,9,3,9,1,12,100,11.11111111111111
4982_marine,9,3,9,1,12,100,11.11111111111111
4991_marine,7,5,7,1,12,100,14.285714285714285
4992_marine,7,5,7,1,12,100,14.285714285714285
4993_marine,7,5,7,1,12,100,14.285714285714285
4994_marine,7,5,7,1,12,100,14.285714285714285
4995_marine,7,6,7,1,13,100,14.285714285714285
4996_marine,12,6,11,5,18,91.66666666666666,41.66666666666667
4997_marine,12,6,11,5,18,91.66666666666666,41.66666666666667
4998_marine,29,10,23,18,39,79.3103448275862,62.06896551724138
4999_marine,40,14,31,22,54,77.5,55.00000000000001
5000_marine,38,14,29,21,52,76.31578947368422,55.26315789473685
5001_marine,38,13,29,21,51,76.31578947368422,55.26315789473685
5002_marine,38,13,29,21,51,76.31578947368422,55.26315789473685
5003_marine,23,9,19,9,32,82.6086956521739,39.130434782608695
5004_marine,10,6,10,3,16,100,30
5005_marine,9,6,9,2,15,100,22.22222222222222
5006_marine,11,6,11,2,17,100,18.181818181818183
5007_marine,11,6,11,2,17,100,18.181818181818183
5008_marine,8,6,8,1,14,100,12.5
5009_marine,17,9,13,7,26,76.47058823529412,41.17647058823529
5010_marine,15,9,12,5,24,80,33.33333333333333
5011_marine,8,6,8,1,14,100,12.5
5012_marine,8,5,8,1,13,100,12.5
5013_marine,15,7,12,5,22,80,33.33333333333333
5014_marine,8,5,8,0,13,100,0
5015_marine,6,5,6,0,11,100,0
5016_marine,6,5,6,0,11,100,0
5017_marine,7,5,7,1,12,100,14.285714285714285
5018_marine,6,5,6,0,11,100,0
5019_marine,6,5,6,0,11,100,0
5020_marine,6,5,6,0,11,100,0
5021_marine,6,5,6,0,11,100,0
5022_marine,6,5,6,0,11,100,0
5023_marine,6,5,6,0,11,100,0
5024_marine,6,3,6,0,9,100,0
5025_marine,6,3,6,0,9,100,0
5026_marine,6,3,6,0,9,100,0
5027_marine,6,3,6,0,9,100,0
5028_marine,6,3,6,0,9,100,0
5029_marine,6,3,6,0,9,100,0
5030_marine,6,3,6,0,9,100,0
5031_marine,6,3,6,0,9,100,0
5032_marine,7,3,7,0,10,100,0
5033_marine,5,3,5,0,8,100,0
5034_marine,5,3,5,0,8,100,0
5035_marine,5,3,5,0,8,100,0
5036_marine,5,3,5,0,8,100,0
5037_marine,4,3,4,0,7,100,0
5038_marine,4,3,4,0,7,100,0
5039_marine,4,3,4,0,7,100,0
5040_marine,4,3,4,0,7,100,0
5041_marine,5,3,5,0,8,100,0
5042_marine,5,3,5,0,8,100,0
5043_marine,5,3,5,0,8,100,0
5044_marine,7,3,7,0,10,100,0
5045_marine,7,3,7,0,10,100,0
5046_marine,7,3,7,0,10,100,0
5047_marine,7,3,7,0,10,100,0
5048_marine,7,3,7,0,10,100,0
5049_marine,7,5,7,0,12,100,0
5050_marine,7,5,7,0,12,100,0
5051_marine,7,5,7,0,12,100,0
5052_marine,7,7,7,0,14,100,0
5053_marine,7,7,7,0,14,100,0
5054_marine,7,7,7,0,14,100,0
5055_marine,7,7,7,0,14,100,0
5056_marine,7,7,7,0,14,100,0
5057_marine,7,7,7,0,14,100,0
5058_marine,7,7,7,0,14,100,0
5059_marine,7,7,7,0,14,100,0
5060_marine,7,7,7,0,14,100,0
5061_marine,7,7,7,0,14,100,0
5062_marine,8,7,8,0,15,100,0
5063_marine,8,7,8,0,15,100,0
5064_marine,8,7,8,0,15,100,0
5065_marine,8,7,8,0,15,100,0
5066_marine,7,5,7,0,12,100,0
5067_marine,7,5,7,0,12,100,0
5068_marine,5,5,5,0,10,100,0
5069_marine,5,5,5,0,10,100,0
5070_marine,5,5,5,0,10,100,0
5071_marine,5,5,5,0,10,100,0
5072_marine,5,5,5,0,10,100,0
5073_marine,4,5,4,0,9,100,0
5074_marine,4,5,4,0,9,100,0
5075_marine,4,5,4,0,9,100,0
5076_marine,4,5,4,0,9,100,0
5077_marine,4,5,4,0,9,100,0
5078_marine,4,5,4,0,9,100,0
5079_marine,4,5,4,0,9,100,0
5080_marine,3,5,3,0,8,100,0
5081_marine,3,5,3,0,8,100,0
5082_marine,3,5,3,0,8,100,0
5083_marine,3,5,3,0,8,100,0
5084_marine,3,5,3,0,8,100,0
5085_marine,3,5,3,0,8,100,0
5086_marine,3,5,3,0,8,100,0
5087_marine,3,5,3,0,8,100,0
5088_marine,3,5,3,0,8,100,0
5097_marine,5,6,5,0,11,100,0
5098_marine,30,11,19,12,41,63.33333333333333,40
5099_marine,30,11,19,12,41,63.33333333333333,40
5100_marine,30,11,19,12,41,63.33333333333333,40
5101_marine,33,11,21,13,44,63.63636363636363,39.39393939393939
5102_marine,25,9,16,11,34,64,44
5103_marine,39,12,23,17,51,58.97435897435898,43.58974358974359
5104_marine,36,12,21,16,48,58.333333333333336,44.44444444444444
5105_marine,39,12,24,17,51,61.53846153846154,43.58974358974359
5106_marine,36,12,21,17,48,58.333333333333336,47.22222222222222
5107_marine,39,12,23,17,51,58.97435897435898,43.58974358974359
5108_marine,42,13,26,18,55,61.904761904761905,42.857142857142854
5109_marine,42,13,26,18,55,61.904761904761905,42.857142857142854
5110_marine,40,11,23,19,51,57.49999999999999,47.5
5111_marine,43,11,25,19,54,58.139534883720934,44.18604651162791
5112_marine,43,11,25,19,54,58.139534883720934,44.18604651162791
5113_marine,41,11,24,19,52,58.536585365853654,46.34146341463415
5114_marine,43,11,25,19,54,58.139534883720934,44.18604651162791
5115_marine,43,11,25,19,54,58.139534883720934,44.18604651162791
5116_marine,29,9,21,16,38,72.41379310344827,55.172413793103445
5117_marine,29,10,21,16,39,72.41379310344827,55.172413793103445
5118_marine,37,10,25,17,47,67.56756756756756,45.94594594594595
5119_marine,37,10,25,17,47,67.56756756756756,45.94594594594595
5120_marine,37,10,25,17,47,67.56756756756756,45.94594594594595
5121_marine,40,12,27,19,52,67.5,47.5
5122_marine,38,13,25,19,51,65.78947368421053,50
5123_marine,41,14,28,20,55,68.29268292682927,48.78048780487805
5124_marine,37,13,25,19,50,67.56756756756756,51.35135135135135
5125_marine,36,13,24,17,49,66.66666666666666,47.22222222222222
5126_marine,37,13,25,17,50,67.56756756756756,45.94594594594595
5127_marine,36,13,23,18,49,63.888888888888886,50
5128_marine,38,13,25,18,51,65.78947368421053,47.368421052631575
5130_marine,39,11,27,16,50,69.23076923076923,41.02564102564102
5131_marine,40,11,27,17,51,67.5,42.5
5132_marine,41,12,27,18,53,65.85365853658537,43.90243902439025
5133_marine,40,13,26,18,53,65,45
5134_marine,42,13,27,19,55,64.28571428571429,45.23809523809524
5135_marine,42,13,27,19,55,64.28571428571429,45.23809523809524
5136_marine,42,13,27,19,55,64.28571428571429,45.23809523809524
5137_marine,42,11,27,19,53,64.28571428571429,45.23809523809524
5138_marine,44,12,29,20,56,65.9090909090909,45.45454545454545
5139_marine,47,18,32,20,65,68.08510638297872,42.5531914893617
5140_marine,52,18,35,22,70,67.3076923076923,42.30769230769231
5141_marine,54,18,36,24,72,66.66666666666666,44.44444444444444
5142_marine,41,16,29,18,57,70.73170731707317,43.90243902439025
5143_marine,20,11,19,3,31,95,15
5144_marine,19,11,18,2,30,94.73684210526315,10.526315789473683
5145_marine,19,11,18,2,30,94.73684210526315,10.526315789473683
5146_marine,19,12,18,2,31,94.73684210526315,10.526315789473683
5147_marine,21,12,20,2,33,95.23809523809523,9.523809523809524
5148_marine,21,13,20,2,34,95.23809523809523,9.523809523809524
5149_marine,21,13,20,2,34,95.23809523809523,9.523809523809524
5150_marine,21,13,20,2,34,95.23809523809523,9.523809523809524
5151_marine,22,14,20,3,36,90.9090909090909,13.636363636363635
5152_marine,23,14,21,3,37,91.30434782608695,13.043478260869565
5153_marine,54,21,38,20,75,70.37037037037037,37.03703703703704
5154_marine,56,21,40,20,77,71.42857142857143,35.714285714285715
5155_marine,43,18,34,18,61,79.06976744186046,41.86046511627907
5156_marine,26,14,24,5,40,92.3076923076923,19.230769230769234
5157_marine,25,14,23,4,39,92,16
5158_marine,25,16,23,4,41,92,16
5159_marine,41,19,33,18,60,80.48780487804879,43.90243902439025
5160_marine,52,22,37,23,74,71.15384615384616,44.230769230769226
5161_marine,49,21,34,21,70,69.38775510204081,42.857142857142854
5162_marine,51,22,36,22,73,70.58823529411765,43.13725490196079
5163_marine,47,22,33,20,69,70.2127659574468,42.5531914893617
5198_marine,44,12,34,13,56,77.27272727272727,29.545454545454547
5199_marine,46,14,36,14,60,78.26086956521739,30.434782608695656
5200_marine,48,16,38,14,64,79.16666666666666,29.166666666666668
5201_marine,48,16,38,14,64,79.16666666666666,29.166666666666668
5202_marine,39,14,34,14,53,87.17948717948718,35.8974358974359
5203_marine,41,12,36,14,53,87.8048780487805,34.146341463414636
5204_marine,30,10,27,7,40,90,23.333333333333332
5205_marine,27,12,27,4,39,100,14.814814814814813
5206_marine,28,12,28,3,40,100,10.714285714285714
5207_marine,26,12,26,3,38,100,11.538461538461538
5208_marine,24,12,24,3,36,100,12.5
5209_marine,23,12,23,2,35,100,8.695652173913043
5210_marine,25,12,25,2,37,100,8
5211_marine,24,12,24,1,36,100,4.166666666666666
5212_marine,24,12,24,1,36,100,4.166666666666666
5213_marine,23,11,23,0,34,100,0
5214_marine,23,11,23,0,34,100,0
5215_marine,22,9,21,1,31,95.45454545454545,4.545454545454546
5216_marine,22,9,21,1,31,95.45454545454545,4.545454545454546
5217_marine,22,9,21,1,31,95.45454545454545,4.545454545454546
5218_marine,20,11,19,1,31,95,5
5219_marine,20,11,19,1,31,95,5
5220_marine,20,13,19,1,33,95,5
5221_marine,20,13,19,1,33,95,5
5222_marine,23,13,22,2,36,95.65217391304348,8.695652173913043
5223_marine,25,13,24,2,38,96,8
5224_marine,25,13,24,2,38,96,8
5225_marine,25,13,24,2,38,96,8
5226_marine,25,13,24,2,38,96,8
5227_marine,25,13,24,2,38,96,8
5228_marine,27,13,26,2,40,96.29629629629629,7.4074074074074066
5229_marine,27,14,26,2,41,96.29629629629629,7.4074074074074066
5230_marine,28,14,26,3,42,92.85714285714286,10.714285714285714
5231_marine,28,14,26,3,42,92.85714285714286,10.714285714285714
5232_marine,28,18,26,3,46,92.85714285714286,10.714285714285714
5233_marine,32,22,30,3,54,93.75,9.375
5234_marine,35,22,32,4,57,91.42857142857143,11.428571428571429
5235_marine,36,24,32,5,60,88.88888888888889,13.88888888888889
5236_marine,39,24,35,6,63,89.74358974358975,15.384615384615385
5237_marine,39,24,35,6,63,89.74358974358975,15.384615384615385
5238_marine,39,22,36,6,61,92.3076923076923,15.384615384615385
5239_marine,39,21,36,6,60,92.3076923076923,15.384615384615385
5240_marine,34,17,31,5,51,91.17647058823529,14.705882352941178
5241_marine,34,17,31,5,51,91.17647058823529,14.705882352941178
5242_marine,33,17,31,4,50,93.93939393939394,12.121212121212121
5243_marine,30,17,28,3,47,93.33333333333333,10
5244_marine,33,17,31,4,50,93.93939393939394,12.121212121212121
5245_marine,33,21,31,4,54,93.93939393939394,12.121212121212121
5246_marine,33,21,31,4,54,93.93939393939394,12.121212121212121
5247_marine,33,21,31,4,54,93.93939393939394,12.121212121212121
5248_marine,32,21,30,3,53,93.75,9.375
5249_marine,32,21,30,3,53,93.75,9.375
5250_marine,30,21,28,3,51,93.33333333333333,10
5251_marine,26,17,24,3,43,92.3076923076923,11.538461538461538
5252_marine,26,15,24,3,41,92.3076923076923,11.538461538461538
5253_marine,26,15,24,3,41,92.3076923076923,11.538461538461538
5254_marine,28,15,26,3,43,92.85714285714286,10.714285714285714
5255_marine,28,15,26,3,43,92.85714285714286,10.714285714285714
5256_marine,28,15,26,3,43,92.85714285714286,10.714285714285714
5257_marine,27,13,25,3,40,92.5925925925926,11.11111111111111
5258_marine,23,13,21,3,36,91.30434782608695,13.043478260869565
5259_marine,23,13,21,3,36,91.30434782608695,13.043478260869565
5260_marine,21,13,19,3,34,90.47619047619048,14.285714285714285
5261_marine,21,13,19,3,34,90.47619047619048,14.285714285714285
5262_marine,19,13,17,3,32,89.47368421052632,15.789473684210526
5263_marine,19,13,17,3,32,89.47368421052632,15.789473684210526
5264_marine,20,13,18,3,33,90,15
5265_marine,20,13,18,3,33,90,15
5266_marine,20,13,18,3,33,90,15
5267_marine,20,13,18,3,33,90,15
5268_marine,20,13,18,3,33,90,15
5269_marine,20,13,18,3,33,90,15
5270_marine,20,13,18,3,33,90,15
5271_marine,20,13,18,3,33,90,15
5272_marine,21,13,19,3,34,90.47619047619048,14.285714285714285
5273_marine,22,13,20,3,35,90.9090909090909,13.636363636363635
5274_marine,21,11,19,3,32,90.47619047619048,14.285714285714285
5275_marine,23,10,19,6,33,82.6086956521739,26.08695652173913
5276_marine,40,20,28,15,60,70,37.5
5277_marine,41,18,29,16,59,70.73170731707317,39.02439024390244
5278_marine,38,18,28,14,56,73.68421052631578,36.84210526315789
5279_marine,36,18,26,13,54,72.22222222222221,36.11111111111111
5280_marine,35,18,26,12,53,74.28571428571429,34.285714285714285
5281_marine,36,18,25,14,54,69.44444444444444,38.88888888888889
5282_marine,29,16,21,9,45,72.41379310344827,31.03448275862069
5283_marine,29,16,21,9,45,72.41379310344827,31.03448275862069
5284_marine,28,17,21,9,45,75,32.142857142857146
5285_marine,28,17,21,9,45,75,32.142857142857146
5286_marine,27,17,20,8,44,74.07407407407408,29.629629629629626
5287_marine,27,17,20,8,44,74.07407407407408,29.629629629629626
5288_marine,14,6,13,2,20,92.85714285714286,14.285714285714285
5289_marine,14,6,13,2,20,92.85714285714286,14.285714285714285
5290_marine,13,5,13,1,18,100,7.6923076923076925
5291_marine,11,5,11,1,16,100,9.090909090909092
5292_marine,10,5,10,1,15,100,10
5293_marine,10,5,10,1,15,100,10
5294_marine,10,5,10,1,15,100,10
5295_marine,11,5,11,2,16,100,18.181818181818183
5296_marine,10,5,10,1,15,100,10
5297_marine,10,5,10,1,15,100,10
5298_marine,10,5,10,1,15,100,10
5299_marine,10,5,10,1,15,100,10
5300_marine,10,5,10,1,15,100,10
5301_marine,10,5,10,1,15,100,10
5302_marine,30,9,23,19,39,76.66666666666667,63.33333333333333
5303_marine,31,9,23,20,40,74.19354838709677,64.51612903225806
5304_marine,29,9,22,19,38,75.86206896551724,65.51724137931035
5305_marine,10,5,9,3,15,90,30
5306_marine,10,5,9,3,15,90,30
5307_marine,56,23,37,27,79,66.07142857142857,48.214285714285715
5308_marine,55,23,36,27,78,65.45454545454545,49.09090909090909
5309_marine,53,23,34,25,76,64.15094339622641,47.16981132075472
5310_marine,53,23,34,25,76,64.15094339622641,47.16981132075472
5311_marine,54,23,34,26,77,62.96296296296296,48.148148148148145
5312_marine,53,23,34,24,76,64.15094339622641,45.28301886792453
5313_marine,53,23,34,23,76,64.15094339622641,43.39622641509434
5314_marine,51,24,34,23,75,66.66666666666666,45.09803921568628
5315_marine,51,24,34,23,75,66.66666666666666,45.09803921568628
5316_marine,50,24,33,22,74,66,44
5317_marine,50,24,33,22,74,66,44
5318_marine,50,24,33,22,74,66,44
5320_marine,42,18,26,21,60,61.904761904761905,50
5333_marine,55,27,37,26,82,67.27272727272727,47.27272727272727
5334_marine,55,27,37,26,82,67.27272727272727,47.27272727272727
5335_marine,11,6,10,5,17,90.9090909090909,45.45454545454545
5336_marine,9,5,9,3,14,100,33.33333333333333
5337_marine,9,5,9,3,14,100,33.33333333333333
5338_marine,8,5,8,2,13,100,25
5339_marine,8,5,8,2,13,100,25
5340_marine,7,5,7,1,12,100,14.285714285714285
5341_marine,7,5,7,1,12,100,14.285714285714285
5342_marine,7,5,7,1,12,100,14.285714285714285
5343_marine,7,5,7,1,12,100,14.285714285714285
5344_marine,8,5,8,2,13,100,25
5345_marine,8,5,8,2,13,100,25
5346_marine,8,5,8,2,13,100,25
5347_marine,8,5,8,2,13,100,25
5348_marine,8,5,8,2,13,100,25
5349_marine,7,5,7,1,12,100,14.285714285714285
5350_marine,7,5,7,1,12,100,14.285714285714285
5351_marine,7,5,7,1,12,100,14.285714285714285
5352_marine,7,5,7,1,12,100,14.285714285714285
5353_marine,7,5,7,1,12,100,14.285714285714285
5354_marine,7,5,7,1,12,100,14.285714285714285
5355_marine,9,6,8,2,15,88.88888888888889,22.22222222222222
5356_marine,35,9,27,22,44,77.14285714285715,62.857142857142854
5357_marine,40,14,30,23,54,75,57.49999999999999
5358_marine,41,14,31,23,55,75.60975609756098,56.09756097560976
5360_marine,37,14,28,20,51,75.67567567567568,54.054054054054056
5361_marine,37,14,28,20,51,75.67567567567568,54.054054054054056
5362_marine,32,7,23,20,39,71.875,62.5
5363_marine,39,13,29,22,52,74.35897435897436,56.41025641025641
5364_marine,42,13,31,25,55,73.80952380952381,59.523809523809526
5365_marine,42,13,31,25,55,73.80952380952381,59.523809523809526
5366_marine,44,13,33,25,57,75,56.81818181818182
5367_marine,42,14,32,23,56,76.19047619047619,54.761904761904766
5368_marine,39,14,29,22,53,74.35897435897436,56.41025641025641
5369_marine,37,14,27,20,51,72.97297297297297,54.054054054054056
5370_marine,36,13,26,20,49,72.22222222222221,55.55555555555556
5371_marine,38,13,28,21,51,73.68421052631578,55.26315789473685
5372_marine,12,6,11,4,18,91.66666666666666,33.33333333333333
5373_marine,9,5,9,1,14,100,11.11111111111111
5374_marine,9,5,9,1,14,100,11.11111111111111
5375_marine,9,5,9,1,14,100,11.11111111111111
5376_marine,8,5,8,0,13,100,0
5377_marine,8,5,8,0,13,100,0
5378_marine,8,5,8,0,13,100,0
5379_marine,8,5,8,0,13,100,0
5380_marine,6,5,6,0,11,100,0
5381_marine,6,5,6,0,11,100,0
5382_marine,6,5,6,0,11,100,0
5383_marine,6,5,6,0,11,100,0
5384_marine,6,5,6,0,11,100,0
5385_marine,6,3,6,0,9,100,0
5386_marine,6,3,6,0,9,100,0
5387_marine,6,3,6,0,9,100,0
5388_marine,6,3,6,0,9,100,0
5389_marine,7,3,7,0,10,100,0
5390_marine,7,3,7,0,10,100,0
5391_marine,7,3,7,0,10,100,0
5392_marine,7,3,7,0,10,100,0
5393_marine,7,3,7,0,10,100,0
5394_marine,7,3,7,0,10,100,0
5395_marine,7,3,7,0,10,100,0
5396_marine,7,3,7,0,10,100,0
5397_marine,7,3,7,0,10,100,0
5398_marine,7,3,7,0,10,100,0
5399_marine,7,3,7,0,10,100,0
5400_marine,7,3,7,0,10,100,0
5401_marine,9,3,9,0,12,100,0
5402_marine,9,3,9,0,12,100,0
5403_marine,9,3,9,0,12,100,0
5404_marine,9,3,9,0,12,100,0
5405_marine,9,3,9,0,12,100,0
5406_marine,9,3,9,0,12,100,0
5407_marine,9,3,9,0,12,100,0
5408_marine,9,3,9,0,12,100,0
5409_marine,9,5,9,0,14,100,0
5410_marine,9,5,9,0,14,100,0
5411_marine,9,7,9,0,16,100,0
5412_marine,9,7,9,0,16,100,0
5413_marine,10,7,10,0,17,100,0
5414_marine,10,7,10,0,17,100,0
5415_marine,10,7,10,0,17,100,0
5416_marine,8,7,8,0,15,100,0
5417_marine,8,7,8,0,15,100,0
5418_marine,8,7,8,0,15,100,0
5419_marine,8,7,8,0,15,100,0
5420_marine,8,7,8,0,15,100,0
5421_marine,8,7,8,0,15,100,0
5422_marine,8,7,8,0,15,100,0
5423_marine,8,7,8,0,15,100,0
5424_marine,8,7,8,0,15,100,0
5425_marine,8,7,8,0,15,100,0
5426_marine,8,5,8,0,13,100,0
5427_marine,7,5,7,0,12,100,0
5428_marine,7,5,7,0,12,100,0
5429_marine,7,5,7,0,12,100,0
5430_marine,5,5,5,0,10,100,0
5431_marine,5,5,5,0,10,100,0
5432_marine,5,5,5,0,10,100,0
5433_marine,5,5,5,0,10,100,0
5434_marine,5,7,5,0,12,100,0
5435_marine,4,7,4,0,11,100,0
5436_marine,4,7,4,0,11,100,0
5437_marine,4,7,4,0,11,100,0
5438_marine,4,7,4,0,11,100,0
5439_marine,4,7,4,0,11,100,0
5440_marine,4,7,4,0,11,100,0
5441_marine,3,7,3,0,10,100,0
5442_marine,3,7,3,0,10,100,0
5443_marine,3,7,3,0,10,100,0
5444_marine,3,7,3,0,10,100,0
5445_marine,3,7,3,0,10,100,0
5446_marine,3,7,3,0,10,100,0
5447_marine,3,7,3,0,10,100,0
5448_marine,3,7,3,0,10,100,0
5449_marine,3,7,3,0,10,100,0
5454_marine,6,7,5,1,13,83.33333333333334,16.666666666666664
5455_marine,30,16,19,19,46,63.33333333333333,63.33333333333333
5456_marine,45,18,26,22,63,57.77777777777777,48.888888888888886
5457_marine,45,16,26,22,61,57.77777777777777,48.888888888888886
5458_marine,45,16,26,22,61,57.77777777777777,48.888888888888886
5459_marine,44,16,26,21,60,59.09090909090909,47.72727272727273
5460_marine,47,16,29,22,63,61.702127659574465,46.808510638297875
5461_marine,45,16,27,22,61,60,48.888888888888886
5462_marine,47,16,29,22,63,61.702127659574465,46.808510638297875
5463_marine,45,16,27,22,61,60,48.888888888888886
5464_marine,45,16,27,22,61,60,48.888888888888886
5465_marine,39,12,24,17,51,61.53846153846154,43.58974358974359
5466_marine,43,12,26,18,55,60.46511627906976,41.86046511627907
5467_marine,42,12,25,18,54,59.523809523809526,42.857142857142854
5468_marine,44,13,27,18,57,61.36363636363637,40.909090909090914
5469_marine,42,11,25,18,53,59.523809523809526,42.857142857142854
5470_marine,42,11,25,18,53,59.523809523809526,42.857142857142854
5471_marine,43,11,25,19,54,58.139534883720934,44.18604651162791
5472_marine,43,11,25,19,54,58.139534883720934,44.18604651162791
5473_marine,43,11,25,19,54,58.139534883720934,44.18604651162791
5474_marine,43,11,25,19,54,58.139534883720934,44.18604651162791
5475_marine,5,4,5,0,9,100,0
5476_marine,5,4,5,0,9,100,0
5477_marine,5,4,5,0,9,100,0
5478_marine,5,4,5,0,9,100,0
5479_marine,6,4,5,1,10,83.33333333333334,16.666666666666664
5480_marine,36,9,23,18,45,63.888888888888886,50
5481_marine,42,16,28,21,58,66.66666666666666,50
5482_marine,44,16,30,21,60,68.18181818181817,47.72727272727273
5483_marine,34,16,24,17,50,70.58823529411765,50
5484_marine,38,13,25,19,51,65.78947368421053,50
5485_marine,50,15,34,25,65,68,50
5486_marine,48,15,33,24,63,68.75,50
5487_marine,48,15,33,24,63,68.75,50
5488_marine,50,15,35,25,65,70,50
5489_marine,53,15,37,26,68,69.81132075471697,49.056603773584904
5490_marine,44,14,29,20,58,65.9090909090909,45.45454545454545
5491_marine,44,14,29,20,58,65.9090909090909,45.45454545454545
5492_marine,42,13,28,19,55,66.66666666666666,45.23809523809524
5493_marine,43,15,28,20,58,65.11627906976744,46.51162790697674
5494_marine,44,15,29,21,59,65.9090909090909,47.72727272727273
5495_marine,45,15,29,22,60,64.44444444444444,48.888888888888886
5496_marine,46,15,30,22,61,65.21739130434783,47.82608695652174
5497_marine,47,16,32,21,63,68.08510638297872,44.680851063829785
5498_marine,51,21,35,22,72,68.62745098039215,43.13725490196079
5499_marine,52,21,35,23,73,67.3076923076923,44.230769230769226
5500_marine,53,21,36,23,74,67.9245283018868,43.39622641509434
5501_marine,52,21,35,22,73,67.3076923076923,42.30769230769231
5502_marine,22,15,20,4,37,90.9090909090909,18.181818181818183
5503_marine,21,15,20,3,36,95.23809523809523,14.285714285714285
5504_marine,20,15,19,2,35,95,10
5505_marine,20,12,19,2,32,95,10
5506_marine,20,13,19,2,33,95,10
5507_marine,18,13,17,2,31,94.44444444444444,11.11111111111111
5508_marine,19,12,18,2,31,94.73684210526315,10.526315789473683
5509_marine,19,12,18,2,31,94.73684210526315,10.526315789473683
5510_marine,19,12,18,2,31,94.73684210526315,10.526315789473683
5511_marine,20,12,19,2,32,95,10
5512_marine,20,13,19,2,33,95,10
5513_marine,22,13,21,3,35,95.45454545454545,13.636363636363635
5514_marine,24,13,23,3,37,95.83333333333334,12.5
5515_marine,24,13,23,3,37,95.83333333333334,12.5
5516_marine,24,13,23,3,37,95.83333333333334,12.5
5517_marine,24,13,23,3,37,95.83333333333334,12.5
5518_marine,23,13,22,3,36,95.65217391304348,13.043478260869565
5519_marine,24,13,22,4,37,91.66666666666666,16.666666666666664
5520_marine,27,14,24,7,41,88.88888888888889,25.925925925925924
5521_marine,28,16,24,8,44,85.71428571428571,28.57142857142857
5522_marine,45,19,34,21,64,75.55555555555556,46.666666666666664
5523_marine,53,23,37,23,76,69.81132075471697,43.39622641509434
5524_marine,52,21,36,23,73,69.23076923076923,44.230769230769226
5558_marine,47,15,37,15,62,78.72340425531915,31.914893617021278
5559_marine,49,17,39,15,66,79.59183673469387,30.612244897959183
5560_marine,49,17,39,15,66,79.59183673469387,30.612244897959183
5561_marine,50,19,40,14,69,80,28.000000000000004
5562_marine,50,18,40,14,68,80,28.000000000000004
5563_marine,42,17,37,13,59,88.09523809523809,30.952380952380953
5564_marine,32,14,29,7,46,90.625,21.875
5565_marine,29,14,29,4,43,100,13.793103448275861
5566_marine,27,16,27,4,43,100,14.814814814814813
5567_marine,29,16,29,4,45,100,13.793103448275861
5568_marine,27,14,27,4,41,100,14.814814814814813
5569_marine,26,12,26,3,38,100,11.538461538461538
5570_marine,23,10,23,2,33,100,8.695652173913043
5571_marine,22,10,22,1,32,100,4.545454545454546
5572_marine,22,10,22,1,32,100,4.545454545454546
5573_marine,22,9,22,1,31,100,4.545454545454546
5574_marine,23,11,23,0,34,100,0
5575_marine,24,11,23,1,35,95.83333333333334,4.166666666666666
5576_marine,24,11,23,1,35,95.83333333333334,4.166666666666666
5577_marine,24,11,23,1,35,95.83333333333334,4.166666666666666
5578_marine,24,11,23,1,35,95.83333333333334,4.166666666666666
5579_marine,24,11,23,1,35,95.83333333333334,4.166666666666666
5580_marine,25,11,24,2,36,96,8
5581_marine,27,11,26,2,38,96.29629629629629,7.4074074074074066
5582_marine,27,13,26,2,40,96.29629629629629,7.4074074074074066
5583_marine,27,13,26,2,40,96.29629629629629,7.4074074074074066
5584_marine,27,13,26,2,40,96.29629629629629,7.4074074074074066
5585_marine,25,11,24,2,36,96,8
5586_marine,25,13,24,2,38,96,8
5587_marine,29,13,28,2,42,96.55172413793103,6.896551724137931
5588_marine,29,16,28,2,45,96.55172413793103,6.896551724137931
5589_marine,29,16,28,2,45,96.55172413793103,6.896551724137931
5590_marine,27,16,26,2,43,96.29629629629629,7.4074074074074066
5591_marine,28,16,26,3,44,92.85714285714286,10.714285714285714
5592_marine,28,16,26,3,44,92.85714285714286,10.714285714285714
5593_marine,28,18,26,3,46,92.85714285714286,10.714285714285714
5594_marine,29,18,26,4,47,89.65517241379311,13.793103448275861
5595_marine,35,20,32,4,55,91.42857142857143,11.428571428571429
5596_marine,35,20,32,4,55,91.42857142857143,11.428571428571429
5597_marine,38,21,35,5,59,92.10526315789474,13.157894736842104
5598_marine,40,19,37,6,59,92.5,15
5599_marine,53,21,45,15,74,84.90566037735849,28.30188679245283
5600_marine,49,23,41,15,72,83.6734693877551,30.612244897959183
5601_marine,35,21,32,5,56,91.42857142857143,14.285714285714285
5602_marine,34,23,32,5,57,94.11764705882352,14.705882352941178
5603_marine,33,21,31,4,54,93.93939393939394,12.121212121212121
5604_marine,33,21,31,4,54,93.93939393939394,12.121212121212121
5605_marine,33,21,31,4,54,93.93939393939394,12.121212121212121
5606_marine,33,21,31,4,54,93.93939393939394,12.121212121212121
5607_marine,33,21,31,4,54,93.93939393939394,12.121212121212121
5608_marine,33,21,31,4,54,93.93939393939394,12.121212121212121
5609_marine,33,21,31,4,54,93.93939393939394,12.121212121212121
5610_marine,31,21,29,4,52,93.54838709677419,12.903225806451612
5611_marine,31,19,29,4,50,93.54838709677419,12.903225806451612
5612_marine,29,17,27,4,46,93.10344827586206,13.793103448275861
5613_marine,29,17,27,4,46,93.10344827586206,13.793103448275861
5614_marine,31,17,29,4,48,93.54838709677419,12.903225806451612
5615_marine,31,15,29,4,46,93.54838709677419,12.903225806451612
5616_marine,29,15,27,4,44,93.10344827586206,13.793103448275861
5617_marine,27,15,25,4,42,92.5925925925926,14.814814814814813
5618_marine,26,15,24,3,41,92.3076923076923,11.538461538461538
5619_marine,24,15,22,3,39,91.66666666666666,12.5
5620_marine,22,15,20,3,37,90.9090909090909,13.636363636363635
5621_marine,22,15,20,3,37,90.9090909090909,13.636363636363635
5622_marine,20,15,18,3,35,90,15
5623_marine,20,13,18,3,33,90,15
5624_marine,20,13,18,3,33,90,15
5625_marine,20,13,18,3,33,90,15
5626_marine,20,13,18,3,33,90,15
5627_marine,20,13,18,3,33,90,15
5628_marine,20,13,18,3,33,90,15
5629_marine,22,13,20,3,35,90.9090909090909,13.636363636363635
5630_marine,22,13,20,3,35,90.9090909090909,13.636363636363635
5631_marine,22,13,20,3,35,90.9090909090909,13.636363636363635
5632_marine,20,13,18,3,33,90,15
5633_marine,22,13,20,4,35,90.9090909090909,18.181818181818183
5634_marine,23,12,18,7,35,78.26086956521739,30.434782608695656
5635_marine,43,22,29,18,65,67.44186046511628,41.86046511627907
5636_marine,41,22,28,16,63,68.29268292682927,39.02439024390244
5637_marine,40,20,27,17,60,67.5,42.5
5638_marine,33,18,22,13,51,66.66666666666666,39.39393939393939
5639_marine,33,19,22,13,52,66.66666666666666,39.39393939393939
5640_marine,33,19,22,13,52,66.66666666666666,39.39393939393939
5641_marine,31,17,21,11,48,67.74193548387096,35.483870967741936
5642_marine,14,6,13,2,20,92.85714285714286,14.285714285714285
5643_marine,13,6,13,1,19,100,7.6923076923076925
5644_marine,13,6,13,1,19,100,7.6923076923076925
5645_marine,13,6,13,1,19,100,7.6923076923076925
5646_marine,12,5,12,1,17,100,8.333333333333332
5647_marine,12,5,12,1,17,100,8.333333333333332
5648_marine,12,5,12,1,17,100,8.333333333333332
5649_marine,12,5,12,1,17,100,8.333333333333332
5650_marine,13,5,13,2,18,100,15.384615384615385
5651_marine,10,5,10,2,15,100,20
5652_marine,11,5,11,2,16,100,18.181818181818183
5653_marine,11,5,11,2,16,100,18.181818181818183
5654_marine,10,5,10,1,15,100,10
5655_marine,13,5,13,4,18,100,30.76923076923077
5656_marine,12,5,12,3,17,100,25
5657_marine,12,5,12,3,17,100,25
5658_marine,12,5,12,3,17,100,25
5659_marine,12,5,12,3,17,100,25
5660_marine,34,9,25,21,43,73.52941176470588,61.76470588235294
5661_marine,12,5,11,3,17,91.66666666666666,25
5662_marine,10,5,9,3,15,90,30
5663_marine,44,16,32,28,60,72.72727272727273,63.63636363636363
5664_marine,43,16,31,27,59,72.09302325581395,62.7906976744186
5665_marine,45,18,33,29,63,73.33333333333333,64.44444444444444
5666_marine,59,26,38,30,85,64.40677966101694,50.847457627118644
5667_marine,59,26,37,30,85,62.71186440677966,50.847457627118644
5668_marine,59,26,37,30,85,62.71186440677966,50.847457627118644
5689_marine,9,6,8,3,15,88.88888888888889,33.33333333333333
5690_marine,73,31,45,38,104,61.64383561643836,52.054794520547944
5691_marine,77,31,49,40,108,63.63636363636363,51.94805194805194
5692_marine,78,32,51,41,110,65.38461538461539,52.56410256410257
5693_marine,70,27,48,39,97,68.57142857142857,55.714285714285715
5694_marine,55,18,41,36,73,74.54545454545455,65.45454545454545
5695_marine,11,6,10,5,17,90.9090909090909,45.45454545454545
5696_marine,47,11,36,33,58,76.59574468085107,70.2127659574468
5697_marine,47,11,36,33,58,76.59574468085107,70.2127659574468
5698_marine,10,6,10,4,16,100,40
5699_marine,8,6,8,2,14,100,25
5700_marine,8,6,8,2,14,100,25
5701_marine,11,6,10,5,17,90.9090909090909,45.45454545454545
5702_marine,8,6,8,2,14,100,25
5703_marine,9,6,9,3,15,100,33.33333333333333
5704_marine,9,6,9,3,15,100,33.33333333333333
5705_marine,9,6,9,3,15,100,33.33333333333333
5706_marine,9,6,9,3,15,100,33.33333333333333
5707_marine,9,6,9,3,15,100,33.33333333333333
5708_marine,9,6,9,3,15,100,33.33333333333333
5709_marine,8,6,8,2,14,100,25
5710_marine,8,5,8,2,13,100,25
5711_marine,8,5,8,2,13,100,25
5712_marine,7,5,7,1,12,100,14.285714285714285
5713_marine,7,5,7,1,12,100,14.285714285714285
5714_marine,7,5,7,1,12,100,14.285714285714285
5715_marine,9,6,9,2,15,100,22.22222222222222
5716_marine,32,9,24,20,41,75,62.5
5717_marine,31,9,23,19,40,74.19354838709677,61.29032258064516
5718_marine,37,13,27,22,50,72.97297297297297,59.45945945945946
5719_marine,41,14,30,24,55,73.17073170731707,58.536585365853654
5720_marine,42,14,31,24,56,73.80952380952381,57.14285714285714
5721_marine,46,14,33,28,60,71.73913043478261,60.86956521739131
5722_marine,47,14,34,29,61,72.3404255319149,61.702127659574465
5723_marine,41,13,30,24,54,73.17073170731707,58.536585365853654
5724_marine,41,13,30,24,54,73.17073170731707,58.536585365853654
5725_marine,13,6,11,6,19,84.61538461538461,46.15384615384615
5726_marine,14,6,13,5,20,92.85714285714286,35.714285714285715
5727_marine,13,6,12,6,19,92.3076923076923,46.15384615384615
5728_marine,39,14,29,22,53,74.35897435897436,56.41025641025641
5729_marine,39,14,29,22,53,74.35897435897436,56.41025641025641
5730_marine,39,13,29,22,52,74.35897435897436,56.41025641025641
5731_marine,39,13,29,22,52,74.35897435897436,56.41025641025641
5732_marine,13,6,12,5,19,92.3076923076923,38.46153846153847
5733_marine,11,5,11,3,16,100,27.27272727272727
5734_marine,11,5,11,3,16,100,27.27272727272727
5735_marine,9,5,9,1,14,100,11.11111111111111
5736_marine,9,5,9,1,14,100,11.11111111111111
5737_marine,9,5,9,1,14,100,11.11111111111111
5738_marine,8,5,8,0,13,100,0
5739_marine,8,5,8,0,13,100,0
5740_marine,8,5,8,0,13,100,0
5741_marine,8,5,8,0,13,100,0
5742_marine,8,5,8,0,13,100,0
5743_marine,8,5,8,0,13,100,0
5744_marine,6,5,6,0,11,100,0
5745_marine,6,5,6,0,11,100,0
5746_marine,6,5,6,0,11,100,0
5747_marine,7,3,7,0,10,100,0
5748_marine,7,3,7,0,10,100,0
5749_marine,7,3,7,0,10,100,0
5750_marine,7,3,7,0,10,100,0
5751_marine,7,3,7,0,10,100,0
5752_marine,7,3,7,0,10,100,0
5753_marine,7,3,7,0,10,100,0
5754_marine,7,3,7,0,10,100,0
5755_marine,7,3,7,0,10,100,0
5756_marine,7,3,7,0,10,100,0
5757_marine,7,3,7,0,10,100,0
5758_marine,7,3,7,0,10,100,0
5759_marine,7,3,7,0,10,100,0
5760_marine,7,3,7,0,10,100,0
5761_marine,12,3,12,0,15,100,0
5762_marine,12,3,12,0,15,100,0
5763_marine,12,5,12,0,17,100,0
5764_marine,12,5,12,0,17,100,0
5765_marine,12,3,12,0,15,100,0
5766_marine,12,3,12,0,15,100,0
5767_marine,12,5,12,0,17,100,0
5768_marine,12,5,12,0,17,100,0
5769_marine,12,7,12,0,19,100,0
5770_marine,12,7,12,0,19,100,0
5771_marine,12,7,12,0,19,100,0
5772_marine,12,7,12,0,19,100,0
5773_marine,12,7,12,0,19,100,0
5774_marine,12,9,12,0,21,100,0
5775_marine,12,9,12,0,21,100,0
5776_marine,12,9,12,0,21,100,0
5777_marine,14,9,14,0,23,100,0
5778_marine,14,9,14,0,23,100,0
5779_marine,14,9,14,0,23,100,0
5780_marine,14,9,14,0,23,100,0
5781_marine,14,9,14,0,23,100,0
5782_marine,12,11,12,0,23,100,0
5783_marine,12,11,12,0,23,100,0
5784_marine,12,11,12,0,23,100,0
5785_marine,12,11,12,0,23,100,0
5786_marine,10,9,10,0,19,100,0
5787_marine,9,9,9,0,18,100,0
5788_marine,9,7,9,0,16,100,0
5789_marine,9,7,9,0,16,100,0
5790_marine,9,7,9,0,16,100,0
5791_marine,7,7,7,0,14,100,0
5792_marine,7,7,7,0,14,100,0
5793_marine,5,7,5,0,12,100,0
5794_marine,5,7,5,0,12,100,0
5795_marine,5,7,5,0,12,100,0
5796_marine,5,7,5,0,12,100,0
5797_marine,5,7,5,0,12,100,0
5798_marine,4,7,4,0,11,100,0
5799_marine,4,7,4,0,11,100,0
5800_marine,4,7,4,0,11,100,0
5801_marine,3,7,3,0,10,100,0
5802_marine,3,7,3,0,10,100,0
5803_marine,3,7,3,0,10,100,0
5804_marine,3,7,3,0,10,100,0
5805_marine,3,7,3,0,10,100,0
5806_marine,3,7,3,0,10,100,0
5807_marine,3,7,3,0,10,100,0
5808_marine,3,7,3,0,10,100,0
5809_marine,3,7,3,0,10,100,0
5810_marine,3,7,3,0,10,100,0
5813_marine,5,9,4,1,14,80,20
5814_marine,6,10,5,1,16,83.33333333333334,16.666666666666664
5815_marine,6,8,5,1,14,83.33333333333334,16.666666666666664
5816_marine,48,18,27,25,66,56.25,52.083333333333336
5817_marine,44,18,25,21,62,56.81818181818182,47.72727272727273
5823_marine,47,16,27,24,63,57.446808510638306,51.06382978723404
5824_marine,47,16,27,24,63,57.446808510638306,51.06382978723404
5825_marine,55,16,32,25,71,58.18181818181818,45.45454545454545
5826_marine,44,14,27,22,58,61.36363636363637,50
5827_marine,44,14,27,22,58,61.36363636363637,50
5828_marine,44,13,28,20,57,63.63636363636363,45.45454545454545
5829_marine,7,4,7,0,11,100,0
5830_marine,42,13,26,20,55,61.904761904761905,47.61904761904761
5831_marine,5,4,5,0,9,100,0
5832_marine,42,12,26,20,54,61.904761904761905,47.61904761904761
5833_marine,46,12,30,20,58,65.21739130434783,43.47826086956522
5834_marine,46,12,30,20,58,65.21739130434783,43.47826086956522
5835_marine,46,12,30,20,58,65.21739130434783,43.47826086956522
5836_marine,34,10,23,17,44,67.64705882352942,50
5837_marine,5,4,5,0,9,100,0
5838_marine,41,14,27,20,55,65.85365853658537,48.78048780487805
5839_marine,42,15,27,21,57,64.28571428571429,50
5840_marine,42,14,27,21,56,64.28571428571429,50
5841_marine,45,16,29,22,61,64.44444444444444,48.888888888888886
5842_marine,45,18,29,22,63,64.44444444444444,48.888888888888886
5843_marine,46,18,30,23,64,65.21739130434783,50
5844_marine,46,18,30,23,64,65.21739130434783,50
5845_marine,47,14,32,23,61,68.08510638297872,48.93617021276596
5846_marine,43,14,28,23,57,65.11627906976744,53.48837209302325
5848_marine,45,14,31,22,59,68.88888888888889,48.888888888888886
5849_marine,50,14,35,25,64,70,50
5850_marine,50,14,36,25,64,72,50
5851_marine,52,19,33,24,71,63.46153846153846,46.15384615384615
5852_marine,51,18,32,24,69,62.745098039215684,47.05882352941176
5853_marine,50,20,31,23,70,62,46
5854_marine,50,22,31,23,72,62,46
5855_marine,51,22,32,23,73,62.745098039215684,45.09803921568628
5856_marine,53,22,33,24,75,62.264150943396224,45.28301886792453
5857_marine,50,22,30,21,72,60,42
5858_marine,55,25,35,22,80,63.63636363636363,40
5859_marine,60,24,37,25,84,61.66666666666667,41.66666666666667
5860_marine,68,24,41,28,92,60.29411764705882,41.17647058823529
5861_marine,54,20,38,24,74,70.37037037037037,44.44444444444444
5862_marine,54,20,39,24,74,72.22222222222221,44.44444444444444
5863_marine,54,20,39,24,74,72.22222222222221,44.44444444444444
5864_marine,54,21,39,24,75,72.22222222222221,44.44444444444444
5865_marine,22,15,20,5,37,90.9090909090909,22.727272727272727
5866_marine,22,16,20,5,38,90.9090909090909,22.727272727272727
5867_marine,21,15,19,4,36,90.47619047619048,19.047619047619047
5868_marine,20,15,19,3,35,95,15
5869_marine,21,15,20,3,36,95.23809523809523,14.285714285714285
5870_marine,18,15,17,2,33,94.44444444444444,11.11111111111111
5871_marine,20,13,19,3,33,95,15
5872_marine,19,12,18,3,31,94.73684210526315,15.789473684210526
5873_marine,20,12,19,4,32,95,20
5874_marine,19,12,18,3,31,94.73684210526315,15.789473684210526
5875_marine,19,12,18,3,31,94.73684210526315,15.789473684210526
5876_marine,21,12,20,3,33,95.23809523809523,14.285714285714285
5877_marine,24,12,23,3,36,95.83333333333334,12.5
5878_marine,24,12,23,3,36,95.83333333333334,12.5
5879_marine,24,12,23,3,36,95.83333333333334,12.5
5880_marine,26,13,24,5,39,92.3076923076923,19.230769230769234
5881_marine,27,13,24,7,40,88.88888888888889,25.925925925925924
5882_marine,29,16,24,9,45,82.75862068965517,31.03448275862069
5883_marine,51,20,39,25,71,76.47058823529412,49.01960784313725
5884_marine,60,21,42,28,81,70,46.666666666666664
5885_marine,60,21,41,28,81,68.33333333333333,46.666666666666664
5913_marine,45,17,36,12,62,80,26.666666666666668
5914_marine,46,19,37,12,65,80.43478260869566,26.08695652173913
5915_marine,50,19,41,15,69,82,30
5916_marine,51,19,41,15,70,80.3921568627451,29.411764705882355
5917_marine,49,19,39,13,68,79.59183673469387,26.53061224489796
5918_marine,50,19,40,14,69,80,28.000000000000004
5919_marine,50,21,40,14,71,80,28.000000000000004
5920_marine,52,21,42,14,73,80.76923076923077,26.923076923076923
5921_marine,36,16,33,7,52,91.66666666666666,19.444444444444446
5922_marine,35,17,32,7,52,91.42857142857143,20
5923_marine,32,16,31,5,48,96.875,15.625
5924_marine,33,18,33,4,51,100,12.121212121212121
5925_marine,31,18,31,4,49,100,12.903225806451612
5926_marine,29,16,29,4,45,100,13.793103448275861
5927_marine,29,12,29,4,41,100,13.793103448275861
5928_marine,27,12,27,4,39,100,14.814814814814813
5929_marine,27,14,27,4,41,100,14.814814814814813
5930_marine,27,12,27,4,39,100,14.814814814814813
5931_marine,31,18,31,4,49,100,12.903225806451612
5932_marine,29,17,29,2,46,100,6.896551724137931
5933_marine,27,13,27,2,40,100,7.4074074074074066
5934_marine,28,13,27,3,41,96.42857142857143,10.714285714285714
5935_marine,27,13,26,2,40,96.29629629629629,7.4074074074074066
5936_marine,27,11,26,2,38,96.29629629629629,7.4074074074074066
5937_marine,27,13,26,2,40,96.29629629629629,7.4074074074074066
5938_marine,27,15,26,2,42,96.29629629629629,7.4074074074074066
5939_marine,27,13,26,2,40,96.29629629629629,7.4074074074074066
5940_marine,25,13,24,2,38,96,8
5941_marine,25,13,24,2,38,96,8
5942_marine,25,13,24,2,38,96,8
5943_marine,25,13,24,2,38,96,8
5944_marine,25,13,24,2,38,96,8
5945_marine,25,13,24,2,38,96,8
5946_marine,25,15,24,2,40,96,8
5947_marine,27,15,26,2,42,96.29629629629629,7.4074074074074066
5948_marine,30,18,29,3,48,96.66666666666667,10
5949_marine,26,16,25,3,42,96.15384615384616,11.538461538461538
5950_marine,26,18,25,3,44,96.15384615384616,11.538461538461538
5951_marine,27,18,25,4,45,92.5925925925926,14.814814814814813
5952_marine,29,18,27,4,47,93.10344827586206,13.793103448275861
5953_marine,32,20,29,5,52,90.625,15.625
5954_marine,36,20,33,5,56,91.66666666666666,13.88888888888889
5955_marine,36,20,33,5,56,91.66666666666666,13.88888888888889
5956_marine,37,20,34,6,57,91.8918918918919,16.216216216216218
5957_marine,41,21,38,8,62,92.6829268292683,19.51219512195122
5958_marine,43,21,40,10,64,93.02325581395348,23.25581395348837
5959_marine,44,21,41,10,65,93.18181818181817,22.727272727272727
5960_marine,43,21,40,11,64,93.02325581395348,25.581395348837212
5961_marine,45,23,42,11,68,93.33333333333333,24.444444444444443
5962_marine,43,23,40,10,66,93.02325581395348,23.25581395348837
5963_marine,42,23,40,9,65,95.23809523809523,21.428571428571427
5964_marine,40,23,38,9,63,95,22.5
5965_marine,42,23,40,9,65,95.23809523809523,21.428571428571427
5966_marine,42,23,40,9,65,95.23809523809523,21.428571428571427
5967_marine,42,23,40,9,65,95.23809523809523,21.428571428571427
5968_marine,43,23,40,10,66,93.02325581395348,23.25581395348837
5969_marine,41,21,38,10,62,92.6829268292683,24.390243902439025
5970_marine,39,21,37,8,60,94.87179487179486,20.51282051282051
5971_marine,35,19,33,8,54,94.28571428571428,22.857142857142858
5972_marine,34,17,32,7,51,94.11764705882352,20.588235294117645
5973_marine,31,17,29,6,48,93.54838709677419,19.35483870967742
5974_marine,33,17,31,6,50,93.93939393939394,18.181818181818183
5975_marine,30,17,28,5,47,93.33333333333333,16.666666666666664
5976_marine,30,17,28,5,47,93.33333333333333,16.666666666666664
5977_marine,29,17,27,4,46,93.10344827586206,13.793103448275861
5978_marine,29,17,27,4,46,93.10344827586206,13.793103448275861
5979_marine,27,15,25,4,42,92.5925925925926,14.814814814814813
5980_marine,25,15,23,4,40,92,16
5981_marine,23,15,21,4,38,91.30434782608695,17.391304347826086
5982_marine,21,15,19,4,36,90.47619047619048,19.047619047619047
5983_marine,21,15,19,4,36,90.47619047619048,19.047619047619047
5984_marine,21,15,19,4,36,90.47619047619048,19.047619047619047
5985_marine,20,15,18,3,35,90,15
5986_marine,20,15,18,3,35,90,15
5987_marine,22,15,20,3,37,90.9090909090909,13.636363636363635
5988_marine,22,13,20,3,35,90.9090909090909,13.636363636363635
5989_marine,22,13,20,3,35,90.9090909090909,13.636363636363635
5990_marine,22,13,20,3,35,90.9090909090909,13.636363636363635
5991_marine,23,13,21,4,36,91.30434782608695,17.391304347826086
5992_marine,26,14,22,7,40,84.61538461538461,26.923076923076923
5993_marine,29,14,24,8,43,82.75862068965517,27.586206896551722
5994_marine,57,26,42,28,83,73.68421052631578,49.122807017543856
5995_marine,58,24,42,30,82,72.41379310344827,51.724137931034484
5996_marine,53,24,38,27,77,71.69811320754717,50.943396226415096
5997_marine,47,22,35,22,69,74.46808510638297,46.808510638297875
5998_marine,37,18,26,15,55,70.27027027027027,40.54054054054054
5999_marine,33,18,22,13,51,66.66666666666666,39.39393939393939
6000_marine,15,8,13,3,23,86.66666666666667,20
6001_marine,14,5,13,2,19,92.85714285714286,14.285714285714285
6002_marine,13,5,13,1,18,100,7.6923076923076925
6003_marine,12,5,12,1,17,100,8.333333333333332
6004_marine,12,5,12,1,17,100,8.333333333333332
6005_marine,12,5,12,1,17,100,8.333333333333332
6006_marine,12,5,12,1,17,100,8.333333333333332
6007_marine,12,5,12,1,17,100,8.333333333333332
6008_marine,13,5,13,2,18,100,15.384615384615385
6009_marine,15,5,13,4,20,86.66666666666667,26.666666666666668
6010_marine,46,18,35,30,64,76.08695652173914,65.21739130434783
6011_marine,50,18,39,33,68,78,66
6012_marine,50,18,39,33,68,78,66
6013_marine,12,5,10,4,17,83.33333333333334,33.33333333333333
6014_marine,12,5,10,4,17,83.33333333333334,33.33333333333333
6015_marine,53,19,41,35,72,77.35849056603774,66.0377358490566
6016_marine,49,19,38,31,68,77.55102040816327,63.26530612244898
6017_marine,47,19,37,29,66,78.72340425531915,61.702127659574465
6018_marine,13,5,12,4,18,92.3076923076923,30.76923076923077
6019_marine,42,13,31,26,55,73.80952380952381,61.904761904761905
6020_marine,47,13,35,31,60,74.46808510638297,65.95744680851064
6021_marine,68,24,43,35,92,63.23529411764706,51.470588235294116
6022_marine,10,5,8,4,15,80,40
6023_marine,33,12,23,21,45,69.6969696969697,63.63636363636363
6024_marine,44,18,31,27,62,70.45454545454545,61.36363636363637
6025_marine,59,22,35,30,81,59.32203389830508,50.847457627118644
6026_marine,61,24,37,33,85,60.65573770491803,54.09836065573771
6027_marine,62,27,38,33,89,61.29032258064516,53.2258064516129
6028_marine,61,26,37,31,87,60.65573770491803,50.81967213114754
6046_marine,80,34,50,43,114,62.5,53.75
6047_marine,81,34,50,44,115,61.72839506172839,54.32098765432099
6048_marine,76,32,50,41,108,65.78947368421053,53.94736842105263
6049_marine,79,32,50,43,111,63.29113924050633,54.43037974683544
6050_marine,76,32,48,40,108,63.1578947368421,52.63157894736842
6051_marine,74,31,47,37,105,63.51351351351351,50
6052_marine,72,33,46,36,105,63.888888888888886,50
6053_marine,73,33,47,37,106,64.38356164383562,50.68493150684932
6054_marine,79,34,51,40,113,64.55696202531645,50.63291139240506
6055_marine,72,32,45,36,104,62.5,50
6056_marine,70,32,45,34,102,64.28571428571429,48.57142857142857
6057_marine,54,22,35,23,76,64.81481481481481,42.592592592592595
6058_marine,9,8,9,3,17,100,33.33333333333333
6059_marine,72,32,47,36,104,65.27777777777779,50
6060_marine,75,32,49,38,107,65.33333333333333,50.66666666666667
6061_marine,75,32,49,38,107,65.33333333333333,50.66666666666667
6062_marine,9,6,9,3,15,100,33.33333333333333
6063_marine,76,32,50,38,108,65.78947368421053,50
6064_marine,73,33,47,36,106,64.38356164383562,49.31506849315068
6065_marine,73,34,47,36,107,64.38356164383562,49.31506849315068
6066_marine,75,35,49,38,110,65.33333333333333,50.66666666666667
6067_marine,76,35,50,39,111,65.78947368421053,51.31578947368421
6068_marine,78,37,52,41,115,66.66666666666666,52.56410256410257
6069_marine,77,37,51,40,114,66.23376623376623,51.94805194805194
6070_marine,77,35,51,40,112,66.23376623376623,51.94805194805194
6071_marine,9,6,9,3,15,100,33.33333333333333
6072_marine,8,5,8,2,13,100,25
6073_marine,8,5,8,2,13,100,25
6074_marine,8,5,8,2,13,100,25
6075_marine,8,5,8,2,13,100,25
6076_marine,10,6,10,3,16,100,30
6077_marine,29,9,22,17,38,75.86206896551724,58.620689655172406
6078_marine,11,6,10,4,17,90.9090909090909,36.36363636363637
6079_marine,10,6,9,3,16,90,30
6080_marine,43,16,30,25,59,69.76744186046511,58.139534883720934
6081_marine,45,16,31,27,61,68.88888888888889,60
6082_marine,45,16,31,27,61,68.88888888888889,60
6083_marine,45,15,31,27,60,68.88888888888889,60
6084_marine,47,15,33,28,62,70.2127659574468,59.57446808510638
6085_marine,13,6,12,4,19,92.3076923076923,30.76923076923077
6086_marine,13,6,12,4,19,92.3076923076923,30.76923076923077
6087_marine,11,6,11,4,17,100,36.36363636363637
6088_marine,12,6,12,4,18,100,33.33333333333333
6089_marine,12,6,12,4,18,100,33.33333333333333
6090_marine,12,6,12,4,18,100,33.33333333333333
6091_marine,11,6,11,3,17,100,27.27272727272727
6092_marine,11,5,11,3,16,100,27.27272727272727
6093_marine,11,5,11,3,16,100,27.27272727272727
6094_marine,11,5,11,3,16,100,27.27272727272727
6095_marine,11,5,11,3,16,100,27.27272727272727
6096_marine,11,5,11,3,16,100,27.27272727272727
6097_marine,11,5,11,3,16,100,27.27272727272727
6098_marine,11,5,11,3,16,100,27.27272727272727
6099_marine,10,5,10,2,15,100,20
6100_marine,8,5,8,0,13,100,0
6101_marine,8,5,8,0,13,100,0
6102_marine,8,5,8,0,13,100,0
6103_marine,8,5,8,0,13,100,0
6104_marine,8,5,8,0,13,100,0
6105_marine,9,5,9,0,14,100,0
6106_marine,9,5,9,0,14,100,0
6107_marine,9,5,9,0,14,100,0
6108_marine,9,5,9,0,14,100,0
6109_marine,9,3,9,0,12,100,0
6110_marine,7,3,7,0,10,100,0
6111_marine,7,3,7,0,10,100,0
6112_marine,7,3,7,0,10,100,0
6113_marine,7,3,7,0,10,100,0
6114_marine,9,3,9,0,12,100,0
6115_marine,9,3,9,0,12,100,0
6116_marine,9,3,9,0,12,100,0
6117_marine,9,3,9,0,12,100,0
6118_marine,9,3,9,0,12,100,0
6119_marine,9,3,9,0,12,100,0
6120_marine,9,3,9,0,12,100,0
6121_marine,16,11,16,2,27,100,12.5
6122_marine,16,11,16,2,27,100,12.5
6123_marine,16,10,16,2,26,100,12.5
6124_marine,16,9,16,2,25,100,12.5
6125_marine,18,9,18,2,27,100,11.11111111111111
6126_marine,16,9,16,0,25,100,0
6127_marine,16,9,16,0,25,100,0
6128_marine,16,9,16,0,25,100,0
6129_marine,16,11,16,0,27,100,0
6130_marine,16,11,16,0,27,100,0
6131_marine,16,11,16,0,27,100,0
6132_marine,16,11,16,0,27,100,0
6133_marine,16,13,16,0,29,100,0
6134_marine,16,13,16,0,29,100,0
6135_marine,16,13,16,0,29,100,0
6136_marine,16,13,16,0,29,100,0
6137_marine,16,13,16,0,29,100,0
6138_marine,16,13,16,0,29,100,0
6139_marine,16,13,16,0,29,100,0
6140_marine,16,13,16,0,29,100,0
6141_marine,14,13,14,0,27,100,0
6142_marine,15,15,14,1,30,93.33333333333333,6.666666666666667
6143_marine,15,15,14,1,30,93.33333333333333,6.666666666666667
6144_marine,15,15,14,1,30,93.33333333333333,6.666666666666667
6145_marine,15,15,14,1,30,93.33333333333333,6.666666666666667
6146_marine,14,13,14,0,27,100,0
6147_marine,11,13,11,0,24,100,0
6148_marine,11,11,11,0,22,100,0
6149_marine,11,11,11,0,22,100,0
6150_marine,11,11,11,0,22,100,0
6151_marine,11,11,11,0,22,100,0
6152_marine,11,11,11,0,22,100,0
6153_marine,9,9,9,0,18,100,0
6154_marine,9,9,9,0,18,100,0
6155_marine,7,9,7,0,16,100,0
6156_marine,7,9,7,0,16,100,0
6157_marine,7,9,7,0,16,100,0
6158_marine,5,9,5,0,14,100,0
6159_marine,4,9,4,0,13,100,0
6160_marine,4,9,4,0,13,100,0
6161_marine,3,9,3,0,12,100,0
6162_marine,3,9,3,0,12,100,0
6163_marine,3,9,3,0,12,100,0
6164_marine,3,9,3,0,12,100,0
6165_marine,3,9,3,0,12,100,0
6166_marine,3,9,3,0,12,100,0
6167_marine,3,9,3,0,12,100,0
6168_marine,3,9,3,0,12,100,0
6169_marine,3,9,3,0,12,100,0
6170_marine,3,9,3,0,12,100,0
6171_marine,3,9,3,0,12,100,0
6172_marine,5,9,5,0,14,100,0
6173_marine,5,10,4,1,15,80,20
6174_marine,6,8,5,1,14,83.33333333333334,16.666666666666664
6175_marine,52,18,30,28,70,57.692307692307686,53.84615384615385
6176_marine,51,18,29,28,69,56.86274509803921,54.90196078431373
6180_marine,50,16,29,26,66,57.99999999999999,52
6181_marine,50,16,29,26,66,57.99999999999999,52
6182_marine,56,16,32,26,72,57.14285714285714,46.42857142857143
6183_marine,56,16,32,26,72,57.14285714285714,46.42857142857143
6184_marine,45,16,27,23,61,60,51.11111111111111
6186_marine,44,14,27,22,58,61.36363636363637,50
6187_marine,44,14,27,22,58,61.36363636363637,50
6188_marine,42,13,26,20,55,61.904761904761905,47.61904761904761
6189_marine,44,14,28,20,58,63.63636363636363,45.45454545454545
6190_marine,44,13,28,20,57,63.63636363636363,45.45454545454545
6191_marine,42,13,26,20,55,61.904761904761905,47.61904761904761
6192_marine,42,13,26,20,55,61.904761904761905,47.61904761904761
6193_marine,42,13,26,20,55,61.904761904761905,47.61904761904761
6195_marine,46,12,30,20,58,65.21739130434783,43.47826086956522
6196_marine,42,12,26,20,54,61.904761904761905,47.61904761904761
6197_marine,5,4,5,0,9,100,0
6198_marine,41,14,27,20,55,65.85365853658537,48.78048780487805
6199_marine,42,14,27,21,56,64.28571428571429,50
6200_marine,42,14,27,21,56,64.28571428571429,50
6202_marine,43,16,27,22,59,62.7906976744186,51.162790697674424
6203_marine,46,16,30,23,62,65.21739130434783,50
6204_marine,45,17,30,22,62,66.66666666666666,48.888888888888886
6205_marine,45,16,31,23,61,68.88888888888889,51.11111111111111
6206_marine,62,24,40,26,86,64.51612903225806,41.935483870967744
6207_marine,46,13,32,22,59,69.56521739130434,47.82608695652174
6208_marine,45,14,31,23,59,68.88888888888889,51.11111111111111
6209_marine,48,14,33,24,62,68.75,50
6210_marine,37,14,26,24,51,70.27027027027027,64.86486486486487
6211_marine,51,18,32,25,69,62.745098039215684,49.01960784313725
6214_marine,50,22,31,23,72,62,46
6215_marine,51,21,32,23,72,62.745098039215684,45.09803921568628
6216_marine,48,21,29,20,69,60.416666666666664,41.66666666666667
6219_marine,40,10,20,20,50,50,50
6220_marine,65,24,38,27,89,58.46153846153847,41.53846153846154
6221_marine,62,24,36,24,86,58.06451612903226,38.70967741935484
6222_marine,65,24,39,25,89,60,38.46153846153847
6223_marine,63,24,39,23,87,61.904761904761905,36.507936507936506
6224_marine,65,24,40,25,89,61.53846153846154,38.46153846153847
6225_marine,57,23,36,22,80,63.1578947368421,38.59649122807017
6226_marine,56,24,35,21,80,62.5,37.5
6227_marine,24,15,21,5,39,87.5,20.833333333333336
6228_marine,23,16,21,4,39,91.30434782608695,17.391304347826086
6229_marine,23,16,21,4,39,91.30434782608695,17.391304347826086
6230_marine,23,15,21,4,38,91.30434782608695,17.391304347826086
6231_marine,23,15,22,3,38,95.65217391304348,13.043478260869565
6232_marine,23,15,22,3,38,95.65217391304348,13.043478260869565
6233_marine,20,15,19,4,35,95,20
6234_marine,19,12,18,3,31,94.73684210526315,15.789473684210526
6235_marine,19,12,18,3,31,94.73684210526315,15.789473684210526
6236_marine,19,12,18,3,31,94.73684210526315,15.789473684210526
6237_marine,19,14,18,3,33,94.73684210526315,15.789473684210526
6238_marine,19,14,18,3,33,94.73684210526315,15.789473684210526
6239_marine,21,14,20,3,35,95.23809523809523,14.285714285714285
6240_marine,24,14,23,3,38,95.83333333333334,12.5
6241_marine,25,12,23,4,37,92,16
6242_marine,26,13,23,6,39,88.46153846153845,23.076923076923077
6243_marine,32,18,26,12,50,81.25,37.5
6244_marine,56,24,42,28,80,75,50
6245_marine,64,23,45,31,87,70.3125,48.4375
6246_marine,61,21,42,28,82,68.85245901639344,45.90163934426229
6247_marine,59,17,40,26,76,67.79661016949152,44.06779661016949
6274_marine,49,17,40,14,66,81.63265306122449,28.57142857142857
6275_marine,52,19,42,16,71,80.76923076923077,30.76923076923077
6276_marine,54,21,44,16,75,81.48148148148148,29.629629629629626
6277_marine,55,21,45,17,76,81.81818181818183,30.909090909090907
6278_marine,60,21,50,17,81,83.33333333333334,28.333333333333332
6279_marine,50,19,44,14,69,88,28.000000000000004
6280_marine,41,16,37,8,57,90.2439024390244,19.51219512195122
6281_marine,41,14,39,6,55,95.1219512195122,14.634146341463413
6282_marine,40,19,39,5,59,97.5,12.5
6283_marine,39,20,38,5,59,97.43589743589743,12.82051282051282
6284_marine,38,20,38,4,58,100,10.526315789473683
6285_marine,34,22,34,4,56,100,11.76470588235294
6286_marine,36,22,36,4,58,100,11.11111111111111
6287_marine,35,20,35,4,55,100,11.428571428571429
6288_marine,37,20,37,4,57,100,10.81081081081081
6289_marine,37,22,37,4,59,100,10.81081081081081
6290_marine,33,22,33,4,55,100,12.121212121212121
6291_marine,33,22,33,4,55,100,12.121212121212121
6292_marine,35,15,35,4,50,100,11.428571428571429
6293_marine,35,15,34,4,50,97.14285714285714,11.428571428571429
6294_marine,30,13,29,3,43,96.66666666666667,10
6295_marine,29,15,28,2,44,96.55172413793103,6.896551724137931
6296_marine,29,19,28,2,48,96.55172413793103,6.896551724137931
6297_marine,27,19,26,2,46,96.29629629629629,7.4074074074074066
6298_marine,27,17,26,2,44,96.29629629629629,7.4074074074074066
6299_marine,27,15,26,2,42,96.29629629629629,7.4074074074074066
6300_marine,29,15,28,2,44,96.55172413793103,6.896551724137931
6301_marine,30,15,29,3,45,96.66666666666667,10
6302_marine,30,15,29,3,45,96.66666666666667,10
6303_marine,30,13,29,3,43,96.66666666666667,10
6304_marine,30,15,29,3,45,96.66666666666667,10
6305_marine,28,15,27,3,43,96.42857142857143,10.714285714285714
6306_marine,28,15,27,3,43,96.42857142857143,10.714285714285714
6307_marine,28,16,27,3,44,96.42857142857143,10.714285714285714
6308_marine,28,16,27,3,44,96.42857142857143,10.714285714285714
6309_marine,30,16,29,5,46,96.66666666666667,16.666666666666664
6310_marine,30,16,29,5,46,96.66666666666667,16.666666666666664
6311_marine,30,18,29,5,48,96.66666666666667,16.666666666666664
6312_marine,31,18,29,6,49,93.54838709677419,19.35483870967742
6313_marine,34,20,31,7,54,91.17647058823529,20.588235294117645
6314_marine,36,20,33,7,56,91.66666666666666,19.444444444444446
6315_marine,39,20,36,8,59,92.3076923076923,20.51282051282051
6316_marine,39,20,36,8,59,92.3076923076923,20.51282051282051
6317_marine,43,21,39,10,64,90.69767441860465,23.25581395348837
6318_marine,44,23,40,11,67,90.9090909090909,25
6319_marine,46,25,42,11,71,91.30434782608695,23.91304347826087
6320_marine,44,27,40,11,71,90.9090909090909,25
6321_marine,46,29,40,11,75,86.95652173913044,23.91304347826087
6322_marine,48,29,42,11,77,87.5,22.916666666666664
6323_marine,48,29,42,11,77,87.5,22.916666666666664
6324_marine,48,29,42,11,77,87.5,22.916666666666664
6325_marine,50,35,44,11,85,88,22
6326_marine,49,35,44,10,84,89.79591836734694,20.408163265306122
6327_marine,47,33,42,10,80,89.36170212765957,21.27659574468085
6328_marine,47,35,42,10,82,89.36170212765957,21.27659574468085
6329_marine,45,29,40,10,74,88.88888888888889,22.22222222222222
6330_marine,45,25,40,10,70,88.88888888888889,22.22222222222222
6331_marine,42,21,37,9,63,88.09523809523809,21.428571428571427
6332_marine,40,21,35,9,61,87.5,22.5
6333_marine,36,19,33,9,55,91.66666666666666,25
6334_marine,36,21,33,9,57,91.66666666666666,25
6335_marine,36,19,33,9,55,91.66666666666666,25
6336_marine,34,17,32,7,51,94.11764705882352,20.588235294117645
6337_marine,33,17,31,6,50,93.93939393939394,18.181818181818183
6338_marine,32,17,30,5,49,93.75,15.625
6339_marine,32,17,30,5,49,93.75,15.625
6340_marine,28,17,26,5,45,92.85714285714286,17.857142857142858
6341_marine,25,17,23,4,42,92,16
6342_marine,25,17,23,4,42,92,16
6343_marine,25,17,23,4,42,92,16
6344_marine,25,17,23,4,42,92,16
6345_marine,27,15,25,4,42,92.5925925925926,14.814814814814813
6346_marine,26,15,24,3,41,92.3076923076923,11.538461538461538
6347_marine,26,15,24,3,41,92.3076923076923,11.538461538461538
6348_marine,26,15,24,3,41,92.3076923076923,11.538461538461538
6349_marine,24,15,22,3,39,91.66666666666666,12.5
6350_marine,24,15,22,3,39,91.66666666666666,12.5
6351_marine,26,16,22,7,42,84.61538461538461,26.923076923076923
6352_marine,59,30,44,29,89,74.57627118644068,49.152542372881356
6353_marine,61,26,44,32,87,72.1311475409836,52.459016393442624
6354_marine,52,26,38,27,78,73.07692307692307,51.92307692307693
6356_marine,46,22,34,24,68,73.91304347826086,52.17391304347826
6357_marine,43,22,31,22,65,72.09302325581395,51.162790697674424
6358_marine,14,8,12,3,22,85.71428571428571,21.428571428571427
6359_marine,13,7,12,2,20,92.3076923076923,15.384615384615385
6360_marine,13,7,12,2,20,92.3076923076923,15.384615384615385
6361_marine,15,7,14,2,22,93.33333333333333,13.333333333333334
6362_marine,14,5,14,1,19,100,7.142857142857142
6363_marine,14,5,14,1,19,100,7.142857142857142
6364_marine,14,5,14,1,19,100,7.142857142857142
6365_marine,14,5,14,1,19,100,7.142857142857142
6366_marine,14,5,14,1,19,100,7.142857142857142
6367_marine,16,5,15,3,21,93.75,18.75
6368_marine,15,5,13,4,20,86.66666666666667,26.666666666666668
6369_marine,65,26,43,32,91,66.15384615384615,49.23076923076923
6370_marine,63,26,41,31,89,65.07936507936508,49.2063492063492
6371_marine,40,22,30,24,62,75,60
6372_marine,62,26,41,32,88,66.12903225806451,51.61290322580645
6373_marine,63,26,41,33,89,65.07936507936508,52.38095238095239
6374_marine,29,10,21,18,39,72.41379310344827,62.06896551724138
6375_marine,68,27,44,38,95,64.70588235294117,55.88235294117647
6376_marine,67,27,43,37,94,64.17910447761194,55.223880597014926
6377_marine,69,25,45,37,94,65.21739130434783,53.62318840579711
6378_marine,69,25,45,37,94,65.21739130434783,53.62318840579711
6379_marine,69,25,45,37,94,65.21739130434783,53.62318840579711
6380_marine,48,17,36,31,65,75,64.58333333333334
6381_marine,71,26,45,38,97,63.38028169014085,53.52112676056338
6382_marine,65,24,40,34,89,61.53846153846154,52.307692307692314
6383_marine,65,26,41,34,91,63.07692307692307,52.307692307692314
6406_marine,82,35,51,43,117,62.19512195121951,52.4390243902439
6407_marine,57,25,40,36,82,70.17543859649122,63.1578947368421
6414_marine,70,29,43,35,99,61.42857142857143,50
6420_marine,68,26,42,35,94,61.76470588235294,51.470588235294116
6421_marine,75,32,49,37,107,65.33333333333333,49.333333333333336
6422_marine,75,32,49,37,107,65.33333333333333,49.333333333333336
6423_marine,76,32,50,38,108,65.78947368421053,50
6424_marine,9,6,9,2,15,100,22.22222222222222
6428_marine,73,32,47,38,105,64.38356164383562,52.054794520547944
6429_marine,81,40,55,40,121,67.90123456790124,49.382716049382715
6430_marine,80,42,54,41,122,67.5,51.24999999999999
6431_marine,9,6,9,3,15,100,33.33333333333333
6432_marine,9,6,9,3,15,100,33.33333333333333
6433_marine,9,6,9,3,15,100,33.33333333333333
6434_marine,9,6,9,3,15,100,33.33333333333333
6435_marine,9,6,9,3,15,100,33.33333333333333
6436_marine,10,6,10,3,16,100,30
6437_marine,10,6,10,3,16,100,30
6438_marine,10,6,10,3,16,100,30
6439_marine,11,6,9,4,17,81.81818181818183,36.36363636363637
6440_marine,75,40,47,39,115,62.66666666666667,52
6441_marine,74,38,46,38,112,62.16216216216216,51.35135135135135
6442_marine,75,38,47,39,113,62.66666666666667,52
6443_marine,16,13,14,4,29,87.5,25
6444_marine,62,29,40,29,91,64.51612903225806,46.774193548387096
6445_marine,79,40,51,39,119,64.55696202531645,49.36708860759494
6446_marine,78,41,50,41,119,64.1025641025641,52.56410256410257
6447_marine,79,43,51,41,122,64.55696202531645,51.89873417721519
6448_marine,78,41,50,40,119,64.1025641025641,51.28205128205128
6449_marine,76,41,49,38,117,64.47368421052632,50
6450_marine,78,41,51,40,119,65.38461538461539,51.28205128205128
6451_marine,13,8,12,5,21,92.3076923076923,38.46153846153847
6452_marine,13,6,12,5,19,92.3076923076923,38.46153846153847
6453_marine,11,6,11,3,17,100,27.27272727272727
6454_marine,11,5,11,3,16,100,27.27272727272727
6455_marine,11,5,11,3,16,100,27.27272727272727
6456_marine,11,5,11,3,16,100,27.27272727272727
6457_marine,11,7,11,3,18,100,27.27272727272727
6458_marine,11,7,11,3,18,100,27.27272727272727
6459_marine,11,7,11,3,18,100,27.27272727272727
6460_marine,11,7,11,3,18,100,27.27272727272727
6461_marine,11,7,11,3,18,100,27.27272727272727
6462_marine,10,7,10,2,17,100,20
6463_marine,10,7,10,2,17,100,20
6464_marine,10,7,10,1,17,100,10
6465_marine,10,7,10,1,17,100,10
6466_marine,10,7,10,1,17,100,10
6467_marine,9,7,9,0,16,100,0
6468_marine,9,7,9,0,16,100,0
6469_marine,9,7,9,0,16,100,0
6470_marine,9,5,9,0,14,100,0
6471_marine,9,5,9,0,14,100,0
6472_marine,9,5,9,0,14,100,0
6473_marine,9,5,9,0,14,100,0
6474_marine,9,5,9,0,14,100,0
6475_marine,9,5,9,0,14,100,0
6476_marine,9,7,9,0,16,100,0
6477_marine,11,7,11,0,18,100,0
6478_marine,11,7,11,0,18,100,0
6479_marine,13,7,13,0,20,100,0
6480_marine,14,11,14,1,25,100,7.142857142857142
6481_marine,43,23,30,20,66,69.76744186046511,46.51162790697674
6482_marine,43,26,31,20,69,72.09302325581395,46.51162790697674
6483_marine,45,26,33,20,71,73.33333333333333,44.44444444444444
6484_marine,20,12,19,4,32,95,20
6485_marine,31,13,24,12,44,77.41935483870968,38.70967741935484
6486_marine,20,10,19,4,30,95,20
6487_marine,16,10,16,0,26,100,0
6488_marine,16,9,16,0,25,100,0
6489_marine,16,13,16,0,29,100,0
6490_marine,16,13,16,0,29,100,0
6491_marine,16,13,16,0,29,100,0
6492_marine,16,13,16,0,29,100,0
6493_marine,18,13,18,0,31,100,0
6494_marine,18,13,18,0,31,100,0
6495_marine,18,13,18,0,31,100,0
6496_marine,18,13,18,0,31,100,0
6497_marine,18,13,18,0,31,100,0
6498_marine,18,15,18,0,33,100,0
6499_marine,19,15,18,1,34,94.73684210526315,5.263157894736842
6500_marine,19,15,18,1,34,94.73684210526315,5.263157894736842
6501_marine,20,15,18,2,35,90,10
6502_marine,21,15,18,3,36,85.71428571428571,14.285714285714285
6503_marine,19,15,16,3,34,84.21052631578947,15.789473684210526
6504_marine,94,47,54,48,141,57.446808510638306,51.06382978723404
6505_marine,93,47,53,47,140,56.98924731182796,50.53763440860215
6506_marine,91,45,53,45,136,58.24175824175825,49.45054945054945
6507_marine,15,13,13,2,28,86.66666666666667,13.333333333333334
6508_marine,15,13,13,2,28,86.66666666666667,13.333333333333334
6509_marine,15,13,13,2,28,86.66666666666667,13.333333333333334
6510_marine,14,13,13,1,27,92.85714285714286,7.142857142857142
6511_marine,14,13,13,1,27,92.85714285714286,7.142857142857142
6512_marine,14,13,13,1,27,92.85714285714286,7.142857142857142
6513_marine,14,13,13,1,27,92.85714285714286,7.142857142857142
6514_marine,14,13,13,1,27,92.85714285714286,7.142857142857142
6515_marine,11,13,11,0,24,100,0
6516_marine,9,13,9,0,22,100,0
6517_marine,9,13,9,0,22,100,0
6518_marine,9,13,9,0,22,100,0
6519_marine,9,9,9,0,18,100,0
6520_marine,7,9,7,0,16,100,0
6521_marine,5,9,5,0,14,100,0
6522_marine,5,9,5,0,14,100,0
6523_marine,3,9,3,0,12,100,0
6524_marine,3,9,3,0,12,100,0
6525_marine,3,9,3,0,12,100,0
6526_marine,5,9,5,0,14,100,0
6527_marine,5,9,5,0,14,100,0
6528_marine,5,9,5,0,14,100,0
6529_marine,5,9,5,0,14,100,0
6530_marine,5,11,5,0,16,100,0
6531_marine,5,11,5,0,16,100,0
6532_marine,6,10,5,1,16,83.33333333333334,16.666666666666664
6533_marine,7,8,6,1,15,85.71428571428571,14.285714285714285
6534_marine,49,17,28,27,66,57.14285714285714,55.10204081632652
6535_marine,52,18,30,28,70,57.692307692307686,53.84615384615385
6536_marine,53,18,31,29,71,58.490566037735846,54.71698113207547
6537_marine,54,18,33,28,72,61.111111111111114,51.85185185185185
6538_marine,52,18,31,28,70,59.61538461538461,53.84615384615385
6539_marine,53,18,31,29,71,58.490566037735846,54.71698113207547
6540_marine,52,18,31,28,70,59.61538461538461,53.84615384615385
6541_marine,46,18,27,24,64,58.69565217391305,52.17391304347826
6542_marine,48,18,29,24,66,60.416666666666664,50
6543_marine,46,18,27,24,64,58.69565217391305,52.17391304347826
6544_marine,46,18,27,24,64,58.69565217391305,52.17391304347826
6545_marine,46,18,27,24,64,58.69565217391305,52.17391304347826
6552_marine,42,13,26,20,55,61.904761904761905,47.61904761904761
6553_marine,42,13,26,20,55,61.904761904761905,47.61904761904761
6556_marine,42,14,26,20,56,61.904761904761905,47.61904761904761
6557_marine,5,4,5,0,9,100,0
6558_marine,5,4,5,0,9,100,0
6559_marine,5,4,5,0,9,100,0
6560_marine,41,14,27,20,55,65.85365853658537,48.78048780487805
6561_marine,42,14,28,21,56,66.66666666666666,50
6562_marine,42,14,28,21,56,66.66666666666666,50
6563_marine,44,16,30,21,60,68.18181818181817,47.72727272727273
6564_marine,64,24,39,27,88,60.9375,42.1875
6565_marine,61,25,38,27,86,62.295081967213115,44.26229508196721
6566_marine,62,24,39,28,86,62.903225806451616,45.16129032258064
6567_marine,54,21,30,25,75,55.55555555555556,46.2962962962963
6568_marine,53,21,29,26,74,54.71698113207547,49.056603773584904
6569_marine,10,5,8,3,15,80,30
6570_marine,35,12,24,23,47,68.57142857142857,65.71428571428571
6571_marine,48,18,29,24,66,60.416666666666664,50
6572_marine,48,17,29,24,65,60.416666666666664,50
6573_marine,47,17,28,23,64,59.57446808510638,48.93617021276596
6574_marine,52,21,32,25,73,61.53846153846154,48.07692307692308
6575_marine,53,21,33,25,74,62.264150943396224,47.16981132075472
6576_marine,53,21,32,26,74,60.37735849056604,49.056603773584904
6580_marine,55,22,33,22,77,60,40
6582_marine,52,21,32,19,73,61.53846153846154,36.53846153846153
6585_marine,54,21,33,19,75,61.111111111111114,35.18518518518518
6586_marine,55,23,34,20,78,61.81818181818181,36.36363636363637
6587_marine,55,23,35,20,78,63.63636363636363,36.36363636363637
6588_marine,55,23,35,20,78,63.63636363636363,36.36363636363637
6589_marine,57,24,37,20,81,64.91228070175438,35.08771929824561
6590_marine,58,25,38,20,83,65.51724137931035,34.48275862068966
6591_marine,25,16,22,5,41,88,20
6592_marine,24,16,22,4,40,91.66666666666666,16.666666666666664
6593_marine,25,15,23,5,40,92,20
6594_marine,23,17,22,3,40,95.65217391304348,13.043478260869565
6595_marine,23,17,22,3,40,95.65217391304348,13.043478260869565
6596_marine,19,14,18,3,33,94.73684210526315,15.789473684210526
6597_marine,19,14,18,3,33,94.73684210526315,15.789473684210526
6598_marine,19,14,18,3,33,94.73684210526315,15.789473684210526
6599_marine,19,16,18,3,35,94.73684210526315,15.789473684210526
6600_marine,21,16,20,3,37,95.23809523809523,14.285714285714285
6601_marine,24,14,23,3,38,95.83333333333334,12.5
6602_marine,25,14,23,5,39,92,20
6603_marine,31,15,27,10,46,87.09677419354838,32.25806451612903
6604_marine,35,18,29,12,53,82.85714285714286,34.285714285714285
6605_marine,72,26,52,32,98,72.22222222222221,44.44444444444444
6606_marine,69,24,49,31,93,71.01449275362319,44.927536231884055
6607_marine,68,27,49,30,95,72.05882352941177,44.11764705882353
6608_marine,67,29,48,31,96,71.64179104477611,46.26865671641791
6609_marine,64,29,45,29,93,70.3125,45.3125
6632_marine,28,6,20,11,34,71.42857142857143,39.285714285714285
6633_marine,65,25,53,19,90,81.53846153846153,29.230769230769234
6634_marine,69,25,57,21,94,82.6086956521739,30.434782608695656
6635_marine,72,25,60,23,97,83.33333333333334,31.944444444444443
6636_marine,70,25,59,21,95,84.28571428571429,30
6638_marine,64,21,54,17,85,84.375,26.5625
6639_marine,69,23,59,18,92,85.5072463768116,26.08695652173913
6640_marine,44,20,40,9,64,90.9090909090909,20.454545454545457
6641_marine,45,23,42,8,68,93.33333333333333,17.77777777777778
6642_marine,46,25,43,7,71,93.47826086956522,15.217391304347828
6643_marine,44,22,43,5,66,97.72727272727273,11.363636363636363
6644_marine,39,22,38,5,61,97.43589743589743,12.82051282051282
6645_marine,39,22,38,5,61,97.43589743589743,12.82051282051282
6646_marine,39,20,38,5,59,97.43589743589743,12.82051282051282
6647_marine,39,22,38,5,61,97.43589743589743,12.82051282051282
6648_marine,39,22,38,5,61,97.43589743589743,12.82051282051282
6649_marine,41,22,40,5,63,97.5609756097561,12.195121951219512
6650_marine,42,22,41,6,64,97.61904761904762,14.285714285714285
6651_marine,42,22,41,6,64,97.61904761904762,14.285714285714285
6652_marine,53,24,47,11,77,88.67924528301887,20.754716981132077
6653_marine,51,22,45,11,73,88.23529411764706,21.568627450980394
6654_marine,37,19,36,5,56,97.2972972972973,13.513513513513514
6655_marine,35,19,34,4,54,97.14285714285714,11.428571428571429
6656_marine,34,19,33,3,53,97.05882352941177,8.823529411764707
6657_marine,32,19,31,3,51,96.875,9.375
6658_marine,32,19,31,3,51,96.875,9.375
6659_marine,32,15,31,3,47,96.875,9.375
6660_marine,30,15,29,3,45,96.66666666666667,10
6661_marine,30,19,29,3,49,96.66666666666667,10
6662_marine,32,19,31,5,51,96.875,15.625
6663_marine,32,17,31,5,49,96.875,15.625
6664_marine,32,17,31,5,49,96.875,15.625
6665_marine,30,18,29,5,48,96.66666666666667,16.666666666666664
6666_marine,30,16,29,5,46,96.66666666666667,16.666666666666664
6667_marine,30,16,29,5,46,96.66666666666667,16.666666666666664
6668_marine,30,16,29,5,46,96.66666666666667,16.666666666666664
6669_marine,30,19,29,5,49,96.66666666666667,16.666666666666664
6670_marine,30,19,29,5,49,96.66666666666667,16.666666666666664
6671_marine,32,19,30,7,51,93.75,21.875
6672_marine,33,21,30,8,54,90.9090909090909,24.242424242424242
6673_marine,33,21,30,8,54,90.9090909090909,24.242424242424242
6674_marine,35,25,32,8,60,91.42857142857143,22.857142857142858
6675_marine,39,27,35,10,66,89.74358974358975,25.64102564102564
6676_marine,44,26,40,11,70,90.9090909090909,25
6677_marine,46,31,42,11,77,91.30434782608695,23.91304347826087
6678_marine,48,34,42,11,82,87.5,22.916666666666664
6679_marine,53,40,47,12,93,88.67924528301887,22.641509433962266
6680_marine,54,41,47,13,95,87.03703703703704,24.074074074074073
6681_marine,56,41,48,15,97,85.71428571428571,26.785714285714285
6682_marine,61,41,51,19,102,83.60655737704919,31.147540983606557
6683_marine,60,39,50,20,99,83.33333333333334,33.33333333333333
6684_marine,137,53,106,83,190,77.37226277372264,60.58394160583942
6685_marine,141,54,110,87,195,78.01418439716312,61.702127659574465
6686_marine,136,53,106,84,189,77.94117647058823,61.76470588235294
6687_marine,133,52,104,81,185,78.19548872180451,60.902255639097746
6690_marine,58,33,49,19,91,84.48275862068965,32.758620689655174
6691_marine,56,31,47,18,87,83.92857142857143,32.142857142857146
6692_marine,45,27,37,14,72,82.22222222222221,31.11111111111111
6693_marine,38,26,33,9,64,86.8421052631579,23.684210526315788
6694_marine,37,26,33,8,63,89.1891891891892,21.62162162162162
6695_marine,37,26,33,8,63,89.1891891891892,21.62162162162162
6696_marine,39,25,35,8,64,89.74358974358975,20.51282051282051
6697_marine,39,21,35,8,60,89.74358974358975,20.51282051282051
6698_marine,34,21,33,7,55,97.05882352941177,20.588235294117645
6699_marine,31,17,30,6,48,96.7741935483871,19.35483870967742
6700_marine,30,17,29,5,47,96.66666666666667,16.666666666666664
6701_marine,27,17,26,4,44,96.29629629629629,14.814814814814813
6702_marine,27,17,26,4,44,96.29629629629629,14.814814814814813
6703_marine,26,17,25,3,43,96.15384615384616,11.538461538461538
6704_marine,28,17,27,3,45,96.42857142857143,10.714285714285714
6705_marine,28,17,27,3,45,96.42857142857143,10.714285714285714
6706_marine,26,17,25,3,43,96.15384615384616,11.538461538461538
6707_marine,25,17,24,2,42,96,8
6708_marine,25,17,24,2,42,96,8
6709_marine,25,17,24,2,42,96,8
6710_marine,25,19,24,2,44,96,8
6711_marine,27,18,23,8,45,85.18518518518519,29.629629629629626
6712_marine,59,32,45,29,91,76.27118644067797,49.152542372881356
6713_marine,56,32,41,30,88,73.21428571428571,53.57142857142857
6714_marine,54,30,41,29,84,75.92592592592592,53.70370370370371
6715_marine,54,30,41,29,84,75.92592592592592,53.70370370370371
6716_marine,45,24,33,24,69,73.33333333333333,53.333333333333336
6717_marine,38,15,29,21,53,76.31578947368422,55.26315789473685
6718_marine,17,8,15,4,25,88.23529411764706,23.52941176470588
6719_marine,16,8,15,3,24,93.75,18.75
6720_marine,16,8,15,3,24,93.75,18.75
6721_marine,16,7,15,3,23,93.75,18.75
6722_marine,15,5,14,2,20,93.33333333333333,13.333333333333334
6723_marine,14,5,14,1,19,100,7.142857142857142
6724_marine,14,5,14,1,19,100,7.142857142857142
6725_marine,15,5,14,2,20,93.33333333333333,13.333333333333334
6726_marine,16,5,15,3,21,93.75,18.75
6727_marine,54,22,41,31,76,75.92592592592592,57.407407407407405
6728_marine,36,14,27,20,50,75,55.55555555555556
6729_marine,36,14,27,21,50,75,58.333333333333336
6732_marine,66,26,43,34,92,65.15151515151516,51.515151515151516
6733_marine,70,29,45,38,99,64.28571428571429,54.285714285714285
6734_marine,67,27,43,37,94,64.17910447761194,55.223880597014926
6735_marine,34,14,25,22,48,73.52941176470588,64.70588235294117
6736_marine,68,27,44,37,95,64.70588235294117,54.41176470588235
6737_marine,71,27,46,37,98,64.7887323943662,52.112676056338024
6738_marine,70,25,45,36,95,64.28571428571429,51.42857142857142
6739_marine,68,25,44,36,93,64.70588235294117,52.94117647058824
6740_marine,48,16,30,23,64,62.5,47.91666666666667
6741_marine,63,25,40,34,88,63.49206349206349,53.96825396825397
6742_marine,64,25,40,34,89,62.5,53.125
6743_marine,71,30,45,38,101,63.38028169014085,53.52112676056338
6744_marine,72,32,45,40,104,62.5,55.55555555555556
6789_marine,79,34,53,38,113,67.08860759493672,48.10126582278481
6790_marine,82,42,56,41,124,68.29268292682927,50
6791_marine,82,41,55,42,123,67.07317073170732,51.21951219512195
6792_marine,79,38,52,40,117,65.82278481012658,50.63291139240506
6793_marine,74,38,48,37,112,64.86486486486487,50
6794_marine,61,36,41,28,97,67.21311475409836,45.90163934426229
6795_marine,74,38,48,37,112,64.86486486486487,50
6796_marine,74,38,48,37,112,64.86486486486487,50
6797_marine,75,38,49,37,113,65.33333333333333,49.333333333333336
6798_marine,77,40,51,39,117,66.23376623376623,50.649350649350644
6799_marine,78,40,51,40,118,65.38461538461539,51.28205128205128
6800_marine,77,42,49,39,119,63.63636363636363,50.649350649350644
6805_marine,41,15,31,27,56,75.60975609756098,65.85365853658537
6806_marine,71,41,44,38,112,61.97183098591549,53.52112676056338
6807_marine,70,41,44,37,111,62.857142857142854,52.85714285714286
6809_marine,70,37,43,36,107,61.42857142857143,51.42857142857142
6810_marine,77,43,49,38,120,63.63636363636363,49.35064935064935
6811_marine,80,49,52,41,129,65,51.24999999999999
6812_marine,81,47,53,42,128,65.4320987654321,51.85185185185185
6813_marine,80,47,52,41,127,65,51.24999999999999
6814_marine,13,8,12,5,21,92.3076923076923,38.46153846153847
6815_marine,40,23,30,26,63,75,65
6816_marine,79,45,50,42,124,63.29113924050633,53.16455696202531
6817_marine,78,44,49,41,122,62.82051282051282,52.56410256410257
6818_marine,47,29,36,27,76,76.59574468085107,57.446808510638306
6819_marine,13,10,12,5,23,92.3076923076923,38.46153846153847
6820_marine,13,8,12,5,21,92.3076923076923,38.46153846153847
6821_marine,13,8,12,5,21,92.3076923076923,38.46153846153847
6822_marine,13,8,12,5,21,92.3076923076923,38.46153846153847
6823_marine,14,8,13,5,22,92.85714285714286,35.714285714285715
6824_marine,12,7,12,3,19,100,25
6825_marine,12,7,12,3,19,100,25
6826_marine,12,7,12,3,19,100,25
6827_marine,12,7,12,3,19,100,25
6828_marine,12,7,12,3,19,100,25
6829_marine,12,7,12,3,19,100,25
6830_marine,12,7,12,3,19,100,25
6831_marine,14,5,14,3,19,100,21.428571428571427
6832_marine,16,7,16,3,23,100,18.75
6833_marine,16,7,16,3,23,100,18.75
6834_marine,16,7,16,3,23,100,18.75
6835_marine,16,7,16,3,23,100,18.75
6836_marine,16,7,16,3,23,100,18.75
6837_marine,15,7,15,2,22,100,13.333333333333334
6838_marine,18,10,17,5,28,94.44444444444444,27.77777777777778
6839_marine,41,24,30,23,65,73.17073170731707,56.09756097560976
6840_marine,40,25,29,22,65,72.5,55.00000000000001
6841_marine,49,26,36,22,75,73.46938775510205,44.89795918367347
6842_marine,50,26,38,21,76,76,42
6843_marine,26,14,25,6,40,96.15384615384616,23.076923076923077
6844_marine,25,14,24,5,39,96,20
6845_marine,24,12,24,4,36,100,16.666666666666664
6846_marine,23,12,23,3,35,100,13.043478260869565
6847_marine,22,12,22,2,34,100,9.090909090909092
6848_marine,20,12,20,0,32,100,0
6849_marine,20,14,20,0,34,100,0
6850_marine,20,13,20,0,33,100,0
6851_marine,20,13,20,0,33,100,0
6852_marine,20,13,20,0,33,100,0
6853_marine,20,13,20,0,33,100,0
6854_marine,20,13,20,0,33,100,0
6855_marine,20,15,20,0,35,100,0
6856_marine,21,15,20,1,36,95.23809523809523,4.761904761904762
6857_marine,22,15,20,2,37,90.9090909090909,9.090909090909092
6858_marine,95,48,56,44,143,58.94736842105262,46.31578947368421
6859_marine,96,48,57,45,144,59.375,46.875
6860_marine,98,46,59,47,144,60.204081632653065,47.95918367346938
6861_marine,100,46,61,48,146,61,48
6862_marine,99,46,60,48,145,60.60606060606061,48.484848484848484
6863_marine,19,15,16,3,34,84.21052631578947,15.789473684210526
6864_marine,93,46,53,47,139,56.98924731182796,50.53763440860215
6865_marine,93,47,53,47,140,56.98924731182796,50.53763440860215
6866_marine,90,45,52,45,135,57.77777777777777,50
6867_marine,92,44,54,47,136,58.69565217391305,51.08695652173913
6868_marine,92,48,54,47,140,58.69565217391305,51.08695652173913
6869_marine,91,48,52,46,139,57.14285714285714,50.54945054945055
6870_marine,89,46,51,44,135,57.30337078651685,49.43820224719101
6871_marine,87,47,49,44,134,56.32183908045977,50.57471264367817
6872_marine,90,46,52,45,136,57.77777777777777,50
6873_marine,89,46,51,44,135,57.30337078651685,49.43820224719101
6874_marine,88,45,51,43,133,57.95454545454546,48.86363636363637
6875_marine,89,45,51,44,134,57.30337078651685,49.43820224719101
6876_marine,88,46,50,43,134,56.81818181818182,48.86363636363637
6877_marine,90,46,50,45,136,55.55555555555556,50
6878_marine,91,45,51,45,136,56.043956043956044,49.45054945054945
6879_marine,12,13,10,2,25,83.33333333333334,16.666666666666664
6880_marine,12,13,10,2,25,83.33333333333334,16.666666666666664
6881_marine,9,13,8,1,22,88.88888888888889,11.11111111111111
6882_marine,8,13,7,1,21,87.5,12.5
6883_marine,8,13,7,1,21,87.5,12.5
6884_marine,8,11,7,1,19,87.5,12.5
6885_marine,8,9,7,1,17,87.5,12.5
6886_marine,6,11,5,1,17,83.33333333333334,16.666666666666664
6887_marine,6,11,5,1,17,83.33333333333334,16.666666666666664
6888_marine,6,11,5,1,17,83.33333333333334,16.666666666666664
6889_marine,87,45,42,51,132,48.275862068965516,58.620689655172406
6890_marine,89,45,44,52,134,49.43820224719101,58.42696629213483
6891_marine,89,41,44,52,130,49.43820224719101,58.42696629213483
6892_marine,85,38,40,49,123,47.05882352941176,57.647058823529406
6893_marine,84,38,41,49,122,48.80952380952381,58.333333333333336
6894_marine,7,12,6,1,19,85.71428571428571,14.285714285714285
6895_marine,79,35,41,46,114,51.89873417721519,58.22784810126582
6896_marine,77,35,39,45,112,50.649350649350644,58.44155844155844
6897_marine,6,8,5,1,14,83.33333333333334,16.666666666666664
6898_marine,6,8,5,1,14,83.33333333333334,16.666666666666664
6899_marine,6,8,5,1,14,83.33333333333334,16.666666666666664
6900_marine,6,8,5,1,14,83.33333333333334,16.666666666666664
6901_marine,6,8,5,1,14,83.33333333333334,16.666666666666664
6902_marine,46,18,27,24,64,58.69565217391305,52.17391304347826
6903_marine,48,19,28,26,67,58.333333333333336,54.166666666666664
6904_marine,49,21,29,27,70,59.183673469387756,55.10204081632652
6905_marine,49,18,29,27,67,59.183673469387756,55.10204081632652
6906_marine,51,18,31,27,69,60.78431372549019,52.94117647058824
6907_marine,52,18,32,28,70,61.53846153846154,53.84615384615385
6908_marine,52,18,32,28,70,61.53846153846154,53.84615384615385
6909_marine,52,18,32,28,70,61.53846153846154,53.84615384615385
6916_marine,45,14,29,22,59,64.44444444444444,48.888888888888886
6917_marine,48,14,31,25,62,64.58333333333334,52.083333333333336
6918_marine,48,14,31,25,62,64.58333333333334,52.083333333333336
6919_marine,49,14,31,26,63,63.26530612244898,53.06122448979592
6920_marine,51,14,32,28,65,62.745098039215684,54.90196078431373
6921_marine,5,4,5,0,9,100,0
6922_marine,5,4,5,0,9,100,0
6923_marine,5,4,5,0,9,100,0
6924_marine,52,20,29,25,72,55.769230769230774,48.07692307692308
6925_marine,51,19,28,24,70,54.90196078431373,47.05882352941176
6928_marine,54,22,30,27,76,55.55555555555556,50
6929_marine,54,22,30,27,76,55.55555555555556,50
6930_marine,36,15,23,24,51,63.888888888888886,66.66666666666666
6931_marine,47,18,28,23,65,59.57446808510638,48.93617021276596
6932_marine,47,17,28,23,64,59.57446808510638,48.93617021276596
6933_marine,48,17,28,24,65,58.333333333333336,50
6934_marine,50,17,29,25,67,57.99999999999999,50
6935_marine,50,17,29,25,67,57.99999999999999,50
6936_marine,49,19,29,24,68,59.183673469387756,48.97959183673469
6937_marine,11,9,11,2,20,100,18.181818181818183
6939_marine,49,19,31,22,68,63.26530612244898,44.89795918367347
6940_marine,48,19,30,21,67,62.5,43.75
6941_marine,48,19,30,21,67,62.5,43.75
6942_marine,48,19,30,21,67,62.5,43.75
6943_marine,47,19,30,20,66,63.829787234042556,42.5531914893617
6948_marine,53,23,34,18,76,64.15094339622641,33.9622641509434
6949_marine,56,23,36,20,79,64.28571428571429,35.714285714285715
6950_marine,55,23,36,19,78,65.45454545454545,34.54545454545455
6951_marine,56,23,36,20,79,64.28571428571429,35.714285714285715
6952_marine,58,25,38,20,83,65.51724137931035,34.48275862068966
6953_marine,59,25,39,21,84,66.10169491525424,35.59322033898305
6954_marine,25,18,22,5,43,88,20
6955_marine,23,19,22,3,42,95.65217391304348,13.043478260869565
6956_marine,23,19,22,3,42,95.65217391304348,13.043478260869565
6957_marine,21,19,20,3,40,95.23809523809523,14.285714285714285
6958_marine,19,16,18,3,35,94.73684210526315,15.789473684210526
6959_marine,21,16,20,3,37,95.23809523809523,14.285714285714285
6960_marine,21,16,20,3,37,95.23809523809523,14.285714285714285
6961_marine,23,16,22,3,39,95.65217391304348,13.043478260869565
6962_marine,26,14,24,4,40,92.3076923076923,15.384615384615385
6963_marine,29,14,26,6,43,89.65517241379311,20.689655172413794
6964_marine,35,19,30,11,54,85.71428571428571,31.428571428571427
6965_marine,59,25,45,29,84,76.27118644067797,49.152542372881356
6966_marine,74,27,52,32,101,70.27027027027027,43.24324324324324
6967_marine,76,29,55,31,105,72.36842105263158,40.78947368421053
6968_marine,74,29,55,31,103,74.32432432432432,41.891891891891895
6969_marine,73,29,54,30,102,73.97260273972603,41.0958904109589
6970_marine,71,27,52,30,98,73.23943661971832,42.25352112676056
6991_marine,40,13,37,7,53,92.5,17.5
6992_marine,69,26,55,21,95,79.71014492753623,30.434782608695656
6993_marine,72,27,58,23,99,80.55555555555556,31.944444444444443
6994_marine,73,27,59,24,100,80.82191780821918,32.87671232876712
6995_marine,72,27,58,25,99,80.55555555555556,34.72222222222222
6996_marine,78,29,64,26,107,82.05128205128204,33.33333333333333
6997_marine,78,31,66,23,109,84.61538461538461,29.48717948717949
6998_marine,83,35,68,28,118,81.92771084337349,33.734939759036145
6999_marine,77,37,66,21,114,85.71428571428571,27.27272727272727
7000_marine,50,25,46,10,75,92,20
7001_marine,48,27,45,9,75,93.75,18.75
7002_marine,46,28,44,7,74,95.65217391304348,15.217391304347828
7003_marine,41,26,40,6,67,97.5609756097561,14.634146341463413
7004_marine,42,26,41,5,68,97.61904761904762,11.904761904761903
7005_marine,41,26,40,5,67,97.5609756097561,12.195121951219512
7006_marine,41,24,40,5,65,97.5609756097561,12.195121951219512
7007_marine,41,24,40,5,65,97.5609756097561,12.195121951219512
7008_marine,39,24,38,5,63,97.43589743589743,12.82051282051282
7009_marine,39,24,38,5,63,97.43589743589743,12.82051282051282
7010_marine,41,24,40,6,65,97.5609756097561,14.634146341463413
7011_marine,52,27,46,11,79,88.46153846153845,21.153846153846153
7012_marine,52,26,46,11,78,88.46153846153845,21.153846153846153
7013_marine,41,21,40,6,62,97.5609756097561,14.634146341463413
7014_marine,39,21,38,7,60,97.43589743589743,17.94871794871795
7015_marine,36,21,35,5,57,97.22222222222221,13.88888888888889
7016_marine,36,21,35,5,57,97.22222222222221,13.88888888888889
7017_marine,32,23,31,5,55,96.875,15.625
7018_marine,32,21,31,5,53,96.875,15.625
7019_marine,32,19,31,5,51,96.875,15.625
7020_marine,32,19,31,5,51,96.875,15.625
7021_marine,32,20,31,5,52,96.875,15.625
7022_marine,32,18,31,5,50,96.875,15.625
7023_marine,32,18,31,5,50,96.875,15.625
7024_marine,32,19,31,5,51,96.875,15.625
7025_marine,32,19,31,5,51,96.875,15.625
7026_marine,33,19,32,6,52,96.96969696969697,18.181818181818183
7027_marine,33,19,32,6,52,96.96969696969697,18.181818181818183
7028_marine,33,19,32,6,52,96.96969696969697,18.181818181818183
7029_marine,33,17,32,6,50,96.96969696969697,18.181818181818183
7030_marine,35,19,34,6,54,97.14285714285714,17.142857142857142
7031_marine,35,21,32,8,56,91.42857142857143,22.857142857142858
7032_marine,35,23,32,8,58,91.42857142857143,22.857142857142858
7033_marine,37,23,33,10,60,89.1891891891892,27.027027027027028
7034_marine,38,23,34,11,61,89.47368421052632,28.947368421052634
7035_marine,42,24,36,11,66,85.71428571428571,26.190476190476193
7036_marine,51,37,43,14,88,84.31372549019608,27.450980392156865
7037_marine,58,45,49,17,103,84.48275862068965,29.310344827586203
7038_marine,64,44,52,22,108,81.25,34.375
7039_marine,145,66,112,88,211,77.24137931034483,60.689655172413794
7040_marine,155,68,120,97,223,77.41935483870968,62.58064516129033
7041_marine,158,64,119,97,222,75.31645569620254,61.39240506329114
7053_marine,49,27,39,18,76,79.59183673469387,36.734693877551024
7054_marine,48,27,38,18,75,79.16666666666666,37.5
7055_marine,45,27,35,16,72,77.77777777777779,35.55555555555556
7056_marine,39,26,32,12,65,82.05128205128204,30.76923076923077
7057_marine,36,26,31,9,62,86.11111111111111,25
7058_marine,35,26,31,8,61,88.57142857142857,22.857142857142858
7059_marine,35,23,31,8,58,88.57142857142857,22.857142857142858
7060_marine,32,21,30,8,53,93.75,25
7061_marine,30,17,29,6,47,96.66666666666667,20
7062_marine,29,17,28,5,46,96.55172413793103,17.24137931034483
7063_marine,27,15,26,4,42,96.29629629629629,14.814814814814813
7064_marine,28,15,27,4,43,96.42857142857143,14.285714285714285
7065_marine,27,17,26,4,44,96.29629629629629,14.814814814814813
7066_marine,26,19,25,3,45,96.15384615384616,11.538461538461538
7067_marine,26,19,25,3,45,96.15384615384616,11.538461538461538
7068_marine,24,19,23,3,43,95.83333333333334,12.5
7069_marine,25,19,23,4,44,92,16
7070_marine,29,17,26,6,46,89.65517241379311,20.689655172413794
7071_marine,28,15,25,6,43,89.28571428571429,21.428571428571427
7072_marine,26,18,22,8,44,84.61538461538461,30.76923076923077
7073_marine,53,28,40,30,81,75.47169811320755,56.60377358490566
7074_marine,56,34,43,29,90,76.78571428571429,51.78571428571429
7075_marine,56,34,43,29,90,76.78571428571429,51.78571428571429
7076_marine,56,34,43,29,90,76.78571428571429,51.78571428571429
7077_marine,56,30,43,29,86,76.78571428571429,51.78571428571429
7078_marine,57,28,42,30,85,73.68421052631578,52.63157894736842
7079_marine,68,28,49,42,96,72.05882352941177,61.76470588235294
7080_marine,72,29,52,44,101,72.22222222222221,61.111111111111114
7081_marine,71,28,53,43,99,74.64788732394366,60.56338028169014
7082_marine,17,8,15,4,25,88.23529411764706,23.52941176470588
7083_marine,17,6,15,4,23,88.23529411764706,23.52941176470588
7084_marine,14,6,13,3,20,92.85714285714286,21.428571428571427
7085_marine,14,6,13,3,20,92.85714285714286,21.428571428571427
7086_marine,15,5,14,4,20,93.33333333333333,26.666666666666668
7087_marine,77,28,50,42,105,64.93506493506493,54.54545454545454
7088_marine,76,30,49,41,106,64.47368421052632,53.94736842105263
7093_marine,73,30,47,41,103,64.38356164383562,56.16438356164384
7094_marine,70,29,46,40,99,65.71428571428571,57.14285714285714
7095_marine,67,27,44,37,94,65.67164179104478,55.223880597014926
7099_marine,70,25,45,36,95,64.28571428571429,51.42857142857142
7100_marine,48,16,30,23,64,62.5,47.91666666666667
7103_marine,83,37,54,48,120,65.06024096385542,57.831325301204814
7104_marine,83,37,54,48,120,65.06024096385542,57.831325301204814
7152_marine,8,14,8,2,22,100,25
7172_marine,78,47,50,39,125,64.1025641025641,50
7173_marine,79,47,51,40,126,64.55696202531645,50.63291139240506
7174_marine,39,23,29,25,62,74.35897435897436,64.1025641025641
7175_marine,38,23,28,24,61,73.68421052631578,63.1578947368421
7179_marine,39,22,29,25,61,74.35897435897436,64.1025641025641
7180_marine,81,48,52,43,129,64.19753086419753,53.086419753086425
7181_marine,84,48,55,47,132,65.47619047619048,55.952380952380956
7182_marine,49,19,37,33,68,75.51020408163265,67.3469387755102
7183_marine,48,17,37,30,65,77.08333333333334,62.5
7184_marine,14,8,13,5,22,92.85714285714286,35.714285714285715
7185_marine,14,8,13,5,22,92.85714285714286,35.714285714285715
7186_marine,13,8,13,4,21,100,30.76923076923077
7187_marine,13,8,13,4,21,100,30.76923076923077
7188_marine,16,8,15,5,24,93.75,31.25
7189_marine,68,28,53,41,96,77.94117647058823,60.29411764705882
7190_marine,18,8,17,5,26,94.44444444444444,27.77777777777778
7191_marine,85,48,58,41,133,68.23529411764706,48.23529411764706
7192_marine,53,26,42,29,79,79.24528301886792,54.71698113207547
7193_marine,21,8,20,5,29,95.23809523809523,23.809523809523807
7194_marine,19,8,17,6,27,89.47368421052632,31.57894736842105
7195_marine,19,8,17,6,27,89.47368421052632,31.57894736842105
7196_marine,19,8,17,6,27,89.47368421052632,31.57894736842105
7197_marine,19,11,17,6,30,89.47368421052632,31.57894736842105
7198_marine,22,11,20,7,33,90.9090909090909,31.818181818181817
7199_marine,44,26,32,24,70,72.72727272727273,54.54545454545454
7200_marine,43,26,32,23,69,74.4186046511628,53.48837209302325
7201_marine,28,15,26,6,43,92.85714285714286,21.428571428571427
7202_marine,26,15,23,6,41,88.46153846153845,23.076923076923077
7203_marine,26,15,24,6,41,92.3076923076923,23.076923076923077
7204_marine,25,15,24,5,40,96,20
7205_marine,24,15,24,4,39,100,16.666666666666664
7206_marine,23,14,23,3,37,100,13.043478260869565
7207_marine,22,14,22,2,36,100,9.090909090909092
7208_marine,22,14,22,2,36,100,9.090909090909092
7209_marine,21,16,21,1,37,100,4.761904761904762
7210_marine,20,16,20,0,36,100,0
7211_marine,20,16,20,0,36,100,0
7212_marine,20,16,20,0,36,100,0
7213_marine,22,17,20,1,39,90.9090909090909,4.545454545454546
7214_marine,25,18,20,4,43,80,16
7215_marine,25,18,20,4,43,80,16
7216_marine,23,17,20,2,40,86.95652173913044,8.695652173913043
7217_marine,105,51,60,51,156,57.14285714285714,48.57142857142857
7218_marine,99,50,57,48,149,57.57575757575758,48.484848484848484
7235_marine,14,13,12,2,27,85.71428571428571,14.285714285714285
7236_marine,18,22,16,2,40,88.88888888888889,11.11111111111111
7238_marine,90,46,50,45,136,55.55555555555556,50
7239_marine,95,48,51,49,143,53.68421052631579,51.578947368421055
7240_marine,18,22,15,4,40,83.33333333333334,22.22222222222222
7241_marine,92,45,48,51,137,52.17391304347826,55.434782608695656
7242_marine,92,48,48,52,140,52.17391304347826,56.52173913043478
7243_marine,56,27,33,45,83,58.92857142857143,80.35714285714286
7244_marine,104,50,49,63,154,47.11538461538461,60.57692307692307
7245_marine,106,49,51,65,155,48.113207547169814,61.32075471698113
7246_marine,95,48,45,55,143,47.368421052631575,57.89473684210527
7247_marine,102,50,46,64,152,45.09803921568628,62.745098039215684
7248_marine,104,50,49,64,154,47.11538461538461,61.53846153846154
7249_marine,97,47,47,59,144,48.45360824742268,60.824742268041234
7250_marine,100,45,47,61,145,47,61
7251_marine,92,41,44,53,133,47.82608695652174,57.608695652173914
7252_marine,87,37,40,51,124,45.97701149425287,58.620689655172406
7254_marine,83,38,40,48,121,48.19277108433735,57.831325301204814
7255_marine,79,36,41,46,115,51.89873417721519,58.22784810126582
7256_marine,77,36,39,45,113,50.649350649350644,58.44155844155844
7257_marine,79,35,40,47,114,50.63291139240506,59.49367088607595
7258_marine,78,34,40,46,112,51.28205128205128,58.97435897435898
7259_marine,73,32,37,41,105,50.68493150684932,56.16438356164384
7260_marine,73,32,37,41,105,50.68493150684932,56.16438356164384
7261_marine,71,32,36,40,103,50.70422535211267,56.33802816901409
7262_marine,70,32,36,39,102,51.42857142857142,55.714285714285715
7263_marine,50,20,30,26,70,60,52
7264_marine,49,18,29,27,67,59.183673469387756,55.10204081632652
7265_marine,81,32,46,41,113,56.79012345679012,50.617283950617285
7266_marine,50,18,30,27,68,60,54
7267_marine,51,19,31,28,70,60.78431372549019,54.90196078431373
7273_marine,52,16,33,29,68,63.46153846153846,55.769230769230774
7274_marine,55,18,36,30,73,65.45454545454545,54.54545454545454
7275_marine,55,16,35,31,71,63.63636363636363,56.36363636363636
7277_marine,55,14,35,32,69,63.63636363636363,58.18181818181818
7278_marine,55,14,35,32,69,63.63636363636363,58.18181818181818
7279_marine,55,14,35,32,69,63.63636363636363,58.18181818181818
7280_marine,54,14,34,31,68,62.96296296296296,57.407407407407405
7281_marine,44,12,30,29,56,68.18181818181817,65.9090909090909
7282_marine,44,12,30,29,56,68.18181818181817,65.9090909090909
7283_marine,44,12,30,29,56,68.18181818181817,65.9090909090909
7284_marine,62,20,37,31,82,59.67741935483871,50
7285_marine,62,20,37,31,82,59.67741935483871,50
7286_marine,55,20,32,26,75,58.18181818181818,47.27272727272727
7287_marine,51,20,28,26,71,54.90196078431373,50.98039215686274
7288_marine,55,23,31,28,78,56.36363636363636,50.90909090909091
7289_marine,57,25,33,28,82,57.89473684210527,49.122807017543856
7290_marine,56,25,32,28,81,57.14285714285714,50
7291_marine,56,24,32,28,80,57.14285714285714,50
7292_marine,55,24,31,27,79,56.36363636363636,49.09090909090909
7293_marine,11,8,10,3,19,90.9090909090909,27.27272727272727
7294_marine,32,13,22,20,45,68.75,62.5
7295_marine,71,24,38,29,95,53.52112676056338,40.845070422535215
7296_marine,57,25,32,29,82,56.14035087719298,50.877192982456144
7297_marine,71,26,38,29,97,53.52112676056338,40.845070422535215
7298_marine,72,26,40,28,98,55.55555555555556,38.88888888888889
7299_marine,73,26,40,29,99,54.794520547945204,39.726027397260275
7300_marine,52,19,33,25,71,63.46153846153846,48.07692307692308
7301_marine,48,19,30,21,67,62.5,43.75
7302_marine,48,19,30,21,67,62.5,43.75
7303_marine,47,19,30,20,66,63.829787234042556,42.5531914893617
7304_marine,48,19,30,21,67,62.5,43.75
7305_marine,47,19,30,20,66,63.829787234042556,42.5531914893617
7306_marine,40,10,22,21,50,55.00000000000001,52.5
7311_marine,55,21,36,18,76,65.45454545454545,32.72727272727273
7312_marine,56,25,36,19,81,64.28571428571429,33.92857142857143
7313_marine,57,27,37,20,84,64.91228070175438,35.08771929824561
7314_marine,59,29,39,20,88,66.10169491525424,33.89830508474576
7315_marine,25,21,23,4,46,92,16
7316_marine,23,19,22,3,42,95.65217391304348,13.043478260869565
7317_marine,23,21,22,3,44,95.65217391304348,13.043478260869565
7318_marine,21,21,20,3,42,95.23809523809523,14.285714285714285
7319_marine,21,20,20,3,41,95.23809523809523,14.285714285714285
7320_marine,25,18,23,4,43,92,16
7321_marine,25,20,23,4,45,92,16
7322_marine,30,20,28,4,50,93.33333333333333,13.333333333333334
7323_marine,32,18,30,5,50,93.75,15.625
7324_marine,39,21,35,9,60,89.74358974358975,23.076923076923077
7325_marine,43,27,37,12,70,86.04651162790698,27.906976744186046
7326_marine,68,30,52,29,98,76.47058823529412,42.64705882352941
7327_marine,66,32,49,30,98,74.24242424242425,45.45454545454545
7328_marine,65,34,49,29,99,75.38461538461539,44.61538461538462
7329_marine,79,32,56,33,111,70.88607594936708,41.77215189873418
7330_marine,73,32,54,30,105,73.97260273972603,41.0958904109589
7353_marine,39,11,36,8,50,92.3076923076923,20.51282051282051
7355_marine,74,32,60,25,106,81.08108108108108,33.78378378378378
7356_marine,77,34,63,26,111,81.81818181818183,33.76623376623377
7357_marine,81,36,66,29,117,81.48148148148148,35.80246913580247
7358_marine,82,38,67,29,120,81.70731707317073,35.36585365853659
7359_marine,52,31,48,11,83,92.3076923076923,21.153846153846153
7360_marine,49,33,46,10,82,93.87755102040816,20.408163265306122
7361_marine,49,33,47,8,82,95.91836734693877,16.3265306122449
7362_marine,47,32,45,8,79,95.74468085106383,17.02127659574468
7363_marine,44,32,43,7,76,97.72727272727273,15.909090909090908
7364_marine,44,32,43,7,76,97.72727272727273,15.909090909090908
7365_marine,42,30,41,6,72,97.61904761904762,14.285714285714285
7366_marine,42,28,41,6,70,97.61904761904762,14.285714285714285
7367_marine,40,28,39,6,68,97.5,15
7368_marine,38,24,37,6,62,97.36842105263158,15.789473684210526
7369_marine,38,24,37,6,62,97.36842105263158,15.789473684210526
7370_marine,38,26,37,6,64,97.36842105263158,15.789473684210526
7371_marine,40,26,39,6,66,97.5,15
7372_marine,40,24,39,6,64,97.5,15
7373_marine,38,23,37,6,61,97.36842105263158,15.789473684210526
7374_marine,34,19,33,6,53,97.05882352941177,17.647058823529413
7375_marine,34,19,33,6,53,97.05882352941177,17.647058823529413
7376_marine,33,21,32,5,54,96.96969696969697,15.151515151515152
7377_marine,32,23,31,5,55,96.875,15.625
7378_marine,32,22,31,5,54,96.875,15.625
7379_marine,32,24,31,5,56,96.875,15.625
7380_marine,33,20,32,6,53,96.96969696969697,18.181818181818183
7381_marine,33,16,32,6,49,96.96969696969697,18.181818181818183
7382_marine,33,16,32,6,49,96.96969696969697,18.181818181818183
7383_marine,33,16,32,6,49,96.96969696969697,18.181818181818183
7384_marine,33,16,32,6,49,96.96969696969697,18.181818181818183
7385_marine,31,16,30,6,47,96.7741935483871,19.35483870967742
7386_marine,31,16,30,6,47,96.7741935483871,19.35483870967742
7387_marine,33,16,32,6,49,96.96969696969697,18.181818181818183
7388_marine,34,18,32,6,52,94.11764705882352,17.647058823529413
7389_marine,34,18,32,6,52,94.11764705882352,17.647058823529413
7390_marine,36,20,32,8,56,88.88888888888889,22.22222222222222
7391_marine,43,22,37,9,65,86.04651162790698,20.930232558139537
7392_marine,44,25,37,10,69,84.0909090909091,22.727272727272727
7393_marine,54,40,46,12,94,85.18518518518519,22.22222222222222
7394_marine,64,49,54,17,113,84.375,26.5625
7395_marine,69,48,55,23,117,79.71014492753623,33.33333333333333
7396_marine,167,78,124,102,245,74.25149700598801,61.07784431137725
7397_marine,177,82,131,116,259,74.01129943502825,65.5367231638418
7412_marine,156,71,111,93,227,71.15384615384616,59.61538461538461
7415_marine,132,50,95,84,182,71.96969696969697,63.63636363636363
7418_marine,45,25,36,16,70,80,35.55555555555556
7419_marine,42,23,33,16,65,78.57142857142857,38.095238095238095
7420_marine,40,23,32,14,63,80,35
7421_marine,34,20,30,10,54,88.23529411764706,29.411764705882355
7422_marine,33,19,30,9,52,90.9090909090909,27.27272727272727
7423_marine,29,18,26,6,47,89.65517241379311,20.689655172413794
7424_marine,30,18,27,7,48,90,23.333333333333332
7425_marine,26,16,23,6,42,88.46153846153845,23.076923076923077
7426_marine,26,16,23,6,42,88.46153846153845,23.076923076923077
7427_marine,25,15,22,6,40,88,24
7428_marine,27,16,23,7,43,85.18518518518519,25.925925925925924
7429_marine,71,27,49,41,98,69.01408450704226,57.74647887323944
7430_marine,71,27,49,41,98,69.01408450704226,57.74647887323944
7431_marine,71,27,49,41,98,69.01408450704226,57.74647887323944
7432_marine,26,16,23,6,42,88.46153846153845,23.076923076923077
7433_marine,25,16,21,7,41,84,28.000000000000004
7434_marine,25,16,22,7,41,88,28.000000000000004
7435_marine,63,31,45,38,94,71.42857142857143,60.317460317460316
7436_marine,24,16,21,6,40,87.5,25
7437_marine,23,14,20,5,37,86.95652173913044,21.73913043478261
7438_marine,23,14,20,5,37,86.95652173913044,21.73913043478261
7439_marine,82,37,60,47,119,73.17073170731707,57.3170731707317
7440_marine,83,35,61,48,118,73.49397590361446,57.831325301204814
7441_marine,101,50,63,54,151,62.37623762376238,53.46534653465347
7442_marine,89,46,56,47,135,62.92134831460674,52.80898876404494
7443_marine,49,20,35,32,69,71.42857142857143,65.3061224489796
7444_marine,49,22,35,32,71,71.42857142857143,65.3061224489796
7445_marine,85,45,53,45,130,62.35294117647059,52.94117647058824
7446_marine,84,44,52,47,128,61.904761904761905,55.952380952380956
7447_marine,93,49,59,50,142,63.44086021505376,53.76344086021505
7448_marine,78,30,51,44,108,65.38461538461539,56.41025641025641
7449_marine,79,42,51,44,121,64.55696202531645,55.69620253164557
7453_marine,78,36,50,46,114,64.1025641025641,58.97435897435898
7454_marine,73,33,46,43,106,63.013698630136986,58.9041095890411
7455_marine,69,33,43,39,102,62.31884057971014,56.52173913043478
7456_marine,72,35,45,41,107,62.5,56.94444444444444
7457_marine,76,38,48,41,114,63.1578947368421,53.94736842105263
7458_marine,71,38,44,38,109,61.97183098591549,53.52112676056338
7540_marine,84,46,52,44,130,61.904761904761905,52.38095238095239
7541_marine,93,55,60,50,148,64.51612903225806,53.76344086021505
7542_marine,109,59,73,59,168,66.97247706422019,54.12844036697248
7543_marine,85,41,56,44,126,65.88235294117646,51.76470588235295
7544_marine,81,40,53,40,121,65.4320987654321,49.382716049382715
7545_marine,81,40,53,40,121,65.4320987654321,49.382716049382715
7546_marine,44,18,34,27,62,77.27272727272727,61.36363636363637
7547_marine,79,39,52,38,118,65.82278481012658,48.10126582278481
7548_marine,86,43,59,42,129,68.6046511627907,48.837209302325576
7549_marine,87,43,60,43,130,68.96551724137932,49.42528735632184
7550_marine,91,45,64,43,136,70.32967032967034,47.25274725274725
7551_marine,86,51,59,41,137,68.6046511627907,47.674418604651166
7552_marine,20,8,19,4,28,95,20
7553_marine,83,45,55,41,128,66.26506024096386,49.39759036144578
7554_marine,83,42,55,41,125,66.26506024096386,49.39759036144578
7555_marine,48,17,36,29,65,75,60.416666666666664
7556_marine,47,17,35,28,64,74.46808510638297,59.57446808510638
7557_marine,84,41,56,40,125,66.66666666666666,47.61904761904761
7558_marine,50,20,38,28,70,76,56.00000000000001
7559_marine,83,44,54,42,127,65.06024096385542,50.602409638554214
7560_marine,85,44,55,44,129,64.70588235294117,51.76470588235295
7561_marine,85,43,59,40,128,69.41176470588235,47.05882352941176
7562_marine,84,44,59,39,128,70.23809523809523,46.42857142857143
7563_marine,82,44,57,38,126,69.51219512195121,46.34146341463415
7564_marine,56,30,46,24,86,82.14285714285714,42.857142857142854
7565_marine,30,16,25,8,46,83.33333333333334,26.666666666666668
7566_marine,27,15,24,7,42,88.88888888888889,25.925925925925924
7567_marine,26,15,24,6,41,92.3076923076923,23.076923076923077
7568_marine,25,15,24,5,40,96,20
7569_marine,25,16,24,5,41,96,20
7570_marine,22,16,22,2,38,100,9.090909090909092
7571_marine,20,16,20,0,36,100,0
7572_marine,22,16,21,1,38,95.45454545454545,4.545454545454546
7573_marine,29,18,23,8,47,79.3103448275862,27.586206896551722
7574_marine,116,56,66,58,172,56.896551724137936,50
7575_marine,114,56,65,56,170,57.01754385964912,49.122807017543856
7576_marine,28,27,25,3,55,89.28571428571429,10.714285714285714
7603_marine,95,48,49,56,143,51.578947368421055,58.94736842105262
7604_marine,113,57,53,70,170,46.902654867256636,61.94690265486725
7605_marine,118,53,54,71,171,45.76271186440678,60.16949152542372
7607_marine,105,43,46,68,148,43.80952380952381,64.76190476190476
7608_marine,100,43,43,64,143,43,64
7623_marine,70,32,36,39,102,51.42857142857142,55.714285714285715
7624_marine,71,32,37,39,103,52.112676056338024,54.929577464788736
7625_marine,72,32,37,40,104,51.388888888888886,55.55555555555556
7626_marine,75,32,41,41,107,54.666666666666664,54.666666666666664
7627_marine,82,32,47,41,114,57.3170731707317,50
7628_marine,60,18,35,37,78,58.333333333333336,61.66666666666667
7629_marine,57,17,33,34,74,57.89473684210527,59.64912280701754
7630_marine,77,28,43,38,105,55.84415584415584,49.35064935064935
7631_marine,59,17,37,34,76,62.71186440677966,57.6271186440678
7632_marine,75,26,43,36,101,57.333333333333336,48
7633_marine,73,28,43,34,101,58.9041095890411,46.57534246575342
7634_marine,61,28,32,33,89,52.459016393442624,54.09836065573771
7635_marine,74,26,43,35,100,58.108108108108105,47.2972972972973
7636_marine,75,24,43,36,99,57.333333333333336,48
7637_marine,76,24,43,37,100,56.57894736842105,48.68421052631579
7638_marine,55,14,35,32,69,63.63636363636363,58.18181818181818
7639_marine,56,14,36,33,70,64.28571428571429,58.92857142857143
7640_marine,37,12,24,28,49,64.86486486486487,75.67567567567568
7641_marine,48,12,32,32,60,66.66666666666666,66.66666666666666
7642_marine,66,23,38,34,89,57.57575757575758,51.515151515151516
7643_marine,65,23,38,33,88,58.46153846153847,50.76923076923077
7644_marine,65,23,38,33,88,58.46153846153847,50.76923076923077
7645_marine,65,23,38,33,88,58.46153846153847,50.76923076923077
7646_marine,53,23,30,26,76,56.60377358490566,49.056603773584904
7647_marine,53,23,30,26,76,56.60377358490566,49.056603773584904
7650_marine,54,25,30,28,79,55.55555555555556,51.85185185185185
7651_marine,54,26,30,28,80,55.55555555555556,51.85185185185185
7652_marine,53,24,30,27,77,56.60377358490566,50.943396226415096
7653_marine,53,24,29,27,77,54.71698113207547,50.943396226415096
7654_marine,57,24,32,31,81,56.14035087719298,54.385964912280706
7655_marine,57,23,32,30,80,56.14035087719298,52.63157894736842
7656_marine,57,23,32,29,80,56.14035087719298,50.877192982456144
7658_marine,62,27,37,30,89,59.67741935483871,48.38709677419355
7659_marine,62,27,37,30,89,59.67741935483871,48.38709677419355
7660_marine,12,9,11,2,21,91.66666666666666,16.666666666666664
7661_marine,33,16,23,19,49,69.6969696969697,57.57575757575758
7662_marine,32,16,23,18,48,71.875,56.25
7663_marine,11,9,11,1,20,100,9.090909090909092
7664_marine,52,19,31,23,71,59.61538461538461,44.230769230769226
7665_marine,52,19,31,23,71,59.61538461538461,44.230769230769226
7666_marine,50,19,30,22,69,60,44
7667_marine,52,19,32,22,71,61.53846153846154,42.30769230769231
7668_marine,13,9,13,1,22,100,7.6923076923076925
7671_marine,55,23,35,19,78,63.63636363636363,34.54545454545455
7672_marine,58,25,37,19,83,63.793103448275865,32.758620689655174
7673_marine,59,27,38,20,86,64.40677966101694,33.89830508474576
7674_marine,64,30,42,22,94,65.625,34.375
7675_marine,64,33,42,22,97,65.625,34.375
7676_marine,63,35,41,22,98,65.07936507936508,34.92063492063492
7677_marine,26,26,24,4,52,92.3076923076923,15.384615384615385
7678_marine,28,26,27,4,54,96.42857142857143,14.285714285714285
7679_marine,26,23,25,3,49,96.15384615384616,11.538461538461538
7680_marine,29,22,27,4,51,93.10344827586206,13.793103448275861
7681_marine,29,22,27,4,51,93.10344827586206,13.793103448275861
7682_marine,30,20,28,4,50,93.33333333333333,13.333333333333334
7683_marine,33,20,31,5,53,93.93939393939394,15.151515151515152
7684_marine,35,22,32,6,57,91.42857142857143,17.142857142857142
7685_marine,40,28,35,11,68,87.5,27.500000000000004
7686_marine,43,29,36,12,72,83.72093023255815,27.906976744186046
7687_marine,81,34,59,34,115,72.8395061728395,41.9753086419753
7688_marine,81,34,59,34,115,72.8395061728395,41.9753086419753
7689_marine,81,34,59,34,115,72.8395061728395,41.9753086419753
7690_marine,70,22,49,32,92,70,45.714285714285715
7708_marine,72,29,56,28,101,77.77777777777779,38.88888888888889
7709_marine,73,39,57,27,112,78.08219178082192,36.986301369863014
7710_marine,73,35,57,27,108,78.08219178082192,36.986301369863014
7711_marine,73,39,57,27,112,78.08219178082192,36.986301369863014
7712_marine,74,42,60,24,116,81.08108108108108,32.432432432432435
7713_marine,76,42,62,25,118,81.57894736842105,32.89473684210527
7714_marine,76,36,62,25,112,81.57894736842105,32.89473684210527
7715_marine,77,43,63,26,120,81.81818181818183,33.76623376623377
7716_marine,49,37,45,10,86,91.83673469387756,20.408163265306122
7717_marine,48,33,45,9,81,93.75,18.75
7718_marine,48,43,45,9,91,93.75,18.75
7719_marine,50,43,47,9,93,94,18
7720_marine,50,42,47,9,92,94,18
7721_marine,51,36,48,10,87,94.11764705882352,19.607843137254903
7722_marine,49,42,48,8,91,97.95918367346938,16.3265306122449
7723_marine,45,42,44,8,87,97.77777777777777,17.77777777777778
7724_marine,47,42,46,8,89,97.87234042553192,17.02127659574468
7725_marine,47,42,46,8,89,97.87234042553192,17.02127659574468
7726_marine,42,40,41,6,82,97.61904761904762,14.285714285714285
7727_marine,40,30,39,6,70,97.5,15
7728_marine,36,26,35,6,62,97.22222222222221,16.666666666666664
7729_marine,34,26,33,6,60,97.05882352941177,17.647058823529413
7730_marine,36,32,35,6,68,97.22222222222221,16.666666666666664
7731_marine,38,32,37,6,70,97.36842105263158,15.789473684210526
7732_marine,38,33,37,6,71,97.36842105263158,15.789473684210526
7733_marine,36,31,35,6,67,97.22222222222221,16.666666666666664
7734_marine,34,29,33,6,63,97.05882352941177,17.647058823529413
7735_marine,34,18,33,6,52,97.05882352941177,17.647058823529413
7736_marine,35,18,34,7,53,97.14285714285714,20
7737_marine,34,18,33,6,52,97.05882352941177,17.647058823529413
7738_marine,34,16,33,6,50,97.05882352941177,17.647058823529413
7739_marine,34,20,33,6,54,97.05882352941177,17.647058823529413
7740_marine,33,22,32,6,55,96.96969696969697,18.181818181818183
7741_marine,32,18,30,6,50,93.75,18.75
7742_marine,32,18,30,6,50,93.75,18.75
7743_marine,34,22,32,6,56,94.11764705882352,17.647058823529413
7744_marine,38,22,36,6,60,94.73684210526315,15.789473684210526
7745_marine,38,22,36,6,60,94.73684210526315,15.789473684210526
7746_marine,38,24,36,6,62,94.73684210526315,15.789473684210526
7747_marine,38,24,36,6,62,94.73684210526315,15.789473684210526
7748_marine,39,28,36,7,67,92.3076923076923,17.94871794871795
7749_marine,38,24,35,8,62,92.10526315789474,21.052631578947366
7750_marine,47,30,41,9,77,87.2340425531915,19.148936170212767
7751_marine,53,43,47,9,96,88.67924528301887,16.9811320754717
7752_marine,64,49,56,16,113,87.5,25
7753_marine,145,78,112,83,223,77.24137931034483,57.24137931034483
7754_marine,162,79,125,95,241,77.1604938271605,58.64197530864198
7755_marine,183,82,135,109,265,73.77049180327869,59.56284153005464
7777_marine,88,37,60,58,125,68.18181818181817,65.9090909090909
7778_marine,120,47,86,78,167,71.66666666666667,65
7779_marine,138,63,91,84,201,65.94202898550725,60.86956521739131
7780_marine,134,63,87,83,197,64.92537313432835,61.940298507462686
7781_marine,39,31,30,16,70,76.92307692307693,41.02564102564102
7782_marine,34,19,28,14,53,82.35294117647058,41.17647058823529
7783_marine,29,19,24,10,48,82.75862068965517,34.48275862068966
7784_marine,105,55,65,57,160,61.904761904761905,54.285714285714285
7785_marine,109,53,67,59,162,61.46788990825688,54.12844036697248
7786_marine,101,53,61,54,154,60.396039603960396,53.46534653465347
7787_marine,105,53,64,57,158,60.952380952380956,54.285714285714285
7788_marine,28,18,23,8,46,82.14285714285714,28.57142857142857
7789_marine,73,27,50,43,100,68.4931506849315,58.9041095890411
7790_marine,79,40,54,49,119,68.35443037974683,62.0253164556962
7791_marine,108,58,68,58,166,62.96296296296296,53.70370370370371
7792_marine,104,57,65,54,161,62.5,51.92307692307693
7793_marine,104,58,64,55,162,61.53846153846154,52.88461538461539
7794_marine,107,59,67,58,166,62.616822429906534,54.20560747663551
7795_marine,107,57,68,58,164,63.55140186915887,54.20560747663551
7796_marine,99,55,62,52,154,62.62626262626263,52.52525252525253
7797_marine,94,49,58,48,143,61.702127659574465,51.06382978723404
7798_marine,94,50,58,48,144,61.702127659574465,51.06382978723404
7799_marine,96,52,60,48,148,62.5,50
7800_marine,105,57,68,53,162,64.76190476190476,50.476190476190474
7801_marine,58,28,43,34,86,74.13793103448276,58.620689655172406
7807_marine,79,42,47,43,121,59.49367088607595,54.43037974683544
7808_marine,89,51,55,46,140,61.79775280898876,51.68539325842697
7809_marine,86,44,55,51,130,63.95348837209303,59.30232558139535
7810_marine,86,42,57,49,128,66.27906976744185,56.97674418604651
7813_marine,16,5,15,7,21,93.75,43.75
7814_marine,82,43,51,49,125,62.19512195121951,59.756097560975604
7815_marine,83,44,52,46,127,62.65060240963856,55.42168674698795
7816_marine,79,40,50,43,119,63.29113924050633,54.43037974683544
7817_marine,79,40,50,43,119,63.29113924050633,54.43037974683544
7818_marine,85,46,52,49,131,61.1764705882353,57.647058823529406
7901_marine,109,50,66,67,159,60.550458715596335,61.46788990825688
7902_marine,117,52,70,71,169,59.82905982905983,60.68376068376068
7910_marine,87,45,60,40,132,68.96551724137932,45.97701149425287
7911_marine,86,49,59,40,135,68.6046511627907,46.51162790697674
7920_marine,81,44,53,43,125,65.4320987654321,53.086419753086425
7924_marine,50,24,40,24,74,80,48
7925_marine,89,46,57,45,135,64.04494382022472,50.56179775280899
7926_marine,94,46,60,46,140,63.829787234042556,48.93617021276596
7927_marine,91,45,57,46,136,62.637362637362635,50.54945054945055
7928_marine,92,47,59,45,139,64.13043478260869,48.91304347826087
7929_marine,29,18,25,9,47,86.20689655172413,31.03448275862069
7930_marine,28,18,24,8,46,85.71428571428571,28.57142857142857
7931_marine,28,17,24,7,45,85.71428571428571,25
7932_marine,25,16,23,4,41,92,16
7933_marine,25,18,22,4,43,88,16
7934_marine,27,18,22,6,45,81.48148148148148,22.22222222222222
7935_marine,114,57,66,54,171,57.89473684210527,47.368421052631575
7936_marine,117,58,68,59,175,58.119658119658126,50.427350427350426
7937_marine,136,63,77,75,199,56.61764705882353,55.14705882352941
7938_marine,142,69,77,84,211,54.22535211267606,59.154929577464785
7939_marine,141,68,75,84,209,53.191489361702125,59.57446808510638
7985_marine,68,29,34,39,97,50,57.35294117647059
7986_marine,65,28,31,36,93,47.69230769230769,55.38461538461539
7987_marine,65,28,31,36,93,47.69230769230769,55.38461538461539
7988_marine,64,28,31,36,92,48.4375,56.25
7989_marine,64,28,31,36,92,48.4375,56.25
7990_marine,63,28,31,35,91,49.2063492063492,55.55555555555556
7991_marine,64,28,33,34,92,51.5625,53.125
7992_marine,64,28,33,36,92,51.5625,56.25
7993_marine,63,28,33,35,91,52.38095238095239,55.55555555555556
7997_marine,6,5,6,0,11,100,0
7998_marine,61,24,32,34,85,52.459016393442624,55.73770491803278
7999_marine,60,24,32,33,84,53.333333333333336,55.00000000000001
8000_marine,59,23,31,32,82,52.54237288135594,54.23728813559322
8001_marine,59,23,31,32,82,52.54237288135594,54.23728813559322
8002_marine,59,23,31,32,82,52.54237288135594,54.23728813559322
8003_marine,54,19,28,29,73,51.85185185185185,53.70370370370371
8004_marine,58,22,31,31,80,53.44827586206896,53.44827586206896
8005_marine,59,22,33,31,81,55.932203389830505,52.54237288135594
8012_marine,54,24,30,28,78,55.55555555555556,51.85185185185185
8013_marine,54,24,30,28,78,55.55555555555556,51.85185185185185
8014_marine,57,24,32,31,81,56.14035087719298,54.385964912280706
8016_marine,61,27,37,28,88,60.65573770491803,45.90163934426229
8018_marine,13,11,11,3,24,84.61538461538461,23.076923076923077
8019_marine,63,27,38,30,90,60.317460317460316,47.61904761904761
8020_marine,14,11,12,3,25,85.71428571428571,21.428571428571427
8021_marine,13,11,12,2,24,92.3076923076923,15.384615384615385
8022_marine,11,9,11,1,20,100,9.090909090909092
8023_marine,39,15,27,21,54,69.23076923076923,53.84615384615385
8024_marine,39,15,27,21,54,69.23076923076923,53.84615384615385
8025_marine,39,15,27,21,54,69.23076923076923,53.84615384615385
8026_marine,34,15,24,19,49,70.58823529411765,55.88235294117647
8027_marine,36,15,26,19,51,72.22222222222221,52.77777777777778
8028_marine,58,21,38,27,79,65.51724137931035,46.55172413793103
8034_marine,61,23,40,21,84,65.57377049180327,34.42622950819672
8035_marine,60,27,39,21,87,65,35
8036_marine,65,31,43,24,96,66.15384615384615,36.92307692307693
8037_marine,69,34,47,24,103,68.11594202898551,34.78260869565217
8038_marine,70,37,48,24,107,68.57142857142857,34.285714285714285
8039_marine,72,39,50,24,111,69.44444444444444,33.33333333333333
8040_marine,35,32,33,4,67,94.28571428571428,11.428571428571429
8041_marine,35,28,33,4,63,94.28571428571428,11.428571428571429
8042_marine,33,28,31,4,61,93.93939393939394,12.121212121212121
8043_marine,37,26,35,5,63,94.5945945945946,13.513513513513514
8044_marine,41,28,37,7,69,90.2439024390244,17.073170731707318
8045_marine,44,19,38,11,63,86.36363636363636,25
8046_marine,50,30,43,14,80,86,28.000000000000004
8047_marine,85,34,63,36,119,74.11764705882354,42.35294117647059
8048_marine,77,26,56,33,103,72.72727272727273,42.857142857142854
8049_marine,76,26,55,32,102,72.36842105263158,42.10526315789473
8050_marine,74,24,54,30,98,72.97297297297297,40.54054054054054
8067_marine,75,33,57,28,108,76,37.333333333333336
8068_marine,78,38,62,30,116,79.48717948717949,38.46153846153847
8069_marine,69,38,58,26,107,84.05797101449275,37.68115942028986
8070_marine,50,36,46,10,86,92,20
8071_marine,49,28,46,9,77,93.87755102040816,18.367346938775512
8072_marine,49,31,46,9,80,93.87755102040816,18.367346938775512
8073_marine,48,39,45,9,87,93.75,18.75
8074_marine,47,49,45,8,96,95.74468085106383,17.02127659574468
8075_marine,50,51,47,9,101,94,18
8076_marine,55,53,51,12,108,92.72727272727272,21.818181818181817
8077_marine,57,54,53,13,111,92.98245614035088,22.807017543859647
8078_marine,58,50,53,14,108,91.37931034482759,24.137931034482758
8079_marine,58,50,53,14,108,91.37931034482759,24.137931034482758
8080_marine,58,48,53,14,106,91.37931034482759,24.137931034482758
8081_marine,56,48,51,14,104,91.07142857142857,25
8082_marine,57,46,52,15,103,91.22807017543859,26.31578947368421
8083_marine,55,47,50,15,102,90.9090909090909,27.27272727272727
8084_marine,58,49,52,17,107,89.65517241379311,29.310344827586203
8085_marine,56,49,51,15,105,91.07142857142857,26.785714285714285
8086_marine,53,50,48,14,103,90.56603773584906,26.41509433962264
8087_marine,51,52,47,12,103,92.15686274509804,23.52941176470588
8088_marine,44,48,40,10,92,90.9090909090909,22.727272727272727
8089_marine,38,37,36,8,75,94.73684210526315,21.052631578947366
8090_marine,40,34,38,8,74,95,20
8091_marine,40,34,38,8,74,95,20
8092_marine,40,34,38,8,74,95,20
8093_marine,38,32,36,8,70,94.73684210526315,21.052631578947366
8094_marine,36,24,34,8,60,94.44444444444444,22.22222222222222
8095_marine,37,18,34,8,55,91.8918918918919,21.62162162162162
8096_marine,35,18,32,8,53,91.42857142857143,22.857142857142858
8097_marine,34,18,31,7,52,91.17647058823529,20.588235294117645
8098_marine,34,16,31,7,50,91.17647058823529,20.588235294117645
8099_marine,34,16,31,7,50,91.17647058823529,20.588235294117645
8100_marine,34,16,31,7,50,91.17647058823529,20.588235294117645
8101_marine,34,16,31,7,50,91.17647058823529,20.588235294117645
8102_marine,37,24,34,7,61,91.8918918918919,18.91891891891892
8103_marine,39,22,36,7,61,92.3076923076923,17.94871794871795
8104_marine,41,22,38,7,63,92.6829268292683,17.073170731707318
8105_marine,41,24,38,7,65,92.6829268292683,17.073170731707318
8106_marine,42,24,39,8,66,92.85714285714286,19.047619047619047
8107_marine,42,26,39,8,68,92.85714285714286,19.047619047619047
8108_marine,46,30,41,8,76,89.13043478260869,17.391304347826086
8109_marine,49,30,43,9,79,87.75510204081633,18.367346938775512
8110_marine,49,32,43,9,81,87.75510204081633,18.367346938775512
8111_marine,58,48,51,12,106,87.93103448275862,20.689655172413794
8112_marine,132,63,105,71,195,79.54545454545455,53.78787878787878
8113_marine,159,76,124,91,235,77.9874213836478,57.23270440251572
8141_marine,128,61,82,78,189,64.0625,60.9375
8142_marine,143,60,95,85,203,66.43356643356644,59.44055944055944
8143_marine,30,19,24,12,49,80,40
8144_marine,115,56,71,66,171,61.73913043478261,57.391304347826086
8145_marine,123,56,79,69,179,64.22764227642277,56.09756097560976
8146_marine,119,58,75,68,177,63.02521008403361,57.14285714285714
8147_marine,106,53,64,58,159,60.37735849056604,54.71698113207547
8149_marine,108,53,67,57,161,62.03703703703704,52.77777777777778
8150_marine,27,16,24,7,43,88.88888888888889,25.925925925925924
8172_marine,91,54,55,52,145,60.43956043956044,57.14285714285714
8173_marine,90,50,54,52,140,60,57.77777777777777
8174_marine,95,49,58,55,144,61.05263157894737,57.89473684210527
8175_marine,56,30,40,33,86,71.42857142857143,58.92857142857143
8178_marine,87,51,52,50,138,59.77011494252874,57.47126436781609
8179_marine,89,53,55,52,142,61.79775280898876,58.42696629213483
8281_marine,97,56,66,42,153,68.04123711340206,43.29896907216495
8282_marine,94,54,63,41,148,67.02127659574468,43.61702127659575
8286_marine,94,48,61,45,142,64.8936170212766,47.87234042553192
8287_marine,92,48,60,44,140,65.21739130434783,47.82608695652174
8288_marine,91,46,59,44,137,64.83516483516483,48.35164835164835
8289_marine,92,48,60,45,140,65.21739130434783,48.91304347826087
8290_marine,100,56,66,49,156,66,49
8291_marine,101,56,66,50,157,65.34653465346535,49.504950495049506
8292_marine,39,20,31,14,59,79.48717948717949,35.8974358974359
8293_marine,31,18,26,8,49,83.87096774193549,25.806451612903224
8294_marine,130,63,76,69,193,58.46153846153847,53.07692307692308
8295_marine,131,64,77,70,195,58.778625954198475,53.43511450381679
8296_marine,135,66,80,75,201,59.25925925925925,55.55555555555556
8297_marine,138,67,80,76,205,57.971014492753625,55.072463768115945
8298_marine,153,77,83,91,230,54.248366013071895,59.47712418300654
8299_marine,153,80,80,94,233,52.28758169934641,61.43790849673203
8300_marine,130,59,58,87,189,44.61538461538462,66.92307692307692
8352_marine,62,28,32,34,90,51.61290322580645,54.83870967741935
8353_marine,62,28,32,34,90,51.61290322580645,54.83870967741935
8364_marine,53,19,27,28,72,50.943396226415096,52.83018867924528
8365_marine,53,19,27,28,72,50.943396226415096,52.83018867924528
8374_marine,64,29,39,31,93,60.9375,48.4375
8375_marine,66,31,41,33,97,62.121212121212125,50
8376_marine,65,29,40,32,94,61.53846153846154,49.23076923076923
8377_marine,64,29,39,30,93,60.9375,46.875
8378_marine,65,29,40,30,94,61.53846153846154,46.15384615384615
8379_marine,65,27,40,30,92,61.53846153846154,46.15384615384615
8380_marine,16,11,14,3,27,87.5,18.75
8381_marine,12,11,12,1,23,100,8.333333333333332
8382_marine,12,9,12,1,21,100,8.333333333333332
8383_marine,12,9,12,1,21,100,8.333333333333332
8384_marine,11,9,11,1,20,100,9.090909090909092
8385_marine,11,9,11,1,20,100,9.090909090909092
8386_marine,57,21,35,29,78,61.40350877192983,50.877192982456144
8387_marine,55,21,33,29,76,60,52.72727272727272
8388_marine,54,21,34,26,75,62.96296296296296,48.148148148148145
8392_marine,67,30,45,26,97,67.16417910447761,38.80597014925373
8393_marine,71,30,48,28,101,67.6056338028169,39.436619718309856
8394_marine,72,34,49,26,106,68.05555555555556,36.11111111111111
8395_marine,68,29,46,24,97,67.64705882352942,35.294117647058826
8396_marine,64,29,43,22,93,67.1875,34.375
8397_marine,64,25,43,23,89,67.1875,35.9375
8398_marine,70,28,49,23,98,70,32.857142857142854
8399_marine,76,34,53,25,110,69.73684210526315,32.89473684210527
8400_marine,40,32,36,6,72,90,15
8401_marine,36,28,34,4,64,94.44444444444444,11.11111111111111
8402_marine,37,28,35,5,65,94.5945945945946,13.513513513513514
8403_marine,40,26,37,6,66,92.5,15
8404_marine,44,28,40,7,72,90.9090909090909,15.909090909090908
8405_marine,43,22,39,7,65,90.69767441860465,16.27906976744186
8406_marine,52,31,45,14,83,86.53846153846155,26.923076923076923
8407_marine,90,38,68,35,128,75.55555555555556,38.88888888888889
8408_marine,80,30,58,31,110,72.5,38.75
8409_marine,78,31,57,28,109,73.07692307692307,35.8974358974359
8422_marine,71,26,51,28,97,71.83098591549296,39.436619718309856
8423_marine,75,28,55,29,103,73.33333333333333,38.666666666666664
8424_marine,74,24,54,30,98,72.97297297297297,40.54054054054054
8425_marine,78,40,59,30,118,75.64102564102564,38.46153846153847
8426_marine,81,38,62,31,119,76.5432098765432,38.2716049382716
8427_marine,80,40,61,30,120,76.25,37.5
8428_marine,56,34,50,15,90,89.28571428571429,26.785714285714285
8429_marine,51,35,47,10,86,92.15686274509804,19.607843137254903
8430_marine,51,38,47,10,89,92.15686274509804,19.607843137254903
8431_marine,51,32,47,10,83,92.15686274509804,19.607843137254903
8432_marine,51,42,47,10,93,92.15686274509804,19.607843137254903
8433_marine,53,52,49,10,105,92.45283018867924,18.867924528301888
8434_marine,58,60,53,11,118,91.37931034482759,18.96551724137931
8435_marine,60,60,54,13,120,90,21.666666666666668
8436_marine,72,63,62,22,135,86.11111111111111,30.555555555555557
8437_marine,113,59,89,56,172,78.76106194690266,49.557522123893804
8438_marine,112,55,88,57,167,78.57142857142857,50.89285714285714
8439_marine,109,54,85,57,163,77.98165137614679,52.293577981651374
8440_marine,117,57,91,65,174,77.77777777777779,55.55555555555556
8441_marine,123,57,96,70,180,78.04878048780488,56.91056910569105
8442_marine,125,59,98,72,184,78.4,57.599999999999994
8443_marine,129,56,103,76,185,79.84496124031007,58.91472868217055
8444_marine,131,56,103,78,187,78.62595419847328,59.541984732824424
8445_marine,123,54,96,71,177,78.04878048780488,57.72357723577236
8446_marine,117,54,92,65,171,78.63247863247864,55.55555555555556
8447_marine,64,52,55,22,116,85.9375,34.375
8448_marine,54,49,49,14,103,90.74074074074075,25.925925925925924
8449_marine,45,44,41,11,89,91.11111111111111,24.444444444444443
8450_marine,44,38,41,10,82,93.18181818181817,22.727272727272727
8451_marine,43,38,39,10,81,90.69767441860465,23.25581395348837
8452_marine,39,38,36,8,77,92.3076923076923,20.51282051282051
8453_marine,35,28,32,8,63,91.42857142857143,22.857142857142858
8454_marine,33,20,30,8,53,90.9090909090909,24.242424242424242
8455_marine,33,18,30,8,51,90.9090909090909,24.242424242424242
8456_marine,33,18,30,8,51,90.9090909090909,24.242424242424242
8457_marine,34,16,31,9,50,91.17647058823529,26.47058823529412
8458_marine,33,18,30,8,51,90.9090909090909,24.242424242424242
8459_marine,33,16,30,8,49,90.9090909090909,24.242424242424242
8460_marine,35,16,32,8,51,91.42857142857143,22.857142857142858
8461_marine,37,16,34,8,53,91.8918918918919,21.62162162162162
8462_marine,39,22,36,8,61,92.3076923076923,20.51282051282051
8463_marine,41,24,38,8,65,92.6829268292683,19.51219512195122
8464_marine,40,24,37,8,64,92.5,20
8465_marine,42,26,37,8,68,88.09523809523809,19.047619047619047
8466_marine,42,28,37,8,70,88.09523809523809,19.047619047619047
8467_marine,46,30,41,8,76,89.13043478260869,17.391304347826086
8468_marine,49,32,43,9,81,87.75510204081633,18.367346938775512
8469_marine,52,36,45,10,88,86.53846153846155,19.230769230769234
8470_marine,53,37,46,11,90,86.79245283018868,20.754716981132077
8471_marine,69,52,61,12,121,88.40579710144928,17.391304347826086
8472_marine,178,74,137,99,252,76.96629213483146,55.61797752808989
8475_marine,79,49,65,21,128,82.27848101265823,26.582278481012654
8496_marine,180,66,114,116,246,63.33333333333333,64.44444444444444
8497_marine,170,65,107,111,235,62.94117647058823,65.29411764705883
8498_marine,167,64,107,109,231,64.07185628742515,65.26946107784431
8499_marine,166,64,108,108,230,65.06024096385542,65.06024096385542
8500_marine,169,64,110,111,233,65.08875739644971,65.68047337278107
8501_marine,175,62,109,114,237,62.28571428571429,65.14285714285715
8502_marine,190,68,117,122,258,61.578947368421055,64.21052631578948
8503_marine,160,65,97,104,225,60.62499999999999,65
8504_marine,168,62,102,109,230,60.71428571428571,64.88095238095238
8505_marine,177,63,110,114,240,62.14689265536724,64.40677966101694
8534_marine,90,45,52,50,135,57.77777777777777,55.55555555555556
8641_marine,103,58,68,48,161,66.01941747572816,46.601941747572816
8642_marine,95,55,64,41,150,67.36842105263158,43.15789473684211
8643_marine,98,54,67,42,152,68.36734693877551,42.857142857142854
8644_marine,96,57,65,42,153,67.70833333333334,43.75
8645_marine,95,54,63,43,149,66.3157894736842,45.26315789473684
8648_marine,100,59,67,44,159,67,44
8649_marine,102,60,69,47,162,67.64705882352942,46.07843137254902
8650_marine,103,60,69,48,163,66.99029126213593,46.601941747572816
8651_marine,86,41,60,50,127,69.76744186046511,58.139534883720934
8652_marine,169,74,105,95,243,62.1301775147929,56.213017751479285
8653_marine,144,73,89,76,217,61.80555555555556,52.77777777777778
8654_marine,142,73,86,74,215,60.56338028169014,52.112676056338024
8729_marine,59,33,36,28,92,61.016949152542374,47.45762711864407
8730_marine,61,32,37,30,93,60.65573770491803,49.18032786885246
8731_marine,63,32,38,32,95,60.317460317460316,50.79365079365079
8732_marine,64,30,38,33,94,59.375,51.5625
8733_marine,64,33,38,33,97,59.375,51.5625
8734_marine,73,34,45,34,107,61.64383561643836,46.57534246575342
8735_marine,56,22,38,31,78,67.85714285714286,55.35714285714286
8736_marine,59,28,39,33,87,66.10169491525424,55.932203389830505
8737_marine,60,26,39,33,86,65,55.00000000000001
8738_marine,16,15,14,3,31,87.5,18.75
8739_marine,15,14,14,2,29,93.33333333333333,13.333333333333334
8740_marine,14,13,14,1,27,100,7.142857142857142
8741_marine,15,13,14,2,28,93.33333333333333,13.333333333333334
8742_marine,58,21,37,26,79,63.793103448275865,44.827586206896555
8743_marine,57,23,36,27,80,63.1578947368421,47.368421052631575
8744_marine,56,21,35,27,77,62.5,48.214285714285715
8745_marine,55,21,35,26,76,63.63636363636363,47.27272727272727
8746_marine,59,21,35,31,80,59.32203389830508,52.54237288135594
8747_marine,61,21,37,31,82,60.65573770491803,50.81967213114754
8752_marine,68,30,45,27,98,66.17647058823529,39.705882352941174
8753_marine,75,36,50,29,111,66.66666666666666,38.666666666666664
8754_marine,75,38,49,29,113,65.33333333333333,38.666666666666664
8755_marine,72,37,48,26,109,66.66666666666666,36.11111111111111
8756_marine,70,38,47,24,108,67.14285714285714,34.285714285714285
8757_marine,72,34,50,23,106,69.44444444444444,31.944444444444443
8758_marine,73,34,50,24,107,68.4931506849315,32.87671232876712
8759_marine,75,34,52,24,109,69.33333333333334,32
8760_marine,37,28,35,5,65,94.5945945945946,13.513513513513514
8761_marine,39,26,37,5,65,94.87179487179486,12.82051282051282
8762_marine,40,28,37,6,68,92.5,15
8763_marine,40,26,37,6,66,92.5,15
8764_marine,43,28,40,6,71,93.02325581395348,13.953488372093023
8765_marine,45,30,41,7,75,91.11111111111111,15.555555555555555
8766_marine,53,39,46,14,92,86.79245283018868,26.41509433962264
8767_marine,89,41,67,34,130,75.28089887640449,38.20224719101123
8768_marine,85,40,64,32,125,75.29411764705883,37.64705882352941
8769_marine,81,28,60,30,109,74.07407407407408,37.03703703703704
8770_marine,78,26,57,31,104,73.07692307692307,39.743589743589745
8779_marine,68,25,49,27,93,72.05882352941177,39.705882352941174
8780_marine,74,28,54,30,102,72.97297297297297,40.54054054054054
8781_marine,78,36,56,32,114,71.7948717948718,41.02564102564102
8782_marine,84,46,62,34,130,73.80952380952381,40.476190476190474
8783_marine,84,44,62,34,128,73.80952380952381,40.476190476190474
8784_marine,85,38,62,35,123,72.94117647058823,41.17647058823529
8785_marine,82,40,62,32,122,75.60975609756098,39.02439024390244
8786_marine,54,37,48,13,91,88.88888888888889,24.074074074074073
8787_marine,52,40,47,11,92,90.38461538461539,21.153846153846153
8788_marine,51,39,47,10,90,92.15686274509804,19.607843137254903
8789_marine,49,42,45,10,91,91.83673469387756,20.408163265306122
8790_marine,49,46,45,10,95,91.83673469387756,20.408163265306122
8791_marine,51,46,47,10,97,92.15686274509804,19.607843137254903
8792_marine,48,56,45,9,104,93.75,18.75
8793_marine,52,56,49,9,108,94.23076923076923,17.307692307692307
8794_marine,56,52,51,11,108,91.07142857142857,19.642857142857142
8795_marine,61,44,53,15,105,86.88524590163934,24.59016393442623
8796_marine,117,64,91,60,181,77.77777777777779,51.28205128205128
8797_marine,130,60,101,73,190,77.6923076923077,56.15384615384615
8798_marine,127,48,98,73,175,77.16535433070865,57.48031496062992
8799_marine,131,55,104,74,186,79.38931297709924,56.48854961832062
8800_marine,119,49,93,66,168,78.15126050420169,55.46218487394958
8801_marine,115,43,90,65,158,78.26086956521739,56.52173913043478
8802_marine,114,42,90,66,156,78.94736842105263,57.89473684210527
8803_marine,112,38,87,66,150,77.67857142857143,58.92857142857143
8806_marine,122,56,95,69,178,77.8688524590164,56.557377049180324
8807_marine,124,62,99,66,186,79.83870967741935,53.2258064516129
8808_marine,56,52,49,18,108,87.5,32.142857142857146
8809_marine,49,54,43,13,103,87.75510204081633,26.53061224489796
8810_marine,44,46,40,11,90,90.9090909090909,25
8811_marine,43,42,39,10,85,90.69767441860465,23.25581395348837
8812_marine,41,42,38,9,83,92.6829268292683,21.951219512195124
8813_marine,41,36,38,9,77,92.6829268292683,21.951219512195124
8814_marine,37,30,34,9,67,91.8918918918919,24.324324324324326
8815_marine,35,20,32,9,55,91.42857142857143,25.71428571428571
8816_marine,35,16,32,9,51,91.42857142857143,25.71428571428571
8817_marine,37,18,34,9,55,91.8918918918919,24.324324324324326
8818_marine,37,16,34,9,53,91.8918918918919,24.324324324324326
8819_marine,38,16,35,8,54,92.10526315789474,21.052631578947366
8820_marine,38,16,35,8,54,92.10526315789474,21.052631578947366
8821_marine,38,18,35,8,56,92.10526315789474,21.052631578947366
8822_marine,38,18,35,8,56,92.10526315789474,21.052631578947366
8823_marine,40,24,37,8,64,92.5,20
8824_marine,42,24,39,8,66,92.85714285714286,19.047619047619047
8825_marine,45,26,40,8,71,88.88888888888889,17.77777777777778
8826_marine,49,32,43,9,81,87.75510204081633,18.367346938775512
8827_marine,51,34,45,9,85,88.23529411764706,17.647058823529413
8828_marine,52,37,45,10,89,86.53846153846155,19.230769230769234
8829_marine,77,48,68,12,125,88.31168831168831,15.584415584415584
8830_marine,82,52,70,15,134,85.36585365853658,18.29268292682927
8831_marine,197,74,147,109,271,74.61928934010153,55.32994923857868
8856_marine,175,42,122,126,217,69.71428571428572,72
8857_marine,203,66,127,132,269,62.5615763546798,65.02463054187191
8858_marine,122,43,89,85,165,72.95081967213115,69.67213114754098
8859_marine,34,14,27,13,48,79.41176470588235,38.23529411764706
8860_marine,175,65,106,115,240,60.57142857142858,65.71428571428571
8861_marine,184,67,113,119,251,61.41304347826087,64.67391304347827
8997_marine,102,53,58,66,155,56.86274509803921,64.70588235294117
8998_marine,75,43,42,43,118,56.00000000000001,57.333333333333336
9000_marine,109,64,70,51,173,64.22018348623854,46.788990825688074
9001_marine,41,24,36,10,65,87.8048780487805,24.390243902439025
9002_marine,41,24,37,11,65,90.2439024390244,26.82926829268293
9003_marine,42,24,37,12,66,88.09523809523809,28.57142857142857
9004_marine,44,25,38,14,69,86.36363636363636,31.818181818181817
9005_marine,100,56,68,46,156,68,46
9006_marine,100,56,68,46,156,68,46
9007_marine,104,59,72,48,163,69.23076923076923,46.15384615384615
9008_marine,113,61,77,53,174,68.14159292035397,46.902654867256636
9009_marine,48,26,41,17,74,85.41666666666666,35.41666666666667
9010_marine,45,25,39,14,70,86.66666666666667,31.11111111111111
9011_marine,45,25,38,14,70,84.44444444444444,31.11111111111111
9012_marine,95,41,67,55,136,70.52631578947368,57.89473684210527
9013_marine,38,28,34,10,66,89.47368421052632,26.31578947368421
9014_marine,143,75,87,75,218,60.83916083916085,52.44755244755245
9015_marine,142,73,85,75,215,59.859154929577464,52.816901408450704
9016_marine,143,73,83,77,216,58.04195804195804,53.84615384615385
9017_marine,145,75,83,81,220,57.24137931034483,55.86206896551724
9018_marine,141,77,79,78,218,56.02836879432624,55.319148936170215
9019_marine,152,86,82,87,238,53.94736842105263,57.23684210526315
9020_marine,150,84,80,85,234,53.333333333333336,56.666666666666664
9087_marine,61,28,34,33,89,55.73770491803278,54.09836065573771
9090_marine,62,32,37,31,94,59.67741935483871,50
9091_marine,64,35,39,33,99,60.9375,51.5625
9092_marine,66,32,41,35,98,62.121212121212125,53.03030303030303
9093_marine,65,34,39,34,99,60,52.307692307692314
9094_marine,58,23,40,31,81,68.96551724137932,53.44827586206896
9097_marine,57,21,38,30,78,66.66666666666666,52.63157894736842
9098_marine,56,24,37,29,80,66.07142857142857,51.78571428571429
9099_marine,58,24,38,30,82,65.51724137931035,51.724137931034484
9100_marine,56,24,38,29,80,67.85714285714286,51.78571428571429
9101_marine,16,16,14,3,32,87.5,18.75
9102_marine,60,26,38,28,86,63.33333333333333,46.666666666666664
9103_marine,62,26,40,28,88,64.51612903225806,45.16129032258064
9104_marine,62,28,40,28,90,64.51612903225806,45.16129032258064
9105_marine,63,26,40,29,89,63.49206349206349,46.03174603174603
9106_marine,65,26,42,29,91,64.61538461538461,44.61538461538462
9107_marine,64,26,42,28,90,65.625,43.75
9108_marine,63,26,41,29,89,65.07936507936508,46.03174603174603
9114_marine,69,30,46,25,99,66.66666666666666,36.231884057971016
9115_marine,74,39,50,28,113,67.56756756756756,37.83783783783784
9116_marine,71,39,49,29,110,69.01408450704226,40.845070422535215
9117_marine,75,37,52,26,112,69.33333333333334,34.66666666666667
9118_marine,40,25,35,7,65,87.5,17.5
9119_marine,38,23,35,5,61,92.10526315789474,13.157894736842104
9120_marine,40,25,37,5,65,92.5,12.5
9121_marine,41,28,37,6,69,90.2439024390244,14.634146341463413
9122_marine,40,28,37,6,68,92.5,15
9123_marine,40,26,37,6,66,92.5,15
9124_marine,41,28,38,6,69,92.6829268292683,14.634146341463413
9125_marine,45,30,41,7,75,91.11111111111111,15.555555555555555
9126_marine,47,38,42,11,85,89.36170212765957,23.404255319148938
9127_marine,51,41,44,16,92,86.27450980392157,31.372549019607842
9128_marine,94,42,71,37,136,75.53191489361703,39.361702127659576
9129_marine,88,40,67,35,128,76.13636363636364,39.77272727272727
9130_marine,81,32,60,32,113,74.07407407407408,39.50617283950617
9139_marine,72,27,52,31,99,72.22222222222221,43.05555555555556
9140_marine,76,46,56,30,122,73.68421052631578,39.473684210526315
9141_marine,74,39,59,31,113,79.72972972972973,41.891891891891895
9142_marine,52,41,46,13,93,88.46153846153845,25
9143_marine,51,41,45,12,92,88.23529411764706,23.52941176470588
9144_marine,49,43,45,10,92,91.83673469387756,20.408163265306122
9145_marine,49,40,45,10,89,91.83673469387756,20.408163265306122
9146_marine,49,38,45,10,87,91.83673469387756,20.408163265306122
9147_marine,46,38,42,9,84,91.30434782608695,19.565217391304348
9148_marine,44,32,40,9,76,90.9090909090909,20.454545454545457
9149_marine,42,28,39,9,70,92.85714285714286,21.428571428571427
9150_marine,42,34,39,9,76,92.85714285714286,21.428571428571427
9151_marine,48,40,45,9,88,93.75,18.75
9152_marine,48,54,45,9,102,93.75,18.75
9153_marine,48,56,45,9,104,93.75,18.75
9154_marine,54,58,50,10,112,92.5925925925926,18.51851851851852
9155_marine,59,55,52,14,114,88.13559322033898,23.728813559322035
9156_marine,123,73,97,62,196,78.86178861788618,50.40650406504065
9157_marine,127,71,100,68,198,78.74015748031496,53.54330708661418
9158_marine,147,57,115,87,204,78.2312925170068,59.183673469387756
9159_marine,138,48,108,83,186,78.26086956521739,60.14492753623188
9164_marine,119,72,94,61,191,78.99159663865547,51.26050420168067
9165_marine,131,69,105,71,200,80.1526717557252,54.19847328244275
9166_marine,135,72,108,72,207,80,53.333333333333336
9167_marine,127,87,102,64,214,80.31496062992126,50.39370078740157
9168_marine,64,72,57,18,136,89.0625,28.125
9169_marine,55,54,49,13,109,89.0909090909091,23.636363636363637
9170_marine,47,52,42,12,99,89.36170212765957,25.53191489361702
9171_marine,47,50,42,12,97,89.36170212765957,25.53191489361702
9172_marine,45,54,42,10,99,93.33333333333333,22.22222222222222
9173_marine,42,42,39,9,84,92.85714285714286,21.428571428571427
9174_marine,38,36,35,9,74,92.10526315789474,23.684210526315788
9175_marine,37,26,34,9,63,91.8918918918919,24.324324324324326
9176_marine,39,20,36,9,59,92.3076923076923,23.076923076923077
9177_marine,39,20,36,9,59,92.3076923076923,23.076923076923077
9178_marine,41,20,38,9,61,92.6829268292683,21.951219512195124
9179_marine,39,21,36,9,60,92.3076923076923,23.076923076923077
9180_marine,38,21,35,8,59,92.10526315789474,21.052631578947366
9181_marine,40,21,37,8,61,92.5,20
9182_marine,40,24,37,8,64,92.5,20
9183_marine,44,24,41,8,68,93.18181818181817,18.181818181818183
9184_marine,46,26,43,8,72,93.47826086956522,17.391304347826086
9185_marine,49,34,43,9,83,87.75510204081633,18.367346938775512
9186_marine,52,39,46,9,91,88.46153846153845,17.307692307692307
9187_marine,56,38,49,10,94,87.5,17.857142857142858
9188_marine,88,54,75,18,142,85.22727272727273,20.454545454545457
9189_marine,94,56,78,23,150,82.97872340425532,24.46808510638298
9190_marine,217,89,161,127,306,74.19354838709677,58.525345622119815
9203_marine,23,12,19,12,35,82.6086956521739,52.17391304347826
9216_marine,213,78,135,140,291,63.38028169014085,65.72769953051643
9220_marine,204,73,126,135,277,61.76470588235294,66.17647058823529
9221_marine,202,71,124,131,273,61.386138613861384,64.85148514851485
9355_marine,97,54,55,65,151,56.70103092783505,67.0103092783505
9356_marine,139,77,90,79,216,64.74820143884892,56.83453237410072
9357_marine,141,78,92,78,219,65.24822695035462,55.319148936170215
9358_marine,134,78,87,70,212,64.92537313432835,52.23880597014925
9359_marine,136,74,89,72,210,65.44117647058823,52.94117647058824
9360_marine,119,65,76,57,184,63.86554621848739,47.89915966386555
9361_marine,43,25,38,11,68,88.37209302325581,25.581395348837212
9362_marine,42,23,40,10,65,95.23809523809523,23.809523809523807
9363_marine,39,23,37,9,62,94.87179487179486,23.076923076923077
9364_marine,40,23,38,10,63,95,25
9365_marine,41,24,38,11,65,92.6829268292683,26.82926829268293
9366_marine,43,30,40,13,73,93.02325581395348,30.23255813953488
9367_marine,46,30,41,16,76,89.13043478260869,34.78260869565217
9368_marine,50,29,43,19,79,86,38
9369_marine,76,48,58,35,124,76.31578947368422,46.05263157894737
9370_marine,72,48,57,31,120,79.16666666666666,43.05555555555556
9371_marine,76,48,59,33,124,77.63157894736842,43.42105263157895
9372_marine,74,48,58,34,122,78.37837837837837,45.94594594594595
9373_marine,38,27,36,8,65,94.73684210526315,21.052631578947366
9374_marine,34,27,33,5,61,97.05882352941177,14.705882352941178
9375_marine,31,30,28,4,61,90.32258064516128,12.903225806451612
9376_marine,137,72,79,72,209,57.66423357664233,52.55474452554745
9377_marine,138,72,79,74,210,57.2463768115942,53.62318840579711
9378_marine,135,72,77,73,207,57.03703703703704,54.074074074074076
9379_marine,138,77,79,73,215,57.2463768115942,52.89855072463768
9380_marine,140,77,79,75,217,56.42857142857143,53.57142857142857
9447_marine,64,33,37,36,97,57.8125,56.25
9448_marine,66,34,37,37,100,56.060606060606055,56.060606060606055
9449_marine,68,34,38,39,102,55.88235294117647,57.35294117647059
9450_marine,73,36,44,42,109,60.273972602739725,57.534246575342465
9451_marine,65,36,39,34,101,60,52.307692307692314
9452_marine,64,32,39,33,96,60.9375,51.5625
9453_marine,57,23,38,33,80,66.66666666666666,57.89473684210527
9454_marine,56,21,38,32,77,67.85714285714286,57.14285714285714
9455_marine,55,21,37,31,76,67.27272727272727,56.36363636363636
9456_marine,58,22,38,32,80,65.51724137931035,55.172413793103445
9457_marine,57,22,38,31,79,66.66666666666666,54.385964912280706
9458_marine,60,24,41,33,84,68.33333333333333,55.00000000000001
9459_marine,55,24,37,29,79,67.27272727272727,52.72727272727272
9460_marine,57,25,39,30,82,68.42105263157895,52.63157894736842
9461_marine,18,16,16,5,34,88.88888888888889,27.77777777777778
9462_marine,43,21,33,25,64,76.74418604651163,58.139534883720934
9463_marine,46,23,35,26,69,76.08695652173914,56.52173913043478
9464_marine,44,21,33,24,65,75,54.54545454545454
9465_marine,19,16,17,4,35,89.47368421052632,21.052631578947366
9466_marine,21,16,19,4,37,90.47619047619048,19.047619047619047
9467_marine,48,25,35,24,73,72.91666666666666,50
9468_marine,69,29,45,33,98,65.21739130434783,47.82608695652174
9469_marine,64,28,41,28,92,64.0625,43.75
9470_marine,59,26,37,26,85,62.71186440677966,44.06779661016949
9472_marine,74,28,49,28,102,66.21621621621621,37.83783783783784
9473_marine,74,32,49,28,106,66.21621621621621,37.83783783783784
9474_marine,74,30,49,28,104,66.21621621621621,37.83783783783784
9475_marine,71,30,46,29,101,64.7887323943662,40.845070422535215
9476_marine,78,36,53,29,114,67.94871794871796,37.17948717948718
9477_marine,65,32,49,25,97,75.38461538461539,38.46153846153847
9478_marine,41,22,38,5,63,92.6829268292683,12.195121951219512
9479_marine,40,23,37,5,63,92.5,12.5
9480_marine,41,28,37,6,69,90.2439024390244,14.634146341463413
9481_marine,41,28,37,6,69,90.2439024390244,14.634146341463413
9482_marine,42,26,38,6,68,90.47619047619048,14.285714285714285
9483_marine,39,28,36,6,67,92.3076923076923,15.384615384615385
9484_marine,40,28,37,7,68,92.5,17.5
9485_marine,40,30,37,7,70,92.5,17.5
9486_marine,48,30,44,8,78,91.66666666666666,16.666666666666664
9487_marine,54,43,49,14,97,90.74074074074075,25.925925925925924
9488_marine,55,45,48,16,100,87.27272727272727,29.09090909090909
9489_marine,90,42,67,36,132,74.44444444444444,40
9490_marine,83,28,61,34,111,73.49397590361446,40.963855421686745
9491_marine,79,28,57,32,107,72.15189873417721,40.50632911392405
9498_marine,64,29,45,25,93,70.3125,39.0625
9499_marine,75,36,55,29,111,73.33333333333333,38.666666666666664
9500_marine,81,49,60,33,130,74.07407407407408,40.74074074074074
9501_marine,53,43,46,14,96,86.79245283018868,26.41509433962264
9502_marine,51,42,45,12,93,88.23529411764706,23.52941176470588
9503_marine,47,40,43,10,87,91.48936170212765,21.27659574468085
9504_marine,47,40,43,10,87,91.48936170212765,21.27659574468085
9505_marine,44,32,40,9,76,90.9090909090909,20.454545454545457
9506_marine,39,29,36,8,68,92.3076923076923,20.51282051282051
9507_marine,41,20,38,8,61,92.6829268292683,19.51219512195122
9508_marine,41,19,38,8,60,92.6829268292683,19.51219512195122
9509_marine,40,21,37,9,61,92.5,22.5
9510_marine,42,29,39,9,71,92.85714285714286,21.428571428571427
9511_marine,44,33,41,9,77,93.18181818181817,20.454545454545457
9512_marine,48,43,45,9,91,93.75,18.75
9513_marine,46,55,43,9,101,93.47826086956522,19.565217391304348
9514_marine,51,63,48,9,114,94.11764705882352,17.647058823529413
9515_marine,54,67,49,11,121,90.74074074074075,20.37037037037037
9516_marine,61,69,54,16,130,88.52459016393442,26.229508196721312
9517_marine,75,76,63,25,151,84,33.33333333333333
9518_marine,138,90,108,75,228,78.26086956521739,54.347826086956516
9519_marine,145,98,113,82,243,77.93103448275862,56.55172413793104
9520_marine,147,98,117,78,245,79.59183673469387,53.06122448979592
9521_marine,138,96,111,74,234,80.43478260869566,53.62318840579711
9522_marine,131,96,105,66,227,80.1526717557252,50.38167938931297
9523_marine,142,97,114,75,239,80.28169014084507,52.816901408450704
9524_marine,137,97,108,70,234,78.83211678832117,51.09489051094891
9525_marine,77,81,67,22,158,87.01298701298701,28.57142857142857
9526_marine,74,79,65,21,153,87.83783783783784,28.37837837837838
9527_marine,68,75,60,18,143,88.23529411764706,26.47058823529412
9528_marine,57,66,52,12,123,91.22807017543859,21.052631578947366
9529_marine,53,54,48,12,107,90.56603773584906,22.641509433962266
9530_marine,52,56,48,11,108,92.3076923076923,21.153846153846153
9531_marine,52,58,48,11,110,92.3076923076923,21.153846153846153
9532_marine,52,60,48,11,112,92.3076923076923,21.153846153846153
9533_marine,66,73,59,15,139,89.39393939393939,22.727272727272727
9534_marine,67,71,61,14,138,91.04477611940298,20.8955223880597
9535_marine,64,69,58,13,133,90.625,20.3125
9536_marine,44,50,41,9,94,93.18181818181817,20.454545454545457
9537_marine,48,39,45,9,87,93.75,18.75
9538_marine,46,37,43,9,83,93.47826086956522,19.565217391304348
9539_marine,45,33,42,9,78,93.33333333333333,20
9540_marine,47,29,44,9,76,93.61702127659575,19.148936170212767
9541_marine,46,29,43,8,75,93.47826086956522,17.391304347826086
9542_marine,47,33,43,8,80,91.48936170212765,17.02127659574468
9543_marine,47,39,43,8,86,91.48936170212765,17.02127659574468
9544_marine,54,39,46,10,93,85.18518518518519,18.51851851851852
9545_marine,85,59,75,10,144,88.23529411764706,11.76470588235294
9546_marine,92,59,78,18,151,84.78260869565217,19.565217391304348
9547_marine,99,56,83,25,155,83.83838383838383,25.252525252525253
9577_marine,113,36,81,86,149,71.68141592920354,76.10619469026548
9579_marine,31,14,27,12,45,87.09677419354838,38.70967741935484
9719_marine,127,75,83,66,202,65.35433070866141,51.96850393700787
9720_marine,124,76,82,62,200,66.12903225806451,50
9721_marine,50,32,40,14,82,80,28.000000000000004
9722_marine,44,27,41,9,71,93.18181818181817,20.454545454545457
9723_marine,43,27,40,10,70,93.02325581395348,23.25581395348837
9724_marine,40,28,39,7,68,97.5,17.5
9725_marine,39,28,38,8,67,97.43589743589743,20.51282051282051
9726_marine,39,28,38,8,67,97.43589743589743,20.51282051282051
9727_marine,39,29,37,7,68,94.87179487179486,17.94871794871795
9728_marine,41,31,40,9,72,97.5609756097561,21.951219512195124
9729_marine,42,30,40,10,72,95.23809523809523,23.809523809523807
9730_marine,43,30,41,11,73,95.34883720930233,25.581395348837212
9731_marine,72,50,57,30,122,79.16666666666666,41.66666666666667
9732_marine,46,30,42,15,76,91.30434782608695,32.608695652173914
9733_marine,38,29,36,7,67,94.73684210526315,18.421052631578945
9734_marine,87,50,61,53,137,70.11494252873564,60.91954022988506
9735_marine,136,74,81,69,210,59.55882352941176,50.73529411764706
9736_marine,137,74,81,70,211,59.12408759124088,51.09489051094891
9807_marine,76,34,40,46,110,52.63157894736842,60.526315789473685
9808_marine,74,34,41,42,108,55.4054054054054,56.75675675675676
9809_marine,70,36,39,41,106,55.714285714285715,58.57142857142858
9810_marine,70,32,40,39,102,57.14285714285714,55.714285714285715
9811_marine,14,13,13,3,27,92.85714285714286,21.428571428571427
9812_marine,12,14,12,1,26,100,8.333333333333332
9813_marine,13,14,12,2,27,92.3076923076923,15.384615384615385
9814_marine,13,13,12,2,26,92.3076923076923,15.384615384615385
9815_marine,14,13,12,3,27,85.71428571428571,21.428571428571427
9816_marine,15,13,13,3,28,86.66666666666667,20
9817_marine,49,16,34,28,65,69.38775510204081,57.14285714285714
9818_marine,48,18,34,27,66,70.83333333333334,56.25
9819_marine,48,19,34,27,67,70.83333333333334,56.25
9820_marine,39,19,26,21,58,66.66666666666666,53.84615384615385
9821_marine,42,19,29,22,61,69.04761904761905,52.38095238095239
9822_marine,71,30,39,36,101,54.929577464788736,50.70422535211267
9823_marine,72,30,40,35,102,55.55555555555556,48.61111111111111
9824_marine,71,30,39,35,101,54.929577464788736,49.29577464788733
9825_marine,70,32,38,34,102,54.285714285714285,48.57142857142857
9826_marine,71,32,41,34,103,57.74647887323944,47.88732394366197
9827_marine,69,32,39,34,101,56.52173913043478,49.275362318840585
9828_marine,67,31,38,33,98,56.71641791044776,49.25373134328358
9829_marine,64,29,41,29,93,64.0625,45.3125
9830_marine,63,29,40,28,92,63.49206349206349,44.44444444444444
9831_marine,66,31,42,30,97,63.63636363636363,45.45454545454545
9832_marine,70,30,46,29,100,65.71428571428571,41.42857142857143
9833_marine,74,32,50,29,106,67.56756756756756,39.189189189189186
9834_marine,79,32,53,33,111,67.08860759493672,41.77215189873418
9835_marine,79,34,53,33,113,67.08860759493672,41.77215189873418
9836_marine,86,38,60,33,124,69.76744186046511,38.372093023255815
9837_marine,68,33,52,27,101,76.47058823529412,39.705882352941174
9838_marine,41,24,38,5,65,92.6829268292683,12.195121951219512
9839_marine,41,28,37,6,69,90.2439024390244,14.634146341463413
9840_marine,43,28,39,6,71,90.69767441860465,13.953488372093023
9841_marine,42,28,38,6,70,90.47619047619048,14.285714285714285
9842_marine,42,30,38,6,72,90.47619047619048,14.285714285714285
9843_marine,37,26,33,7,63,89.1891891891892,18.91891891891892
9844_marine,38,20,35,7,58,92.10526315789474,18.421052631578945
9845_marine,40,22,37,7,62,92.5,17.5
9846_marine,43,26,39,8,69,90.69767441860465,18.6046511627907
9847_marine,47,33,42,9,80,89.36170212765957,19.148936170212767
9848_marine,53,43,48,13,96,90.56603773584906,24.528301886792452
9849_marine,54,43,47,15,97,87.03703703703704,27.77777777777778
9850_marine,88,49,65,35,137,73.86363636363636,39.77272727272727
9851_marine,85,35,63,34,120,74.11764705882354,40
9852_marine,79,28,57,30,107,72.15189873417721,37.9746835443038
9858_marine,69,28,50,27,97,72.46376811594203,39.130434782608695
9859_marine,76,44,55,30,120,72.36842105263158,39.473684210526315
9860_marine,51,43,44,14,94,86.27450980392157,27.450980392156865
9861_marine,49,40,43,12,89,87.75510204081633,24.489795918367346
9862_marine,43,32,39,10,75,90.69767441860465,23.25581395348837
9863_marine,42,32,38,9,74,90.47619047619048,21.428571428571427
9864_marine,42,30,38,9,72,90.47619047619048,21.428571428571427
9865_marine,39,22,36,8,61,92.3076923076923,20.51282051282051
9866_marine,41,18,38,8,59,92.6829268292683,19.51219512195122
9867_marine,39,16,36,8,55,92.3076923076923,20.51282051282051
9868_marine,41,19,38,8,60,92.6829268292683,19.51219512195122
9869_marine,40,23,37,9,63,92.5,22.5
9870_marine,39,29,36,9,68,92.3076923076923,23.076923076923077
9871_marine,39,33,36,9,72,92.3076923076923,23.076923076923077
9872_marine,43,41,40,9,84,93.02325581395348,20.930232558139537
9873_marine,43,42,40,9,85,93.02325581395348,20.930232558139537
9874_marine,43,52,40,9,95,93.02325581395348,20.930232558139537
9875_marine,45,62,42,9,107,93.33333333333333,20
9876_marine,48,64,43,10,112,89.58333333333334,20.833333333333336
9877_marine,59,74,53,12,133,89.83050847457628,20.33898305084746
9878_marine,64,70,56,17,134,87.5,26.5625
9879_marine,67,74,60,17,141,89.55223880597015,25.37313432835821
9880_marine,73,78,63,20,151,86.3013698630137,27.397260273972602
9881_marine,74,75,65,22,149,87.83783783783784,29.72972972972973
9882_marine,73,75,64,21,148,87.67123287671232,28.767123287671232
9883_marine,70,75,62,19,145,88.57142857142857,27.142857142857142
9884_marine,64,75,57,16,139,89.0625,25
9885_marine,55,63,48,14,118,87.27272727272727,25.454545454545453
9886_marine,56,66,51,11,122,91.07142857142857,19.642857142857142
9887_marine,55,64,51,10,119,92.72727272727272,18.181818181818183
9888_marine,54,62,51,9,116,94.44444444444444,16.666666666666664
9889_marine,54,64,51,9,118,94.44444444444444,16.666666666666664
9890_marine,55,62,52,10,117,94.54545454545455,18.181818181818183
9891_marine,54,66,50,11,120,92.5925925925926,20.37037037037037
9892_marine,73,75,64,16,148,87.67123287671232,21.91780821917808
9893_marine,131,86,101,58,217,77.09923664122137,44.274809160305345
9894_marine,129,86,99,58,215,76.74418604651163,44.96124031007752
9895_marine,75,75,65,16,150,86.66666666666667,21.333333333333336
9896_marine,65,70,59,10,135,90.76923076923077,15.384615384615385
9897_marine,52,57,47,9,109,90.38461538461539,17.307692307692307
9898_marine,55,57,49,10,112,89.0909090909091,18.181818181818183
9899_marine,55,51,49,10,106,89.0909090909091,18.181818181818183
9900_marine,54,43,47,10,97,87.03703703703704,18.51851851851852
9901_marine,57,41,50,11,98,87.71929824561403,19.298245614035086
9902_marine,54,39,48,9,93,88.88888888888889,16.666666666666664
9903_marine,56,43,50,9,99,89.28571428571429,16.071428571428573
9904_marine,101,65,82,19,166,81.1881188118812,18.81188118811881
9905_marine,247,102,180,133,349,72.8744939271255,53.84615384615385
9920_marine,22,13,19,10,35,86.36363636363636,45.45454545454545
9921_marine,156,49,109,115,205,69.87179487179486,73.71794871794873
10064_marine,154,72,95,99,226,61.68831168831169,64.28571428571429
10065_marine,159,74,98,102,233,61.63522012578616,64.15094339622641
10066_marine,150,75,93,92,225,62,61.33333333333333
10076_marine,129,81,83,64,210,64.34108527131784,49.6124031007752
10077_marine,132,83,86,63,215,65.15151515151516,47.72727272727273
10078_marine,129,81,85,60,210,65.89147286821705,46.51162790697674
10079_marine,128,81,83,63,209,64.84375,49.21875
10080_marine,132,82,85,67,214,64.39393939393939,50.75757575757576
10081_marine,48,35,42,9,83,87.5,18.75
10082_marine,47,33,43,8,80,91.48936170212765,17.02127659574468
10083_marine,44,31,40,7,75,90.9090909090909,15.909090909090908
10084_marine,42,27,40,7,69,95.23809523809523,16.666666666666664
10085_marine,41,27,40,6,68,97.5609756097561,14.634146341463413
10086_marine,41,29,40,6,70,97.5609756097561,14.634146341463413
10087_marine,46,28,42,11,74,91.30434782608695,23.91304347826087
10088_marine,45,28,42,10,73,93.33333333333333,22.22222222222222
10089_marine,39,29,38,6,68,97.43589743589743,15.384615384615385
10090_marine,38,31,37,6,69,97.36842105263158,15.789473684210526
10091_marine,38,30,37,6,68,97.36842105263158,15.789473684210526
10092_marine,37,30,36,7,67,97.2972972972973,18.91891891891892
10093_marine,37,31,36,5,68,97.2972972972973,13.513513513513514
10094_marine,137,73,85,69,210,62.04379562043796,50.36496350364964
10095_marine,140,74,87,72,214,62.142857142857146,51.42857142857142
10096_marine,102,41,51,61,143,50,59.80392156862745
10109_marine,196,122,99,113,318,50.51020408163265,57.6530612244898
10166_marine,76,36,37,47,112,48.68421052631579,61.8421052631579
10167_marine,78,36,39,48,114,50,61.53846153846154
10168_marine,49,20,31,38,69,63.26530612244898,77.55102040816327
10169_marine,11,11,9,4,22,81.81818181818183,36.36363636363637
10170_marine,8,11,8,1,19,100,12.5
10171_marine,10,11,10,1,21,100,10
10172_marine,10,12,10,1,22,100,10
10173_marine,10,12,10,1,22,100,10
10174_marine,12,10,12,1,22,100,8.333333333333332
10175_marine,13,11,12,2,24,92.3076923076923,15.384615384615385
10176_marine,13,14,12,2,27,92.3076923076923,15.384615384615385
10177_marine,14,14,13,2,28,92.85714285714286,14.285714285714285
10178_marine,14,14,13,2,28,92.85714285714286,14.285714285714285
10179_marine,14,13,13,2,27,92.85714285714286,14.285714285714285
10180_marine,36,18,23,20,54,63.888888888888886,55.55555555555556
10181_marine,39,17,25,22,56,64.1025641025641,56.41025641025641
10182_marine,67,28,35,35,95,52.23880597014925,52.23880597014925
10183_marine,67,28,36,35,95,53.73134328358209,52.23880597014925
10188_marine,66,31,37,32,97,56.060606060606055,48.484848484848484
10189_marine,68,33,39,34,101,57.35294117647059,50
10190_marine,69,33,39,35,102,56.52173913043478,50.72463768115942
10191_marine,72,35,41,37,107,56.94444444444444,51.388888888888886
10192_marine,27,19,24,7,46,88.88888888888889,25.925925925925924
10193_marine,29,19,26,7,48,89.65517241379311,24.137931034482758
10194_marine,79,31,54,32,110,68.35443037974683,40.50632911392405
10195_marine,78,39,53,31,117,67.94871794871796,39.743589743589745
10196_marine,65,37,52,26,102,80,40
10197_marine,43,31,40,7,74,93.02325581395348,16.27906976744186
10198_marine,44,28,40,6,72,90.9090909090909,13.636363636363635
10199_marine,44,30,40,6,74,90.9090909090909,13.636363636363635
10200_marine,42,30,38,6,72,90.47619047619048,14.285714285714285
10201_marine,40,32,36,6,72,90,15
10202_marine,39,22,35,7,61,89.74358974358975,17.94871794871795
10203_marine,39,18,35,7,57,89.74358974358975,17.94871794871795
10204_marine,41,14,37,7,55,90.2439024390244,17.073170731707318
10205_marine,40,12,37,7,52,92.5,17.5
10206_marine,41,14,38,8,55,92.6829268292683,19.51219512195122
10207_marine,42,13,38,9,55,90.47619047619048,21.428571428571427
10208_marine,46,21,41,10,67,89.13043478260869,21.73913043478261
10209_marine,52,37,47,14,89,90.38461538461539,26.923076923076923
10210_marine,56,43,49,17,99,87.5,30.357142857142854
10211_marine,94,48,71,39,142,75.53191489361703,41.48936170212766
10212_marine,87,38,67,34,125,77.01149425287356,39.08045977011494
10213_marine,79,28,59,32,107,74.68354430379746,40.50632911392405
10214_marine,76,28,57,29,104,75,38.15789473684211
10215_marine,77,38,58,28,115,75.32467532467533,36.36363636363637
10218_marine,73,42,53,27,115,72.6027397260274,36.986301369863014
10219_marine,51,43,44,14,94,86.27450980392157,27.450980392156865
10220_marine,49,42,43,12,91,87.75510204081633,24.489795918367346
10221_marine,48,38,43,11,86,89.58333333333334,22.916666666666664
10222_marine,40,28,36,9,68,90,22.5
10223_marine,39,20,36,8,59,92.3076923076923,20.51282051282051
10224_marine,41,20,38,8,61,92.6829268292683,19.51219512195122
10225_marine,41,16,38,8,57,92.6829268292683,19.51219512195122
10226_marine,37,16,34,8,53,91.8918918918919,21.62162162162162
10227_marine,38,19,35,8,57,92.10526315789474,21.052631578947366
10228_marine,38,18,35,8,56,92.10526315789474,21.052631578947366
10229_marine,38,24,35,8,62,92.10526315789474,21.052631578947366
10230_marine,39,32,36,9,71,92.3076923076923,23.076923076923077
10231_marine,39,40,36,9,79,92.3076923076923,23.076923076923077
10232_marine,38,50,36,8,88,94.73684210526315,21.052631578947366
10233_marine,40,52,38,8,92,95,20
10234_marine,42,54,40,8,96,95.23809523809523,19.047619047619047
10235_marine,42,52,40,8,94,95.23809523809523,19.047619047619047
10236_marine,48,42,45,8,90,93.75,16.666666666666664
10237_marine,48,44,45,8,92,93.75,16.666666666666664
10238_marine,48,42,45,8,90,93.75,16.666666666666664
10239_marine,48,48,45,8,96,93.75,16.666666666666664
10240_marine,44,46,41,8,90,93.18181818181817,18.181818181818183
10241_marine,48,48,44,9,96,91.66666666666666,18.75
10242_marine,47,44,43,10,91,91.48936170212765,21.27659574468085
10243_marine,47,42,43,10,89,91.48936170212765,21.27659574468085
10244_marine,47,30,43,10,77,91.48936170212765,21.27659574468085
10245_marine,46,36,43,9,82,93.47826086956522,19.565217391304348
10246_marine,50,52,47,9,102,94,18
10247_marine,54,52,51,9,106,94.44444444444444,16.666666666666664
10248_marine,54,56,51,9,110,94.44444444444444,16.666666666666664
10249_marine,56,68,51,9,124,91.07142857142857,16.071428571428573
10250_marine,56,70,51,9,126,91.07142857142857,16.071428571428573
10251_marine,64,84,59,9,148,92.1875,14.0625
10252_marine,75,85,66,16,160,88,21.333333333333336
10253_marine,86,89,71,20,175,82.55813953488372,23.25581395348837
10254_marine,139,78,107,62,217,76.97841726618705,44.60431654676259
10255_marine,79,80,70,15,159,88.60759493670885,18.9873417721519
10256_marine,70,76,64,11,146,91.42857142857143,15.714285714285714
10257_marine,61,67,52,14,128,85.24590163934425,22.950819672131146
10258_marine,100,82,84,18,182,84,18
10259_marine,106,78,87,21,184,82.0754716981132,19.81132075471698
10260_marine,106,74,87,21,180,82.0754716981132,19.81132075471698
10261_marine,97,63,82,17,160,84.5360824742268,17.525773195876287
10262_marine,88,56,78,10,144,88.63636363636364,11.363636363636363
10263_marine,86,58,78,8,144,90.69767441860465,9.30232558139535
10264_marine,110,70,89,21,180,80.9090909090909,19.090909090909093
10279_marine,22,15,18,11,37,81.81818181818183,50
10280_marine,17,13,15,8,30,88.23529411764706,47.05882352941176
10281_marine,23,15,18,11,38,78.26086956521739,47.82608695652174
10417_marine,157,76,98,99,233,62.42038216560509,63.05732484076433
10418_marine,151,76,93,96,227,61.58940397350994,63.576158940397356
10419_marine,148,74,91,93,222,61.48648648648649,62.83783783783784
10420_marine,149,75,93,94,224,62.41610738255034,63.08724832214765
10421_marine,148,72,92,94,220,62.16216216216216,63.51351351351351
10422_marine,149,70,92,95,219,61.74496644295302,63.758389261744966
10423_marine,151,70,92,97,221,60.9271523178808,64.23841059602648
10424_marine,158,78,96,103,236,60.75949367088608,65.18987341772153
10425_marine,143,62,86,90,205,60.13986013986013,62.93706293706294
10433_marine,135,77,82,71,212,60.74074074074074,52.59259259259259
10434_marine,131,78,80,68,209,61.06870229007634,51.908396946564885
10435_marine,130,82,81,67,212,62.30769230769231,51.53846153846153
10436_marine,130,78,81,67,208,62.30769230769231,51.53846153846153
10437_marine,54,37,44,15,91,81.48148148148148,27.77777777777778
10438_marine,53,36,44,14,89,83.01886792452831,26.41509433962264
10439_marine,54,36,45,15,90,83.33333333333334,27.77777777777778
10440_marine,52,35,44,13,87,84.61538461538461,25
10441_marine,49,34,44,7,83,89.79591836734694,14.285714285714285
10442_marine,51,34,46,9,85,90.19607843137256,17.647058823529413
10443_marine,46,32,42,8,78,91.30434782608695,17.391304347826086
10444_marine,43,32,40,6,75,93.02325581395348,13.953488372093023
10445_marine,42,28,40,6,70,95.23809523809523,14.285714285714285
10446_marine,42,30,40,5,72,95.23809523809523,11.904761904761903
10447_marine,57,37,49,15,94,85.96491228070175,26.31578947368421
10448_marine,55,37,46,15,92,83.63636363636363,27.27272727272727
10449_marine,45,29,41,9,74,91.11111111111111,20
10450_marine,40,29,39,5,69,97.5,12.5
10451_marine,38,31,37,5,69,97.36842105263158,13.157894736842104
10452_marine,41,33,40,9,74,97.5609756097561,21.951219512195124
10453_marine,68,48,57,30,116,83.82352941176471,44.11764705882353
10454_marine,68,48,57,31,116,83.82352941176471,45.588235294117645
10455_marine,146,77,91,74,223,62.328767123287676,50.68493150684932
10456_marine,138,76,86,70,214,62.31884057971014,50.72463768115942
10457_marine,97,43,47,58,140,48.45360824742268,59.79381443298969
10458_marine,144,87,84,75,231,58.333333333333336,52.083333333333336
10459_marine,94,48,43,60,142,45.744680851063826,63.829787234042556
10467_marine,132,71,55,89,203,41.66666666666667,67.42424242424242
10468_marine,205,127,105,119,332,51.21951219512195,58.048780487804876
10469_marine,218,135,109,129,353,50,59.174311926605505
10470_marine,192,119,96,113,311,50,58.854166666666664
10526_marine,94,42,44,61,136,46.808510638297875,64.8936170212766
10527_marine,12,11,9,5,23,75,41.66666666666667
10528_marine,11,11,9,4,22,81.81818181818183,36.36363636363637
10529_marine,9,11,8,2,20,88.88888888888889,22.22222222222222
10530_marine,8,10,8,1,18,100,12.5
10531_marine,8,10,8,1,18,100,12.5
10532_marine,8,10,8,1,18,100,12.5
10533_marine,8,8,8,1,16,100,12.5
10534_marine,8,8,8,1,16,100,12.5
10535_marine,8,8,8,1,16,100,12.5
10536_marine,9,8,8,2,17,88.88888888888889,22.22222222222222
10537_marine,11,10,10,2,21,90.9090909090909,18.181818181818183
10538_marine,11,12,10,2,23,90.9090909090909,18.181818181818183
10539_marine,12,10,11,2,22,91.66666666666666,16.666666666666664
10540_marine,12,11,11,2,23,91.66666666666666,16.666666666666664
10541_marine,14,11,11,4,25,78.57142857142857,28.57142857142857
10542_marine,64,29,32,35,93,50,54.6875
10543_marine,65,31,34,36,96,52.307692307692314,55.38461538461539
10550_marine,68,37,39,35,105,57.35294117647059,51.470588235294116
10551_marine,72,35,41,37,107,56.94444444444444,51.388888888888886
10552_marine,52,24,38,29,76,73.07692307692307,55.769230769230774
10553_marine,54,24,40,29,78,74.07407407407408,53.70370370370371
10554_marine,32,19,30,6,51,93.75,18.75
10555_marine,96,48,59,46,144,61.458333333333336,47.91666666666667
10556_marine,107,54,70,48,161,65.42056074766354,44.85981308411215
10557_marine,49,29,45,9,78,91.83673469387756,18.367346938775512
10558_marine,49,33,45,6,82,91.83673469387756,12.244897959183673
10559_marine,51,35,47,6,86,92.15686274509804,11.76470588235294
10560_marine,49,38,45,7,87,91.83673469387756,14.285714285714285
10561_marine,39,28,35,7,67,89.74358974358975,17.94871794871795
10562_marine,40,18,36,8,58,90,20
10563_marine,40,16,36,8,56,90,20
10564_marine,42,14,38,8,56,90.47619047619048,19.047619047619047
10565_marine,41,16,38,8,57,92.6829268292683,19.51219512195122
10566_marine,41,14,38,8,55,92.6829268292683,19.51219512195122
10567_marine,41,13,38,8,54,92.6829268292683,19.51219512195122
10568_marine,40,13,36,9,53,90,22.5
10569_marine,47,17,42,11,64,89.36170212765957,23.404255319148938
10570_marine,50,30,45,14,80,90,28.000000000000004
10571_marine,57,43,50,17,100,87.71929824561403,29.82456140350877
10572_marine,90,48,69,36,138,76.66666666666667,40
10573_marine,90,48,69,36,138,76.66666666666667,40
10574_marine,87,46,67,33,133,77.01149425287356,37.93103448275862
10575_marine,83,40,63,33,123,75.90361445783132,39.75903614457831
10576_marine,76,30,57,30,106,75,39.473684210526315
10577_marine,75,32,55,29,107,73.33333333333333,38.666666666666664
10578_marine,75,50,54,29,125,72,38.666666666666664
10579_marine,50,44,44,13,94,88,26
10580_marine,44,34,39,11,78,88.63636363636364,25
10581_marine,40,26,36,9,66,90,22.5
10582_marine,39,18,36,8,57,92.3076923076923,20.51282051282051
10583_marine,41,16,38,8,57,92.6829268292683,19.51219512195122
10584_marine,39,16,36,8,55,92.3076923076923,20.51282051282051
10585_marine,38,16,35,8,54,92.10526315789474,21.052631578947366
10586_marine,39,21,36,8,60,92.3076923076923,20.51282051282051
10587_marine,39,16,36,8,55,92.3076923076923,20.51282051282051
10588_marine,38,24,36,7,62,94.73684210526315,18.421052631578945
10589_marine,38,32,36,7,70,94.73684210526315,18.421052631578945
10590_marine,38,40,36,7,78,94.73684210526315,18.421052631578945
10591_marine,39,52,37,8,91,94.87179487179486,20.51282051282051
10592_marine,39,52,37,8,91,94.87179487179486,20.51282051282051
10593_marine,39,52,37,8,91,94.87179487179486,20.51282051282051
10594_marine,41,44,39,8,85,95.1219512195122,19.51219512195122
10595_marine,42,38,39,8,80,92.85714285714286,19.047619047619047
10596_marine,44,38,41,8,82,93.18181818181817,18.181818181818183
10597_marine,45,36,42,8,81,93.33333333333333,17.77777777777778
10598_marine,45,38,42,8,83,93.33333333333333,17.77777777777778
10599_marine,45,34,42,8,79,93.33333333333333,17.77777777777778
10600_marine,45,32,42,8,77,93.33333333333333,17.77777777777778
10601_marine,45,26,42,8,71,93.33333333333333,17.77777777777778
10602_marine,44,26,41,8,70,93.18181818181817,18.181818181818183
10603_marine,44,30,41,8,74,93.18181818181817,18.181818181818183
10604_marine,43,38,40,8,81,93.02325581395348,18.6046511627907
10605_marine,44,48,41,9,92,93.18181818181817,20.454545454545457
10606_marine,52,56,47,9,108,90.38461538461539,17.307692307692307
10607_marine,54,64,49,9,118,90.74074074074075,16.666666666666664
10608_marine,54,64,49,9,118,90.74074074074075,16.666666666666664
10609_marine,58,72,53,9,130,91.37931034482759,15.517241379310345
10610_marine,62,74,57,9,136,91.93548387096774,14.516129032258066
10611_marine,68,86,63,9,154,92.64705882352942,13.23529411764706
10612_marine,71,84,65,10,155,91.54929577464789,14.084507042253522
10613_marine,83,90,75,14,173,90.36144578313254,16.867469879518072
10614_marine,120,105,108,16,225,90,13.333333333333334
10615_marine,126,101,112,17,227,88.88888888888889,13.492063492063492
10616_marine,128,99,113,17,227,88.28125,13.28125
10617_marine,125,91,107,19,216,85.6,15.2
10618_marine,168,91,136,59,259,80.95238095238095,35.11904761904761
10619_marine,203,91,158,94,294,77.83251231527095,46.30541871921182
10620_marine,192,86,149,87,278,77.60416666666666,45.3125
10621_marine,101,59,86,17,160,85.14851485148515,16.831683168316832
10622_marine,90,52,80,10,142,88.88888888888889,11.11111111111111
10623_marine,88,60,80,8,148,90.9090909090909,9.090909090909092
10624_marine,113,71,92,21,184,81.41592920353983,18.58407079646018
10775_marine,154,84,95,98,238,61.68831168831169,63.63636363636363
10776_marine,159,79,99,102,238,62.264150943396224,64.15094339622641
10777_marine,154,77,97,98,231,62.98701298701299,63.63636363636363
10778_marine,36,24,32,9,60,88.88888888888889,25
10779_marine,37,26,32,10,63,86.48648648648648,27.027027027027028
10780_marine,147,75,92,94,222,62.585034013605444,63.94557823129252
10781_marine,155,76,96,101,231,61.935483870967744,65.16129032258064
10782_marine,171,81,107,114,252,62.57309941520468,66.66666666666666
10783_marine,158,67,99,102,225,62.65822784810127,64.55696202531645
10784_marine,180,93,114,114,273,63.33333333333333,63.33333333333333
10785_marine,161,85,102,98,246,63.35403726708074,60.86956521739131
10786_marine,162,83,104,97,245,64.19753086419753,59.876543209876544
10787_marine,163,94,102,94,257,62.57668711656442,57.668711656441715
10788_marine,154,90,99,86,244,64.28571428571429,55.84415584415584
10789_marine,151,90,95,84,241,62.913907284768214,55.62913907284768
10790_marine,153,87,97,84,240,63.39869281045751,54.90196078431373
10791_marine,146,80,90,79,226,61.64383561643836,54.109589041095894
10792_marine,149,77,92,81,226,61.74496644295302,54.36241610738255
10793_marine,145,78,88,78,223,60.689655172413794,53.79310344827586
10794_marine,56,37,45,16,93,80.35714285714286,28.57142857142857
10795_marine,52,36,45,12,88,86.53846153846155,23.076923076923077
10796_marine,49,31,42,11,80,85.71428571428571,22.448979591836736
10797_marine,45,31,39,9,76,86.66666666666667,20
10798_marine,42,32,36,8,74,85.71428571428571,19.047619047619047
10799_marine,46,32,40,8,78,86.95652173913044,17.391304347826086
10800_marine,47,32,42,7,79,89.36170212765957,14.893617021276595
10801_marine,46,34,42,7,80,91.30434782608695,15.217391304347828
10802_marine,51,34,47,8,85,92.15686274509804,15.686274509803921
10803_marine,52,34,48,9,86,92.3076923076923,17.307692307692307
10804_marine,49,34,44,7,83,89.79591836734694,14.285714285714285
10805_marine,47,32,42,7,79,89.36170212765957,14.893617021276595
10806_marine,47,34,43,7,81,91.48936170212765,14.893617021276595
10807_marine,51,31,47,12,82,92.15686274509804,23.52941176470588
10808_marine,52,29,47,13,81,90.38461538461539,25
10809_marine,50,29,46,11,79,92,22
10810_marine,45,29,43,7,74,95.55555555555556,15.555555555555555
10811_marine,45,29,43,7,74,95.55555555555556,15.555555555555555
10812_marine,44,31,42,8,75,95.45454545454545,18.181818181818183
10813_marine,69,51,57,30,120,82.6086956521739,43.47826086956522
10814_marine,71,48,59,31,119,83.09859154929578,43.66197183098591
10815_marine,72,48,61,30,120,84.72222222222221,41.66666666666667
10816_marine,145,78,93,71,223,64.13793103448275,48.96551724137931
10817_marine,140,76,88,67,216,62.857142857142854,47.85714285714286
10818_marine,149,89,93,76,238,62.41610738255034,51.006711409395976
10819_marine,141,87,88,71,228,62.4113475177305,50.35460992907801
10820_marine,143,84,86,73,227,60.13986013986013,51.048951048951054
10822_marine,151,98,84,81,249,55.62913907284768,53.64238410596026
10824_marine,116,64,51,81,180,43.96551724137931,69.82758620689656
10826_marine,190,124,102,108,314,53.68421052631579,56.84210526315789
10827_marine,210,129,111,121,339,52.85714285714286,57.61904761904761
10828_marine,210,126,111,121,336,52.85714285714286,57.61904761904761
10829_marine,220,131,114,130,351,51.81818181818182,59.09090909090909
10830_marine,223,129,120,127,352,53.81165919282511,56.95067264573991
10831_marine,224,128,122,128,352,54.46428571428571,57.14285714285714
10832_marine,223,130,122,128,353,54.7085201793722,57.399103139013455
10833_marine,187,95,118,119,282,63.101604278074866,63.63636363636363
10834_marine,169,83,108,102,252,63.905325443786985,60.35502958579882
10835_marine,89,59,69,26,148,77.52808988764045,29.213483146067414
10836_marine,180,95,110,115,275,61.111111111111114,63.888888888888886
10838_marine,84,57,69,23,141,82.14285714285714,27.380952380952383
10843_marine,74,50,61,19,124,82.43243243243244,25.675675675675674
10886_marine,118,66,51,79,184,43.22033898305085,66.94915254237289
10887_marine,12,11,10,4,23,83.33333333333334,33.33333333333333
10888_marine,11,11,9,3,22,81.81818181818183,27.27272727272727
10889_marine,9,10,8,2,19,88.88888888888889,22.22222222222222
10890_marine,9,10,8,2,19,88.88888888888889,22.22222222222222
10891_marine,9,10,8,2,19,88.88888888888889,22.22222222222222
10892_marine,8,6,8,1,14,100,12.5
10893_marine,8,8,8,1,16,100,12.5
10894_marine,8,8,8,1,16,100,12.5
10895_marine,8,8,8,1,16,100,12.5
10896_marine,8,6,8,1,14,100,12.5
10897_marine,9,8,8,2,17,88.88888888888889,22.22222222222222
10898_marine,9,12,8,2,21,88.88888888888889,22.22222222222222
10899_marine,11,10,10,2,21,90.9090909090909,18.181818181818183
10900_marine,36,18,22,24,54,61.111111111111114,66.66666666666666
10901_marine,35,18,22,23,53,62.857142857142854,65.71428571428571
10902_marine,68,31,34,40,99,50,58.82352941176471
10903_marine,67,31,34,39,98,50.74626865671642,58.2089552238806
10910_marine,65,37,36,35,102,55.38461538461539,53.84615384615385
10911_marine,84,37,43,44,121,51.19047619047619,52.38095238095239
10912_marine,58,25,38,37,83,65.51724137931035,63.793103448275865
10913_marine,25,19,22,7,44,88,28.000000000000004
10914_marine,59,26,42,33,85,71.1864406779661,55.932203389830505
10915_marine,90,43,53,44,133,58.88888888888889,48.888888888888886
10916_marine,93,42,58,44,135,62.365591397849464,47.31182795698925
10917_marine,108,54,68,49,162,62.96296296296296,45.370370370370374
10918_marine,52,27,47,11,79,90.38461538461539,21.153846153846153
10919_marine,54,30,49,9,84,90.74074074074075,16.666666666666664
10920_marine,52,39,48,8,91,92.3076923076923,15.384615384615385
10921_marine,50,34,46,8,84,92,16
10922_marine,40,20,36,8,60,90,20
10923_marine,40,14,36,8,54,90,20
10924_marine,42,16,38,8,58,90.47619047619048,19.047619047619047
10925_marine,42,16,38,8,58,90.47619047619048,19.047619047619047
10926_marine,39,14,36,8,53,92.3076923076923,20.51282051282051
10927_marine,39,15,36,8,54,92.3076923076923,20.51282051282051
10928_marine,40,13,37,9,53,92.5,22.5
10929_marine,40,13,37,9,53,92.5,22.5
10930_marine,41,15,37,10,56,90.2439024390244,24.390243902439025
10931_marine,47,20,42,14,67,89.36170212765957,29.78723404255319
10932_marine,49,21,44,14,70,89.79591836734694,28.57142857142857
10933_marine,50,29,45,15,79,90,30
10934_marine,55,42,49,16,97,89.0909090909091,29.09090909090909
10935_marine,76,47,62,33,123,81.57894736842105,43.42105263157895
10936_marine,83,50,62,33,133,74.69879518072288,39.75903614457831
10937_marine,73,54,58,32,127,79.45205479452055,43.83561643835616
10938_marine,51,47,44,14,98,86.27450980392157,27.450980392156865
10939_marine,49,42,43,12,91,87.75510204081633,24.489795918367346
10940_marine,40,26,36,9,66,90,22.5
10941_marine,39,18,36,8,57,92.3076923076923,20.51282051282051
10942_marine,42,16,39,8,58,92.85714285714286,19.047619047619047
10943_marine,39,16,36,8,55,92.3076923076923,20.51282051282051
10944_marine,39,17,36,8,56,92.3076923076923,20.51282051282051
10945_marine,39,16,36,8,55,92.3076923076923,20.51282051282051
10946_marine,38,20,36,7,58,94.73684210526315,18.421052631578945
10947_marine,38,28,36,7,66,94.73684210526315,18.421052631578945
10948_marine,40,40,38,7,80,95,17.5
10949_marine,38,42,36,7,80,94.73684210526315,18.421052631578945
10950_marine,40,46,38,7,86,95,17.5
10951_marine,40,50,38,7,90,95,17.5
10952_marine,41,50,39,8,91,95.1219512195122,19.51219512195122
10953_marine,39,42,37,8,81,94.87179487179486,20.51282051282051
10954_marine,41,42,39,8,83,95.1219512195122,19.51219512195122
10955_marine,43,38,40,8,81,93.02325581395348,18.6046511627907
10956_marine,41,28,38,8,69,92.6829268292683,19.51219512195122
10957_marine,40,32,37,8,72,92.5,20
10958_marine,40,24,37,8,64,92.5,20
10959_marine,42,20,39,8,62,92.85714285714286,19.047619047619047
10960_marine,42,22,39,8,64,92.85714285714286,19.047619047619047
10961_marine,46,40,43,8,86,93.47826086956522,17.391304347826086
10962_marine,52,52,49,8,104,94.23076923076923,15.384615384615385
10963_marine,53,60,48,8,113,90.56603773584906,15.09433962264151
10964_marine,54,60,49,8,114,90.74074074074075,14.814814814814813
10965_marine,54,60,49,8,114,90.74074074074075,14.814814814814813
10966_marine,55,70,50,9,125,90.9090909090909,16.363636363636363
10967_marine,55,70,50,9,125,90.9090909090909,16.363636363636363
10968_marine,54,62,49,9,116,90.74074074074075,16.666666666666664
10969_marine,56,68,51,9,124,91.07142857142857,16.071428571428573
10970_marine,58,74,53,9,132,91.37931034482759,15.517241379310345
10971_marine,76,80,71,9,156,93.42105263157895,11.842105263157894
10972_marine,125,107,109,16,232,87.2,12.8
10973_marine,134,113,118,18,247,88.05970149253731,13.432835820895523
10974_marine,171,117,147,41,288,85.96491228070175,23.976608187134502
10975_marine,170,111,146,39,281,85.88235294117646,22.941176470588236
10976_marine,176,99,150,51,275,85.22727272727273,28.97727272727273
10979_marine,221,92,176,92,313,79.63800904977376,41.6289592760181
10980_marine,116,71,94,22,187,81.03448275862068,18.96551724137931
10981_marine,96,59,82,14,155,85.41666666666666,14.583333333333334
10982_marine,90,52,80,8,142,88.88888888888889,8.88888888888889
10983_marine,86,50,78,8,136,90.69767441860465,9.30232558139535
10984_marine,111,69,92,19,180,82.88288288288288,17.117117117117118
10985_marine,239,95,180,118,334,75.31380753138075,49.37238493723849
11011_marine,60,28,49,18,88,81.66666666666667,30
11136_marine,172,95,110,111,267,63.95348837209303,64.53488372093024
11137_marine,43,28,38,16,71,88.37209302325581,37.2093023255814
11138_marine,36,25,33,9,61,91.66666666666666,25
11139_marine,39,25,34,12,64,87.17948717948718,30.76923076923077
11140_marine,160,75,100,104,235,62.5,65
11141_marine,168,76,103,112,244,61.30952380952381,66.66666666666666
11142_marine,158,69,99,102,227,62.65822784810127,64.55696202531645
11143_marine,166,82,105,103,248,63.25301204819277,62.048192771084345
11144_marine,182,88,116,114,270,63.73626373626373,62.637362637362635
11145_marine,188,95,121,116,283,64.36170212765957,61.702127659574465
11146_marine,170,88,109,101,258,64.11764705882354,59.411764705882355
11147_marine,161,88,102,94,249,63.35403726708074,58.38509316770186
11148_marine,56,35,46,16,91,82.14285714285714,28.57142857142857
11149_marine,55,36,46,14,91,83.63636363636363,25.454545454545453
11150_marine,60,36,49,18,96,81.66666666666667,30
11151_marine,147,79,90,81,226,61.224489795918366,55.10204081632652
11152_marine,57,37,47,17,94,82.45614035087719,29.82456140350877
11153_marine,50,33,43,10,83,86,20
11154_marine,45,31,39,9,76,86.66666666666667,20
11155_marine,43,31,37,7,74,86.04651162790698,16.27906976744186
11156_marine,41,29,35,7,70,85.36585365853658,17.073170731707318
11157_marine,35,22,32,7,57,91.42857142857143,20
11158_marine,40,30,35,6,70,87.5,15
11159_marine,40,30,35,6,70,87.5,15
11160_marine,42,30,37,6,72,88.09523809523809,14.285714285714285
11161_marine,42,28,38,7,70,90.47619047619048,16.666666666666664
11162_marine,49,32,45,8,81,91.83673469387756,16.3265306122449
11163_marine,50,32,46,7,82,92,14.000000000000002
11164_marine,52,34,47,8,86,90.38461538461539,15.384615384615385
11165_marine,52,34,47,8,86,90.38461538461539,15.384615384615385
11166_marine,52,34,47,8,86,90.38461538461539,15.384615384615385
11167_marine,51,34,48,9,85,94.11764705882352,17.647058823529413
11168_marine,47,34,44,9,81,93.61702127659575,19.148936170212767
11169_marine,46,28,43,9,74,93.47826086956522,19.565217391304348
11170_marine,46,30,43,9,76,93.47826086956522,19.565217391304348
11171_marine,47,30,44,9,77,93.61702127659575,19.148936170212767
11172_marine,44,28,43,8,72,97.72727272727273,18.181818181818183
11173_marine,44,29,42,8,73,95.45454545454545,18.181818181818183
11174_marine,45,31,43,7,76,95.55555555555556,15.555555555555555
11175_marine,45,33,43,7,78,95.55555555555556,15.555555555555555
11176_marine,45,34,43,7,79,95.55555555555556,15.555555555555555
11177_marine,44,34,42,7,78,95.45454545454545,15.909090909090908
11178_marine,144,89,92,72,233,63.888888888888886,50
11179_marine,149,90,93,77,239,62.41610738255034,51.67785234899329
11180_marine,151,95,90,80,246,59.60264900662252,52.980132450331126
11181_marine,152,95,91,81,247,59.86842105263158,53.289473684210535
11182_marine,164,100,93,92,264,56.70731707317073,56.09756097560976
11183_marine,176,105,99,104,281,56.25,59.09090909090909
11184_marine,162,101,90,91,263,55.55555555555556,56.17283950617284
11185_marine,74,57,58,25,131,78.37837837837837,33.78378378378378
11186_marine,197,115,112,114,312,56.852791878172596,57.868020304568525
11187_marine,217,128,122,126,345,56.22119815668203,58.06451612903226
11188_marine,185,91,112,122,276,60.54054054054055,65.94594594594595
11189_marine,186,95,114,124,281,61.29032258064516,66.66666666666666
11190_marine,88,55,67,29,143,76.13636363636364,32.95454545454545
11191_marine,82,56,65,22,138,79.26829268292683,26.82926829268293
11192_marine,80,52,65,18,132,81.25,22.5
11193_marine,77,50,64,15,127,83.11688311688312,19.480519480519483
11194_marine,75,48,63,15,123,84,20
11195_marine,73,46,61,15,119,83.56164383561644,20.54794520547945
11196_marine,71,46,59,15,117,83.09859154929578,21.12676056338028
11197_marine,68,48,58,14,116,85.29411764705883,20.588235294117645
11198_marine,70,51,59,16,121,84.28571428571429,22.857142857142858
11199_marine,82,56,69,18,138,84.14634146341463,21.951219512195124
11200_marine,88,56,71,22,144,80.68181818181817,25
11201_marine,92,57,75,25,149,81.52173913043478,27.173913043478258
11246_marine,127,75,53,88,202,41.732283464566926,69.29133858267717
11247_marine,122,75,49,85,197,40.16393442622951,69.67213114754098
11248_marine,118,77,47,82,195,39.83050847457627,69.49152542372882
11249_marine,10,11,8,3,21,80,30
11250_marine,9,11,8,2,20,88.88888888888889,22.22222222222222
11251_marine,9,10,8,2,19,88.88888888888889,22.22222222222222
11252_marine,7,10,6,2,17,85.71428571428571,28.57142857142857
11253_marine,7,10,6,2,17,85.71428571428571,28.57142857142857
11254_marine,7,8,6,2,15,85.71428571428571,28.57142857142857
11255_marine,6,6,6,1,12,100,16.666666666666664
11256_marine,6,6,6,1,12,100,16.666666666666664
11257_marine,6,10,6,1,16,100,16.666666666666664
11258_marine,7,10,6,2,17,85.71428571428571,28.57142857142857
11259_marine,9,10,8,2,19,88.88888888888889,22.22222222222222
11260_marine,36,18,21,26,54,58.333333333333336,72.22222222222221
11261_marine,39,17,22,28,56,56.41025641025641,71.7948717948718
11262_marine,73,32,36,45,105,49.31506849315068,61.64383561643836
11263_marine,72,37,34,42,109,47.22222222222222,58.333333333333336
11270_marine,81,39,40,43,120,49.382716049382715,53.086419753086425
11271_marine,89,41,44,43,130,49.43820224719101,48.31460674157304
11272_marine,103,50,52,54,153,50.48543689320388,52.42718446601942
11273_marine,101,53,51,52,154,50.495049504950494,51.48514851485149
11274_marine,92,47,49,46,139,53.2608695652174,50
11275_marine,84,41,42,42,125,50,50
11277_marine,112,50,69,50,162,61.60714285714286,44.642857142857146
11278_marine,117,59,73,53,176,62.39316239316239,45.2991452991453
11279_marine,57,28,52,13,85,91.22807017543859,22.807017543859647
11280_marine,55,36,50,10,91,90.9090909090909,18.181818181818183
11281_marine,52,38,48,8,90,92.3076923076923,15.384615384615385
11282_marine,44,30,40,8,74,90.9090909090909,18.181818181818183
11283_marine,40,18,36,8,58,90,20
11284_marine,42,16,38,8,58,90.47619047619048,19.047619047619047
11285_marine,42,16,38,8,58,90.47619047619048,19.047619047619047
11286_marine,39,14,36,8,53,92.3076923076923,20.51282051282051
11287_marine,40,16,37,9,56,92.5,22.5
11288_marine,40,18,37,9,58,92.5,22.5
11289_marine,41,18,37,10,59,90.2439024390244,24.390243902439025
11290_marine,41,16,37,10,57,90.2439024390244,24.390243902439025
11291_marine,42,16,37,11,58,88.09523809523809,26.190476190476193
11292_marine,42,16,37,11,58,88.09523809523809,26.190476190476193
11293_marine,44,16,39,13,60,88.63636363636364,29.545454545454547
11294_marine,46,25,41,13,71,89.13043478260869,28.26086956521739
11295_marine,48,37,43,13,85,89.58333333333334,27.083333333333332
11296_marine,50,40,44,13,90,88,26
11297_marine,48,40,42,13,88,87.5,27.083333333333332
11298_marine,46,32,40,12,78,86.95652173913044,26.08695652173913
11299_marine,42,18,37,10,60,88.09523809523809,23.809523809523807
11300_marine,41,16,37,9,57,90.2439024390244,21.951219512195124
11301_marine,40,16,37,8,56,92.5,20
11302_marine,41,19,38,8,60,92.6829268292683,19.51219512195122
11303_marine,39,18,36,8,57,92.3076923076923,20.51282051282051
11304_marine,38,20,36,7,58,94.73684210526315,18.421052631578945
11305_marine,38,22,36,7,60,94.73684210526315,18.421052631578945
11306_marine,40,36,38,7,76,95,17.5
11307_marine,40,44,38,7,84,95,17.5
11308_marine,40,46,38,7,86,95,17.5
11309_marine,40,48,38,7,88,95,17.5
11310_marine,40,50,38,7,90,95,17.5
11311_marine,40,50,38,7,90,95,17.5
11312_marine,38,42,36,7,80,94.73684210526315,18.421052631578945
11313_marine,39,38,37,7,77,94.87179487179486,17.94871794871795
11314_marine,41,32,38,8,73,92.6829268292683,19.51219512195122
11315_marine,41,24,38,8,65,92.6829268292683,19.51219512195122
11316_marine,41,24,38,8,65,92.6829268292683,19.51219512195122
11317_marine,41,22,38,8,63,92.6829268292683,19.51219512195122
11318_marine,40,20,37,8,60,92.5,20
11319_marine,40,26,37,8,66,92.5,20
11320_marine,44,40,41,8,84,93.18181818181817,18.181818181818183
11321_marine,50,54,45,8,104,90,16
11322_marine,52,60,47,8,112,90.38461538461539,15.384615384615385
11323_marine,54,58,49,8,112,90.74074074074075,14.814814814814813
11324_marine,54,60,49,8,114,90.74074074074075,14.814814814814813
11325_marine,55,68,50,8,123,90.9090909090909,14.545454545454545
11326_marine,55,68,50,9,123,90.9090909090909,16.363636363636363
11327_marine,58,72,53,9,130,91.37931034482759,15.517241379310345
11328_marine,55,68,50,9,123,90.9090909090909,16.363636363636363
11329_marine,49,50,44,8,99,89.79591836734694,16.3265306122449
11330_marine,68,70,61,10,138,89.70588235294117,14.705882352941178
11331_marine,128,109,112,16,237,87.5,12.5
11332_marine,142,115,120,23,257,84.50704225352112,16.19718309859155
11333_marine,234,135,189,93,369,80.76923076923077,39.743589743589745
11334_marine,256,114,204,112,370,79.6875,43.75
11339_marine,134,71,113,22,205,84.32835820895522,16.417910447761194
11340_marine,118,66,99,17,184,83.89830508474576,14.40677966101695
11341_marine,93,56,80,11,149,86.02150537634408,11.827956989247312
11342_marine,90,52,80,8,142,88.88888888888889,8.88888888888889
11343_marine,90,50,80,8,140,88.88888888888889,8.88888888888889
11344_marine,88,63,80,8,151,90.9090909090909,9.090909090909092
11345_marine,125,71,102,27,196,81.6,21.6
11361_marine,35,18,32,10,53,91.42857142857143,28.57142857142857
11484_marine,38,25,34,10,63,89.47368421052632,26.31578947368421
11485_marine,40,25,36,10,65,90,25
11486_marine,41,24,38,9,65,92.6829268292683,21.951219512195124
11487_marine,42,25,38,11,67,90.47619047619048,26.190476190476193
11488_marine,43,26,38,12,69,88.37209302325581,27.906976744186046
11489_marine,44,26,39,13,70,88.63636363636364,29.545454545454547
11490_marine,44,26,40,13,70,90.9090909090909,29.545454545454547
11491_marine,111,49,79,71,160,71.17117117117117,63.96396396396396
11494_marine,48,27,39,16,75,81.25,33.33333333333333
11495_marine,50,35,42,18,85,84,36
11496_marine,54,34,44,20,88,81.48148148148148,37.03703703703704
11497_marine,50,32,41,17,82,82,34
11498_marine,162,75,104,102,237,64.19753086419753,62.96296296296296
11499_marine,165,78,105,106,243,63.63636363636363,64.24242424242425
11500_marine,162,74,101,106,236,62.34567901234568,65.4320987654321
11502_marine,105,40,58,72,145,55.23809523809524,68.57142857142857
11503_marine,176,88,111,109,264,63.06818181818182,61.93181818181818
11504_marine,180,89,114,111,269,63.33333333333333,61.66666666666667
11505_marine,147,66,102,92,213,69.38775510204081,62.585034013605444
11506_marine,60,37,50,22,97,83.33333333333334,36.666666666666664
11507_marine,53,30,46,14,83,86.79245283018868,26.41509433962264
11508_marine,46,30,40,10,76,86.95652173913044,21.73913043478261
11509_marine,46,31,40,10,77,86.95652173913044,21.73913043478261
11510_marine,45,35,39,9,80,86.66666666666667,20
11511_marine,44,35,38,8,79,86.36363636363636,18.181818181818183
11512_marine,44,35,38,8,79,86.36363636363636,18.181818181818183
11513_marine,41,31,35,7,72,85.36585365853658,17.073170731707318
11514_marine,34,23,31,6,57,91.17647058823529,17.647058823529413
11515_marine,35,24,32,7,59,91.42857142857143,20
11516_marine,35,24,32,7,59,91.42857142857143,20
11517_marine,34,22,31,6,56,91.17647058823529,17.647058823529413
11518_marine,35,18,32,7,53,91.42857142857143,20
11519_marine,35,18,33,7,53,94.28571428571428,20
11520_marine,35,18,33,7,53,94.28571428571428,20
11521_marine,35,18,33,8,53,94.28571428571428,22.857142857142858
11522_marine,41,26,37,8,67,90.2439024390244,19.51219512195122
11523_marine,47,28,42,9,75,89.36170212765957,19.148936170212767
11524_marine,48,28,43,10,76,89.58333333333334,20.833333333333336
11525_marine,50,30,45,10,80,90,20
11526_marine,51,34,46,9,85,90.19607843137256,17.647058823529413
11527_marine,49,34,46,9,83,93.87755102040816,18.367346938775512
11528_marine,46,34,43,8,80,93.47826086956522,17.391304347826086
11529_marine,52,35,47,12,87,90.38461538461539,23.076923076923077
11530_marine,72,50,58,29,122,80.55555555555556,40.27777777777778
11531_marine,53,38,47,15,91,88.67924528301887,28.30188679245283
11532_marine,50,27,46,13,77,92,26
11533_marine,45,26,43,9,71,95.55555555555556,20
11534_marine,47,28,45,9,75,95.74468085106383,19.148936170212767
11535_marine,46,28,44,8,74,95.65217391304348,17.391304347826086
11536_marine,45,29,43,7,74,95.55555555555556,15.555555555555555
11537_marine,45,32,43,7,77,95.55555555555556,15.555555555555555
11538_marine,44,33,42,7,77,95.45454545454545,15.909090909090908
11539_marine,44,37,42,7,81,95.45454545454545,15.909090909090908
11540_marine,47,35,42,10,82,89.36170212765957,21.27659574468085
11541_marine,50,37,44,13,87,88,26
11542_marine,142,76,90,73,218,63.38028169014085,51.40845070422535
11543_marine,154,92,97,79,246,62.98701298701299,51.298701298701296
11544_marine,189,108,115,102,297,60.84656084656085,53.96825396825397
11545_marine,195,110,119,106,305,61.02564102564103,54.35897435897436
11546_marine,215,118,124,122,333,57.674418604651166,56.74418604651162
11547_marine,165,83,103,102,248,62.42424242424243,61.81818181818181
11548_marine,163,82,100,102,245,61.34969325153374,62.57668711656442
11549_marine,85,55,66,28,140,77.64705882352942,32.94117647058823
11550_marine,76,53,61,18,129,80.26315789473685,23.684210526315788
11551_marine,76,47,63,14,123,82.89473684210526,18.421052631578945
11552_marine,69,43,58,13,112,84.05797101449275,18.84057971014493
11553_marine,65,40,55,13,105,84.61538461538461,20
11554_marine,60,38,50,13,98,83.33333333333334,21.666666666666668
11555_marine,58,37,49,11,95,84.48275862068965,18.96551724137931
11556_marine,56,37,47,9,93,83.92857142857143,16.071428571428573
11557_marine,58,37,49,9,95,84.48275862068965,15.517241379310345
11558_marine,59,37,49,10,96,83.05084745762711,16.94915254237288
11559_marine,63,37,52,12,100,82.53968253968253,19.047619047619047
11560_marine,67,38,54,14,105,80.59701492537313,20.8955223880597
11561_marine,75,44,62,17,119,82.66666666666667,22.666666666666664
11562_marine,91,53,74,23,144,81.31868131868131,25.274725274725274
11563_marine,95,54,78,26,149,82.10526315789474,27.368421052631582
11564_marine,200,100,125,120,300,62.5,60
11565_marine,203,100,125,121,303,61.57635467980296,59.60591133004927
11566_marine,207,109,118,122,316,57.00483091787439,58.93719806763285
11608_marine,125,86,48,88,211,38.4,70.39999999999999
11609_marine,118,77,43,84,195,36.440677966101696,71.1864406779661
11610_marine,103,44,40,81,147,38.83495145631068,78.64077669902912
11611_marine,8,11,6,3,19,75,37.5
11612_marine,8,11,6,3,19,75,37.5
11613_marine,8,11,6,3,19,75,37.5
11614_marine,7,10,6,2,17,85.71428571428571,28.57142857142857
11615_marine,7,10,6,2,17,85.71428571428571,28.57142857142857
11616_marine,7,8,6,2,15,85.71428571428571,28.57142857142857
11617_marine,7,12,6,2,19,85.71428571428571,28.57142857142857
11618_marine,7,10,6,2,17,85.71428571428571,28.57142857142857
11619_marine,8,10,8,1,18,100,12.5
11620_marine,9,11,8,2,20,88.88888888888889,22.22222222222222
11621_marine,38,18,21,28,56,55.26315789473685,73.68421052631578
11622_marine,41,18,22,31,59,53.65853658536586,75.60975609756098
11623_marine,73,36,33,43,109,45.20547945205479,58.9041095890411
11624_marine,83,37,36,47,120,43.373493975903614,56.62650602409639
11631_marine,94,45,46,48,139,48.93617021276596,51.06382978723404
11632_marine,96,46,48,50,142,50,52.083333333333336
11633_marine,78,34,32,45,112,41.02564102564102,57.692307692307686
11638_marine,116,50,72,54,166,62.06896551724138,46.55172413793103
11639_marine,134,59,80,65,193,59.70149253731343,48.507462686567166
11640_marine,57,28,50,12,85,87.71929824561403,21.052631578947366
11641_marine,56,40,50,11,96,89.28571428571429,19.642857142857142
11642_marine,51,38,46,9,89,90.19607843137256,17.647058823529413
11643_marine,45,31,40,9,76,88.88888888888889,20
11644_marine,43,19,38,9,62,88.37209302325581,20.930232558139537
11645_marine,43,15,38,9,58,88.37209302325581,20.930232558139537
11646_marine,42,15,37,10,57,88.09523809523809,23.809523809523807
11647_marine,41,18,37,10,59,90.2439024390244,24.390243902439025
11648_marine,41,18,37,10,59,90.2439024390244,24.390243902439025
11649_marine,41,18,37,10,59,90.2439024390244,24.390243902439025
11650_marine,41,18,37,10,59,90.2439024390244,24.390243902439025
11651_marine,41,16,37,10,57,90.2439024390244,24.390243902439025
11652_marine,42,16,37,11,58,88.09523809523809,26.190476190476193
11653_marine,42,16,37,11,58,88.09523809523809,26.190476190476193
11654_marine,42,20,37,11,62,88.09523809523809,26.190476190476193
11655_marine,42,22,37,11,64,88.09523809523809,26.190476190476193
11656_marine,43,20,38,11,63,88.37209302325581,25.581395348837212
11657_marine,43,16,38,11,59,88.37209302325581,25.581395348837212
11658_marine,42,16,37,10,58,88.09523809523809,23.809523809523807
11659_marine,41,18,37,9,59,90.2439024390244,21.951219512195124
11660_marine,42,20,39,8,62,92.85714285714286,19.047619047619047
11661_marine,39,18,36,8,57,92.3076923076923,20.51282051282051
11662_marine,38,22,36,7,60,94.73684210526315,18.421052631578945
11663_marine,40,24,38,7,64,95,17.5
11664_marine,40,26,38,7,66,95,17.5
11665_marine,40,36,38,7,76,95,17.5
11666_marine,40,44,38,7,84,95,17.5
11667_marine,40,46,38,7,86,95,17.5
11668_marine,40,46,38,7,86,95,17.5
11669_marine,40,50,38,7,90,95,17.5
11670_marine,36,44,34,7,80,94.44444444444444,19.444444444444446
11671_marine,38,36,36,7,74,94.73684210526315,18.421052631578945
11672_marine,39,30,37,7,69,94.87179487179486,17.94871794871795
11673_marine,40,28,37,7,68,92.5,17.5
11674_marine,40,32,37,7,72,92.5,17.5
11675_marine,42,20,39,8,62,92.85714285714286,19.047619047619047
11676_marine,42,20,39,8,62,92.85714285714286,19.047619047619047
11677_marine,42,24,39,8,66,92.85714285714286,19.047619047619047
11678_marine,44,28,39,8,72,88.63636363636364,18.181818181818183
11679_marine,45,38,40,8,83,88.88888888888889,17.77777777777778
11680_marine,51,48,46,8,99,90.19607843137256,15.686274509803921
11681_marine,51,58,46,8,109,90.19607843137256,15.686274509803921
11682_marine,53,58,48,8,111,90.56603773584906,15.09433962264151
11683_marine,53,60,48,8,113,90.56603773584906,15.09433962264151
11684_marine,53,60,48,8,113,90.56603773584906,15.09433962264151
11685_marine,55,66,50,8,121,90.9090909090909,14.545454545454545
11686_marine,61,62,56,8,123,91.80327868852459,13.114754098360656
11687_marine,60,68,55,8,128,91.66666666666666,13.333333333333334
11688_marine,61,68,56,8,129,91.80327868852459,13.114754098360656
11689_marine,64,62,59,8,126,92.1875,12.5
11690_marine,77,70,70,10,147,90.9090909090909,12.987012987012985
11691_marine,132,117,115,17,249,87.12121212121212,12.878787878787879
11692_marine,175,98,147,45,273,84,25.71428571428571
11693_marine,276,114,222,123,390,80.43478260869566,44.565217391304344
11700_marine,120,66,97,21,186,80.83333333333333,17.5
11701_marine,100,58,84,14,158,84,14.000000000000002
11702_marine,88,50,78,8,138,88.63636363636364,9.090909090909092
11703_marine,92,50,82,8,142,89.13043478260869,8.695652173913043
11704_marine,94,46,84,8,140,89.36170212765957,8.51063829787234
11705_marine,109,60,94,13,169,86.23853211009175,11.926605504587156
11706_marine,125,74,107,19,199,85.6,15.2
11707_marine,150,90,126,29,240,84,19.333333333333332
11721_marine,39,18,35,11,57,89.74358974358975,28.205128205128204
11842_marine,39,23,34,12,62,87.17948717948718,30.76923076923077
11843_marine,41,25,37,12,66,90.2439024390244,29.268292682926827
11844_marine,42,23,39,10,65,92.85714285714286,23.809523809523807
11845_marine,46,29,42,10,75,91.30434782608695,21.73913043478261
11846_marine,44,29,40,8,73,90.9090909090909,18.181818181818183
11847_marine,43,28,39,9,71,90.69767441860465,20.930232558139537
11848_marine,43,26,40,8,69,93.02325581395348,18.6046511627907
11849_marine,42,26,39,8,68,92.85714285714286,19.047619047619047
11850_marine,41,26,38,7,67,92.6829268292683,17.073170731707318
11851_marine,41,26,38,7,67,92.6829268292683,17.073170731707318
11852_marine,40,23,38,8,63,95,20
11853_marine,42,25,38,8,67,90.47619047619048,19.047619047619047
11854_marine,48,31,41,10,79,85.41666666666666,20.833333333333336
11855_marine,46,28,39,10,74,84.78260869565217,21.73913043478261
11856_marine,52,35,43,14,87,82.6923076923077,26.923076923076923
11857_marine,171,80,108,108,251,63.1578947368421,63.1578947368421
11858_marine,164,79,104,106,243,63.41463414634146,64.63414634146342
11859_marine,50,26,43,20,76,86,40
11862_marine,105,40,58,72,145,55.23809523809524,68.57142857142857
11863_marine,183,103,116,110,286,63.387978142076506,60.10928961748634
11864_marine,187,99,119,114,286,63.63636363636363,60.962566844919785
11865_marine,58,43,47,17,101,81.03448275862068,29.310344827586203
11866_marine,49,38,40,12,87,81.63265306122449,24.489795918367346
11867_marine,48,37,39,11,85,81.25,22.916666666666664
11868_marine,46,30,39,11,76,84.78260869565217,23.91304347826087
11869_marine,35,22,32,7,57,91.42857142857143,20
11870_marine,41,31,36,7,72,87.8048780487805,17.073170731707318
11871_marine,41,31,36,7,72,87.8048780487805,17.073170731707318
11872_marine,41,29,36,7,70,87.8048780487805,17.073170731707318
11873_marine,36,20,33,8,56,91.66666666666666,22.22222222222222
11874_marine,36,20,33,8,56,91.66666666666666,22.22222222222222
11875_marine,37,20,34,9,57,91.8918918918919,24.324324324324326
11876_marine,37,20,35,9,57,94.5945945945946,24.324324324324326
11877_marine,38,20,36,10,58,94.73684210526315,26.31578947368421
11878_marine,37,20,35,9,57,94.5945945945946,24.324324324324326
11879_marine,36,20,34,8,56,94.44444444444444,22.22222222222222
11880_marine,36,20,34,8,56,94.44444444444444,22.22222222222222
11881_marine,36,20,34,9,56,94.44444444444444,25
11882_marine,36,20,34,9,56,94.44444444444444,25
11883_marine,42,26,37,8,68,88.09523809523809,19.047619047619047
11884_marine,43,26,38,7,69,88.37209302325581,16.27906976744186
11885_marine,44,26,39,8,70,88.63636363636364,18.181818181818183
11886_marine,47,30,42,9,77,89.36170212765957,19.148936170212767
11887_marine,49,32,46,9,81,93.87755102040816,18.367346938775512
11888_marine,49,34,46,8,83,93.87755102040816,16.3265306122449
11889_marine,53,35,48,11,88,90.56603773584906,20.754716981132077
11890_marine,58,37,52,16,95,89.65517241379311,27.586206896551722
11891_marine,71,45,59,24,116,83.09859154929578,33.80281690140845
11892_marine,56,35,51,14,91,91.07142857142857,25
11893_marine,44,27,42,8,71,95.45454545454545,18.181818181818183
11894_marine,47,28,44,9,75,93.61702127659575,19.148936170212767
11895_marine,48,31,45,10,79,93.75,20.833333333333336
11896_marine,48,32,44,10,80,91.66666666666666,20.833333333333336
11897_marine,52,36,45,14,88,86.53846153846155,26.923076923076923
11898_marine,55,41,46,18,96,83.63636363636363,32.72727272727273
11899_marine,153,81,97,81,234,63.39869281045751,52.94117647058824
11900_marine,156,82,98,85,238,62.82051282051282,54.48717948717948
11901_marine,142,75,90,74,217,63.38028169014085,52.112676056338024
11902_marine,189,95,121,100,284,64.02116402116403,52.910052910052904
11903_marine,182,97,112,96,279,61.53846153846154,52.74725274725275
11904_marine,189,98,116,101,287,61.37566137566137,53.43915343915344
11905_marine,87,51,67,31,138,77.01149425287356,35.63218390804598
11906_marine,169,80,107,101,249,63.31360946745562,59.76331360946746
11907_marine,170,81,107,102,251,62.94117647058823,60
11908_marine,89,54,69,29,143,77.52808988764045,32.58426966292135
11909_marine,81,48,66,21,129,81.48148148148148,25.925925925925924
11910_marine,70,42,58,13,112,82.85714285714286,18.571428571428573
11911_marine,64,39,55,13,103,85.9375,20.3125
11912_marine,57,36,49,11,93,85.96491228070175,19.298245614035086
11913_marine,50,29,44,10,79,88,20
11914_marine,49,24,45,7,73,91.83673469387756,14.285714285714285
11915_marine,48,24,44,6,72,91.66666666666666,12.5
11916_marine,49,25,45,7,74,91.83673469387756,14.285714285714285
11917_marine,49,25,45,7,74,91.83673469387756,14.285714285714285
11918_marine,50,25,46,7,75,92,14.000000000000002
11919_marine,49,25,45,8,74,91.83673469387756,16.3265306122449
11920_marine,59,33,49,8,92,83.05084745762711,13.559322033898304
11921_marine,65,33,54,12,98,83.07692307692308,18.461538461538463
11922_marine,69,35,57,14,104,82.6086956521739,20.28985507246377
11923_marine,78,44,66,16,122,84.61538461538461,20.51282051282051
11924_marine,99,57,79,28,156,79.7979797979798,28.28282828282828
11925_marine,203,97,128,119,300,63.05418719211823,58.620689655172406
11926_marine,200,101,121,115,301,60.5,57.49999999999999
11927_marine,206,103,116,125,309,56.310679611650485,60.679611650485434
11968_marine,123,84,46,86,207,37.39837398373984,69.91869918699187
11971_marine,97,43,38,75,140,39.175257731958766,77.31958762886599
11972_marine,121,78,44,85,199,36.36363636363637,70.24793388429752
11974_marine,8,11,6,3,19,75,37.5
11975_marine,8,11,6,3,19,75,37.5
11976_marine,8,11,6,3,19,75,37.5
11977_marine,8,10,6,3,18,75,37.5
11978_marine,8,10,6,3,18,75,37.5
11979_marine,7,10,6,2,17,85.71428571428571,28.57142857142857
11980_marine,36,20,20,26,56,55.55555555555556,72.22222222222221
11981_marine,38,20,20,28,58,52.63157894736842,73.68421052631578
11982_marine,43,21,21,33,64,48.837209302325576,76.74418604651163
11983_marine,42,20,22,31,62,52.38095238095239,73.80952380952381
11984_marine,98,54,43,58,152,43.87755102040816,59.183673469387756
11998_marine,124,58,69,64,182,55.64516129032258,51.61290322580645
11999_marine,140,61,78,72,201,55.714285714285715,51.42857142857142
12000_marine,110,38,77,64,148,70,58.18181818181818
12001_marine,58,29,51,13,87,87.93103448275862,22.413793103448278
12002_marine,55,39,49,11,94,89.0909090909091,20
12003_marine,52,39,47,10,91,90.38461538461539,19.230769230769234
12004_marine,48,32,43,10,80,89.58333333333334,20.833333333333336
12005_marine,46,19,41,10,65,89.13043478260869,21.73913043478261
12006_marine,46,17,41,10,63,89.13043478260869,21.73913043478261
12007_marine,44,20,39,10,64,88.63636363636364,22.727272727272727
12008_marine,43,18,39,10,61,90.69767441860465,23.25581395348837
12009_marine,43,18,39,10,61,90.69767441860465,23.25581395348837
12010_marine,43,18,39,10,61,90.69767441860465,23.25581395348837
12011_marine,43,18,39,10,61,90.69767441860465,23.25581395348837
12012_marine,41,18,37,10,59,90.2439024390244,24.390243902439025
12013_marine,43,18,39,10,61,90.69767441860465,23.25581395348837
12014_marine,44,18,40,10,62,90.9090909090909,22.727272727272727
12015_marine,47,18,42,11,65,89.36170212765957,23.404255319148938
12016_marine,45,18,40,11,63,88.88888888888889,24.444444444444443
12017_marine,44,20,39,10,64,88.63636363636364,22.727272727272727
12018_marine,40,20,37,8,60,92.5,20
12019_marine,40,20,37,8,60,92.5,20
12020_marine,41,21,38,8,62,92.6829268292683,19.51219512195122
12021_marine,40,22,38,7,62,95,17.5
12022_marine,40,22,38,7,62,95,17.5
12023_marine,40,28,38,7,68,95,17.5
12024_marine,40,26,38,7,66,95,17.5
12025_marine,40,46,38,7,86,95,17.5
12026_marine,40,44,38,7,84,95,17.5
12027_marine,38,44,36,7,82,94.73684210526315,18.421052631578945
12028_marine,40,46,38,7,86,95,17.5
12029_marine,41,42,39,7,83,95.1219512195122,17.073170731707318
12030_marine,42,38,40,7,80,95.23809523809523,16.666666666666664
12031_marine,42,26,40,7,68,95.23809523809523,16.666666666666664
12032_marine,43,24,40,7,67,93.02325581395348,16.27906976744186
12033_marine,43,22,40,7,65,93.02325581395348,16.27906976744186
12034_marine,44,20,41,7,64,93.18181818181817,15.909090909090908
12035_marine,46,24,41,7,70,89.13043478260869,15.217391304347828
12036_marine,47,28,42,8,75,89.36170212765957,17.02127659574468
12037_marine,48,36,43,7,84,89.58333333333334,14.583333333333334
12038_marine,51,42,46,7,93,90.19607843137256,13.725490196078432
12039_marine,51,44,46,7,95,90.19607843137256,13.725490196078432
12040_marine,54,46,49,8,100,90.74074074074075,14.814814814814813
12041_marine,53,56,48,8,109,90.56603773584906,15.09433962264151
12042_marine,55,52,50,8,107,90.9090909090909,14.545454545454545
12043_marine,54,64,49,7,118,90.74074074074075,12.962962962962962
12044_marine,56,64,51,7,120,91.07142857142857,12.5
12045_marine,60,66,55,7,126,91.66666666666666,11.666666666666666
12046_marine,60,72,55,7,132,91.66666666666666,11.666666666666666
12047_marine,62,66,57,8,128,91.93548387096774,12.903225806451612
12048_marine,61,60,56,8,121,91.80327868852459,13.114754098360656
12049_marine,58,44,53,8,102,91.37931034482759,13.793103448275861
12050_marine,80,67,75,8,147,93.75,10
12051_marine,137,125,118,17,262,86.13138686131386,12.408759124087592
12052_marine,147,113,125,23,260,85.03401360544217,15.646258503401361
12053_marine,241,117,195,91,358,80.91286307053942,37.75933609958506
12059_marine,141,70,114,32,211,80.85106382978722,22.69503546099291
12060_marine,124,65,101,21,189,81.45161290322581,16.93548387096774
12061_marine,112,52,92,17,164,82.14285714285714,15.178571428571427
12062_marine,102,54,88,12,156,86.27450980392157,11.76470588235294
12063_marine,94,50,86,8,144,91.48936170212765,8.51063829787234
12064_marine,96,46,88,8,142,91.66666666666666,8.333333333333332
12065_marine,94,48,86,8,142,91.48936170212765,8.51063829787234
12066_marine,100,48,86,9,148,86,9
12067_marine,112,53,97,13,165,86.60714285714286,11.607142857142858
12068_marine,122,58,104,18,180,85.24590163934425,14.754098360655737
12078_marine,40,17,34,13,57,85,32.5
12080_marine,35,17,32,9,52,91.42857142857143,25.71428571428571
12084_marine,35,21,30,12,56,85.71428571428571,34.285714285714285
12200_marine,42,23,37,14,65,88.09523809523809,33.33333333333333
12201_marine,37,23,33,10,60,89.1891891891892,27.027027027027028
12202_marine,37,21,35,10,58,94.5945945945946,27.027027027027028
12203_marine,44,23,40,14,67,90.9090909090909,31.818181818181817
12204_marine,66,31,50,26,97,75.75757575757575,39.39393939393939
12205_marine,52,29,44,14,81,84.61538461538461,26.923076923076923
12206_marine,48,27,42,9,75,87.5,18.75
12207_marine,47,27,41,8,74,87.2340425531915,17.02127659574468
12208_marine,46,26,41,7,72,89.13043478260869,15.217391304347828
12209_marine,47,26,42,8,73,89.36170212765957,17.02127659574468
12210_marine,47,27,42,8,74,89.36170212765957,17.02127659574468
12211_marine,42,28,37,8,70,88.09523809523809,19.047619047619047
12212_marine,41,26,35,8,67,85.36585365853658,19.51219512195122
12213_marine,40,28,33,9,68,82.5,22.5
12214_marine,43,29,36,10,72,83.72093023255815,23.25581395348837
12215_marine,49,34,42,11,83,85.71428571428571,22.448979591836736
12216_marine,174,82,109,106,256,62.643678160919535,60.91954022988506
12217_marine,168,77,107,103,245,63.69047619047619,61.30952380952381
12223_marine,186,113,117,116,299,62.903225806451616,62.365591397849464
12224_marine,194,109,122,119,303,62.88659793814433,61.34020618556701
12225_marine,59,50,47,18,109,79.66101694915254,30.508474576271187
12226_marine,59,42,49,17,101,83.05084745762711,28.8135593220339
12227_marine,56,37,46,16,93,82.14285714285714,28.57142857142857
12228_marine,48,35,40,11,83,83.33333333333334,22.916666666666664
12229_marine,46,33,38,9,79,82.6086956521739,19.565217391304348
12230_marine,37,22,33,8,59,89.1891891891892,21.62162162162162
12231_marine,39,19,35,10,58,89.74358974358975,25.64102564102564
12232_marine,38,19,35,9,57,92.10526315789474,23.684210526315788
12233_marine,38,20,35,10,58,92.10526315789474,26.31578947368421
12234_marine,36,20,34,8,56,94.44444444444444,22.22222222222222
12235_marine,36,20,34,8,56,94.44444444444444,22.22222222222222
12236_marine,36,20,34,8,56,94.44444444444444,22.22222222222222
12237_marine,36,20,34,8,56,94.44444444444444,22.22222222222222
12238_marine,36,20,34,8,56,94.44444444444444,22.22222222222222
12239_marine,42,30,38,8,72,90.47619047619048,19.047619047619047
12240_marine,43,30,39,8,73,90.69767441860465,18.6046511627907
12241_marine,41,30,37,8,71,90.2439024390244,19.51219512195122
12242_marine,36,20,33,8,56,91.66666666666666,22.22222222222222
12243_marine,36,20,33,8,56,91.66666666666666,22.22222222222222
12244_marine,36,20,33,8,56,91.66666666666666,22.22222222222222
12245_marine,38,20,35,8,58,92.10526315789474,21.052631578947366
12246_marine,42,28,39,8,70,92.85714285714286,19.047619047619047
12247_marine,45,30,42,9,75,93.33333333333333,20
12248_marine,45,28,42,8,73,93.33333333333333,17.77777777777778
12249_marine,46,28,43,9,74,93.47826086956522,19.565217391304348
12250_marine,51,35,47,11,86,92.15686274509804,21.568627450980394
12251_marine,55,37,51,13,92,92.72727272727272,23.636363636363637
12252_marine,55,33,50,13,88,90.9090909090909,23.636363636363637
12253_marine,57,33,49,12,90,85.96491228070175,21.052631578947366
12254_marine,55,36,47,14,91,85.45454545454545,25.454545454545453
12255_marine,64,41,52,23,105,81.25,35.9375
12256_marine,66,43,52,25,109,78.78787878787878,37.878787878787875
12257_marine,178,91,109,96,269,61.23595505617978,53.93258426966292
12258_marine,178,92,115,95,270,64.60674157303372,53.37078651685393
12259_marine,176,91,111,95,267,63.06818181818182,53.97727272727273
12260_marine,180,96,113,94,276,62.77777777777778,52.22222222222223
12261_marine,179,92,113,95,271,63.128491620111724,53.072625698324025
12262_marine,183,92,116,97,275,63.387978142076506,53.00546448087432
12263_marine,90,53,70,31,143,77.77777777777779,34.44444444444444
12264_marine,90,58,73,28,148,81.11111111111111,31.11111111111111
12265_marine,133,63,95,71,196,71.42857142857143,53.383458646616546
12266_marine,85,52,68,25,137,80,29.411764705882355
12267_marine,80,48,64,20,128,80,25
12268_marine,68,42,56,15,110,82.35294117647058,22.058823529411764
12269_marine,65,39,56,13,104,86.15384615384616,20
12270_marine,55,37,47,11,92,85.45454545454545,20
12271_marine,46,29,40,8,75,86.95652173913044,17.391304347826086
12272_marine,42,27,38,6,69,90.47619047619048,14.285714285714285
12273_marine,42,24,38,6,66,90.47619047619048,14.285714285714285
12274_marine,42,23,38,6,65,90.47619047619048,14.285714285714285
12275_marine,42,23,38,6,65,90.47619047619048,14.285714285714285
12276_marine,42,24,38,6,66,90.47619047619048,14.285714285714285
12277_marine,44,24,40,6,68,90.9090909090909,13.636363636363635
12278_marine,46,25,42,6,71,91.30434782608695,13.043478260869565
12279_marine,50,24,46,6,74,92,12
12280_marine,51,24,47,7,75,92.15686274509804,13.725490196078432
12281_marine,49,25,45,7,74,91.83673469387756,14.285714285714285
12282_marine,57,25,51,9,82,89.47368421052632,15.789473684210526
12283_marine,67,27,57,13,94,85.07462686567165,19.402985074626866
12284_marine,76,43,64,15,119,84.21052631578947,19.736842105263158
12285_marine,100,57,82,26,157,82,26
12286_marine,188,94,122,110,282,64.8936170212766,58.51063829787234
12287_marine,204,97,123,117,301,60.29411764705882,57.35294117647059
12333_marine,10,17,7,4,27,70,40
12334_marine,12,17,9,4,29,75,33.33333333333333
12336_marine,8,11,6,3,19,75,37.5
12339_marine,9,11,6,3,20,66.66666666666666,33.33333333333333
12340_marine,36,20,20,26,56,55.55555555555556,72.22222222222221
12341_marine,42,21,21,32,63,50,76.19047619047619
12342_marine,65,28,33,52,93,50.76923076923077,80
12343_marine,98,60,40,60,158,40.816326530612244,61.224489795918366
12344_marine,90,54,39,53,144,43.333333333333336,58.88888888888889
12359_marine,129,60,69,67,189,53.48837209302325,51.93798449612403
12360_marine,142,77,79,75,219,55.633802816901415,52.816901408450704
12361_marine,148,82,83,76,230,56.08108108108109,51.35135135135135
12362_marine,148,86,83,74,234,56.08108108108109,50
12363_marine,61,42,53,14,103,86.88524590163934,22.950819672131146
12364_marine,59,46,53,12,105,89.83050847457628,20.33898305084746
12365_marine,56,47,51,10,103,91.07142857142857,17.857142857142858
12366_marine,57,44,51,11,101,89.47368421052632,19.298245614035086
12367_marine,53,41,47,11,94,88.67924528301887,20.754716981132077
12368_marine,43,35,39,10,78,90.69767441860465,23.25581395348837
12369_marine,43,24,39,10,67,90.69767441860465,23.25581395348837
12370_marine,43,22,39,10,65,90.69767441860465,23.25581395348837
12371_marine,45,22,41,10,67,91.11111111111111,22.22222222222222
12372_marine,43,20,39,10,63,90.69767441860465,23.25581395348837
12373_marine,44,20,40,10,64,90.9090909090909,22.727272727272727
12374_marine,44,20,40,10,64,90.9090909090909,22.727272727272727
12375_marine,44,20,40,10,64,90.9090909090909,22.727272727272727
12376_marine,41,22,37,9,63,90.2439024390244,21.951219512195124
12377_marine,40,20,37,8,60,92.5,20
12378_marine,42,20,39,8,62,92.85714285714286,19.047619047619047
12379_marine,41,19,38,8,60,92.6829268292683,19.51219512195122
12380_marine,40,19,38,7,59,95,17.5
12381_marine,40,18,38,7,58,95,17.5
12382_marine,40,22,38,7,62,95,17.5
12383_marine,42,22,40,7,64,95.23809523809523,16.666666666666664
12384_marine,42,38,40,7,80,95.23809523809523,16.666666666666664
12385_marine,41,44,39,7,85,95.1219512195122,17.073170731707318
12386_marine,41,44,39,7,85,95.1219512195122,17.073170731707318
12387_marine,44,44,42,7,88,95.45454545454545,15.909090909090908
12388_marine,42,28,40,7,70,95.23809523809523,16.666666666666664
12389_marine,44,24,42,7,68,95.45454545454545,15.909090909090908
12390_marine,44,34,43,6,78,97.72727272727273,13.636363636363635
12391_marine,45,22,43,6,67,95.55555555555556,13.333333333333334
12392_marine,45,20,43,6,65,95.55555555555556,13.333333333333334
12393_marine,47,20,43,6,67,91.48936170212765,12.76595744680851
12394_marine,47,20,43,6,67,91.48936170212765,12.76595744680851
12395_marine,47,28,42,6,75,89.36170212765957,12.76595744680851
12396_marine,46,36,41,5,82,89.13043478260869,10.869565217391305
12397_marine,49,38,44,6,87,89.79591836734694,12.244897959183673
12398_marine,53,42,48,6,95,90.56603773584906,11.320754716981133
12399_marine,52,44,47,6,96,90.38461538461539,11.538461538461538
12400_marine,58,44,53,6,102,91.37931034482759,10.344827586206897
12401_marine,60,48,55,7,108,91.66666666666666,11.666666666666666
12402_marine,59,60,54,7,119,91.52542372881356,11.864406779661017
12403_marine,59,62,54,7,121,91.52542372881356,11.864406779661017
12404_marine,59,64,54,7,123,91.52542372881356,11.864406779661017
12405_marine,64,64,59,7,128,92.1875,10.9375
12406_marine,65,66,60,7,131,92.3076923076923,10.76923076923077
12407_marine,58,50,53,8,108,91.37931034482759,13.793103448275861
12408_marine,59,30,54,8,89,91.52542372881356,13.559322033898304
12409_marine,79,49,70,10,128,88.60759493670885,12.658227848101266
12410_marine,144,118,125,18,262,86.80555555555556,12.5
12411_marine,152,124,130,23,276,85.52631578947368,15.131578947368421
12420_marine,134,67,109,25,201,81.34328358208955,18.65671641791045
12421_marine,125,60,103,20,185,82.39999999999999,16
12422_marine,109,52,94,12,161,86.23853211009175,11.009174311926607
12423_marine,108,48,94,12,156,87.03703703703704,11.11111111111111
12424_marine,98,44,90,8,142,91.83673469387756,8.16326530612245
12425_marine,100,46,92,8,146,92,8
12426_marine,102,44,90,9,146,88.23529411764706,8.823529411764707
12427_marine,106,46,93,13,152,87.73584905660378,12.264150943396226
12428_marine,123,58,107,19,181,86.99186991869918,15.447154471544716
12437_marine,49,24,40,18,73,81.63265306122449,36.734693877551024
12438_marine,43,21,36,14,64,83.72093023255815,32.55813953488372
12439_marine,42,21,36,14,63,85.71428571428571,33.33333333333333
12440_marine,40,20,36,13,60,90,32.5
12560_marine,40,26,37,12,66,92.5,30
12561_marine,40,27,37,11,67,92.5,27.500000000000004
12562_marine,45,27,40,14,72,88.88888888888889,31.11111111111111
12563_marine,52,29,45,17,81,86.53846153846155,32.69230769230769
12564_marine,62,35,51,19,97,82.25806451612904,30.64516129032258
12565_marine,55,31,47,14,86,85.45454545454545,25.454545454545453
12566_marine,50,28,43,12,78,86,24
12567_marine,48,28,41,10,76,85.41666666666666,20.833333333333336
12568_marine,43,27,37,7,70,86.04651162790698,16.27906976744186
12569_marine,44,28,38,7,72,86.36363636363636,15.909090909090908
12570_marine,43,28,38,6,71,88.37209302325581,13.953488372093023
12571_marine,39,26,34,7,65,87.17948717948718,17.94871794871795
12572_marine,40,26,34,9,66,85,22.5
12573_marine,42,28,36,9,70,85.71428571428571,21.428571428571427
12574_marine,42,28,36,9,70,85.71428571428571,21.428571428571427
12575_marine,47,34,41,9,81,87.2340425531915,19.148936170212767
12576_marine,176,82,112,104,258,63.63636363636363,59.09090909090909
12582_marine,186,104,117,114,290,62.903225806451616,61.29032258064516
12583_marine,192,104,120,117,296,62.5,60.9375
12584_marine,67,51,52,23,118,77.61194029850746,34.32835820895522
12585_marine,64,47,53,19,111,82.8125,29.6875
12586_marine,122,59,88,70,181,72.1311475409836,57.377049180327866
12587_marine,121,59,88,70,180,72.72727272727273,57.85123966942148
12588_marine,69,41,53,25,110,76.81159420289855,36.231884057971016
12589_marine,62,39,47,22,101,75.80645161290323,35.483870967741936
12590_marine,50,34,42,13,84,84,26
12591_marine,42,24,37,11,66,88.09523809523809,26.190476190476193
12592_marine,40,24,35,9,64,87.5,22.5
12593_marine,41,22,36,10,63,87.8048780487805,24.390243902439025
12594_marine,41,19,36,10,60,87.8048780487805,24.390243902439025
12595_marine,38,19,34,8,57,89.47368421052632,21.052631578947366
12596_marine,40,20,36,8,60,90,20
12597_marine,43,26,39,8,69,90.69767441860465,18.6046511627907
12598_marine,44,34,40,7,78,90.9090909090909,15.909090909090908
12599_marine,47,34,43,8,81,91.48936170212765,17.02127659574468
12600_marine,46,32,42,8,78,91.30434782608695,17.391304347826086
12601_marine,46,35,42,7,81,91.30434782608695,15.217391304347828
12602_marine,41,31,36,7,72,87.8048780487805,17.073170731707318
12603_marine,35,19,32,7,54,91.42857142857143,20
12604_marine,35,21,32,7,56,91.42857142857143,20
12605_marine,35,20,32,7,55,91.42857142857143,20
12606_marine,36,20,33,8,56,91.66666666666666,22.22222222222222
12607_marine,40,22,37,9,62,92.5,22.5
12608_marine,47,31,41,10,78,87.2340425531915,21.27659574468085
12609_marine,50,32,43,12,82,86,24
12610_marine,55,32,46,15,87,83.63636363636363,27.27272727272727
12611_marine,64,39,52,17,103,81.25,26.5625
12612_marine,74,46,59,25,120,79.72972972972973,33.78378378378378
12613_marine,74,51,59,26,125,79.72972972972973,35.13513513513514
12614_marine,143,73,101,84,216,70.62937062937063,58.74125874125874
12615_marine,149,73,104,87,222,69.79865771812081,58.38926174496645
12616_marine,162,77,110,95,239,67.90123456790124,58.64197530864198
12617_marine,188,92,117,97,280,62.23404255319149,51.59574468085106
12618_marine,180,87,113,93,267,62.77777777777778,51.66666666666667
12619_marine,146,69,101,83,215,69.17808219178082,56.849315068493155
12620_marine,146,69,102,85,215,69.86301369863014,58.21917808219178
12621_marine,147,68,103,82,215,70.06802721088435,55.78231292517006
12622_marine,89,51,70,29,140,78.65168539325843,32.58426966292135
12623_marine,76,46,61,18,122,80.26315789473685,23.684210526315788
12624_marine,75,43,62,17,118,82.66666666666667,22.666666666666664
12625_marine,73,38,60,16,111,82.1917808219178,21.91780821917808
12626_marine,68,37,56,15,105,82.35294117647058,22.058823529411764
12627_marine,58,36,49,12,94,84.48275862068965,20.689655172413794
12628_marine,55,35,47,9,90,85.45454545454545,16.363636363636363
12629_marine,52,35,44,7,87,84.61538461538461,13.461538461538462
12630_marine,41,26,37,7,67,90.2439024390244,17.073170731707318
12631_marine,40,23,36,7,63,90,17.5
12632_marine,39,24,35,6,63,89.74358974358975,15.384615384615385
12633_marine,38,24,35,5,62,92.10526315789474,13.157894736842104
12634_marine,38,24,35,5,62,92.10526315789474,13.157894736842104
12635_marine,41,24,38,5,65,92.6829268292683,12.195121951219512
12636_marine,41,24,38,5,65,92.6829268292683,12.195121951219512
12637_marine,41,24,38,5,65,92.6829268292683,12.195121951219512
12638_marine,42,24,38,6,66,90.47619047619048,14.285714285714285
12639_marine,42,24,38,6,66,90.47619047619048,14.285714285714285
12640_marine,44,24,40,6,68,90.9090909090909,13.636363636363635
12641_marine,45,25,41,7,70,91.11111111111111,15.555555555555555
12642_marine,51,25,47,7,76,92.15686274509804,13.725490196078432
12643_marine,61,26,55,9,87,90.1639344262295,14.754098360655737
12644_marine,70,28,59,12,98,84.28571428571429,17.142857142857142
12645_marine,74,43,62,13,117,83.78378378378379,17.56756756756757
12646_marine,98,55,81,23,153,82.6530612244898,23.46938775510204
12699_marine,58,26,28,49,84,48.275862068965516,84.48275862068965
12700_marine,55,26,27,46,81,49.09090909090909,83.63636363636363
12701_marine,110,73,45,75,183,40.909090909090914,68.18181818181817
12702_marine,102,63,42,65,165,41.17647058823529,63.725490196078425
12721_marine,134,70,72,72,204,53.73134328358209,53.73134328358209
12724_marine,130,52,92,76,182,70.76923076923077,58.46153846153847
12725_marine,64,40,57,15,104,89.0625,23.4375
12726_marine,62,41,56,12,103,90.32258064516128,19.35483870967742
12727_marine,61,49,55,11,110,90.1639344262295,18.0327868852459
12728_marine,59,47,53,11,106,89.83050847457628,18.64406779661017
12729_marine,47,29,43,10,76,91.48936170212765,21.27659574468085
12730_marine,45,24,41,10,69,91.11111111111111,22.22222222222222
12731_marine,44,22,40,10,66,90.9090909090909,22.727272727272727
12732_marine,44,24,40,10,68,90.9090909090909,22.727272727272727
12733_marine,44,22,40,10,66,90.9090909090909,22.727272727272727
12734_marine,44,20,40,10,64,90.9090909090909,22.727272727272727
12735_marine,41,20,37,9,61,90.2439024390244,21.951219512195124
12736_marine,44,20,41,8,64,93.18181818181817,18.181818181818183
12737_marine,44,20,41,8,64,93.18181818181817,18.181818181818183
12738_marine,40,19,38,7,59,95,17.5
12739_marine,40,19,38,7,59,95,17.5
12740_marine,43,19,41,7,62,95.34883720930233,16.27906976744186
12741_marine,43,18,41,7,61,95.34883720930233,16.27906976744186
12742_marine,41,20,39,7,61,95.1219512195122,17.073170731707318
12743_marine,39,22,37,7,61,94.87179487179486,17.94871794871795
12744_marine,42,36,40,7,78,95.23809523809523,16.666666666666664
12745_marine,43,44,41,7,87,95.34883720930233,16.27906976744186
12746_marine,44,44,43,6,88,97.72727272727273,13.636363636363635
12747_marine,44,32,43,6,76,97.72727272727273,13.636363636363635
12748_marine,44,24,43,6,68,97.72727272727273,13.636363636363635
12749_marine,44,24,43,6,68,97.72727272727273,13.636363636363635
12750_marine,47,20,43,6,67,91.48936170212765,12.76595744680851
12751_marine,47,20,43,6,67,91.48936170212765,12.76595744680851
12752_marine,46,20,42,5,66,91.30434782608695,10.869565217391305
12753_marine,48,20,44,5,68,91.66666666666666,10.416666666666668
12754_marine,47,20,43,4,67,91.48936170212765,8.51063829787234
12755_marine,48,36,43,5,84,89.58333333333334,10.416666666666668
12756_marine,47,26,42,4,73,89.36170212765957,8.51063829787234
12757_marine,48,30,43,4,78,89.58333333333334,8.333333333333332
12758_marine,52,34,47,4,86,90.38461538461539,7.6923076923076925
12759_marine,51,22,46,5,73,90.19607843137256,9.803921568627452
12760_marine,56,44,51,5,100,91.07142857142857,8.928571428571429
12761_marine,59,48,54,6,107,91.52542372881356,10.16949152542373
12762_marine,60,58,55,7,118,91.66666666666666,11.666666666666666
12763_marine,60,60,55,7,120,91.66666666666666,11.666666666666666
12764_marine,60,52,55,7,112,91.66666666666666,11.666666666666666
12765_marine,56,40,51,7,96,91.07142857142857,12.5
12766_marine,60,61,55,7,121,91.66666666666666,11.666666666666666
12767_marine,69,69,63,8,138,91.30434782608695,11.594202898550725
12768_marine,85,83,77,8,168,90.58823529411765,9.411764705882353
12769_marine,146,118,127,17,264,86.98630136986301,11.643835616438356
12781_marine,138,66,115,28,204,83.33333333333334,20.28985507246377
12782_marine,122,59,103,18,181,84.42622950819673,14.754098360655737
12783_marine,119,54,102,15,173,85.71428571428571,12.605042016806722
12784_marine,108,52,96,12,160,88.88888888888889,11.11111111111111
12785_marine,118,55,103,15,173,87.28813559322035,12.711864406779661
12786_marine,118,53,104,15,171,88.13559322033898,12.711864406779661
12787_marine,119,54,104,17,173,87.39495798319328,14.285714285714285
12788_marine,160,73,140,30,233,87.5,18.75
12802_marine,40,19,36,13,59,90,32.5
12922_marine,49,31,40,17,80,81.63265306122449,34.69387755102041
12924_marine,122,55,88,77,177,72.1311475409836,63.114754098360656
12925_marine,50,34,44,11,84,88,22
12926_marine,48,28,42,10,76,87.5,20.833333333333336
12927_marine,46,28,40,10,74,86.95652173913044,21.73913043478261
12928_marine,44,29,38,8,73,86.36363636363636,18.181818181818183
12929_marine,41,28,35,7,69,85.36585365853658,17.073170731707318
12930_marine,41,29,35,7,70,85.36585365853658,17.073170731707318
12931_marine,40,29,33,8,69,82.5,20
12932_marine,42,28,35,10,70,83.33333333333334,23.809523809523807
12933_marine,44,28,37,11,72,84.0909090909091,25
12934_marine,43,26,36,10,69,83.72093023255815,23.25581395348837
12935_marine,48,32,39,10,80,81.25,20.833333333333336
12936_marine,178,84,111,104,262,62.35955056179775,58.42696629213483
12940_marine,159,96,99,91,255,62.264150943396224,57.23270440251572
12941_marine,192,106,119,116,298,61.979166666666664,60.416666666666664
12942_marine,195,103,120,118,298,61.53846153846154,60.51282051282051
12943_marine,197,104,122,119,301,61.92893401015228,60.40609137055838
12944_marine,61,48,48,19,109,78.68852459016394,31.147540983606557
12945_marine,58,40,47,17,98,81.03448275862068,29.310344827586203
12946_marine,69,37,54,26,106,78.26086956521739,37.68115942028986
12947_marine,120,58,89,68,178,74.16666666666667,56.666666666666664
12948_marine,117,54,88,66,171,75.21367521367522,56.41025641025641
12949_marine,111,53,83,60,164,74.77477477477478,54.054054054054056
12950_marine,60,38,50,15,98,83.33333333333334,25
12951_marine,50,39,41,13,89,82,26
12952_marine,49,39,41,12,88,83.6734693877551,24.489795918367346
12953_marine,49,34,41,12,83,83.6734693877551,24.489795918367346
12954_marine,50,32,42,12,82,84,24
12955_marine,49,31,42,11,80,85.71428571428571,22.448979591836736
12956_marine,45,21,40,11,66,88.88888888888889,24.444444444444443
12957_marine,48,28,43,12,76,89.58333333333334,25
12958_marine,49,36,43,10,85,87.75510204081633,20.408163265306122
12959_marine,50,35,44,8,85,88,16
12960_marine,49,38,43,7,87,87.75510204081633,14.285714285714285
12961_marine,50,36,43,11,86,86,22
12962_marine,48,34,40,12,82,83.33333333333334,25
12963_marine,50,32,40,14,82,80,28.000000000000004
12964_marine,56,37,46,14,93,82.14285714285714,25
12965_marine,57,40,47,14,97,82.45614035087719,24.561403508771928
12966_marine,58,40,48,14,98,82.75862068965517,24.137931034482758
12967_marine,62,46,51,18,108,82.25806451612904,29.03225806451613
12968_marine,65,45,53,21,110,81.53846153846153,32.30769230769231
12969_marine,70,47,55,25,117,78.57142857142857,35.714285714285715
12970_marine,75,47,58,28,122,77.33333333333333,37.333333333333336
12971_marine,123,60,89,71,183,72.35772357723577,57.72357723577236
12972_marine,145,69,104,83,214,71.72413793103448,57.24137931034483
12973_marine,149,71,107,82,220,71.81208053691275,55.033557046979865
12974_marine,152,70,105,86,222,69.07894736842105,56.57894736842105
12975_marine,92,54,71,30,146,77.17391304347827,32.608695652173914
12976_marine,94,51,71,30,145,75.53191489361703,31.914893617021278
12977_marine,89,52,68,29,141,76.40449438202246,32.58426966292135
12978_marine,86,50,68,26,136,79.06976744186046,30.23255813953488
12979_marine,79,50,64,21,129,81.0126582278481,26.582278481012654
12980_marine,70,45,56,16,115,80,22.857142857142858
12981_marine,70,40,57,16,110,81.42857142857143,22.857142857142858
12982_marine,65,36,53,14,101,81.53846153846153,21.53846153846154
12983_marine,65,36,53,14,101,81.53846153846153,21.53846153846154
12984_marine,58,36,48,13,94,82.75862068965517,22.413793103448278
12985_marine,52,35,44,9,87,84.61538461538461,17.307692307692307
12986_marine,45,29,39,9,74,86.66666666666667,20
12987_marine,41,25,37,7,66,90.2439024390244,17.073170731707318
12988_marine,41,24,37,7,65,90.2439024390244,17.073170731707318
12989_marine,40,24,37,6,64,92.5,15
12990_marine,40,25,37,6,65,92.5,15
12991_marine,38,25,35,5,63,92.10526315789474,13.157894736842104
12992_marine,38,25,35,5,63,92.10526315789474,13.157894736842104
12993_marine,38,24,35,5,62,92.10526315789474,13.157894736842104
12994_marine,38,23,35,5,61,92.10526315789474,13.157894736842104
12995_marine,38,23,35,5,61,92.10526315789474,13.157894736842104
12996_marine,38,23,35,5,61,92.10526315789474,13.157894736842104
12997_marine,40,23,37,5,63,92.5,12.5
12998_marine,40,23,37,5,63,92.5,12.5
12999_marine,40,23,37,5,63,92.5,12.5
13000_marine,40,24,37,5,64,92.5,12.5
13001_marine,42,24,39,5,66,92.85714285714286,11.904761904761903
13002_marine,44,25,40,6,69,90.9090909090909,13.636363636363635
13003_marine,49,25,45,7,74,91.83673469387756,14.285714285714285
13004_marine,55,26,51,9,81,92.72727272727272,16.363636363636363
13005_marine,71,33,62,11,104,87.32394366197182,15.492957746478872
13006_marine,86,48,75,14,134,87.20930232558139,16.27906976744186
13059_marine,69,32,30,56,101,43.47826086956522,81.15942028985508
13060_marine,79,33,36,66,112,45.56962025316456,83.54430379746836
13061_marine,115,83,46,80,198,40,69.56521739130434
13083_marine,158,89,87,86,247,55.06329113924051,54.43037974683544
13084_marine,165,89,93,92,254,56.36363636363636,55.757575757575765
13085_marine,177,99,104,92,276,58.75706214689266,51.9774011299435
13086_marine,67,40,60,15,107,89.55223880597015,22.388059701492537
13087_marine,65,47,59,13,112,90.76923076923077,20
13088_marine,60,55,54,12,115,90,20
13089_marine,59,55,54,10,114,91.52542372881356,16.94915254237288
13090_marine,48,25,44,10,73,91.66666666666666,20.833333333333336
13091_marine,44,22,40,10,66,90.9090909090909,22.727272727272727
13092_marine,44,22,40,10,66,90.9090909090909,22.727272727272727
13093_marine,42,20,38,10,62,90.47619047619048,23.809523809523807
13094_marine,42,20,38,10,62,90.47619047619048,23.809523809523807
13095_marine,44,20,41,8,64,93.18181818181817,18.181818181818183
13096_marine,44,20,41,8,64,93.18181818181817,18.181818181818183
13097_marine,43,19,41,7,62,95.34883720930233,16.27906976744186
13098_marine,43,19,41,7,62,95.34883720930233,16.27906976744186
13099_marine,43,19,41,7,62,95.34883720930233,16.27906976744186
13100_marine,41,19,39,7,60,95.1219512195122,17.073170731707318
13101_marine,41,18,39,7,59,95.1219512195122,17.073170731707318
13102_marine,39,18,37,7,57,94.87179487179486,17.94871794871795
13103_marine,40,28,39,6,68,97.5,15
13104_marine,43,30,42,6,73,97.67441860465115,13.953488372093023
13105_marine,48,44,47,6,92,97.91666666666666,12.5
13106_marine,48,44,47,6,92,97.91666666666666,12.5
13107_marine,48,34,45,6,82,93.75,12.5
13108_marine,48,28,45,6,76,93.75,12.5
13109_marine,49,22,45,6,71,91.83673469387756,12.244897959183673
13110_marine,47,20,43,4,67,91.48936170212765,8.51063829787234
13111_marine,47,20,43,4,67,91.48936170212765,8.51063829787234
13112_marine,47,20,43,3,67,91.48936170212765,6.382978723404255
13113_marine,47,20,43,3,67,91.48936170212765,6.382978723404255
13114_marine,46,20,42,2,66,91.30434782608695,4.3478260869565215
13115_marine,48,22,44,2,70,91.66666666666666,4.166666666666666
13116_marine,49,26,44,3,75,89.79591836734694,6.122448979591836
13117_marine,49,22,44,3,71,89.79591836734694,6.122448979591836
13118_marine,50,20,45,4,70,90,8
13119_marine,50,22,45,4,72,90,8
13120_marine,58,40,53,5,98,91.37931034482759,8.620689655172415
13121_marine,59,46,54,5,105,91.52542372881356,8.47457627118644
13122_marine,55,43,50,7,98,90.9090909090909,12.727272727272727
13123_marine,53,29,48,7,82,90.56603773584906,13.20754716981132
13124_marine,54,29,49,7,83,90.74074074074075,12.962962962962962
13125_marine,65,65,59,7,130,90.76923076923077,10.76923076923077
13126_marine,76,75,70,7,151,92.10526315789474,9.210526315789473
13127_marine,80,77,74,8,157,92.5,10
13128_marine,93,81,84,9,174,90.32258064516128,9.67741935483871
13129_marine,156,106,136,18,262,87.17948717948718,11.538461538461538
13135_marine,169,88,148,35,257,87.57396449704143,20.710059171597635
13142_marine,143,67,120,26,210,83.91608391608392,18.181818181818183
13143_marine,139,63,117,22,202,84.17266187050359,15.827338129496402
13144_marine,130,59,110,22,189,84.61538461538461,16.923076923076923
13151_marine,58,29,51,12,87,87.93103448275862,20.689655172413794
13284_marine,132,55,95,83,187,71.96969696969697,62.878787878787875
13285_marine,61,37,51,17,98,83.60655737704919,27.86885245901639
13286_marine,44,26,38,11,70,86.36363636363636,25
13287_marine,43,26,37,10,69,86.04651162790698,23.25581395348837
13288_marine,41,21,37,10,62,90.2439024390244,24.390243902439025
13289_marine,45,30,39,8,75,86.66666666666667,17.77777777777778
13290_marine,46,29,39,9,75,84.78260869565217,19.565217391304348
13291_marine,43,27,36,9,70,83.72093023255815,20.930232558139537
13292_marine,41,27,34,9,68,82.92682926829268,21.951219512195124
13293_marine,47,26,38,11,73,80.85106382978722,23.404255319148938
13294_marine,49,26,40,11,75,81.63265306122449,22.448979591836736
13295_marine,48,30,39,10,78,81.25,20.833333333333336
13296_marine,107,44,73,63,151,68.22429906542055,58.87850467289719
13297_marine,101,44,69,63,145,68.31683168316832,62.37623762376238
13299_marine,187,108,113,114,295,60.42780748663101,60.962566844919785
13300_marine,192,111,119,116,303,61.979166666666664,60.416666666666664
13301_marine,201,98,126,121,299,62.68656716417911,60.19900497512438
13302_marine,63,48,50,21,111,79.36507936507937,33.33333333333333
13303_marine,61,43,49,19,104,80.32786885245902,31.147540983606557
13304_marine,52,36,41,14,88,78.84615384615384,26.923076923076923
13305_marine,49,35,40,13,84,81.63265306122449,26.53061224489796
13306_marine,53,37,44,15,90,83.01886792452831,28.30188679245283
13307_marine,54,36,45,15,90,83.33333333333334,27.77777777777778
13308_marine,55,38,45,16,93,81.81818181818183,29.09090909090909
13309_marine,61,38,50,18,99,81.9672131147541,29.508196721311474
13310_marine,54,40,44,14,94,81.48148148148148,25.925925925925924
13311_marine,59,41,49,15,100,83.05084745762711,25.423728813559322
13312_marine,63,47,51,19,110,80.95238095238095,30.158730158730158
13313_marine,72,48,57,28,120,79.16666666666666,38.88888888888889
13314_marine,64,46,51,21,110,79.6875,32.8125
13315_marine,59,43,48,19,102,81.35593220338984,32.20338983050847
13316_marine,58,42,49,17,100,84.48275862068965,29.310344827586203
13317_marine,59,39,50,17,98,84.7457627118644,28.8135593220339
13318_marine,56,38,47,14,94,83.92857142857143,25
13319_marine,54,36,45,13,90,83.33333333333334,24.074074074074073
13320_marine,55,40,45,13,95,81.81818181818183,23.636363636363637
13321_marine,73,48,60,26,121,82.1917808219178,35.61643835616438
13322_marine,71,49,57,25,120,80.28169014084507,35.2112676056338
13323_marine,71,49,57,25,120,80.28169014084507,35.2112676056338
13324_marine,125,64,91,75,189,72.8,60
13325_marine,127,63,92,75,190,72.44094488188976,59.055118110236215
13326_marine,128,64,93,75,192,72.65625,58.59375
13327_marine,128,62,93,75,190,72.65625,58.59375
13328_marine,126,62,91,72,188,72.22222222222221,57.14285714285714
13329_marine,126,62,88,71,188,69.84126984126983,56.34920634920635
13330_marine,131,61,93,76,192,70.99236641221374,58.01526717557252
13331_marine,141,66,101,82,207,71.63120567375887,58.156028368794324
13332_marine,142,66,102,81,208,71.83098591549296,57.04225352112676
13333_marine,86,50,68,27,136,79.06976744186046,31.3953488372093
13334_marine,82,47,64,27,129,78.04878048780488,32.926829268292686
13335_marine,77,46,63,22,123,81.81818181818183,28.57142857142857
13336_marine,65,39,50,17,104,76.92307692307693,26.153846153846157
13337_marine,65,39,50,17,104,76.92307692307693,26.153846153846157
13338_marine,60,37,48,14,97,80,23.333333333333332
13339_marine,60,36,48,14,96,80,23.333333333333332
13340_marine,58,36,46,12,94,79.3103448275862,20.689655172413794
13341_marine,55,35,45,10,90,81.81818181818183,18.181818181818183
13342_marine,44,27,40,10,71,90.9090909090909,22.727272727272727
13343_marine,40,27,36,8,67,90,20
13344_marine,40,25,36,8,65,90,20
13345_marine,40,25,36,8,65,90,20
13346_marine,40,24,37,6,64,92.5,15
13347_marine,40,24,37,6,64,92.5,15
13348_marine,40,24,37,6,64,92.5,15
13349_marine,40,25,37,6,65,92.5,15
13350_marine,40,25,37,6,65,92.5,15
13351_marine,38,26,35,5,64,92.10526315789474,13.157894736842104
13352_marine,38,26,35,5,64,92.10526315789474,13.157894736842104
13353_marine,38,26,35,5,64,92.10526315789474,13.157894736842104
13354_marine,38,26,35,5,64,92.10526315789474,13.157894736842104
13355_marine,38,25,35,5,63,92.10526315789474,13.157894736842104
13356_marine,38,25,35,5,63,92.10526315789474,13.157894736842104
13357_marine,38,25,35,5,63,92.10526315789474,13.157894736842104
13358_marine,38,24,35,5,62,92.10526315789474,13.157894736842104
13359_marine,38,23,35,5,61,92.10526315789474,13.157894736842104
13360_marine,38,23,35,5,61,92.10526315789474,13.157894736842104
13361_marine,38,23,35,5,61,92.10526315789474,13.157894736842104
13362_marine,40,23,37,5,63,92.5,12.5
13363_marine,41,24,38,5,65,92.6829268292683,12.195121951219512
13364_marine,46,25,42,6,71,91.30434782608695,13.043478260869565
13365_marine,50,26,46,7,76,92,14.000000000000002
13366_marine,68,33,61,11,101,89.70588235294117,16.176470588235293
13367_marine,93,50,80,20,143,86.02150537634408,21.50537634408602
13368_marine,178,96,115,94,274,64.60674157303372,52.80898876404494
13369_marine,182,98,116,96,280,63.73626373626373,52.74725274725275
13370_marine,181,98,118,99,279,65.19337016574586,54.69613259668509
13371_marine,202,109,135,118,311,66.83168316831683,58.415841584158414
13421_marine,81,38,34,73,119,41.9753086419753,90.12345679012346
13444_marine,159,87,89,88,246,55.9748427672956,55.34591194968554
13445_marine,197,113,118,101,310,59.89847715736041,51.26903553299492
13446_marine,77,45,69,18,122,89.6103896103896,23.376623376623375
13447_marine,69,48,63,15,117,91.30434782608695,21.73913043478261
13448_marine,65,44,59,12,109,90.76923076923077,18.461538461538463
13449_marine,60,54,55,11,114,91.66666666666666,18.333333333333332
13450_marine,58,48,54,10,106,93.10344827586206,17.24137931034483
13451_marine,42,28,38,10,70,90.47619047619048,23.809523809523807
13452_marine,42,23,38,10,65,90.47619047619048,23.809523809523807
13453_marine,46,23,42,10,69,91.30434782608695,21.73913043478261
13454_marine,46,22,43,8,68,93.47826086956522,17.391304347826086
13455_marine,46,24,43,8,70,93.47826086956522,17.391304347826086
13456_marine,46,22,44,7,68,95.65217391304348,15.217391304347828
13457_marine,45,20,43,7,65,95.55555555555556,15.555555555555555
13458_marine,45,20,43,7,65,95.55555555555556,15.555555555555555
13459_marine,43,22,41,7,65,95.34883720930233,16.27906976744186
13460_marine,43,23,42,6,66,97.67441860465115,13.953488372093023
13461_marine,42,21,41,6,63,97.61904761904762,14.285714285714285
13462_marine,45,21,44,6,66,97.77777777777777,13.333333333333334
13463_marine,46,21,45,6,67,97.82608695652173,13.043478260869565
13464_marine,46,23,45,6,69,97.82608695652173,13.043478260869565
13465_marine,48,29,45,6,77,93.75,12.5
13466_marine,48,43,45,6,91,93.75,12.5
13467_marine,51,41,47,6,92,92.15686274509804,11.76470588235294
13468_marine,48,39,44,4,87,91.66666666666666,8.333333333333332
13469_marine,48,33,44,4,81,91.66666666666666,8.333333333333332
13470_marine,47,33,43,3,80,91.48936170212765,6.382978723404255
13471_marine,47,31,43,3,78,91.48936170212765,6.382978723404255
13472_marine,47,21,43,3,68,91.48936170212765,6.382978723404255
13473_marine,48,21,44,2,69,91.66666666666666,4.166666666666666
13474_marine,48,21,44,2,69,91.66666666666666,4.166666666666666
13475_marine,48,21,44,2,69,91.66666666666666,4.166666666666666
13476_marine,49,21,44,3,70,89.79591836734694,6.122448979591836
13477_marine,50,22,45,3,72,90,6
13478_marine,50,22,45,3,72,90,6
13479_marine,50,24,45,3,74,90,6
13480_marine,51,28,46,4,79,90.19607843137256,7.8431372549019605
13481_marine,52,27,47,5,79,90.38461538461539,9.615384615384617
13482_marine,53,23,48,6,76,90.56603773584906,11.320754716981133
13483_marine,57,23,52,7,80,91.22807017543859,12.280701754385964
13484_marine,58,23,52,7,81,89.65517241379311,12.068965517241379
13485_marine,69,69,63,7,138,91.30434782608695,10.144927536231885
13486_marine,73,79,67,7,152,91.78082191780823,9.58904109589041
13487_marine,82,79,76,8,161,92.6829268292683,9.75609756097561
13488_marine,93,85,82,11,178,88.17204301075269,11.827956989247312
13489_marine,162,119,140,21,281,86.41975308641975,12.962962962962962
13503_marine,145,69,123,23,214,84.82758620689656,15.862068965517242
13504_marine,141,61,118,26,202,83.68794326241135,18.439716312056735
13506_marine,122,55,104,23,177,85.24590163934425,18.852459016393443
13641_marine,53,42,44,15,95,83.01886792452831,28.30188679245283
13645_marine,65,37,55,17,102,84.61538461538461,26.153846153846157
13646_marine,45,28,39,10,73,86.66666666666667,22.22222222222222
13647_marine,38,21,34,9,59,89.47368421052632,23.684210526315788
13648_marine,39,21,35,10,60,89.74358974358975,25.64102564102564
13649_marine,39,26,35,10,65,89.74358974358975,25.64102564102564
13650_marine,41,24,36,10,65,87.8048780487805,24.390243902439025
13651_marine,45,28,38,10,73,84.44444444444444,22.22222222222222
13652_marine,47,28,38,10,75,80.85106382978722,21.27659574468085
13653_marine,50,27,41,11,77,82,22
13654_marine,54,29,45,14,83,83.33333333333334,25.925925925925924
13655_marine,52,30,43,12,82,82.6923076923077,23.076923076923077
13656_marine,56,37,43,17,93,76.78571428571429,30.357142857142854
13657_marine,181,96,112,110,277,61.87845303867403,60.773480662983424
13659_marine,201,108,125,122,309,62.189054726368155,60.69651741293532
13660_marine,72,50,55,26,122,76.38888888888889,36.11111111111111
13661_marine,71,50,54,25,121,76.05633802816901,35.2112676056338
13662_marine,56,41,46,16,97,82.14285714285714,28.57142857142857
13663_marine,42,26,38,12,68,90.47619047619048,28.57142857142857
13664_marine,40,25,36,10,65,90,25
13665_marine,42,24,36,12,66,85.71428571428571,28.57142857142857
13666_marine,41,25,35,11,66,85.36585365853658,26.82926829268293
13667_marine,41,25,35,11,66,85.36585365853658,26.82926829268293
13668_marine,47,33,39,11,80,82.97872340425532,23.404255319148938
13669_marine,47,33,41,12,80,87.2340425531915,25.53191489361702
13670_marine,51,37,41,14,88,80.3921568627451,27.450980392156865
13671_marine,55,42,45,15,97,81.81818181818183,27.27272727272727
13672_marine,64,48,52,20,112,81.25,31.25
13673_marine,99,59,77,50,158,77.77777777777779,50.505050505050505
13674_marine,98,55,78,49,153,79.59183673469387,50
13675_marine,100,55,78,50,155,78,50
13676_marine,95,52,78,45,147,82.10526315789474,47.368421052631575
13677_marine,75,47,57,31,122,76,41.333333333333336
13678_marine,94,53,75,48,147,79.7872340425532,51.06382978723404
13679_marine,94,53,75,47,147,79.7872340425532,50
13680_marine,91,53,72,44,144,79.12087912087912,48.35164835164835
13681_marine,132,59,99,79,191,75,59.84848484848485
13682_marine,132,63,98,78,195,74.24242424242425,59.09090909090909
13683_marine,132,63,97,78,195,73.48484848484848,59.09090909090909
13684_marine,139,64,102,81,203,73.38129496402878,58.27338129496403
13685_marine,131,62,96,73,193,73.2824427480916,55.72519083969466
13686_marine,81,53,65,26,134,80.24691358024691,32.098765432098766
13687_marine,81,51,65,26,132,80.24691358024691,32.098765432098766
13688_marine,80,53,63,27,133,78.75,33.75
13689_marine,81,51,63,29,132,77.77777777777779,35.80246913580247
13690_marine,76,47,62,24,123,81.57894736842105,31.57894736842105
13691_marine,70,43,59,20,113,84.28571428571429,28.57142857142857
13692_marine,64,38,54,16,102,84.375,25
13693_marine,56,38,47,14,94,83.92857142857143,25
13694_marine,58,36,47,14,94,81.03448275862068,24.137931034482758
13695_marine,58,36,47,14,94,81.03448275862068,24.137931034482758
13696_marine,49,27,40,12,76,81.63265306122449,24.489795918367346
13697_marine,48,26,40,11,74,83.33333333333334,22.916666666666664
13698_marine,47,24,41,9,71,87.2340425531915,19.148936170212767
13699_marine,45,25,41,9,70,91.11111111111111,20
13700_marine,45,25,41,9,70,91.11111111111111,20
13701_marine,42,25,38,8,67,90.47619047619048,19.047619047619047
13702_marine,40,25,36,8,65,90,20
13703_marine,39,24,36,7,63,92.3076923076923,17.94871794871795
13704_marine,39,25,36,7,64,92.3076923076923,17.94871794871795
13705_marine,38,24,35,6,62,92.10526315789474,15.789473684210526
13706_marine,38,24,35,6,62,92.10526315789474,15.789473684210526
13707_marine,38,25,35,6,63,92.10526315789474,15.789473684210526
13708_marine,38,26,35,6,64,92.10526315789474,15.789473684210526
13709_marine,40,24,37,6,64,92.5,15
13710_marine,39,24,36,5,63,92.3076923076923,12.82051282051282
13711_marine,38,24,35,5,62,92.10526315789474,13.157894736842104
13712_marine,38,23,35,5,61,92.10526315789474,13.157894736842104
13713_marine,38,23,35,5,61,92.10526315789474,13.157894736842104
13714_marine,38,23,35,5,61,92.10526315789474,13.157894736842104
13715_marine,38,23,35,5,61,92.10526315789474,13.157894736842104
13716_marine,38,22,35,5,60,92.10526315789474,13.157894736842104
13717_marine,38,22,35,5,60,92.10526315789474,13.157894736842104
13718_marine,38,22,35,5,60,92.10526315789474,13.157894736842104
13719_marine,38,25,35,5,63,92.10526315789474,13.157894736842104
13720_marine,38,25,35,5,63,92.10526315789474,13.157894736842104
13721_marine,38,24,35,5,62,92.10526315789474,13.157894736842104
13722_marine,38,24,35,5,62,92.10526315789474,13.157894736842104
13723_marine,40,23,37,5,63,92.5,12.5
13724_marine,44,23,41,5,67,93.18181818181817,11.363636363636363
13725_marine,46,25,43,5,71,93.47826086956522,10.869565217391305
13726_marine,52,26,48,7,78,92.3076923076923,13.461538461538462
13727_marine,70,35,63,10,105,90,14.285714285714285
13728_marine,89,46,77,17,135,86.51685393258427,19.101123595505616
13729_marine,173,96,116,93,269,67.05202312138728,53.75722543352601
13730_marine,173,98,116,94,271,67.05202312138728,54.33526011560693
13731_marine,108,59,91,30,167,84.25925925925925,27.77777777777778
13732_marine,207,108,134,125,315,64.73429951690821,60.38647342995169
13802_marine,185,114,109,98,299,58.91891891891892,52.972972972972975
13803_marine,211,121,121,111,332,57.345971563981045,52.60663507109005
13804_marine,215,112,124,116,327,57.674418604651166,53.95348837209303
13805_marine,221,115,127,115,336,57.466063348416284,52.03619909502263
13806_marine,79,46,71,17,125,89.87341772151899,21.518987341772153
13807_marine,67,46,61,14,113,91.04477611940298,20.8955223880597
13808_marine,67,44,61,14,111,91.04477611940298,20.8955223880597
13809_marine,64,46,59,11,110,92.1875,17.1875
13810_marine,60,50,55,11,110,91.66666666666666,18.333333333333332
13811_marine,56,45,52,10,101,92.85714285714286,17.857142857142858
13812_marine,48,32,44,10,80,91.66666666666666,20.833333333333336
13813_marine,48,24,44,10,72,91.66666666666666,20.833333333333336
13814_marine,46,28,44,7,74,95.65217391304348,15.217391304347828
13815_marine,48,22,46,9,70,95.83333333333334,18.75
13816_marine,47,22,45,9,69,95.74468085106383,19.148936170212767
13817_marine,48,22,46,9,70,95.83333333333334,18.75
13818_marine,48,20,47,8,68,97.91666666666666,16.666666666666664
13819_marine,46,20,45,6,66,97.82608695652173,13.043478260869565
13820_marine,44,23,43,6,67,97.72727272727273,13.636363636363635
13821_marine,45,23,44,6,68,97.77777777777777,13.333333333333334
13822_marine,48,23,45,6,71,93.75,12.5
13823_marine,48,21,45,6,69,93.75,12.5
13824_marine,49,21,46,6,70,93.87755102040816,12.244897959183673
13825_marine,49,21,46,6,70,93.87755102040816,12.244897959183673
13826_marine,49,23,45,5,72,91.83673469387756,10.204081632653061
13827_marine,48,25,44,4,73,91.66666666666666,8.333333333333332
13828_marine,47,25,43,3,72,91.48936170212765,6.382978723404255
13829_marine,48,29,44,3,77,91.66666666666666,6.25
13830_marine,50,37,46,3,87,92,6
13831_marine,50,35,46,3,85,92,6
13832_marine,49,29,45,2,78,91.83673469387756,4.081632653061225
13833_marine,50,26,46,2,76,92,4
13834_marine,50,24,46,2,74,92,4
13835_marine,50,24,46,2,74,92,4
13836_marine,51,24,46,3,75,90.19607843137256,5.88235294117647
13837_marine,51,24,46,3,75,90.19607843137256,5.88235294117647
13838_marine,51,26,46,3,77,90.19607843137256,5.88235294117647
13839_marine,51,26,46,3,77,90.19607843137256,5.88235294117647
13840_marine,51,24,46,3,75,90.19607843137256,5.88235294117647
13841_marine,54,24,49,4,78,90.74074074074075,7.4074074074074066
13842_marine,56,24,51,6,80,91.07142857142857,10.714285714285714
13843_marine,57,24,52,7,81,91.22807017543859,12.280701754385964
13844_marine,58,28,52,7,86,89.65517241379311,12.068965517241379
13845_marine,70,64,64,7,134,91.42857142857143,10
13846_marine,74,78,68,7,152,91.8918918918919,9.45945945945946
13847_marine,75,80,69,8,155,92,10.666666666666668
13848_marine,94,85,83,11,179,88.29787234042553,11.702127659574469
13849_marine,163,125,141,20,288,86.50306748466258,12.269938650306749
13854_marine,171,79,149,28,250,87.13450292397661,16.374269005847953
14005_marine,65,37,55,17,102,84.61538461538461,26.153846153846157
14006_marine,50,28,44,11,78,88,22
14007_marine,46,27,40,11,73,86.95652173913044,23.91304347826087
14008_marine,41,23,37,12,64,90.2439024390244,29.268292682926827
14009_marine,42,26,37,13,68,88.09523809523809,30.952380952380953
14010_marine,42,26,37,11,68,88.09523809523809,26.190476190476193
14011_marine,43,26,36,10,69,83.72093023255815,23.25581395348837
14012_marine,49,30,40,11,79,81.63265306122449,22.448979591836736
14013_marine,53,28,44,13,81,83.01886792452831,24.528301886792452
14014_marine,56,33,46,15,89,82.14285714285714,26.785714285714285
14015_marine,63,39,50,18,102,79.36507936507937,28.57142857142857
14016_marine,72,49,54,27,121,75,37.5
14017_marine,208,108,131,123,316,62.980769230769226,59.13461538461539
14018_marine,198,107,125,117,305,63.13131313131313,59.09090909090909
14019_marine,200,105,127,120,305,63.5,60
14020_marine,67,48,54,21,115,80.59701492537313,31.343283582089555
14021_marine,57,39,49,15,96,85.96491228070175,26.31578947368421
14022_marine,41,27,36,11,68,87.8048780487805,26.82926829268293
14023_marine,37,24,34,11,61,91.8918918918919,29.72972972972973
14024_marine,36,24,33,10,60,91.66666666666666,27.77777777777778
14025_marine,36,23,33,10,59,91.66666666666666,27.77777777777778
14026_marine,39,23,36,12,62,92.3076923076923,30.76923076923077
14027_marine,41,23,38,12,64,92.6829268292683,29.268292682926827
14028_marine,41,24,38,12,65,92.6829268292683,29.268292682926827
14029_marine,41,24,38,12,65,92.6829268292683,29.268292682926827
14030_marine,44,25,39,12,69,88.63636363636364,27.27272727272727
14031_marine,52,36,44,14,88,84.61538461538461,26.923076923076923
14032_marine,52,36,44,14,88,84.61538461538461,26.923076923076923
14033_marine,59,43,48,19,102,81.35593220338984,32.20338983050847
14034_marine,65,44,52,22,109,80,33.84615384615385
14035_marine,67,47,52,24,114,77.61194029850746,35.82089552238806
14036_marine,67,48,54,22,115,80.59701492537313,32.83582089552239
14037_marine,73,49,56,28,122,76.71232876712328,38.35616438356164
14038_marine,94,56,75,48,150,79.7872340425532,51.06382978723404
14039_marine,98,55,76,50,153,77.55102040816327,51.02040816326531
14040_marine,99,55,77,49,154,77.77777777777779,49.494949494949495
14041_marine,80,48,66,27,128,82.5,33.75
14042_marine,78,50,65,24,128,83.33333333333334,30.76923076923077
14043_marine,77,47,63,22,124,81.81818181818183,28.57142857142857
14044_marine,75,46,62,22,121,82.66666666666667,29.333333333333332
14045_marine,70,40,59,17,110,84.28571428571429,24.285714285714285
14046_marine,63,40,52,16,103,82.53968253968253,25.396825396825395
14047_marine,62,41,51,15,103,82.25806451612904,24.193548387096776
14048_marine,60,36,49,15,96,81.66666666666667,25
14049_marine,59,35,49,14,94,83.05084745762711,23.728813559322035
14050_marine,59,35,49,14,94,83.05084745762711,23.728813559322035
14051_marine,51,24,43,13,75,84.31372549019608,25.49019607843137
14052_marine,50,24,42,12,74,84,24
14053_marine,50,24,43,11,74,86,22
14054_marine,50,24,43,11,74,86,22
14055_marine,49,24,43,10,73,87.75510204081633,20.408163265306122
14056_marine,48,24,43,9,72,89.58333333333334,18.75
14057_marine,48,24,43,9,72,89.58333333333334,18.75
14058_marine,44,24,39,9,68,88.63636363636364,20.454545454545457
14059_marine,43,25,38,8,68,88.37209302325581,18.6046511627907
14060_marine,42,24,38,7,66,90.47619047619048,16.666666666666664
14061_marine,40,24,36,7,64,90,17.5
14062_marine,40,24,36,7,64,90,17.5
14063_marine,39,24,35,6,63,89.74358974358975,15.384615384615385
14064_marine,39,26,35,6,65,89.74358974358975,15.384615384615385
14065_marine,39,24,35,6,63,89.74358974358975,15.384615384615385
14066_marine,39,24,35,6,63,89.74358974358975,15.384615384615385
14067_marine,39,24,35,6,63,89.74358974358975,15.384615384615385
14068_marine,39,25,35,6,64,89.74358974358975,15.384615384615385
14069_marine,38,25,34,5,63,89.47368421052632,13.157894736842104
14070_marine,37,25,33,5,62,89.1891891891892,13.513513513513514
14071_marine,37,25,33,5,62,89.1891891891892,13.513513513513514
14072_marine,37,25,33,5,62,89.1891891891892,13.513513513513514
14073_marine,37,25,33,5,62,89.1891891891892,13.513513513513514
14074_marine,39,24,35,5,63,89.74358974358975,12.82051282051282
14075_marine,39,24,35,5,63,89.74358974358975,12.82051282051282
14076_marine,39,24,35,5,63,89.74358974358975,12.82051282051282
14077_marine,38,23,34,5,61,89.47368421052632,13.157894736842104
14078_marine,38,23,34,5,61,89.47368421052632,13.157894736842104
14079_marine,38,23,34,5,61,89.47368421052632,13.157894736842104
14080_marine,39,23,35,5,62,89.74358974358975,12.82051282051282
14081_marine,39,22,35,5,61,89.74358974358975,12.82051282051282
14082_marine,39,25,35,5,64,89.74358974358975,12.82051282051282
14083_marine,39,24,35,5,63,89.74358974358975,12.82051282051282
14084_marine,44,23,40,5,67,90.9090909090909,11.363636363636363
14085_marine,46,23,42,5,69,91.30434782608695,10.869565217391305
14086_marine,49,24,45,5,73,91.83673469387756,10.204081632653061
14087_marine,52,26,47,6,78,90.38461538461539,11.538461538461538
14088_marine,61,27,55,10,88,90.1639344262295,16.39344262295082
14089_marine,77,39,67,14,116,87.01298701298701,18.181818181818183
14090_marine,82,47,72,16,129,87.8048780487805,19.51219512195122
14091_marine,117,67,96,31,184,82.05128205128204,26.495726495726498
14160_marine,192,125,107,106,317,55.729166666666664,55.208333333333336
14161_marine,195,123,110,106,318,56.41025641025641,54.35897435897436
14162_marine,188,116,110,99,304,58.51063829787234,52.659574468085104
14163_marine,178,78,113,97,256,63.48314606741573,54.49438202247191
14164_marine,178,75,111,100,253,62.35955056179775,56.17977528089888
14165_marine,184,76,115,103,260,62.5,55.97826086956522
14166_marine,79,43,72,17,122,91.13924050632912,21.518987341772153
14167_marine,81,47,73,18,128,90.12345679012346,22.22222222222222
14168_marine,75,46,68,14,121,90.66666666666666,18.666666666666668
14169_marine,70,39,63,12,109,90,17.142857142857142
14170_marine,65,51,59,11,116,90.76923076923077,16.923076923076923
14171_marine,59,47,54,10,106,91.52542372881356,16.94915254237288
14172_marine,49,40,44,10,89,89.79591836734694,20.408163265306122
14173_marine,48,28,45,7,76,93.75,14.583333333333334
14174_marine,48,38,45,7,86,93.75,14.583333333333334
14175_marine,51,36,48,9,87,94.11764705882352,17.647058823529413
14176_marine,51,22,48,9,73,94.11764705882352,17.647058823529413
14177_marine,52,22,50,8,74,96.15384615384616,15.384615384615385
14178_marine,52,24,50,8,76,96.15384615384616,15.384615384615385
14179_marine,49,21,47,6,70,95.91836734693877,12.244897959183673
14180_marine,53,23,49,6,76,92.45283018867924,11.320754716981133
14181_marine,51,23,47,6,74,92.15686274509804,11.76470588235294
14182_marine,51,23,47,6,74,92.15686274509804,11.76470588235294
14183_marine,51,23,47,6,74,92.15686274509804,11.76470588235294
14184_marine,51,23,46,5,74,90.19607843137256,9.803921568627452
14185_marine,51,23,46,5,74,90.19607843137256,9.803921568627452
14186_marine,50,23,45,4,73,90,8
14187_marine,49,25,44,3,74,89.79591836734694,6.122448979591836
14188_marine,51,25,46,3,76,90.19607843137256,5.88235294117647
14189_marine,52,26,47,3,78,90.38461538461539,5.769230769230769
14190_marine,52,28,47,3,80,90.38461538461539,5.769230769230769
14191_marine,52,36,47,3,88,90.38461538461539,5.769230769230769
14192_marine,51,34,46,2,85,90.19607843137256,3.9215686274509802
14193_marine,51,34,46,2,85,90.19607843137256,3.9215686274509802
14194_marine,51,32,46,2,83,90.19607843137256,3.9215686274509802
14195_marine,51,24,46,2,75,90.19607843137256,3.9215686274509802
14196_marine,51,24,46,2,75,90.19607843137256,3.9215686274509802
14197_marine,52,24,46,3,76,88.46153846153845,5.769230769230769
14198_marine,52,24,46,3,76,88.46153846153845,5.769230769230769
14199_marine,52,24,46,3,76,88.46153846153845,5.769230769230769
14200_marine,54,24,48,3,78,88.88888888888889,5.555555555555555
14201_marine,54,24,48,3,78,88.88888888888889,5.555555555555555
14202_marine,56,24,50,5,80,89.28571428571429,8.928571428571429
14203_marine,58,26,52,7,84,89.65517241379311,12.068965517241379
14204_marine,59,28,52,7,87,88.13559322033898,11.864406779661017
14205_marine,67,32,60,7,99,89.55223880597015,10.44776119402985
14206_marine,76,72,69,7,148,90.78947368421053,9.210526315789473
14207_marine,76,76,69,8,152,90.78947368421053,10.526315789473683
14208_marine,89,71,79,9,160,88.76404494382022,10.112359550561797
14209_marine,153,117,133,17,270,86.9281045751634,11.11111111111111
14210_marine,167,116,146,19,283,87.42514970059881,11.377245508982035
14211_marine,164,90,142,20,254,86.58536585365853,12.195121951219512
14212_marine,165,86,143,20,251,86.66666666666667,12.121212121212121
14213_marine,162,84,142,20,246,87.65432098765432,12.345679012345679
14214_marine,165,84,146,23,249,88.48484848484848,13.939393939393941
14362_marine,72,36,55,23,108,76.38888888888889,31.944444444444443
14365_marine,135,60,97,81,195,71.85185185185186,60
14366_marine,58,34,51,13,92,87.93103448275862,22.413793103448278
14367_marine,49,31,42,11,80,85.71428571428571,22.448979591836736
14368_marine,41,22,35,11,63,85.36585365853658,26.82926829268293
14369_marine,42,26,36,12,68,85.71428571428571,28.57142857142857
14370_marine,45,26,37,11,71,82.22222222222221,24.444444444444443
14371_marine,46,22,38,11,68,82.6086956521739,23.91304347826087
14372_marine,48,24,39,13,72,81.25,27.083333333333332
14373_marine,58,33,47,14,91,81.03448275862068,24.137931034482758
14374_marine,64,43,50,18,107,78.125,28.125
14375_marine,99,61,68,44,160,68.68686868686868,44.44444444444444
14376_marine,178,90,116,109,268,65.1685393258427,61.23595505617978
14377_marine,240,115,151,138,355,62.916666666666664,57.49999999999999
14378_marine,81,49,62,28,130,76.5432098765432,34.5679012345679
14379_marine,75,48,60,22,123,80,29.333333333333332
14380_marine,58,38,48,15,96,82.75862068965517,25.862068965517242
14381_marine,45,24,39,10,69,86.66666666666667,22.22222222222222
14382_marine,44,22,38,10,66,86.36363636363636,22.727272727272727
14383_marine,42,22,38,10,64,90.47619047619048,23.809523809523807
14384_marine,44,22,40,11,66,90.9090909090909,25
14385_marine,44,22,40,11,66,90.9090909090909,25
14386_marine,42,23,38,11,65,90.47619047619048,26.190476190476193
14387_marine,41,23,37,10,64,90.2439024390244,24.390243902439025
14388_marine,42,23,38,11,65,90.47619047619048,26.190476190476193
14389_marine,42,23,38,11,65,90.47619047619048,26.190476190476193
14390_marine,43,23,39,11,66,90.69767441860465,25.581395348837212
14391_marine,46,23,42,12,69,91.30434782608695,26.08695652173913
14392_marine,45,25,39,11,70,86.66666666666667,24.444444444444443
14393_marine,45,26,38,12,71,84.44444444444444,26.666666666666668
14394_marine,51,36,42,12,87,82.35294117647058,23.52941176470588
14395_marine,53,35,44,12,88,83.01886792452831,22.641509433962266
14396_marine,55,38,45,14,93,81.81818181818183,25.454545454545453
14397_marine,59,41,49,14,100,83.05084745762711,23.728813559322035
14398_marine,61,47,51,14,108,83.60655737704919,22.950819672131146
14399_marine,70,48,58,19,118,82.85714285714286,27.142857142857142
14400_marine,74,49,59,23,123,79.72972972972973,31.08108108108108
14401_marine,58,34,50,12,92,86.20689655172413,20.689655172413794
14402_marine,58,34,50,12,92,86.20689655172413,20.689655172413794
14403_marine,52,24,46,12,76,88.46153846153845,23.076923076923077
14404_marine,53,24,46,12,77,86.79245283018868,22.641509433962266
14405_marine,52,24,45,11,76,86.53846153846155,21.153846153846153
14406_marine,52,24,45,11,76,86.53846153846155,21.153846153846153
14407_marine,52,24,45,11,76,86.53846153846155,21.153846153846153
14408_marine,52,24,45,11,76,86.53846153846155,21.153846153846153
14409_marine,51,24,45,10,75,88.23529411764706,19.607843137254903
14410_marine,51,24,45,10,75,88.23529411764706,19.607843137254903
14411_marine,51,24,45,10,75,88.23529411764706,19.607843137254903
14412_marine,51,24,45,10,75,88.23529411764706,19.607843137254903
14413_marine,50,24,45,9,74,90,18
14414_marine,48,24,43,9,72,89.58333333333334,18.75
14415_marine,48,25,43,9,73,89.58333333333334,18.75
14416_marine,48,24,43,9,72,89.58333333333334,18.75
14417_marine,46,24,42,7,70,91.30434782608695,15.217391304347828
14418_marine,46,25,42,7,71,91.30434782608695,15.217391304347828
14419_marine,46,25,42,7,71,91.30434782608695,15.217391304347828
14420_marine,44,23,40,7,67,90.9090909090909,15.909090909090908
14421_marine,43,24,39,6,67,90.69767441860465,13.953488372093023
14422_marine,43,24,39,6,67,90.69767441860465,13.953488372093023
14423_marine,41,24,37,6,65,90.2439024390244,14.634146341463413
14424_marine,41,24,37,6,65,90.2439024390244,14.634146341463413
14425_marine,41,24,37,6,65,90.2439024390244,14.634146341463413
14426_marine,41,24,37,6,65,90.2439024390244,14.634146341463413
14427_marine,41,25,37,6,66,90.2439024390244,14.634146341463413
14428_marine,39,25,35,4,64,89.74358974358975,10.256410256410255
14429_marine,42,25,38,4,67,90.47619047619048,9.523809523809524
14430_marine,40,25,36,4,65,90,10
14431_marine,40,25,36,4,65,90,10
14432_marine,40,25,36,4,65,90,10
14433_marine,41,25,37,5,66,90.2439024390244,12.195121951219512
14434_marine,40,25,36,5,65,90,12.5
14435_marine,42,25,38,5,67,90.47619047619048,11.904761904761903
14436_marine,42,25,38,5,67,90.47619047619048,11.904761904761903
14437_marine,42,24,38,5,66,90.47619047619048,11.904761904761903
14438_marine,42,24,38,5,66,90.47619047619048,11.904761904761903
14439_marine,42,24,38,5,66,90.47619047619048,11.904761904761903
14440_marine,42,23,38,5,65,90.47619047619048,11.904761904761903
14441_marine,42,23,38,5,65,90.47619047619048,11.904761904761903
14442_marine,42,23,38,5,65,90.47619047619048,11.904761904761903
14443_marine,42,24,38,5,66,90.47619047619048,11.904761904761903
14444_marine,43,25,39,5,68,90.69767441860465,11.627906976744185
14445_marine,46,25,42,5,71,91.30434782608695,10.869565217391305
14446_marine,48,23,44,5,71,91.66666666666666,10.416666666666668
14447_marine,51,24,47,5,75,92.15686274509804,9.803921568627452
14448_marine,52,25,47,6,77,90.38461538461539,11.538461538461538
14449_marine,62,28,57,9,90,91.93548387096774,14.516129032258066
14450_marine,73,34,64,11,107,87.67123287671232,15.068493150684931
14451_marine,96,45,83,16,141,86.45833333333334,16.666666666666664
14452_marine,111,59,91,25,170,81.98198198198197,22.52252252252252
14515_marine,61,51,51,16,112,83.60655737704919,26.229508196721312
14520_marine,76,42,68,16,118,89.47368421052632,21.052631578947366
14521_marine,77,43,68,17,120,88.31168831168831,22.07792207792208
14524_marine,184,78,113,104,262,61.41304347826087,56.52173913043478
14525_marine,186,79,115,107,265,61.82795698924731,57.52688172043011
14526_marine,191,79,118,107,270,61.78010471204188,56.02094240837696
14527_marine,193,81,122,107,274,63.212435233160626,55.44041450777202
14528_marine,86,46,77,19,132,89.53488372093024,22.093023255813954
14529_marine,73,41,66,14,114,90.41095890410958,19.17808219178082
14530_marine,70,51,63,12,121,90,17.142857142857142
14531_marine,63,49,58,10,112,92.06349206349206,15.873015873015872
14532_marine,51,42,47,9,93,92.15686274509804,17.647058823529413
14533_marine,49,30,46,7,79,93.87755102040816,14.285714285714285
14534_marine,52,26,49,7,78,94.23076923076923,13.461538461538462
14535_marine,54,48,52,8,102,96.29629629629629,14.814814814814813
14536_marine,56,48,54,8,104,96.42857142857143,14.285714285714285
14537_marine,54,28,50,8,82,92.5925925925926,14.814814814814813
14538_marine,54,25,50,8,79,92.5925925925926,14.814814814814813
14539_marine,52,25,48,6,77,92.3076923076923,11.538461538461538
14540_marine,52,23,48,6,75,92.3076923076923,11.538461538461538
14541_marine,53,23,49,6,76,92.45283018867924,11.320754716981133
14542_marine,52,23,48,6,75,92.3076923076923,11.538461538461538
14543_marine,55,23,50,6,78,90.9090909090909,10.909090909090908
14544_marine,55,23,50,4,78,90.9090909090909,7.2727272727272725
14545_marine,55,24,50,3,79,90.9090909090909,5.454545454545454
14546_marine,55,22,50,3,77,90.9090909090909,5.454545454545454
14547_marine,55,22,50,3,77,90.9090909090909,5.454545454545454
14548_marine,53,24,48,3,77,90.56603773584906,5.660377358490567
14549_marine,53,26,48,3,79,90.56603773584906,5.660377358490567
14550_marine,52,28,47,3,80,90.38461538461539,5.769230769230769
14551_marine,52,38,47,3,90,90.38461538461539,5.769230769230769
14552_marine,51,38,46,2,89,90.19607843137256,3.9215686274509802
14553_marine,51,36,46,2,87,90.19607843137256,3.9215686274509802
14554_marine,53,26,48,2,79,90.56603773584906,3.7735849056603774
14555_marine,53,24,48,2,77,90.56603773584906,3.7735849056603774
14556_marine,53,24,48,2,77,90.56603773584906,3.7735849056603774
14557_marine,54,24,48,3,78,88.88888888888889,5.555555555555555
14558_marine,54,24,48,3,78,88.88888888888889,5.555555555555555
14559_marine,54,24,48,3,78,88.88888888888889,5.555555555555555
14560_marine,54,24,48,3,78,88.88888888888889,5.555555555555555
14561_marine,54,26,48,3,80,88.88888888888889,5.555555555555555
14562_marine,56,28,50,5,84,89.28571428571429,8.928571428571429
14563_marine,59,28,52,7,87,88.13559322033898,11.864406779661017
14564_marine,59,30,52,7,89,88.13559322033898,11.864406779661017
14565_marine,62,30,55,7,92,88.70967741935483,11.29032258064516
14566_marine,64,32,57,7,96,89.0625,10.9375
14567_marine,69,50,62,7,119,89.85507246376811,10.144927536231885
14568_marine,88,79,80,9,167,90.9090909090909,10.227272727272728
14569_marine,150,113,134,15,263,89.33333333333333,10
14570_marine,156,103,140,15,259,89.74358974358975,9.615384615384617
14571_marine,152,83,136,15,235,89.47368421052632,9.868421052631579
14572_marine,156,85,140,15,241,89.74358974358975,9.615384615384617
14573_marine,164,92,144,20,256,87.8048780487805,12.195121951219512
14574_marine,274,120,236,87,394,86.13138686131386,31.751824817518248
14576_marine,188,96,163,30,284,86.70212765957447,15.957446808510639
14577_marine,188,90,163,32,278,86.70212765957447,17.02127659574468
14582_marine,163,74,137,29,237,84.04907975460122,17.791411042944784
14722_marine,79,38,61,26,117,77.21518987341773,32.91139240506329
14726_marine,77,38,65,24,115,84.4155844155844,31.16883116883117
14727_marine,53,29,45,13,82,84.90566037735849,24.528301886792452
14728_marine,48,28,40,12,76,83.33333333333334,25
14729_marine,46,26,38,13,72,82.6086956521739,28.26086956521739
14730_marine,45,28,37,12,73,82.22222222222221,26.666666666666668
14731_marine,48,28,39,13,76,81.25,27.083333333333332
14732_marine,52,32,43,15,84,82.6923076923077,28.846153846153843
14733_marine,65,43,52,19,108,80,29.230769230769234
14734_marine,78,47,57,32,125,73.07692307692307,41.02564102564102
14735_marine,171,73,115,103,244,67.2514619883041,60.23391812865497
14736_marine,169,86,111,97,255,65.68047337278107,57.396449704142015
14737_marine,84,47,64,28,131,76.19047619047619,33.33333333333333
14738_marine,69,38,55,18,107,79.71014492753623,26.08695652173913
14739_marine,55,37,45,13,92,81.81818181818183,23.636363636363637
14740_marine,51,31,43,9,82,84.31372549019608,17.647058823529413
14741_marine,45,21,39,9,66,86.66666666666667,20
14742_marine,45,21,41,10,66,91.11111111111111,22.22222222222222
14743_marine,46,21,42,11,67,91.30434782608695,23.91304347826087
14744_marine,46,21,42,11,67,91.30434782608695,23.91304347826087
14745_marine,46,21,42,11,67,91.30434782608695,23.91304347826087
14746_marine,46,21,42,11,67,91.30434782608695,23.91304347826087
14747_marine,45,21,41,11,66,91.11111111111111,24.444444444444443
14748_marine,44,21,40,11,65,90.9090909090909,25
14749_marine,43,22,39,10,65,90.69767441860465,23.25581395348837
14750_marine,44,22,40,10,66,90.9090909090909,22.727272727272727
14751_marine,46,22,42,10,68,91.30434782608695,21.73913043478261
14752_marine,46,22,42,10,68,91.30434782608695,21.73913043478261
14753_marine,46,23,42,10,69,91.30434782608695,21.73913043478261
14754_marine,46,23,42,10,69,91.30434782608695,21.73913043478261
14755_marine,48,23,44,10,71,91.66666666666666,20.833333333333336
14756_marine,49,23,44,11,72,89.79591836734694,22.448979591836736
14757_marine,51,24,46,11,75,90.19607843137256,21.568627450980394
14758_marine,52,24,46,12,76,88.46153846153845,23.076923076923077
14759_marine,58,34,50,12,92,86.20689655172413,20.689655172413794
14760_marine,60,34,50,12,94,83.33333333333334,20
14761_marine,53,24,48,10,77,90.56603773584906,18.867924528301888
14762_marine,53,24,48,10,77,90.56603773584906,18.867924528301888
14763_marine,53,24,48,10,77,90.56603773584906,18.867924528301888
14764_marine,52,24,47,10,76,90.38461538461539,19.230769230769234
14765_marine,50,26,45,10,76,90,20
14766_marine,51,26,45,10,77,88.23529411764706,19.607843137254903
14767_marine,53,26,47,10,79,88.67924528301887,18.867924528301888
14768_marine,53,26,47,10,79,88.67924528301887,18.867924528301888
14769_marine,53,26,47,10,79,88.67924528301887,18.867924528301888
14770_marine,52,24,47,9,76,90.38461538461539,17.307692307692307
14771_marine,52,23,47,9,75,90.38461538461539,17.307692307692307
14772_marine,52,25,47,9,77,90.38461538461539,17.307692307692307
14773_marine,52,23,47,9,75,90.38461538461539,17.307692307692307
14774_marine,50,24,46,7,74,92,14.000000000000002
14775_marine,50,24,46,7,74,92,14.000000000000002
14776_marine,50,24,46,7,74,92,14.000000000000002
14777_marine,50,24,46,7,74,92,14.000000000000002
14778_marine,50,24,46,7,74,92,14.000000000000002
14779_marine,47,24,43,6,71,91.48936170212765,12.76595744680851
14780_marine,46,24,42,5,70,91.30434782608695,10.869565217391305
14781_marine,44,24,40,5,68,90.9090909090909,11.363636363636363
14782_marine,44,24,40,5,68,90.9090909090909,11.363636363636363
14783_marine,44,24,40,5,68,90.9090909090909,11.363636363636363
14784_marine,44,24,40,5,68,90.9090909090909,11.363636363636363
14785_marine,44,24,40,5,68,90.9090909090909,11.363636363636363
14786_marine,43,25,39,4,68,90.69767441860465,9.30232558139535
14787_marine,43,25,39,4,68,90.69767441860465,9.30232558139535
14788_marine,40,25,36,4,65,90,10
14789_marine,40,25,36,4,65,90,10
14790_marine,40,25,36,4,65,90,10
14791_marine,40,25,36,4,65,90,10
14792_marine,40,25,36,4,65,90,10
14793_marine,40,25,36,4,65,90,10
14794_marine,40,25,36,4,65,90,10
14795_marine,42,25,38,4,67,90.47619047619048,9.523809523809524
14796_marine,41,25,37,4,66,90.2439024390244,9.75609756097561
14797_marine,42,25,38,5,67,90.47619047619048,11.904761904761903
14798_marine,42,24,38,5,66,90.47619047619048,11.904761904761903
14799_marine,42,24,38,5,66,90.47619047619048,11.904761904761903
14800_marine,42,24,38,5,66,90.47619047619048,11.904761904761903
14801_marine,42,24,38,5,66,90.47619047619048,11.904761904761903
14802_marine,42,24,38,5,66,90.47619047619048,11.904761904761903
14803_marine,42,24,38,5,66,90.47619047619048,11.904761904761903
14804_marine,42,25,38,5,67,90.47619047619048,11.904761904761903
14805_marine,43,24,39,5,67,90.69767441860465,11.627906976744185
14806_marine,47,25,43,5,72,91.48936170212765,10.638297872340425
14807_marine,51,23,47,5,74,92.15686274509804,9.803921568627452
14808_marine,52,24,47,6,76,90.38461538461539,11.538461538461538
14809_marine,54,25,49,6,79,90.74074074074075,11.11111111111111
14810_marine,59,28,54,7,87,91.52542372881356,11.864406779661017
14811_marine,69,31,62,11,100,89.85507246376811,15.942028985507244
14812_marine,86,47,74,14,133,86.04651162790698,16.27906976744186
14813_marine,103,56,88,19,159,85.43689320388349,18.446601941747574
14814_marine,110,68,92,25,178,83.63636363636363,22.727272727272727
14873_marine,55,49,46,13,104,83.63636363636363,23.636363636363637
14877_marine,77,50,68,19,127,88.31168831168831,24.675324675324674
14878_marine,79,54,70,19,133,88.60759493670885,24.050632911392405
14879_marine,80,54,71,20,134,88.75,25
14880_marine,78,54,69,19,132,88.46153846153845,24.358974358974358
14881_marine,207,97,119,129,304,57.48792270531401,62.31884057971014
14882_marine,209,86,119,131,295,56.9377990430622,62.67942583732058
14883_marine,116,41,46,95,157,39.6551724137931,81.89655172413794
14886_marine,175,74,102,99,249,58.285714285714285,56.57142857142857
14887_marine,199,84,121,112,283,60.80402010050251,56.28140703517588
14888_marine,196,82,124,107,278,63.26530612244898,54.59183673469388
14889_marine,82,47,75,15,129,91.46341463414635,18.29268292682927
14890_marine,77,47,71,12,124,92.20779220779221,15.584415584415584
14891_marine,71,47,67,9,118,94.36619718309859,12.676056338028168
14892_marine,62,49,59,7,111,95.16129032258065,11.29032258064516
14893_marine,62,53,59,7,115,95.16129032258065,11.29032258064516
14894_marine,61,55,58,7,116,95.08196721311475,11.475409836065573
14895_marine,60,55,56,6,115,93.33333333333333,10
14896_marine,64,55,60,8,119,93.75,12.5
14897_marine,62,52,58,8,114,93.54838709677419,12.903225806451612
14898_marine,54,27,50,6,81,92.5925925925926,11.11111111111111
14899_marine,57,25,53,6,82,92.98245614035088,10.526315789473683
14900_marine,57,21,53,6,78,92.98245614035088,10.526315789473683
14901_marine,58,22,53,6,80,91.37931034482759,10.344827586206897
14902_marine,59,22,54,6,81,91.52542372881356,10.16949152542373
14903_marine,57,22,52,4,79,91.22807017543859,7.017543859649122
14904_marine,56,22,51,3,78,91.07142857142857,5.357142857142857
14905_marine,56,22,51,3,78,91.07142857142857,5.357142857142857
14906_marine,56,22,51,3,78,91.07142857142857,5.357142857142857
14907_marine,56,22,51,3,78,91.07142857142857,5.357142857142857
14908_marine,56,22,51,3,78,91.07142857142857,5.357142857142857
14909_marine,57,24,52,3,81,91.22807017543859,5.263157894736842
14910_marine,57,28,52,3,85,91.22807017543859,5.263157894736842
14911_marine,57,28,52,3,85,91.22807017543859,5.263157894736842
14912_marine,56,40,51,2,96,91.07142857142857,3.571428571428571
14913_marine,56,36,51,2,92,91.07142857142857,3.571428571428571
14914_marine,55,34,50,2,89,90.9090909090909,3.6363636363636362
14915_marine,53,26,48,2,79,90.56603773584906,3.7735849056603774
14916_marine,54,26,48,3,80,88.88888888888889,5.555555555555555
14917_marine,54,26,48,3,80,88.88888888888889,5.555555555555555
14918_marine,54,26,48,3,80,88.88888888888889,5.555555555555555
14919_marine,54,26,48,3,80,88.88888888888889,5.555555555555555
14920_marine,54,28,48,3,82,88.88888888888889,5.555555555555555
14921_marine,54,28,48,3,82,88.88888888888889,5.555555555555555
14922_marine,55,28,49,4,83,89.0909090909091,7.2727272727272725
14923_marine,57,30,50,6,87,87.71929824561403,10.526315789473683
14924_marine,60,30,53,7,90,88.33333333333333,11.666666666666666
14925_marine,60,30,53,7,90,88.33333333333333,11.666666666666666
14926_marine,63,30,56,7,93,88.88888888888889,11.11111111111111
14927_marine,63,32,56,7,95,88.88888888888889,11.11111111111111
14928_marine,82,69,74,9,151,90.2439024390244,10.975609756097562
14929_marine,90,77,82,9,167,91.11111111111111,10
14930_marine,150,103,134,15,253,89.33333333333333,10
14931_marine,154,107,138,15,261,89.6103896103896,9.740259740259742
14932_marine,158,105,142,15,263,89.87341772151899,9.49367088607595
14933_marine,165,105,149,15,270,90.30303030303031,9.090909090909092
14934_marine,183,104,157,21,287,85.79234972677595,11.475409836065573
14935_marine,295,135,240,89,430,81.35593220338984,30.16949152542373
15084_marine,85,40,71,24,125,83.52941176470588,28.235294117647058
15086_marine,81,45,68,26,126,83.9506172839506,32.098765432098766
15087_marine,56,34,48,16,90,85.71428571428571,28.57142857142857
15088_marine,59,36,49,16,95,83.05084745762711,27.11864406779661
15089_marine,55,28,46,16,83,83.63636363636363,29.09090909090909
15090_marine,52,29,43,17,81,82.6923076923077,32.69230769230769
15091_marine,60,38,48,18,98,80,30
15092_marine,66,44,53,22,110,80.3030303030303,33.33333333333333
15093_marine,78,48,58,34,126,74.35897435897436,43.58974358974359
15094_marine,174,78,119,106,252,68.39080459770115,60.91954022988506
15095_marine,169,69,113,100,238,66.86390532544378,59.171597633136095
15096_marine,85,46,66,29,131,77.64705882352942,34.11764705882353
15097_marine,64,37,52,17,101,81.25,26.5625
15098_marine,55,31,45,12,86,81.81818181818183,21.818181818181817
15099_marine,48,21,42,10,69,87.5,20.833333333333336
15100_marine,50,21,44,11,71,88,22
15101_marine,50,21,44,11,71,88,22
15102_marine,48,21,44,11,69,91.66666666666666,22.916666666666664
15103_marine,49,21,45,11,70,91.83673469387756,22.448979591836736
15104_marine,48,21,44,10,69,91.66666666666666,20.833333333333336
15105_marine,49,21,45,10,70,91.83673469387756,20.408163265306122
15106_marine,48,21,45,9,69,93.75,18.75
15107_marine,47,21,43,10,68,91.48936170212765,21.27659574468085
15108_marine,47,21,43,10,68,91.48936170212765,21.27659574468085
15109_marine,49,19,45,10,68,91.83673469387756,20.408163265306122
15110_marine,49,19,45,10,68,91.83673469387756,20.408163265306122
15111_marine,50,20,46,10,70,92,20
15112_marine,50,21,46,10,71,92,20
15113_marine,48,21,44,9,69,91.66666666666666,18.75
15114_marine,50,20,46,9,70,92,18
15115_marine,50,20,46,9,70,92,18
15116_marine,50,20,46,9,70,92,18
15117_marine,50,21,46,9,71,92,18
15118_marine,50,23,46,9,73,92,18
15119_marine,50,23,46,9,73,92,18
15120_marine,53,23,48,10,76,90.56603773584906,18.867924528301888
15121_marine,53,24,49,9,77,92.45283018867924,16.9811320754717
15122_marine,52,24,48,9,76,92.3076923076923,17.307692307692307
15123_marine,52,24,48,9,76,92.3076923076923,17.307692307692307
15124_marine,52,24,48,9,76,92.3076923076923,17.307692307692307
15125_marine,52,26,48,9,78,92.3076923076923,17.307692307692307
15126_marine,52,24,48,9,76,92.3076923076923,17.307692307692307
15127_marine,52,24,48,9,76,92.3076923076923,17.307692307692307
15128_marine,52,24,48,9,76,92.3076923076923,17.307692307692307
15129_marine,51,25,47,8,76,92.15686274509804,15.686274509803921
15130_marine,51,26,47,7,77,92.15686274509804,13.725490196078432
15131_marine,50,26,46,6,76,92,12
15132_marine,50,26,46,6,76,92,12
15133_marine,49,26,45,6,75,91.83673469387756,12.244897959183673
15134_marine,48,26,44,5,74,91.66666666666666,10.416666666666668
15135_marine,48,26,44,5,74,91.66666666666666,10.416666666666668
15136_marine,48,26,44,5,74,91.66666666666666,10.416666666666668
15137_marine,46,26,42,5,72,91.30434782608695,10.869565217391305
15138_marine,46,26,42,5,72,91.30434782608695,10.869565217391305
15139_marine,46,24,42,5,70,91.30434782608695,10.869565217391305
15140_marine,46,24,42,5,70,91.30434782608695,10.869565217391305
15141_marine,46,24,42,5,70,91.30434782608695,10.869565217391305
15142_marine,45,24,41,5,69,91.11111111111111,11.11111111111111
15143_marine,46,24,42,5,70,91.30434782608695,10.869565217391305
15144_marine,45,24,41,4,69,91.11111111111111,8.88888888888889
15145_marine,44,24,40,4,68,90.9090909090909,9.090909090909092
15146_marine,44,25,40,4,69,90.9090909090909,9.090909090909092
15147_marine,44,25,40,4,69,90.9090909090909,9.090909090909092
15148_marine,44,25,40,4,69,90.9090909090909,9.090909090909092
15149_marine,44,25,40,4,69,90.9090909090909,9.090909090909092
15150_marine,44,25,40,4,69,90.9090909090909,9.090909090909092
15151_marine,44,25,40,4,69,90.9090909090909,9.090909090909092
15152_marine,42,25,38,4,67,90.47619047619048,9.523809523809524
15153_marine,42,25,38,4,67,90.47619047619048,9.523809523809524
15154_marine,42,25,38,4,67,90.47619047619048,9.523809523809524
15155_marine,44,25,40,4,69,90.9090909090909,9.090909090909092
15156_marine,44,25,40,4,69,90.9090909090909,9.090909090909092
15157_marine,43,25,39,4,68,90.69767441860465,9.30232558139535
15158_marine,43,25,39,4,68,90.69767441860465,9.30232558139535
15159_marine,44,24,40,5,68,90.9090909090909,11.363636363636363
15160_marine,44,24,40,5,68,90.9090909090909,11.363636363636363
15161_marine,44,24,40,5,68,90.9090909090909,11.363636363636363
15162_marine,44,24,40,5,68,90.9090909090909,11.363636363636363
15163_marine,44,24,40,5,68,90.9090909090909,11.363636363636363
15164_marine,44,24,40,5,68,90.9090909090909,11.363636363636363
15165_marine,45,25,41,5,70,91.11111111111111,11.11111111111111
15166_marine,45,25,41,5,70,91.11111111111111,11.11111111111111
15167_marine,49,25,45,5,74,91.83673469387756,10.204081632653061
15168_marine,53,25,49,5,78,92.45283018867924,9.433962264150944
15169_marine,56,23,51,6,79,91.07142857142857,10.714285714285714
15170_marine,55,29,50,6,84,90.9090909090909,10.909090909090908
15171_marine,65,32,60,7,97,92.3076923076923,10.76923076923077
15172_marine,74,33,68,10,107,91.8918918918919,13.513513513513514
15173_marine,81,40,73,11,121,90.12345679012346,13.580246913580247
15174_marine,96,53,83,16,149,86.45833333333334,16.666666666666664
15175_marine,124,69,105,28,193,84.67741935483872,22.58064516129032
15234_marine,72,51,61,21,123,84.72222222222221,29.166666666666668
15238_marine,180,82,109,116,262,60.55555555555555,64.44444444444444
15239_marine,188,82,115,120,270,61.170212765957444,63.829787234042556
15241_marine,219,107,132,134,326,60.273972602739725,61.18721461187214
15242_marine,220,101,133,131,321,60.45454545454545,59.54545454545455
15243_marine,225,92,136,134,317,60.44444444444444,59.55555555555555
15244_marine,216,95,133,125,311,61.57407407407407,57.870370370370374
15245_marine,205,89,126,119,294,61.46341463414634,58.048780487804876
15246_marine,205,86,126,117,291,61.46341463414634,57.073170731707314
15247_marine,204,84,129,114,288,63.23529411764706,55.88235294117647
15248_marine,204,84,130,111,288,63.725490196078425,54.41176470588235
15249_marine,86,49,80,14,135,93.02325581395348,16.27906976744186
15250_marine,84,45,78,12,129,92.85714285714286,14.285714285714285
15251_marine,81,39,75,9,120,92.5925925925926,11.11111111111111
15252_marine,78,37,73,7,115,93.58974358974359,8.974358974358974
15253_marine,74,53,69,7,127,93.24324324324324,9.45945945945946
15254_marine,65,53,61,6,118,93.84615384615384,9.230769230769232
15255_marine,67,51,63,6,118,94.02985074626866,8.955223880597014
15256_marine,67,53,63,6,120,94.02985074626866,8.955223880597014
15257_marine,65,55,61,6,120,93.84615384615384,9.230769230769232
15258_marine,57,28,53,6,85,92.98245614035088,10.526315789473683
15259_marine,58,26,53,6,84,91.37931034482759,10.344827586206897
15260_marine,58,24,53,6,82,91.37931034482759,10.344827586206897
15261_marine,57,24,52,5,81,91.22807017543859,8.771929824561402
15262_marine,57,24,52,4,81,91.22807017543859,7.017543859649122
15263_marine,56,24,51,3,80,91.07142857142857,5.357142857142857
15264_marine,56,24,51,3,80,91.07142857142857,5.357142857142857
15265_marine,56,24,51,3,80,91.07142857142857,5.357142857142857
15266_marine,56,24,51,3,80,91.07142857142857,5.357142857142857
15267_marine,56,24,51,3,80,91.07142857142857,5.357142857142857
15268_marine,56,24,51,3,80,91.07142857142857,5.357142857142857
15269_marine,56,26,51,3,82,91.07142857142857,5.357142857142857
15270_marine,56,30,51,3,86,91.07142857142857,5.357142857142857
15271_marine,55,28,50,2,83,90.9090909090909,3.6363636363636362
15272_marine,56,38,51,2,94,91.07142857142857,3.571428571428571
15273_marine,57,38,52,2,95,91.22807017543859,3.508771929824561
15274_marine,57,34,52,2,91,91.22807017543859,3.508771929824561
15275_marine,57,26,52,2,83,91.22807017543859,3.508771929824561
15276_marine,58,26,52,3,84,89.65517241379311,5.172413793103448
15277_marine,57,26,51,3,83,89.47368421052632,5.263157894736842
15278_marine,54,28,48,3,82,88.88888888888889,5.555555555555555
15279_marine,54,28,48,3,82,88.88888888888889,5.555555555555555
15280_marine,54,28,48,3,82,88.88888888888889,5.555555555555555
15281_marine,54,28,48,3,82,88.88888888888889,5.555555555555555
15282_marine,57,28,51,5,85,89.47368421052632,8.771929824561402
15283_marine,61,30,54,6,91,88.52459016393442,9.836065573770492
15284_marine,62,30,55,7,92,88.70967741935483,11.29032258064516
15285_marine,62,30,55,7,92,88.70967741935483,11.29032258064516
15286_marine,65,30,58,7,95,89.23076923076924,10.76923076923077
15287_marine,65,30,58,7,95,89.23076923076924,10.76923076923077
15288_marine,67,31,60,8,98,89.55223880597015,11.940298507462686
15289_marine,74,33,66,9,107,89.1891891891892,12.162162162162163
15290_marine,84,47,76,9,131,90.47619047619048,10.714285714285714
15291_marine,92,55,84,9,147,91.30434782608695,9.782608695652174
15292_marine,94,77,86,9,171,91.48936170212765,9.574468085106384
15293_marine,161,113,145,15,274,90.06211180124224,9.316770186335404
15294_marine,177,119,154,19,296,87.00564971751412,10.734463276836157
15295_marine,210,141,180,31,351,85.71428571428571,14.761904761904763
15441_marine,80,44,64,25,124,80,31.25
15445_marine,86,46,76,23,132,88.37209302325581,26.744186046511626
15446_marine,78,41,67,20,119,85.8974358974359,25.64102564102564
15447_marine,61,30,52,16,91,85.24590163934425,26.229508196721312
15448_marine,56,25,49,16,81,87.5,28.57142857142857
15449_marine,56,27,48,16,83,85.71428571428571,28.57142857142857
15450_marine,69,38,58,22,107,84.05797101449275,31.88405797101449
15451_marine,71,42,55,28,113,77.46478873239437,39.436619718309856
15452_marine,84,51,63,35,135,75,41.66666666666667
15453_marine,174,76,119,104,250,68.39080459770115,59.77011494252874
15454_marine,159,67,110,90,226,69.18238993710692,56.60377358490566
15455_marine,85,45,67,25,130,78.82352941176471,29.411764705882355
15456_marine,65,37,54,15,102,83.07692307692308,23.076923076923077
15457_marine,52,23,45,10,75,86.53846153846155,19.230769230769234
15458_marine,50,22,44,10,72,88,20
15459_marine,51,21,45,10,72,88.23529411764706,19.607843137254903
15460_marine,49,21,45,10,70,91.83673469387756,20.408163265306122
15461_marine,50,21,47,9,71,94,18
15462_marine,49,21,46,8,70,93.87755102040816,16.3265306122449
15463_marine,50,21,47,7,71,94,14.000000000000002
15464_marine,49,19,46,7,68,93.87755102040816,14.285714285714285
15465_marine,49,19,46,7,68,93.87755102040816,14.285714285714285
15466_marine,49,19,46,7,68,93.87755102040816,14.285714285714285
15467_marine,49,19,46,7,68,93.87755102040816,14.285714285714285
15468_marine,49,19,46,7,68,93.87755102040816,14.285714285714285
15469_marine,48,19,45,6,67,93.75,12.5
15470_marine,48,20,45,6,68,93.75,12.5
15471_marine,48,20,45,6,68,93.75,12.5
15472_marine,48,20,45,6,68,93.75,12.5
15473_marine,50,22,46,7,72,92,14.000000000000002
15474_marine,50,23,46,7,73,92,14.000000000000002
15475_marine,50,23,46,7,73,92,14.000000000000002
15476_marine,51,23,47,8,74,92.15686274509804,15.686274509803921
15477_marine,52,24,48,9,76,92.3076923076923,17.307692307692307
15478_marine,52,24,48,9,76,92.3076923076923,17.307692307692307
15479_marine,52,24,48,9,76,92.3076923076923,17.307692307692307
15480_marine,52,24,48,9,76,92.3076923076923,17.307692307692307
15481_marine,51,24,47,7,75,92.15686274509804,13.725490196078432
15482_marine,49,24,46,6,73,93.87755102040816,12.244897959183673
15483_marine,49,24,46,6,73,93.87755102040816,12.244897959183673
15484_marine,48,26,45,6,74,93.75,12.5
15485_marine,48,27,45,6,75,93.75,12.5
15486_marine,48,27,45,6,75,93.75,12.5
15487_marine,47,27,44,6,74,93.61702127659575,12.76595744680851
15488_marine,46,27,43,5,73,93.47826086956522,10.869565217391305
15489_marine,46,28,43,5,74,93.47826086956522,10.869565217391305
15490_marine,46,28,43,5,74,93.47826086956522,10.869565217391305
15491_marine,46,28,43,5,74,93.47826086956522,10.869565217391305
15492_marine,47,28,44,5,75,93.61702127659575,10.638297872340425
15493_marine,45,28,42,5,73,93.33333333333333,11.11111111111111
15494_marine,45,26,42,5,71,93.33333333333333,11.11111111111111
15495_marine,45,26,42,5,71,93.33333333333333,11.11111111111111
15496_marine,45,26,42,5,71,93.33333333333333,11.11111111111111
15497_marine,45,26,42,5,71,93.33333333333333,11.11111111111111
15498_marine,45,26,42,5,71,93.33333333333333,11.11111111111111
15499_marine,44,26,41,5,70,93.18181818181817,11.363636363636363
15500_marine,44,26,41,5,70,93.18181818181817,11.363636363636363
15501_marine,44,26,41,5,70,93.18181818181817,11.363636363636363
15502_marine,43,26,40,4,69,93.02325581395348,9.30232558139535
15503_marine,43,24,40,4,67,93.02325581395348,9.30232558139535
15504_marine,43,24,40,4,67,93.02325581395348,9.30232558139535
15505_marine,43,24,40,4,67,93.02325581395348,9.30232558139535
15506_marine,43,25,40,4,68,93.02325581395348,9.30232558139535
15507_marine,43,25,40,4,68,93.02325581395348,9.30232558139535
15508_marine,43,25,40,4,68,93.02325581395348,9.30232558139535
15509_marine,43,25,40,4,68,93.02325581395348,9.30232558139535
15510_marine,43,25,40,4,68,93.02325581395348,9.30232558139535
15511_marine,43,25,40,4,68,93.02325581395348,9.30232558139535
15512_marine,43,25,40,4,68,93.02325581395348,9.30232558139535
15513_marine,42,25,39,3,67,92.85714285714286,7.142857142857142
15514_marine,43,25,39,3,68,90.69767441860465,6.976744186046512
15515_marine,45,25,41,3,70,91.11111111111111,6.666666666666667
15516_marine,43,25,39,3,68,90.69767441860465,6.976744186046512
15517_marine,44,25,40,4,69,90.9090909090909,9.090909090909092
15518_marine,43,25,39,4,68,90.69767441860465,9.30232558139535
15519_marine,43,25,39,4,68,90.69767441860465,9.30232558139535
15520_marine,43,24,39,4,67,90.69767441860465,9.30232558139535
15521_marine,44,24,40,5,68,90.9090909090909,11.363636363636363
15522_marine,44,24,40,5,68,90.9090909090909,11.363636363636363
15523_marine,44,24,40,5,68,90.9090909090909,11.363636363636363
15524_marine,44,24,40,5,68,90.9090909090909,11.363636363636363
15525_marine,45,26,41,5,71,91.11111111111111,11.11111111111111
15526_marine,45,25,41,5,70,91.11111111111111,11.11111111111111
15527_marine,47,25,43,5,72,91.48936170212765,10.638297872340425
15528_marine,49,28,45,5,77,91.83673469387756,10.204081632653061
15529_marine,58,29,53,6,87,91.37931034482759,10.344827586206897
15530_marine,61,29,56,6,90,91.80327868852459,9.836065573770492
15531_marine,62,29,57,6,91,91.93548387096774,9.67741935483871
15532_marine,67,33,62,7,100,92.53731343283582,10.44776119402985
15533_marine,74,33,69,10,107,93.24324324324324,13.513513513513514
15534_marine,82,40,73,12,122,89.02439024390245,14.634146341463413
15535_marine,117,66,102,22,183,87.17948717948718,18.803418803418804
15602_marine,94,68,81,21,162,86.17021276595744,22.340425531914892
15603_marine,94,61,82,20,155,87.2340425531915,21.27659574468085
15604_marine,201,90,126,116,291,62.68656716417911,57.711442786069654
15605_marine,210,88,133,114,298,63.33333333333333,54.285714285714285
15606_marine,203,88,130,110,291,64.03940886699507,54.187192118226605
15607_marine,208,84,134,113,292,64.42307692307693,54.32692307692307
15608_marine,206,85,133,110,291,64.56310679611651,53.398058252427184
15609_marine,90,47,82,14,137,91.11111111111111,15.555555555555555
15610_marine,89,37,81,11,126,91.01123595505618,12.359550561797752
15611_marine,73,33,68,7,106,93.15068493150685,9.58904109589041
15612_marine,74,31,69,7,105,93.24324324324324,9.45945945945946
15613_marine,74,60,69,7,134,93.24324324324324,9.45945945945946
15614_marine,65,56,61,6,121,93.84615384615384,9.230769230769232
15615_marine,67,56,63,6,123,94.02985074626866,8.955223880597014
15616_marine,67,55,63,6,122,94.02985074626866,8.955223880597014
15617_marine,66,55,61,6,121,92.42424242424242,9.090909090909092
15618_marine,58,28,53,6,86,91.37931034482759,10.344827586206897
15619_marine,57,26,52,5,83,91.22807017543859,8.771929824561402
15620_marine,59,24,54,5,83,91.52542372881356,8.47457627118644
15621_marine,58,24,53,4,82,91.37931034482759,6.896551724137931
15622_marine,58,24,53,4,82,91.37931034482759,6.896551724137931
15623_marine,59,24,54,3,83,91.52542372881356,5.084745762711865
15624_marine,59,24,54,3,83,91.52542372881356,5.084745762711865
15625_marine,59,24,54,3,83,91.52542372881356,5.084745762711865
15626_marine,59,24,54,3,83,91.52542372881356,5.084745762711865
15627_marine,59,24,54,3,83,91.52542372881356,5.084745762711865
15628_marine,57,26,52,3,83,91.22807017543859,5.263157894736842
15629_marine,57,26,52,3,83,91.22807017543859,5.263157894736842
15630_marine,58,28,53,3,86,91.37931034482759,5.172413793103448
15631_marine,57,30,52,2,87,91.22807017543859,3.508771929824561
15632_marine,57,40,52,2,97,91.22807017543859,3.508771929824561
15633_marine,57,38,52,2,95,91.22807017543859,3.508771929824561
15634_marine,57,36,52,2,93,91.22807017543859,3.508771929824561
15635_marine,58,28,52,3,86,89.65517241379311,5.172413793103448
15636_marine,59,28,53,3,87,89.83050847457628,5.084745762711865
15637_marine,59,30,53,3,89,89.83050847457628,5.084745762711865
15638_marine,61,30,55,3,91,90.1639344262295,4.918032786885246
15639_marine,60,28,54,3,88,90,5
15640_marine,56,28,50,3,84,89.28571428571429,5.357142857142857
15641_marine,57,28,51,4,85,89.47368421052632,7.017543859649122
15642_marine,57,30,51,5,87,89.47368421052632,8.771929824561402
15643_marine,63,30,56,6,93,88.88888888888889,9.523809523809524
15644_marine,66,30,57,7,96,86.36363636363636,10.606060606060606
15645_marine,67,30,58,7,97,86.56716417910447,10.44776119402985
15646_marine,69,30,60,7,99,86.95652173913044,10.144927536231885
15647_marine,69,30,60,7,99,86.95652173913044,10.144927536231885
15648_marine,69,31,60,8,100,86.95652173913044,11.594202898550725
15649_marine,75,31,65,9,106,86.66666666666667,12
15650_marine,73,31,65,9,104,89.04109589041096,12.32876712328767
15651_marine,76,33,68,9,109,89.47368421052632,11.842105263157894
15652_marine,77,33,68,9,110,88.31168831168831,11.688311688311687
15653_marine,85,45,76,9,130,89.41176470588236,10.588235294117647
15654_marine,86,53,75,9,139,87.20930232558139,10.465116279069768
15655_marine,183,130,156,21,313,85.24590163934425,11.475409836065573
15656_marine,193,137,166,24,330,86.01036269430051,12.435233160621761
15657_marine,213,136,185,26,349,86.85446009389672,12.206572769953052
15800_marine,77,32,61,25,109,79.22077922077922,32.467532467532465
15801_marine,92,48,75,30,140,81.52173913043478,32.608695652173914
15805_marine,94,48,80,26,142,85.1063829787234,27.659574468085108
15806_marine,68,33,59,17,101,86.76470588235294,25
15807_marine,74,32,64,20,106,86.48648648648648,27.027027027027028
15808_marine,75,41,63,23,116,84,30.666666666666664
15809_marine,83,45,65,30,128,78.3132530120482,36.144578313253014
15810_marine,190,84,127,127,274,66.84210526315789,66.84210526315789
15811_marine,199,87,138,126,286,69.34673366834171,63.31658291457286
15812_marine,178,81,124,106,259,69.66292134831461,59.55056179775281
15813_marine,176,75,121,104,251,68.75,59.09090909090909
15814_marine,84,46,69,28,130,82.14285714285714,33.33333333333333
15815_marine,66,37,55,15,103,83.33333333333334,22.727272727272727
15816_marine,63,35,55,10,98,87.3015873015873,15.873015873015872
15817_marine,58,25,52,10,83,89.65517241379311,17.24137931034483
15818_marine,56,25,50,10,81,89.28571428571429,17.857142857142858
15819_marine,52,22,49,8,74,94.23076923076923,15.384615384615385
15820_marine,51,22,48,7,73,94.11764705882352,13.725490196078432
15821_marine,51,20,48,7,71,94.11764705882352,13.725490196078432
15822_marine,51,20,48,7,71,94.11764705882352,13.725490196078432
15823_marine,51,20,48,7,71,94.11764705882352,13.725490196078432
15824_marine,51,19,48,7,70,94.11764705882352,13.725490196078432
15825_marine,51,19,48,7,70,94.11764705882352,13.725490196078432
15826_marine,50,19,47,6,69,94,12
15827_marine,50,21,47,6,71,94,12
15828_marine,50,21,47,6,71,94,12
15829_marine,50,22,47,6,72,94,12
15830_marine,50,22,47,6,72,94,12
15831_marine,50,22,47,6,72,94,12
15832_marine,50,23,47,6,73,94,12
15833_marine,48,23,45,6,71,93.75,12.5
15834_marine,48,23,45,6,71,93.75,12.5
15835_marine,48,23,45,6,71,93.75,12.5
15836_marine,48,24,45,6,72,93.75,12.5
15837_marine,48,25,45,6,73,93.75,12.5
15838_marine,49,25,46,6,74,93.87755102040816,12.244897959183673
15839_marine,49,25,46,6,74,93.87755102040816,12.244897959183673
15840_marine,49,24,46,6,73,93.87755102040816,12.244897959183673
15841_marine,48,25,45,5,73,93.75,10.416666666666668
15842_marine,47,26,44,5,73,93.61702127659575,10.638297872340425
15843_marine,47,28,44,5,75,93.61702127659575,10.638297872340425
15844_marine,47,28,44,5,75,93.61702127659575,10.638297872340425
15845_marine,47,27,44,5,74,93.61702127659575,10.638297872340425
15846_marine,47,27,44,5,74,93.61702127659575,10.638297872340425
15847_marine,47,27,44,5,74,93.61702127659575,10.638297872340425
15848_marine,47,28,44,5,75,93.61702127659575,10.638297872340425
15849_marine,45,28,42,5,73,93.33333333333333,11.11111111111111
15850_marine,45,28,42,5,73,93.33333333333333,11.11111111111111
15851_marine,45,28,42,5,73,93.33333333333333,11.11111111111111
15852_marine,45,28,42,5,73,93.33333333333333,11.11111111111111
15853_marine,45,28,42,5,73,93.33333333333333,11.11111111111111
15854_marine,45,28,42,5,73,93.33333333333333,11.11111111111111
15855_marine,45,28,42,5,73,93.33333333333333,11.11111111111111
15856_marine,44,28,41,5,72,93.18181818181817,11.363636363636363
15857_marine,44,28,41,5,72,93.18181818181817,11.363636363636363
15858_marine,44,28,41,5,72,93.18181818181817,11.363636363636363
15859_marine,47,28,44,5,75,93.61702127659575,10.638297872340425
15860_marine,46,28,43,4,74,93.47826086956522,8.695652173913043
15861_marine,46,28,43,4,74,93.47826086956522,8.695652173913043
15862_marine,46,26,43,4,72,93.47826086956522,8.695652173913043
15863_marine,46,26,43,4,72,93.47826086956522,8.695652173913043
15864_marine,46,26,43,4,72,93.47826086956522,8.695652173913043
15865_marine,46,27,43,4,73,93.47826086956522,8.695652173913043
15866_marine,46,27,43,4,73,93.47826086956522,8.695652173913043
15867_marine,45,27,42,4,72,93.33333333333333,8.88888888888889
15868_marine,45,27,42,4,72,93.33333333333333,8.88888888888889
15869_marine,44,27,41,3,71,93.18181818181817,6.8181818181818175
15870_marine,44,27,41,3,71,93.18181818181817,6.8181818181818175
15871_marine,42,27,39,3,69,92.85714285714286,7.142857142857142
15872_marine,42,27,39,3,69,92.85714285714286,7.142857142857142
15873_marine,42,27,39,3,69,92.85714285714286,7.142857142857142
15874_marine,42,27,39,3,69,92.85714285714286,7.142857142857142
15875_marine,44,27,41,3,71,93.18181818181817,6.8181818181818175
15876_marine,44,27,41,3,71,93.18181818181817,6.8181818181818175
15877_marine,45,27,41,3,72,91.11111111111111,6.666666666666667
15878_marine,46,27,42,4,73,91.30434782608695,8.695652173913043
15879_marine,43,27,39,4,70,90.69767441860465,9.30232558139535
15880_marine,43,27,39,4,70,90.69767441860465,9.30232558139535
15881_marine,43,27,39,4,70,90.69767441860465,9.30232558139535
15882_marine,44,26,40,5,70,90.9090909090909,11.363636363636363
15883_marine,44,26,40,5,70,90.9090909090909,11.363636363636363
15884_marine,44,26,40,5,70,90.9090909090909,11.363636363636363
15885_marine,44,26,40,5,70,90.9090909090909,11.363636363636363
15886_marine,45,30,41,5,75,91.11111111111111,11.11111111111111
15887_marine,45,29,41,5,74,91.11111111111111,11.11111111111111
15888_marine,47,29,43,5,76,91.48936170212765,10.638297872340425
15889_marine,56,30,52,5,86,92.85714285714286,8.928571428571429
15890_marine,59,30,54,6,89,91.52542372881356,10.16949152542373
15891_marine,61,28,56,6,89,91.80327868852459,9.836065573770492
15892_marine,67,30,62,7,97,92.53731343283582,10.44776119402985
15893_marine,71,33,66,7,104,92.95774647887323,9.859154929577464
15894_marine,75,34,69,11,109,92,14.666666666666666
15895_marine,92,50,80,20,142,86.95652173913044,21.73913043478261
15962_marine,100,67,89,19,167,89,19
15963_marine,98,67,89,16,165,90.81632653061224,16.3265306122449
15964_marine,90,60,82,14,150,91.11111111111111,15.555555555555555
15965_marine,90,71,81,12,161,90,13.333333333333334
15966_marine,92,71,83,13,163,90.21739130434783,14.130434782608695
15967_marine,97,44,88,16,141,90.72164948453609,16.49484536082474
15968_marine,90,43,82,13,133,91.11111111111111,14.444444444444443
15969_marine,86,39,78,10,125,90.69767441860465,11.627906976744185
15970_marine,79,36,74,8,115,93.67088607594937,10.126582278481013
15971_marine,81,40,76,7,121,93.82716049382715,8.641975308641975
15972_marine,81,62,76,7,143,93.82716049382715,8.641975308641975
15973_marine,78,58,74,6,136,94.87179487179486,7.6923076923076925
15974_marine,71,58,66,6,129,92.95774647887323,8.450704225352112
15975_marine,65,33,60,6,98,92.3076923076923,9.230769230769232
15976_marine,63,29,58,6,92,92.06349206349206,9.523809523809524
15977_marine,60,26,55,5,86,91.66666666666666,8.333333333333332
15978_marine,60,26,55,5,86,91.66666666666666,8.333333333333332
15979_marine,60,28,55,5,88,91.66666666666666,8.333333333333332
15980_marine,59,26,54,4,85,91.52542372881356,6.779661016949152
15981_marine,59,26,54,4,85,91.52542372881356,6.779661016949152
15982_marine,59,24,54,4,83,91.52542372881356,6.779661016949152
15983_marine,58,24,53,3,82,91.37931034482759,5.172413793103448
15984_marine,59,24,54,3,83,91.52542372881356,5.084745762711865
15985_marine,59,26,54,3,85,91.52542372881356,5.084745762711865
15986_marine,59,26,54,3,85,91.52542372881356,5.084745762711865
15987_marine,59,26,54,3,85,91.52542372881356,5.084745762711865
15988_marine,60,26,55,3,86,91.66666666666666,5
15989_marine,60,26,55,3,86,91.66666666666666,5
15990_marine,60,28,55,3,88,91.66666666666666,5
15991_marine,59,32,54,2,91,91.52542372881356,3.389830508474576
15992_marine,59,40,54,2,99,91.52542372881356,3.389830508474576
15993_marine,59,38,54,2,97,91.52542372881356,3.389830508474576
15994_marine,58,32,52,3,90,89.65517241379311,5.172413793103448
15995_marine,62,32,56,3,94,90.32258064516128,4.838709677419355
15996_marine,59,30,53,3,89,89.83050847457628,5.084745762711865
15997_marine,59,30,53,3,89,89.83050847457628,5.084745762711865
15998_marine,59,30,53,3,89,89.83050847457628,5.084745762711865
15999_marine,59,30,53,3,89,89.83050847457628,5.084745762711865
16000_marine,62,28,54,4,90,87.09677419354838,6.451612903225806
16001_marine,60,30,52,4,90,86.66666666666667,6.666666666666667
16002_marine,61,30,53,4,91,86.88524590163934,6.557377049180328
16003_marine,63,30,54,6,93,85.71428571428571,9.523809523809524
16004_marine,65,30,56,7,95,86.15384615384616,10.76923076923077
16005_marine,65,32,56,7,97,86.15384615384616,10.76923076923077
16006_marine,66,30,57,7,96,86.36363636363636,10.606060606060606
16007_marine,68,32,59,7,100,86.76470588235294,10.294117647058822
16008_marine,69,31,60,8,100,86.95652173913044,11.594202898550725
16009_marine,75,31,65,9,106,86.66666666666667,12
16010_marine,77,31,67,9,108,87.01298701298701,11.688311688311687
16011_marine,81,33,71,9,114,87.65432098765432,11.11111111111111
16012_marine,93,39,82,9,132,88.17204301075269,9.67741935483871
16013_marine,100,51,87,9,151,87,9
16014_marine,97,48,84,9,145,86.5979381443299,9.278350515463918
16015_marine,97,48,83,10,145,85.56701030927834,10.309278350515463
16016_marine,103,86,87,10,189,84.46601941747572,9.70873786407767
16017_marine,198,141,172,20,339,86.86868686868688,10.1010101010101
16018_marine,207,145,180,25,352,86.95652173913044,12.077294685990339
16052_marine,69,49,57,14,118,82.6086956521739,20.28985507246377
16070_marine,185,66,134,123,251,72.43243243243244,66.48648648648648
16071_marine,123,55,90,79,178,73.17073170731707,64.22764227642277
16072_marine,167,100,111,99,267,66.46706586826348,59.281437125748504
16159_marine,78,35,63,25,113,80.76923076923077,32.05128205128205
16160_marine,84,36,70,26,120,83.33333333333334,30.952380952380953
16161_marine,233,123,169,143,356,72.53218884120172,61.37339055793991
16164_marine,129,67,105,38,196,81.3953488372093,29.457364341085274
16165_marine,127,70,105,34,197,82.67716535433071,26.77165354330709
16166_marine,109,52,87,32,161,79.81651376146789,29.357798165137616
16167_marine,104,50,81,35,154,77.88461538461539,33.65384615384615
16168_marine,224,105,155,142,329,69.19642857142857,63.39285714285714
16169_marine,223,107,157,139,330,70.4035874439462,62.33183856502242
16170_marine,210,90,145,131,300,69.04761904761905,62.38095238095238
16171_marine,201,87,141,124,288,70.1492537313433,61.69154228855721
16172_marine,96,58,76,29,154,79.16666666666666,30.208333333333332
16173_marine,78,51,63,20,129,80.76923076923077,25.64102564102564
16174_marine,58,27,52,12,85,89.65517241379311,20.689655172413794
16175_marine,60,27,54,10,87,90,16.666666666666664
16176_marine,60,26,54,10,86,90,16.666666666666664
16177_marine,56,26,53,8,82,94.64285714285714,14.285714285714285
16178_marine,53,23,50,7,76,94.33962264150944,13.20754716981132
16179_marine,53,23,50,7,76,94.33962264150944,13.20754716981132
16180_marine,53,22,50,7,75,94.33962264150944,13.20754716981132
16181_marine,53,22,50,7,75,94.33962264150944,13.20754716981132
16182_marine,51,24,48,7,75,94.11764705882352,13.725490196078432
16183_marine,51,22,48,7,73,94.11764705882352,13.725490196078432
16184_marine,50,22,47,6,72,94,12
16185_marine,50,22,47,6,72,94,12
16186_marine,49,23,46,5,72,93.87755102040816,10.204081632653061
16187_marine,49,23,46,5,72,93.87755102040816,10.204081632653061
16188_marine,49,24,46,5,73,93.87755102040816,10.204081632653061
16189_marine,48,23,45,4,71,93.75,8.333333333333332
16190_marine,48,23,45,4,71,93.75,8.333333333333332
16191_marine,48,23,45,4,71,93.75,8.333333333333332
16192_marine,48,23,45,4,71,93.75,8.333333333333332
16193_marine,49,23,46,5,72,93.87755102040816,10.204081632653061
16194_marine,49,23,46,5,72,93.87755102040816,10.204081632653061
16195_marine,49,23,46,5,72,93.87755102040816,10.204081632653061
16196_marine,49,23,46,5,72,93.87755102040816,10.204081632653061
16197_marine,49,23,46,5,72,93.87755102040816,10.204081632653061
16198_marine,49,24,46,5,73,93.87755102040816,10.204081632653061
16199_marine,47,25,44,5,72,93.61702127659575,10.638297872340425
16200_marine,47,25,44,5,72,93.61702127659575,10.638297872340425
16201_marine,46,25,43,5,71,93.47826086956522,10.869565217391305
16202_marine,45,25,42,5,70,93.33333333333333,11.11111111111111
16203_marine,45,28,42,5,73,93.33333333333333,11.11111111111111
16204_marine,45,28,42,5,73,93.33333333333333,11.11111111111111
16205_marine,45,28,42,5,73,93.33333333333333,11.11111111111111
16206_marine,45,28,42,5,73,93.33333333333333,11.11111111111111
16207_marine,45,28,42,5,73,93.33333333333333,11.11111111111111
16208_marine,45,28,42,5,73,93.33333333333333,11.11111111111111
16209_marine,45,28,42,5,73,93.33333333333333,11.11111111111111
16210_marine,45,28,42,5,73,93.33333333333333,11.11111111111111
16211_marine,45,28,42,5,73,93.33333333333333,11.11111111111111
16212_marine,44,28,41,5,72,93.18181818181817,11.363636363636363
16213_marine,44,28,41,5,72,93.18181818181817,11.363636363636363
16214_marine,44,28,41,5,72,93.18181818181817,11.363636363636363
16215_marine,44,28,41,5,72,93.18181818181817,11.363636363636363
16216_marine,44,28,41,5,72,93.18181818181817,11.363636363636363
16217_marine,43,28,40,4,71,93.02325581395348,9.30232558139535
16218_marine,45,28,42,4,73,93.33333333333333,8.88888888888889
16219_marine,45,28,42,4,73,93.33333333333333,8.88888888888889
16220_marine,45,28,42,4,73,93.33333333333333,8.88888888888889
16221_marine,45,28,42,4,73,93.33333333333333,8.88888888888889
16222_marine,45,28,42,4,73,93.33333333333333,8.88888888888889
16223_marine,45,28,42,4,73,93.33333333333333,8.88888888888889
16224_marine,45,28,42,4,73,93.33333333333333,8.88888888888889
16225_marine,45,29,42,4,74,93.33333333333333,8.88888888888889
16226_marine,45,29,42,3,74,93.33333333333333,6.666666666666667
16227_marine,45,29,42,3,74,93.33333333333333,6.666666666666667
16228_marine,45,28,42,3,73,93.33333333333333,6.666666666666667
16229_marine,45,28,42,3,73,93.33333333333333,6.666666666666667
16230_marine,45,26,42,3,71,93.33333333333333,6.666666666666667
16231_marine,45,26,42,3,71,93.33333333333333,6.666666666666667
16232_marine,45,26,42,3,71,93.33333333333333,6.666666666666667
16233_marine,45,27,42,3,72,93.33333333333333,6.666666666666667
16234_marine,45,27,42,3,72,93.33333333333333,6.666666666666667
16235_marine,47,27,44,3,74,93.61702127659575,6.382978723404255
16236_marine,47,27,44,3,74,93.61702127659575,6.382978723404255
16237_marine,44,27,41,3,71,93.18181818181817,6.8181818181818175
16238_marine,44,27,41,3,71,93.18181818181817,6.8181818181818175
16239_marine,44,27,40,3,71,90.9090909090909,6.8181818181818175
16240_marine,45,27,41,4,72,91.11111111111111,8.88888888888889
16241_marine,45,27,41,4,72,91.11111111111111,8.88888888888889
16242_marine,43,27,39,4,70,90.69767441860465,9.30232558139535
16243_marine,44,28,40,5,72,90.9090909090909,11.363636363636363
16244_marine,44,28,40,5,72,90.9090909090909,11.363636363636363
16245_marine,46,28,42,5,74,91.30434782608695,10.869565217391305
16246_marine,47,28,43,5,75,91.48936170212765,10.638297872340425
16247_marine,47,30,43,5,77,91.48936170212765,10.638297872340425
16248_marine,51,29,47,5,80,92.15686274509804,9.803921568627452
16249_marine,54,30,50,5,84,92.5925925925926,9.25925925925926
16250_marine,58,30,53,6,88,91.37931034482759,10.344827586206897
16251_marine,61,29,56,6,90,91.80327868852459,9.836065573770492
16252_marine,66,30,61,6,96,92.42424242424242,9.090909090909092
16253_marine,70,32,66,6,102,94.28571428571428,8.571428571428571
16254_marine,71,34,66,7,105,92.95774647887323,9.859154929577464
16255_marine,123,65,108,25,188,87.8048780487805,20.32520325203252
16320_marine,109,61,97,21,170,88.9908256880734,19.26605504587156
16321_marine,124,73,104,39,197,83.87096774193549,31.451612903225808
16322_marine,93,77,85,12,170,91.39784946236558,12.903225806451612
16323_marine,91,73,83,12,164,91.20879120879121,13.186813186813188
16324_marine,87,64,79,11,151,90.80459770114942,12.643678160919542
16325_marine,84,67,76,11,151,90.47619047619048,13.095238095238097
16326_marine,86,65,78,11,151,90.69767441860465,12.790697674418606
16327_marine,86,65,78,11,151,90.69767441860465,12.790697674418606
16328_marine,82,65,75,9,147,91.46341463414635,10.975609756097562
16329_marine,79,36,74,8,115,93.67088607594937,10.126582278481013
16330_marine,79,36,73,7,115,92.40506329113924,8.860759493670885
16331_marine,82,52,76,7,134,92.6829268292683,8.536585365853659
16332_marine,79,62,74,6,141,93.67088607594937,7.59493670886076
16333_marine,69,30,64,6,99,92.7536231884058,8.695652173913043
16334_marine,65,29,60,6,94,92.3076923076923,9.230769230769232
16335_marine,64,28,59,5,92,92.1875,7.8125
16336_marine,64,26,59,5,90,92.1875,7.8125
16337_marine,62,26,57,5,88,91.93548387096774,8.064516129032258
16338_marine,62,26,57,5,88,91.93548387096774,8.064516129032258
16339_marine,61,26,56,4,87,91.80327868852459,6.557377049180328
16340_marine,59,26,54,4,85,91.52542372881356,6.779661016949152
16341_marine,59,26,54,4,85,91.52542372881356,6.779661016949152
16342_marine,59,26,54,4,85,91.52542372881356,6.779661016949152
16343_marine,58,24,53,3,82,91.37931034482759,5.172413793103448
16344_marine,59,25,54,3,84,91.52542372881356,5.084745762711865
16345_marine,59,25,54,3,84,91.52542372881356,5.084745762711865
16346_marine,60,25,55,3,85,91.66666666666666,5
16347_marine,60,26,55,3,86,91.66666666666666,5
16348_marine,60,26,55,3,86,91.66666666666666,5
16349_marine,60,26,55,3,86,91.66666666666666,5
16350_marine,60,28,55,3,88,91.66666666666666,5
16351_marine,60,39,55,2,99,91.66666666666666,3.3333333333333335
16352_marine,60,40,55,2,100,91.66666666666666,3.3333333333333335
16353_marine,58,40,53,2,98,91.37931034482759,3.4482758620689653
16354_marine,61,30,55,3,91,90.1639344262295,4.918032786885246
16355_marine,61,38,55,3,99,90.1639344262295,4.918032786885246
16356_marine,59,36,53,3,95,89.83050847457628,5.084745762711865
16357_marine,60,32,54,4,92,90,6.666666666666667
16358_marine,61,32,53,4,93,86.88524590163934,6.557377049180328
16359_marine,61,32,53,4,93,86.88524590163934,6.557377049180328
16360_marine,61,30,53,4,91,86.88524590163934,6.557377049180328
16361_marine,62,32,54,4,94,87.09677419354838,6.451612903225806
16362_marine,60,30,52,4,90,86.66666666666667,6.666666666666667
16363_marine,66,30,57,6,96,86.36363636363636,9.090909090909092
16364_marine,64,30,55,6,94,85.9375,9.375
16365_marine,65,30,56,7,95,86.15384615384616,10.76923076923077
16366_marine,69,30,60,7,99,86.95652173913044,10.144927536231885
16367_marine,73,31,64,7,104,87.67123287671232,9.58904109589041
16368_marine,79,31,69,9,110,87.34177215189874,11.39240506329114
16369_marine,81,31,71,9,112,87.65432098765432,11.11111111111111
16370_marine,95,37,85,9,132,89.47368421052632,9.473684210526317
16371_marine,226,150,199,23,376,88.05309734513274,10.176991150442479
16372_marine,236,156,208,27,392,88.13559322033898,11.440677966101696
16373_marine,234,156,206,27,390,88.03418803418803,11.538461538461538
16374_marine,227,152,200,24,379,88.10572687224669,10.572687224669604
16375_marine,229,154,202,25,383,88.20960698689956,10.91703056768559
16376_marine,224,150,197,24,374,87.94642857142857,10.714285714285714
16377_marine,219,138,192,24,357,87.67123287671232,10.95890410958904
16378_marine,215,152,187,25,367,86.9767441860465,11.627906976744185
16391_marine,235,129,217,29,364,92.34042553191489,12.340425531914894
16411_marine,77,49,65,13,126,84.4155844155844,16.883116883116884
16412_marine,66,46,56,9,112,84.84848484848484,13.636363636363635
16413_marine,70,52,58,12,122,82.85714285714286,17.142857142857142
16417_marine,65,51,53,13,116,81.53846153846153,20
16420_marine,57,47,46,11,104,80.7017543859649,19.298245614035086
16429_marine,36,32,33,5,68,91.66666666666666,13.88888888888889
16430_marine,118,55,86,76,173,72.88135593220339,64.40677966101694
16431_marine,175,115,119,107,290,68,61.142857142857146
16432_marine,168,108,112,100,276,66.66666666666666,59.523809523809526
16518_marine,80,35,63,23,115,78.75,28.749999999999996
16519_marine,83,31,70,21,114,84.33734939759037,25.301204819277107
16520_marine,106,52,87,33,158,82.0754716981132,31.132075471698112
16521_marine,125,63,101,44,188,80.80000000000001,35.199999999999996
16522_marine,319,180,225,197,499,70.53291536050156,61.75548589341693
16523_marine,307,167,217,186,474,70.68403908794788,60.586319218241044
16524_marine,312,176,221,186,488,70.83333333333334,59.61538461538461
16525_marine,315,186,226,185,501,71.74603174603175,58.730158730158735
16526_marine,355,219,244,213,574,68.73239436619718,60
16527_marine,278,150,196,158,428,70.50359712230215,56.83453237410072
16528_marine,239,114,170,142,353,71.1297071129707,59.41422594142259
16529_marine,111,62,88,35,173,79.27927927927928,31.53153153153153
16530_marine,101,59,82,30,160,81.1881188118812,29.7029702970297
16531_marine,81,49,67,20,130,82.71604938271605,24.691358024691358
16532_marine,66,29,57,16,95,86.36363636363636,24.242424242424242
16533_marine,65,27,59,13,92,90.76923076923077,20
16534_marine,62,27,57,9,89,91.93548387096774,14.516129032258066
16535_marine,58,26,55,9,84,94.82758620689656,15.517241379310345
16536_marine,58,26,55,8,84,94.82758620689656,13.793103448275861
16537_marine,57,24,54,7,81,94.73684210526315,12.280701754385964
16538_marine,55,23,52,7,78,94.54545454545455,12.727272727272727
16539_marine,53,25,50,7,78,94.33962264150944,13.20754716981132
16540_marine,53,25,50,7,78,94.33962264150944,13.20754716981132
16541_marine,52,24,49,6,76,94.23076923076923,11.538461538461538
16542_marine,50,25,47,4,75,94,8
16543_marine,50,25,47,4,75,94,8
16544_marine,50,25,47,4,75,94,8
16545_marine,50,25,47,4,75,94,8
16546_marine,48,25,45,4,73,93.75,8.333333333333332
16547_marine,46,26,43,4,72,93.47826086956522,8.695652173913043
16548_marine,46,24,43,4,70,93.47826086956522,8.695652173913043
16549_marine,46,24,43,4,70,93.47826086956522,8.695652173913043
16550_marine,46,24,43,4,70,93.47826086956522,8.695652173913043
16551_marine,46,23,43,4,69,93.47826086956522,8.695652173913043
16552_marine,46,23,43,4,69,93.47826086956522,8.695652173913043
16553_marine,46,23,43,4,69,93.47826086956522,8.695652173913043
16554_marine,46,23,43,4,69,93.47826086956522,8.695652173913043
16555_marine,46,23,43,4,69,93.47826086956522,8.695652173913043
16556_marine,47,23,44,5,70,93.61702127659575,10.638297872340425
16557_marine,47,23,44,5,70,93.61702127659575,10.638297872340425
16558_marine,47,24,44,5,71,93.61702127659575,10.638297872340425
16559_marine,47,24,44,5,71,93.61702127659575,10.638297872340425
16560_marine,47,25,44,5,72,93.61702127659575,10.638297872340425
16561_marine,49,28,46,4,77,93.87755102040816,8.16326530612245
16562_marine,49,28,46,5,77,93.87755102040816,10.204081632653061
16563_marine,47,30,44,5,77,93.61702127659575,10.638297872340425
16564_marine,47,30,44,5,77,93.61702127659575,10.638297872340425
16565_marine,47,30,44,5,77,93.61702127659575,10.638297872340425
16566_marine,47,30,44,5,77,93.61702127659575,10.638297872340425
16567_marine,46,30,43,5,76,93.47826086956522,10.869565217391305
16568_marine,44,31,41,5,75,93.18181818181817,11.363636363636363
16569_marine,44,31,41,5,75,93.18181818181817,11.363636363636363
16570_marine,43,30,40,4,73,93.02325581395348,9.30232558139535
16571_marine,43,30,40,4,73,93.02325581395348,9.30232558139535
16572_marine,43,30,40,4,73,93.02325581395348,9.30232558139535
16573_marine,43,30,40,4,73,93.02325581395348,9.30232558139535
16574_marine,43,30,40,4,73,93.02325581395348,9.30232558139535
16575_marine,43,28,40,4,71,93.02325581395348,9.30232558139535
16576_marine,43,28,40,4,71,93.02325581395348,9.30232558139535
16577_marine,45,28,42,4,73,93.33333333333333,8.88888888888889
16578_marine,45,28,42,4,73,93.33333333333333,8.88888888888889
16579_marine,45,28,42,4,73,93.33333333333333,8.88888888888889
16580_marine,45,28,42,4,73,93.33333333333333,8.88888888888889
16581_marine,45,28,42,4,73,93.33333333333333,8.88888888888889
16582_marine,45,27,42,4,72,93.33333333333333,8.88888888888889
16583_marine,44,27,41,3,71,93.18181818181817,6.8181818181818175
16584_marine,44,28,41,3,72,93.18181818181817,6.8181818181818175
16585_marine,44,28,41,3,72,93.18181818181817,6.8181818181818175
16586_marine,44,28,41,3,72,93.18181818181817,6.8181818181818175
16587_marine,44,28,41,3,72,93.18181818181817,6.8181818181818175
16588_marine,44,28,41,3,72,93.18181818181817,6.8181818181818175
16589_marine,43,28,41,2,71,95.34883720930233,4.651162790697675
16590_marine,43,28,41,2,71,95.34883720930233,4.651162790697675
16591_marine,43,28,41,2,71,95.34883720930233,4.651162790697675
16592_marine,43,28,41,2,71,95.34883720930233,4.651162790697675
16593_marine,43,28,41,2,71,95.34883720930233,4.651162790697675
16594_marine,44,28,41,3,72,93.18181818181817,6.8181818181818175
16595_marine,46,28,43,3,74,93.47826086956522,6.521739130434782
16596_marine,47,28,44,3,75,93.61702127659575,6.382978723404255
16597_marine,47,26,44,3,73,93.61702127659575,6.382978723404255
16598_marine,47,26,44,3,73,93.61702127659575,6.382978723404255
16599_marine,46,27,43,3,73,93.47826086956522,6.521739130434782
16600_marine,46,29,43,3,75,93.47826086956522,6.521739130434782
16601_marine,50,29,46,4,79,92,8
16602_marine,48,29,44,4,77,91.66666666666666,8.333333333333332
16603_marine,48,29,44,4,77,91.66666666666666,8.333333333333332
16604_marine,46,28,42,4,74,91.30434782608695,8.695652173913043
16605_marine,47,28,43,5,75,91.48936170212765,10.638297872340425
16606_marine,47,28,43,5,75,91.48936170212765,10.638297872340425
16607_marine,50,30,46,5,80,92,10
16608_marine,49,30,45,5,79,91.83673469387756,10.204081632653061
16609_marine,53,29,49,5,82,92.45283018867924,9.433962264150944
16610_marine,56,30,51,6,86,91.07142857142857,10.714285714285714
16611_marine,61,29,56,6,90,91.80327868852459,9.836065573770492
16612_marine,70,29,65,8,99,92.85714285714286,11.428571428571429
16613_marine,75,32,71,8,107,94.66666666666667,10.666666666666668
16614_marine,76,34,71,9,110,93.42105263157895,11.842105263157894
16615_marine,121,70,106,26,191,87.60330578512396,21.487603305785125
16672_marine,289,150,165,179,439,57.09342560553633,61.93771626297578
16673_marine,123,79,105,25,202,85.36585365853658,20.32520325203252
16677_marine,127,71,112,22,198,88.18897637795276,17.322834645669293
16678_marine,120,67,108,18,187,90,15
16679_marine,104,82,96,12,186,92.3076923076923,11.538461538461538
16680_marine,123,83,103,36,206,83.73983739837398,29.268292682926827
16681_marine,116,81,97,34,197,83.62068965517241,29.310344827586203
16682_marine,89,71,82,9,160,92.13483146067416,10.112359550561797
16683_marine,72,51,65,9,123,90.27777777777779,12.5
16684_marine,70,29,64,7,99,91.42857142857143,10
16685_marine,66,29,60,7,95,90.9090909090909,10.606060606060606
16686_marine,67,30,60,7,97,89.55223880597015,10.44776119402985
16687_marine,72,56,64,8,128,88.88888888888889,11.11111111111111
16688_marine,83,62,76,8,145,91.56626506024097,9.63855421686747
16689_marine,83,62,77,7,145,92.7710843373494,8.433734939759036
16690_marine,81,58,75,7,139,92.5925925925926,8.641975308641975
16691_marine,82,64,76,7,146,92.6829268292683,8.536585365853659
16692_marine,73,60,68,6,133,93.15068493150685,8.21917808219178
16693_marine,62,29,57,5,91,91.93548387096774,8.064516129032258
16694_marine,62,28,57,5,90,91.93548387096774,8.064516129032258
16695_marine,62,26,57,5,88,91.93548387096774,8.064516129032258
16696_marine,62,26,57,5,88,91.93548387096774,8.064516129032258
16697_marine,60,26,55,5,86,91.66666666666666,8.333333333333332
16698_marine,59,24,54,4,83,91.52542372881356,6.779661016949152
16699_marine,59,24,54,4,83,91.52542372881356,6.779661016949152
16700_marine,59,24,54,4,83,91.52542372881356,6.779661016949152
16701_marine,59,26,54,4,85,91.52542372881356,6.779661016949152
16702_marine,57,26,52,4,83,91.22807017543859,7.017543859649122
16703_marine,56,25,51,3,81,91.07142857142857,5.357142857142857
16704_marine,57,25,52,3,82,91.22807017543859,5.263157894736842
16705_marine,58,25,53,3,83,91.37931034482759,5.172413793103448
16706_marine,58,27,53,3,85,91.37931034482759,5.172413793103448
16707_marine,58,27,53,3,85,91.37931034482759,5.172413793103448
16708_marine,57,29,52,3,86,91.22807017543859,5.263157894736842
16709_marine,57,29,52,3,86,91.22807017543859,5.263157894736842
16710_marine,58,41,53,2,99,91.37931034482759,3.4482758620689653
16711_marine,62,49,57,2,111,91.93548387096774,3.225806451612903
16712_marine,62,49,57,2,111,91.93548387096774,3.225806451612903
16713_marine,61,43,55,3,104,90.1639344262295,4.918032786885246
16714_marine,62,35,56,4,97,90.32258064516128,6.451612903225806
16715_marine,62,42,56,4,104,90.32258064516128,6.451612903225806
16716_marine,63,40,55,4,103,87.3015873015873,6.349206349206349
16717_marine,63,38,55,4,101,87.3015873015873,6.349206349206349
16718_marine,63,36,55,4,99,87.3015873015873,6.349206349206349
16719_marine,63,38,55,4,101,87.3015873015873,6.349206349206349
16720_marine,63,38,55,4,101,87.3015873015873,6.349206349206349
16721_marine,66,36,58,4,102,87.87878787878788,6.0606060606060606
16722_marine,68,36,60,4,104,88.23529411764706,5.88235294117647
16723_marine,70,34,61,6,104,87.14285714285714,8.571428571428571
16724_marine,72,34,63,6,106,87.5,8.333333333333332
16725_marine,74,34,65,7,108,87.83783783783784,9.45945945945946
16726_marine,75,32,66,7,107,88,9.333333333333334
16727_marine,79,33,70,7,112,88.60759493670885,8.860759493670885
16728_marine,85,41,75,9,126,88.23529411764706,10.588235294117647
16729_marine,94,41,84,9,135,89.36170212765957,9.574468085106384
16730_marine,213,120,191,20,333,89.67136150234741,9.389671361502346
16734_marine,268,170,233,45,438,86.94029850746269,16.791044776119403
16736_marine,232,151,204,28,383,87.93103448275862,12.068965517241379
16755_marine,209,124,190,21,333,90.9090909090909,10.047846889952153
16770_marine,91,54,78,16,145,85.71428571428571,17.582417582417584
16771_marine,66,47,57,8,113,86.36363636363636,12.121212121212121
16772_marine,19,3,14,2,22,73.68421052631578,10.526315789473683
16773_marine,63,46,54,9,109,85.71428571428571,14.285714285714285
16774_marine,67,50,58,10,117,86.56716417910447,14.925373134328357
16775_marine,70,52,61,9,122,87.14285714285714,12.857142857142856
16776_marine,58,49,49,8,107,84.48275862068965,13.793103448275861
16777_marine,52,37,43,6,89,82.6923076923077,11.538461538461538
16778_marine,56,39,47,7,95,83.92857142857143,12.5
16779_marine,61,43,51,9,104,83.60655737704919,14.754098360655737
16789_marine,37,33,34,6,70,91.8918918918919,16.216216216216218
16790_marine,36,34,33,6,70,91.66666666666666,16.666666666666664
16791_marine,80,55,65,42,135,81.25,52.5
16792_marine,163,109,110,100,272,67.48466257668711,61.34969325153374
16877_marine,84,35,69,25,119,82.14285714285714,29.761904761904763
16878_marine,72,26,63,17,98,87.5,23.61111111111111
16879_marine,84,39,72,25,123,85.71428571428571,29.761904761904763
16880_marine,125,66,99,42,191,79.2,33.6
16881_marine,320,171,227,195,491,70.9375,60.9375
16882_marine,316,177,224,192,493,70.88607594936708,60.75949367088608
16885_marine,306,173,217,182,479,70.91503267973856,59.47712418300654
16886_marine,372,236,259,214,608,69.6236559139785,57.52688172043011
16887_marine,254,147,184,143,401,72.44094488188976,56.2992125984252
16888_marine,128,74,100,36,202,78.125,28.125
16889_marine,103,56,87,21,159,84.46601941747572,20.388349514563107
16890_marine,78,40,68,16,118,87.17948717948718,20.51282051282051
16891_marine,69,34,62,12,103,89.85507246376811,17.391304347826086
16892_marine,66,27,61,11,93,92.42424242424242,16.666666666666664
16893_marine,62,26,59,9,88,95.16129032258065,14.516129032258066
16894_marine,59,26,56,8,85,94.91525423728814,13.559322033898304
16895_marine,56,26,53,7,82,94.64285714285714,12.5
16896_marine,55,26,52,7,81,94.54545454545455,12.727272727272727
16897_marine,55,26,52,7,81,94.54545454545455,12.727272727272727
16898_marine,53,26,50,5,79,94.33962264150944,9.433962264150944
16899_marine,52,26,49,4,78,94.23076923076923,7.6923076923076925
16900_marine,48,26,45,4,74,93.75,8.333333333333332
16901_marine,48,26,45,4,74,93.75,8.333333333333332
16902_marine,48,25,45,4,73,93.75,8.333333333333332
16903_marine,48,25,45,4,73,93.75,8.333333333333332
16904_marine,48,25,45,4,73,93.75,8.333333333333332
16905_marine,48,25,45,4,73,93.75,8.333333333333332
16906_marine,48,25,45,4,73,93.75,8.333333333333332
16907_marine,48,27,45,4,75,93.75,8.333333333333332
16908_marine,48,27,45,4,75,93.75,8.333333333333332
16909_marine,46,27,43,4,73,93.47826086956522,8.695652173913043
16910_marine,46,27,43,4,73,93.47826086956522,8.695652173913043
16911_marine,46,29,43,4,75,93.47826086956522,8.695652173913043
16912_marine,46,26,43,4,72,93.47826086956522,8.695652173913043
16913_marine,46,26,43,4,72,93.47826086956522,8.695652173913043
16914_marine,46,26,43,4,72,93.47826086956522,8.695652173913043
16915_marine,46,24,43,4,70,93.47826086956522,8.695652173913043
16916_marine,46,24,43,4,70,93.47826086956522,8.695652173913043
16917_marine,46,27,43,4,73,93.47826086956522,8.695652173913043
16918_marine,46,27,43,4,73,93.47826086956522,8.695652173913043
16919_marine,46,28,43,4,74,93.47826086956522,8.695652173913043
16920_marine,46,28,43,4,74,93.47826086956522,8.695652173913043
16921_marine,48,28,45,3,76,93.75,6.25
16922_marine,47,28,44,4,75,93.61702127659575,8.51063829787234
16923_marine,47,30,44,4,77,93.61702127659575,8.51063829787234
16924_marine,47,30,44,4,77,93.61702127659575,8.51063829787234
16925_marine,47,30,44,4,77,93.61702127659575,8.51063829787234
16926_marine,47,30,44,4,77,93.61702127659575,8.51063829787234
16927_marine,47,30,44,4,77,93.61702127659575,8.51063829787234
16928_marine,47,31,44,4,78,93.61702127659575,8.51063829787234
16929_marine,47,31,44,4,78,93.61702127659575,8.51063829787234
16930_marine,47,31,44,4,78,93.61702127659575,8.51063829787234
16931_marine,45,31,42,4,76,93.33333333333333,8.88888888888889
16932_marine,43,31,40,4,74,93.02325581395348,9.30232558139535
16933_marine,43,31,40,4,74,93.02325581395348,9.30232558139535
16934_marine,43,31,40,4,74,93.02325581395348,9.30232558139535
16935_marine,43,31,40,4,74,93.02325581395348,9.30232558139535
16936_marine,45,31,42,6,76,93.33333333333333,13.333333333333334
16937_marine,47,30,44,6,77,93.61702127659575,12.76595744680851
16938_marine,46,27,43,5,73,93.47826086956522,10.869565217391305
16939_marine,46,27,43,5,73,93.47826086956522,10.869565217391305
16940_marine,46,27,43,5,73,93.47826086956522,10.869565217391305
16941_marine,44,27,41,3,71,93.18181818181817,6.8181818181818175
16942_marine,44,27,41,3,71,93.18181818181817,6.8181818181818175
16943_marine,43,27,41,2,70,95.34883720930233,4.651162790697675
16944_marine,43,28,41,2,71,95.34883720930233,4.651162790697675
16945_marine,45,28,43,4,73,95.55555555555556,8.88888888888889
16946_marine,45,28,43,4,73,95.55555555555556,8.88888888888889
16947_marine,45,28,43,4,73,95.55555555555556,8.88888888888889
16948_marine,45,28,43,4,73,95.55555555555556,8.88888888888889
16949_marine,45,28,43,4,73,95.55555555555556,8.88888888888889
16950_marine,45,28,43,4,73,95.55555555555556,8.88888888888889
16951_marine,47,28,45,4,75,95.74468085106383,8.51063829787234
16952_marine,47,28,45,4,75,95.74468085106383,8.51063829787234
16953_marine,47,28,45,4,75,95.74468085106383,8.51063829787234
16954_marine,49,28,47,4,77,95.91836734693877,8.16326530612245
16955_marine,49,28,47,4,77,95.91836734693877,8.16326530612245
16956_marine,51,28,49,4,79,96.07843137254902,7.8431372549019605
16957_marine,51,30,49,4,81,96.07843137254902,7.8431372549019605
16958_marine,51,30,49,4,81,96.07843137254902,7.8431372549019605
16959_marine,51,30,48,5,81,94.11764705882352,9.803921568627452
16960_marine,51,28,48,5,79,94.11764705882352,9.803921568627452
16961_marine,52,28,49,6,80,94.23076923076923,11.538461538461538
16962_marine,52,29,49,6,81,94.23076923076923,11.538461538461538
16963_marine,52,29,49,6,81,94.23076923076923,11.538461538461538
16964_marine,53,29,49,6,82,92.45283018867924,11.320754716981133
16965_marine,53,29,49,6,82,92.45283018867924,11.320754716981133
16966_marine,52,28,48,7,80,92.3076923076923,13.461538461538462
16967_marine,51,28,47,7,79,92.15686274509804,13.725490196078432
16968_marine,52,30,48,7,82,92.3076923076923,13.461538461538462
16969_marine,56,30,52,7,86,92.85714285714286,12.5
16970_marine,56,30,52,7,86,92.85714285714286,12.5
16971_marine,60,30,55,8,90,91.66666666666666,13.333333333333334
16972_marine,69,29,64,8,98,92.7536231884058,11.594202898550725
16973_marine,76,30,72,8,106,94.73684210526315,10.526315789473683
16974_marine,77,34,72,9,111,93.5064935064935,11.688311688311687
16975_marine,123,72,108,27,195,87.8048780487805,21.951219512195124
17031_marine,160,95,136,36,255,85,22.5
17032_marine,142,88,128,22,230,90.14084507042254,15.492957746478872
17033_marine,132,87,118,18,219,89.39393939393939,13.636363636363635
17034_marine,138,87,124,20,225,89.85507246376811,14.492753623188406
17035_marine,140,106,124,21,246,88.57142857142857,15
17036_marine,121,98,108,18,219,89.25619834710744,14.87603305785124
17037_marine,109,89,99,10,198,90.82568807339449,9.174311926605505
17038_marine,102,83,96,8,185,94.11764705882352,7.8431372549019605
17039_marine,96,77,90,8,173,93.75,8.333333333333332
17040_marine,74,54,68,7,128,91.8918918918919,9.45945945945946
17041_marine,72,38,67,6,110,93.05555555555556,8.333333333333332
17042_marine,72,28,66,6,100,91.66666666666666,8.333333333333332
17043_marine,70,24,64,6,94,91.42857142857143,8.571428571428571
17044_marine,65,26,59,6,91,90.76923076923077,9.230769230769232
17045_marine,64,26,57,7,90,89.0625,10.9375
17046_marine,61,24,55,7,85,90.1639344262295,11.475409836065573
17047_marine,61,26,55,7,87,90.1639344262295,11.475409836065573
17048_marine,63,30,57,7,93,90.47619047619048,11.11111111111111
17049_marine,70,58,64,7,128,91.42857142857143,10
17050_marine,81,60,75,7,141,92.5925925925926,8.641975308641975
17051_marine,79,58,73,6,137,92.40506329113924,7.59493670886076
17052_marine,65,47,59,6,112,90.76923076923077,9.230769230769232
17053_marine,61,28,55,6,89,90.1639344262295,9.836065573770492
17054_marine,60,28,55,5,88,91.66666666666666,8.333333333333332
17055_marine,60,28,55,5,88,91.66666666666666,8.333333333333332
17056_marine,60,28,55,5,88,91.66666666666666,8.333333333333332
17057_marine,57,28,52,4,85,91.22807017543859,7.017543859649122
17058_marine,57,26,52,4,83,91.22807017543859,7.017543859649122
17059_marine,57,26,52,4,83,91.22807017543859,7.017543859649122
17060_marine,57,26,52,4,83,91.22807017543859,7.017543859649122
17061_marine,57,26,52,4,83,91.22807017543859,7.017543859649122
17062_marine,59,27,54,4,86,91.52542372881356,6.779661016949152
17063_marine,58,29,53,3,87,91.37931034482759,5.172413793103448
17064_marine,60,27,55,3,87,91.66666666666666,5
17065_marine,60,29,55,3,89,91.66666666666666,5
17066_marine,60,29,55,3,89,91.66666666666666,5
17067_marine,59,30,54,3,89,91.52542372881356,5.084745762711865
17068_marine,59,32,54,3,91,91.52542372881356,5.084745762711865
17069_marine,63,35,58,3,98,92.06349206349206,4.761904761904762
17070_marine,64,47,59,2,111,92.1875,3.125
17071_marine,71,47,66,3,118,92.95774647887323,4.225352112676056
17072_marine,76,49,68,4,125,89.47368421052632,5.263157894736842
17073_marine,72,39,64,4,111,88.88888888888889,5.555555555555555
17074_marine,72,35,64,4,107,88.88888888888889,5.555555555555555
17075_marine,69,33,61,4,102,88.40579710144928,5.797101449275362
17076_marine,70,35,62,4,105,88.57142857142857,5.714285714285714
17077_marine,70,34,62,4,104,88.57142857142857,5.714285714285714
17078_marine,70,34,62,4,104,88.57142857142857,5.714285714285714
17079_marine,70,36,62,4,106,88.57142857142857,5.714285714285714
17080_marine,70,34,62,4,104,88.57142857142857,5.714285714285714
17081_marine,70,36,62,4,106,88.57142857142857,5.714285714285714
17082_marine,72,36,64,4,108,88.88888888888889,5.555555555555555
17083_marine,75,32,66,6,107,88,8
17084_marine,74,34,65,6,108,87.83783783783784,8.108108108108109
17085_marine,79,34,70,7,113,88.60759493670885,8.860759493670885
17086_marine,78,34,69,7,112,88.46153846153845,8.974358974358974
17087_marine,83,35,74,7,118,89.1566265060241,8.433734939759036
17088_marine,91,43,81,9,134,89.01098901098901,9.89010989010989
17089_marine,104,55,94,9,159,90.38461538461539,8.653846153846153
17090_marine,227,134,205,21,361,90.30837004405286,9.251101321585903
17105_marine,228,137,208,24,365,91.22807017543859,10.526315789473683
17106_marine,229,131,210,25,360,91.70305676855895,10.91703056768559
17107_marine,391,170,318,143,561,81.32992327365729,36.57289002557545
17108_marine,227,114,207,26,341,91.18942731277532,11.45374449339207
17116_marine,356,189,291,127,545,81.74157303370787,35.674157303370784
17130_marine,86,53,75,11,139,87.20930232558139,12.790697674418606
17131_marine,82,50,73,11,132,89.02439024390245,13.414634146341465
17132_marine,83,50,73,10,133,87.95180722891565,12.048192771084338
17133_marine,82,48,72,12,130,87.8048780487805,14.634146341463413
17137_marine,62,46,51,9,108,82.25806451612904,14.516129032258066
17138_marine,56,45,46,8,101,82.14285714285714,14.285714285714285
17139_marine,21,3,13,5,24,61.904761904761905,23.809523809523807
17140_marine,64,46,54,9,110,84.375,14.0625
17150_marine,37,33,35,6,70,94.5945945945946,16.216216216216218
17151_marine,37,34,35,6,71,94.5945945945946,16.216216216216218
17152_marine,162,105,108,99,267,66.66666666666666,61.111111111111114
17153_marine,173,107,119,105,280,68.78612716763006,60.69364161849711
17154_marine,137,69,84,98,206,61.31386861313869,71.53284671532847
17236_marine,80,28,67,21,108,83.75,26.25
17237_marine,71,22,64,16,93,90.14084507042254,22.535211267605636
17238_marine,67,25,59,13,92,88.05970149253731,19.402985074626866
17239_marine,129,43,110,36,172,85.27131782945736,27.906976744186046
17240_marine,345,177,256,200,522,74.20289855072464,57.971014492753625
17242_marine,352,196,264,190,548,75,53.97727272727273
17243_marine,334,203,249,182,537,74.55089820359282,54.49101796407185
17244_marine,338,204,248,182,542,73.37278106508876,53.84615384615385
17245_marine,338,207,246,188,545,72.7810650887574,55.62130177514793
17246_marine,336,198,243,182,534,72.32142857142857,54.166666666666664
17247_marine,127,65,105,31,192,82.67716535433071,24.409448818897637
17248_marine,95,46,82,19,141,86.31578947368422,20
17249_marine,77,36,70,12,113,90.9090909090909,15.584415584415584
17250_marine,69,28,64,12,97,92.7536231884058,17.391304347826086
17251_marine,68,26,63,10,94,92.64705882352942,14.705882352941178
17252_marine,65,26,60,10,91,92.3076923076923,15.384615384615385
17253_marine,63,28,58,8,91,92.06349206349206,12.698412698412698
17254_marine,62,26,57,7,88,91.93548387096774,11.29032258064516
17255_marine,61,27,56,6,88,91.80327868852459,9.836065573770492
17256_marine,61,27,56,5,88,91.80327868852459,8.19672131147541
17257_marine,58,27,53,4,85,91.37931034482759,6.896551724137931
17258_marine,58,26,53,4,84,91.37931034482759,6.896551724137931
17259_marine,58,26,53,4,84,91.37931034482759,6.896551724137931
17260_marine,56,26,51,4,82,91.07142857142857,7.142857142857142
17261_marine,52,26,49,4,78,94.23076923076923,7.6923076923076925
17262_marine,50,25,47,4,75,94,8
17263_marine,48,26,45,4,74,93.75,8.333333333333332
17264_marine,48,26,45,4,74,93.75,8.333333333333332
17265_marine,48,26,45,4,74,93.75,8.333333333333332
17266_marine,48,27,45,4,75,93.75,8.333333333333332
17267_marine,48,27,45,4,75,93.75,8.333333333333332
17268_marine,48,27,45,4,75,93.75,8.333333333333332
17269_marine,48,27,45,4,75,93.75,8.333333333333332
17270_marine,48,28,45,4,76,93.75,8.333333333333332
17271_marine,48,30,45,4,78,93.75,8.333333333333332
17272_marine,46,28,43,4,74,93.47826086956522,8.695652173913043
17273_marine,46,27,43,4,73,93.47826086956522,8.695652173913043
17274_marine,46,27,43,4,73,93.47826086956522,8.695652173913043
17275_marine,46,28,43,4,74,93.47826086956522,8.695652173913043
17276_marine,46,28,43,4,74,93.47826086956522,8.695652173913043
17277_marine,46,28,43,4,74,93.47826086956522,8.695652173913043
17278_marine,46,28,43,4,74,93.47826086956522,8.695652173913043
17279_marine,46,28,43,4,74,93.47826086956522,8.695652173913043
17280_marine,45,29,42,3,74,93.33333333333333,6.666666666666667
17281_marine,49,27,46,3,76,93.87755102040816,6.122448979591836
17282_marine,48,27,45,3,75,93.75,6.25
17283_marine,48,29,45,3,77,93.75,6.25
17284_marine,48,30,45,3,78,93.75,6.25
17285_marine,48,30,45,3,78,93.75,6.25
17286_marine,50,30,47,5,80,94,10
17287_marine,50,30,47,5,80,94,10
17288_marine,50,31,47,5,81,94,10
17289_marine,50,31,47,5,81,94,10
17290_marine,51,31,48,5,82,94.11764705882352,9.803921568627452
17291_marine,51,31,48,5,82,94.11764705882352,9.803921568627452
17292_marine,51,31,48,5,82,94.11764705882352,9.803921568627452
17293_marine,53,30,50,5,83,94.33962264150944,9.433962264150944
17294_marine,53,30,50,5,83,94.33962264150944,9.433962264150944
17295_marine,53,30,50,5,83,94.33962264150944,9.433962264150944
17296_marine,53,30,50,5,83,94.33962264150944,9.433962264150944
17297_marine,55,30,52,5,85,94.54545454545455,9.090909090909092
17298_marine,55,30,52,5,85,94.54545454545455,9.090909090909092
17299_marine,56,30,54,4,86,96.42857142857143,7.142857142857142
17300_marine,56,28,54,4,84,96.42857142857143,7.142857142857142
17301_marine,56,28,54,4,84,96.42857142857143,7.142857142857142
17302_marine,54,28,52,4,82,96.29629629629629,7.4074074074074066
17303_marine,54,29,52,4,83,96.29629629629629,7.4074074074074066
17304_marine,54,29,52,4,83,96.29629629629629,7.4074074074074066
17305_marine,52,29,50,4,81,96.15384615384616,7.6923076923076925
17306_marine,54,28,52,4,82,96.29629629629629,7.4074074074074066
17307_marine,54,28,52,4,82,96.29629629629629,7.4074074074074066
17308_marine,53,28,51,4,81,96.22641509433963,7.547169811320755
17309_marine,51,28,49,4,79,96.07843137254902,7.8431372549019605
17310_marine,51,28,49,4,79,96.07843137254902,7.8431372549019605
17311_marine,51,28,49,4,79,96.07843137254902,7.8431372549019605
17312_marine,51,28,49,4,79,96.07843137254902,7.8431372549019605
17313_marine,51,30,49,4,81,96.07843137254902,7.8431372549019605
17314_marine,51,30,49,4,81,96.07843137254902,7.8431372549019605
17315_marine,51,30,49,4,81,96.07843137254902,7.8431372549019605
17316_marine,51,30,49,4,81,96.07843137254902,7.8431372549019605
17317_marine,51,30,49,4,81,96.07843137254902,7.8431372549019605
17318_marine,51,30,49,4,81,96.07843137254902,7.8431372549019605
17319_marine,52,30,50,4,82,96.15384615384616,7.6923076923076925
17320_marine,52,30,50,4,82,96.15384615384616,7.6923076923076925
17321_marine,53,30,50,5,83,94.33962264150944,9.433962264150944
17322_marine,54,30,51,6,84,94.44444444444444,11.11111111111111
17323_marine,52,28,49,6,80,94.23076923076923,11.538461538461538
17324_marine,54,29,51,6,83,94.44444444444444,11.11111111111111
17325_marine,54,29,51,6,83,94.44444444444444,11.11111111111111
17326_marine,54,29,50,6,83,92.5925925925926,11.11111111111111
17327_marine,55,28,51,7,83,92.72727272727272,12.727272727272727
17328_marine,56,30,52,7,86,92.85714285714286,12.5
17329_marine,56,30,52,7,86,92.85714285714286,12.5
17330_marine,58,30,54,7,88,93.10344827586206,12.068965517241379
17331_marine,61,29,56,8,90,91.80327868852459,13.114754098360656
17332_marine,68,29,63,8,97,92.64705882352942,11.76470588235294
17333_marine,72,29,68,8,101,94.44444444444444,11.11111111111111
17334_marine,76,33,72,8,109,94.73684210526315,10.526315789473683
17335_marine,136,73,121,26,209,88.97058823529412,19.11764705882353
17392_marine,156,100,141,21,256,90.38461538461539,13.461538461538462
17393_marine,138,89,123,18,227,89.13043478260869,13.043478260869565
17394_marine,129,103,117,12,232,90.69767441860465,9.30232558139535
17395_marine,131,105,119,12,236,90.83969465648855,9.16030534351145
17396_marine,88,64,82,8,152,93.18181818181817,9.090909090909092
17397_marine,80,42,74,7,122,92.5,8.75
17398_marine,76,38,70,7,114,92.10526315789474,9.210526315789473
17399_marine,73,36,67,6,109,91.78082191780823,8.21917808219178
17400_marine,71,30,65,6,101,91.54929577464789,8.450704225352112
17401_marine,72,32,65,7,104,90.27777777777779,9.722222222222223
17402_marine,68,32,61,7,100,89.70588235294117,10.294117647058822
17403_marine,68,30,61,7,98,89.70588235294117,10.294117647058822
17404_marine,67,28,61,7,95,91.04477611940298,10.44776119402985
17405_marine,67,26,61,7,93,91.04477611940298,10.44776119402985
17406_marine,67,26,61,7,93,91.04477611940298,10.44776119402985
17407_marine,67,26,61,7,93,91.04477611940298,10.44776119402985
17408_marine,66,26,60,6,92,90.9090909090909,9.090909090909092
17409_marine,65,30,59,6,95,90.76923076923077,9.230769230769232
17410_marine,68,31,62,6,99,91.17647058823529,8.823529411764707
17411_marine,68,37,62,6,105,91.17647058823529,8.823529411764707
17412_marine,67,32,61,6,99,91.04477611940298,8.955223880597014
17413_marine,67,28,61,6,95,91.04477611940298,8.955223880597014
17414_marine,71,28,63,6,99,88.73239436619718,8.450704225352112
17415_marine,71,28,63,6,99,88.73239436619718,8.450704225352112
17416_marine,69,26,62,4,95,89.85507246376811,5.797101449275362
17417_marine,67,26,60,4,93,89.55223880597015,5.970149253731343
17418_marine,67,26,60,4,93,89.55223880597015,5.970149253731343
17419_marine,69,26,62,4,95,89.85507246376811,5.797101449275362
17420_marine,69,26,62,4,95,89.85507246376811,5.797101449275362
17421_marine,69,25,62,4,94,89.85507246376811,5.797101449275362
17422_marine,68,25,61,3,93,89.70588235294117,4.411764705882353
17423_marine,68,25,61,3,93,89.70588235294117,4.411764705882353
17424_marine,70,27,63,3,97,90,4.285714285714286
17425_marine,71,27,64,3,98,90.14084507042254,4.225352112676056
17426_marine,71,27,64,3,98,90.14084507042254,4.225352112676056
17427_marine,71,30,64,3,101,90.14084507042254,4.225352112676056
17428_marine,70,30,63,4,100,90,5.714285714285714
17429_marine,72,43,65,4,115,90.27777777777779,5.555555555555555
17430_marine,79,45,71,4,124,89.87341772151899,5.063291139240507
17431_marine,77,49,69,4,126,89.6103896103896,5.194805194805195
17432_marine,81,47,73,4,128,90.12345679012346,4.938271604938271
17433_marine,80,43,72,4,123,90,5
17434_marine,80,39,72,4,119,90,5
17435_marine,76,35,68,4,111,89.47368421052632,5.263157894736842
17436_marine,76,35,68,4,111,89.47368421052632,5.263157894736842
17437_marine,74,35,66,4,109,89.1891891891892,5.405405405405405
17438_marine,74,34,66,4,108,89.1891891891892,5.405405405405405
17439_marine,74,36,66,4,110,89.1891891891892,5.405405405405405
17440_marine,74,36,66,4,110,89.1891891891892,5.405405405405405
17441_marine,74,36,66,4,110,89.1891891891892,5.405405405405405
17442_marine,75,32,66,4,107,88,5.333333333333334
17443_marine,76,32,68,5,108,89.47368421052632,6.578947368421052
17444_marine,76,34,68,5,110,89.47368421052632,6.578947368421052
17445_marine,80,34,72,6,114,90,7.5
17446_marine,82,34,74,6,116,90.2439024390244,7.317073170731707
17447_marine,87,35,78,7,122,89.65517241379311,8.045977011494253
17448_marine,94,35,84,9,129,89.36170212765957,9.574468085106384
17449_marine,101,43,91,9,144,90.0990099009901,8.91089108910891
17450_marine,122,65,108,13,187,88.52459016393442,10.655737704918032
17451_marine,275,171,247,32,446,89.81818181818181,11.636363636363637
17461_marine,238,120,216,31,358,90.75630252100841,13.025210084033615
17465_marine,219,112,201,21,331,91.78082191780823,9.58904109589041
17466_marine,83,29,73,6,112,87.95180722891565,7.228915662650602
17467_marine,83,29,72,8,112,86.74698795180723,9.63855421686747
17468_marine,225,108,208,25,333,92.44444444444444,11.11111111111111
17471_marine,234,132,217,23,366,92.73504273504274,9.82905982905983
17472_marine,237,136,219,29,373,92.40506329113924,12.236286919831224
17479_marine,218,135,199,23,353,91.28440366972477,10.550458715596331
17511_marine,39,34,37,6,73,94.87179487179486,15.384615384615385
17512_marine,40,35,37,7,75,92.5,17.5
17513_marine,182,110,125,113,292,68.68131868131869,62.08791208791209
17514_marine,147,82,93,102,229,63.26530612244898,69.38775510204081
17515_marine,140,71,87,100,211,62.142857142857146,71.42857142857143
17592_marine,98,31,84,31,129,85.71428571428571,31.63265306122449
17593_marine,89,28,77,22,117,86.51685393258427,24.719101123595504
17594_marine,86,24,75,21,110,87.20930232558139,24.418604651162788
17595_marine,79,22,68,18,101,86.07594936708861,22.78481012658228
17596_marine,68,20,62,9,88,91.17647058823529,13.23529411764706
17597_marine,74,22,69,8,96,93.24324324324324,10.81081081081081
17598_marine,73,23,66,9,96,90.41095890410958,12.32876712328767
17599_marine,140,45,119,34,185,85,24.285714285714285
17600_marine,356,178,266,196,534,74.71910112359551,55.0561797752809
17603_marine,185,101,160,40,286,86.48648648648648,21.62162162162162
17604_marine,346,208,256,185,554,73.98843930635837,53.46820809248555
17605_marine,148,88,126,35,236,85.13513513513513,23.64864864864865
17606_marine,105,54,98,16,159,93.33333333333333,15.238095238095239
17607_marine,86,42,81,11,128,94.18604651162791,12.790697674418606
17608_marine,78,28,73,10,106,93.58974358974359,12.82051282051282
17609_marine,73,27,68,9,100,93.15068493150685,12.32876712328767
17610_marine,69,29,64,10,98,92.7536231884058,14.492753623188406
17611_marine,68,28,63,8,96,92.64705882352942,11.76470588235294
17612_marine,66,29,61,8,95,92.42424242424242,12.121212121212121
17613_marine,64,27,59,7,91,92.1875,10.9375
17614_marine,61,27,56,4,88,91.80327868852459,6.557377049180328
17615_marine,61,27,56,4,88,91.80327868852459,6.557377049180328
17616_marine,62,27,57,4,89,91.93548387096774,6.451612903225806
17617_marine,62,27,57,4,89,91.93548387096774,6.451612903225806
17618_marine,62,27,57,4,89,91.93548387096774,6.451612903225806
17619_marine,60,26,55,4,86,91.66666666666666,6.666666666666667
17620_marine,60,27,55,4,87,91.66666666666666,6.666666666666667
17621_marine,60,27,55,4,87,91.66666666666666,6.666666666666667
17622_marine,58,26,53,4,84,91.37931034482759,6.896551724137931
17623_marine,56,26,51,4,82,91.07142857142857,7.142857142857142
17624_marine,56,27,51,4,83,91.07142857142857,7.142857142857142
17625_marine,56,27,51,4,83,91.07142857142857,7.142857142857142
17626_marine,56,28,51,4,84,91.07142857142857,7.142857142857142
17627_marine,56,28,51,4,84,91.07142857142857,7.142857142857142
17628_marine,56,28,51,4,84,91.07142857142857,7.142857142857142
17629_marine,56,28,51,4,84,91.07142857142857,7.142857142857142
17630_marine,56,28,51,4,84,91.07142857142857,7.142857142857142
17631_marine,54,32,49,4,86,90.74074074074075,7.4074074074074066
17632_marine,52,28,49,4,80,94.23076923076923,7.6923076923076925
17633_marine,52,29,49,4,81,94.23076923076923,7.6923076923076925
17634_marine,52,29,49,4,81,94.23076923076923,7.6923076923076925
17635_marine,49,28,46,4,77,93.87755102040816,8.16326530612245
17636_marine,49,28,46,4,77,93.87755102040816,8.16326530612245
17637_marine,49,28,46,4,77,93.87755102040816,8.16326530612245
17638_marine,48,28,45,3,76,93.75,6.25
17639_marine,48,28,45,3,76,93.75,6.25
17640_marine,48,28,45,3,76,93.75,6.25
17641_marine,55,27,50,3,82,90.9090909090909,5.454545454545454
17642_marine,55,27,51,2,82,92.72727272727272,3.6363636363636362
17643_marine,55,29,51,2,84,92.72727272727272,3.6363636363636362
17644_marine,55,29,51,2,84,92.72727272727272,3.6363636363636362
17645_marine,58,29,54,4,87,93.10344827586206,6.896551724137931
17646_marine,58,29,54,4,87,93.10344827586206,6.896551724137931
17647_marine,58,29,54,4,87,93.10344827586206,6.896551724137931
17648_marine,58,31,54,4,89,93.10344827586206,6.896551724137931
17649_marine,58,31,54,4,89,93.10344827586206,6.896551724137931
17650_marine,58,31,54,4,89,93.10344827586206,6.896551724137931
17651_marine,58,31,54,4,89,93.10344827586206,6.896551724137931
17652_marine,58,31,54,4,89,93.10344827586206,6.896551724137931
17653_marine,59,31,54,5,90,91.52542372881356,8.47457627118644
17654_marine,59,30,54,5,89,91.52542372881356,8.47457627118644
17655_marine,58,30,54,4,88,93.10344827586206,6.896551724137931
17656_marine,56,30,52,4,86,92.85714285714286,7.142857142857142
17657_marine,56,30,52,4,86,92.85714285714286,7.142857142857142
17658_marine,58,30,54,4,88,93.10344827586206,6.896551724137931
17659_marine,58,30,54,4,88,93.10344827586206,6.896551724137931
17660_marine,58,30,54,4,88,93.10344827586206,6.896551724137931
17661_marine,58,30,54,4,88,93.10344827586206,6.896551724137931
17662_marine,58,30,54,4,88,93.10344827586206,6.896551724137931
17663_marine,58,29,54,4,87,93.10344827586206,6.896551724137931
17664_marine,58,31,54,4,89,93.10344827586206,6.896551724137931
17665_marine,58,31,54,4,89,93.10344827586206,6.896551724137931
17666_marine,58,31,54,4,89,93.10344827586206,6.896551724137931
17667_marine,58,31,54,4,89,93.10344827586206,6.896551724137931
17668_marine,58,29,54,4,87,93.10344827586206,6.896551724137931
17669_marine,56,29,54,4,85,96.42857142857143,7.142857142857142
17670_marine,56,29,54,4,85,96.42857142857143,7.142857142857142
17671_marine,56,29,54,4,85,96.42857142857143,7.142857142857142
17672_marine,58,28,56,4,86,96.55172413793103,6.896551724137931
17673_marine,58,28,56,4,86,96.55172413793103,6.896551724137931
17674_marine,57,28,55,4,85,96.49122807017544,7.017543859649122
17675_marine,57,30,55,4,87,96.49122807017544,7.017543859649122
17676_marine,57,30,55,4,87,96.49122807017544,7.017543859649122
17677_marine,57,30,55,4,87,96.49122807017544,7.017543859649122
17678_marine,57,30,55,4,87,96.49122807017544,7.017543859649122
17679_marine,56,30,54,4,86,96.42857142857143,7.142857142857142
17680_marine,56,30,54,4,86,96.42857142857143,7.142857142857142
17681_marine,54,30,52,4,84,96.29629629629629,7.4074074074074066
17682_marine,54,30,52,4,84,96.29629629629629,7.4074074074074066
17683_marine,55,30,53,5,85,96.36363636363636,9.090909090909092
17684_marine,54,30,51,6,84,94.44444444444444,11.11111111111111
17685_marine,53,31,50,6,84,94.33962264150944,11.320754716981133
17686_marine,53,29,50,6,82,94.33962264150944,11.320754716981133
17687_marine,53,29,50,6,82,94.33962264150944,11.320754716981133
17688_marine,53,28,50,6,81,94.33962264150944,11.320754716981133
17689_marine,58,30,54,7,88,93.10344827586206,12.068965517241379
17690_marine,60,30,56,7,90,93.33333333333333,11.666666666666666
17691_marine,61,30,56,8,91,91.80327868852459,13.114754098360656
17692_marine,68,29,63,8,97,92.64705882352942,11.76470588235294
17693_marine,75,29,71,8,104,94.66666666666667,10.666666666666668
17694_marine,82,31,78,8,113,95.1219512195122,9.75609756097561
17695_marine,138,74,124,24,212,89.85507246376811,17.391304347826086
17749_marine,203,123,176,40,326,86.69950738916256,19.704433497536947
17750_marine,192,134,169,35,326,88.02083333333334,18.229166666666664
17751_marine,184,134,166,31,318,90.21739130434783,16.847826086956523
17752_marine,156,123,142,17,279,91.02564102564102,10.897435897435898
17753_marine,134,113,120,14,247,89.55223880597015,10.44776119402985
17754_marine,130,105,118,11,235,90.76923076923077,8.461538461538462
17755_marine,89,50,83,7,139,93.25842696629213,7.865168539325842
17756_marine,80,41,74,7,121,92.5,8.75
17757_marine,77,39,70,7,116,90.9090909090909,9.090909090909092
17758_marine,78,36,71,7,114,91.02564102564102,8.974358974358974
17759_marine,78,34,71,7,112,91.02564102564102,8.974358974358974
17760_marine,78,34,71,7,112,91.02564102564102,8.974358974358974
17761_marine,76,32,69,7,108,90.78947368421053,9.210526315789473
17762_marine,73,32,67,7,105,91.78082191780823,9.58904109589041
17763_marine,71,30,65,7,101,91.54929577464789,9.859154929577464
17764_marine,71,30,65,7,101,91.54929577464789,9.859154929577464
17765_marine,70,30,64,6,100,91.42857142857143,8.571428571428571
17766_marine,70,30,64,6,100,91.42857142857143,8.571428571428571
17767_marine,69,30,63,6,99,91.30434782608695,8.695652173913043
17768_marine,69,30,63,6,99,91.30434782608695,8.695652173913043
17769_marine,70,30,64,6,100,91.42857142857143,8.571428571428571
17770_marine,69,32,63,6,101,91.30434782608695,8.695652173913043
17771_marine,69,32,63,6,101,91.30434782608695,8.695652173913043
17772_marine,69,32,63,6,101,91.30434782608695,8.695652173913043
17773_marine,71,32,63,6,103,88.73239436619718,8.450704225352112
17774_marine,71,32,63,6,103,88.73239436619718,8.450704225352112
17775_marine,71,28,63,5,99,88.73239436619718,7.042253521126761
17776_marine,71,28,63,5,99,88.73239436619718,7.042253521126761
17777_marine,69,28,62,4,97,89.85507246376811,5.797101449275362
17778_marine,69,28,62,4,97,89.85507246376811,5.797101449275362
17779_marine,71,28,64,4,99,90.14084507042254,5.633802816901409
17780_marine,71,28,64,4,99,90.14084507042254,5.633802816901409
17781_marine,71,27,64,4,98,90.14084507042254,5.633802816901409
17782_marine,70,27,63,3,97,90,4.285714285714286
17783_marine,71,27,64,3,98,90.14084507042254,4.225352112676056
17784_marine,73,27,66,3,100,90.41095890410958,4.10958904109589
17785_marine,73,27,66,3,100,90.41095890410958,4.10958904109589
17786_marine,73,29,66,3,102,90.41095890410958,4.10958904109589
17787_marine,75,30,68,4,105,90.66666666666666,5.333333333333334
17788_marine,86,42,78,9,128,90.69767441860465,10.465116279069768
17789_marine,143,73,127,21,216,88.81118881118881,14.685314685314685
17790_marine,146,81,130,21,227,89.04109589041096,14.383561643835616
17791_marine,89,57,81,7,146,91.01123595505618,7.865168539325842
17792_marine,97,65,87,11,162,89.69072164948454,11.34020618556701
17793_marine,99,67,89,11,166,89.8989898989899,11.11111111111111
17794_marine,92,59,84,6,151,91.30434782608695,6.521739130434782
17795_marine,80,35,72,4,115,90,5
17796_marine,78,37,70,4,115,89.74358974358975,5.128205128205128
17797_marine,78,37,70,4,115,89.74358974358975,5.128205128205128
17798_marine,76,34,68,4,110,89.47368421052632,5.263157894736842
17799_marine,76,36,68,4,112,89.47368421052632,5.263157894736842
17800_marine,76,34,68,4,110,89.47368421052632,5.263157894736842
17801_marine,75,32,68,3,107,90.66666666666666,4
17802_marine,76,32,68,3,108,89.47368421052632,3.9473684210526314
17803_marine,78,32,70,5,110,89.74358974358975,6.41025641025641
17804_marine,76,34,68,5,110,89.47368421052632,6.578947368421052
17805_marine,81,34,73,6,115,90.12345679012346,7.4074074074074066
17806_marine,83,34,75,6,117,90.36144578313254,7.228915662650602
17807_marine,87,35,79,6,122,90.80459770114942,6.896551724137931
17808_marine,94,35,84,9,129,89.36170212765957,9.574468085106384
17809_marine,96,37,86,9,133,89.58333333333334,9.375
17810_marine,251,138,226,27,389,90.0398406374502,10.756972111553784
17811_marine,273,171,246,31,444,90.10989010989012,11.355311355311356
17822_marine,247,130,222,32,377,89.87854251012146,12.955465587044534
17823_marine,245,126,222,30,371,90.61224489795919,12.244897959183673
17824_marine,378,189,310,123,567,82.01058201058201,32.53968253968254
17825_marine,364,177,299,122,541,82.14285714285714,33.51648351648351
17826_marine,203,90,186,22,293,91.62561576354679,10.83743842364532
17827_marine,80,25,69,8,105,86.25,10
17828_marine,213,100,196,25,313,92.01877934272301,11.737089201877934
17830_marine,382,194,302,146,576,79.05759162303664,38.21989528795812
17831_marine,210,100,192,26,310,91.42857142857143,12.380952380952381
17832_marine,219,119,202,22,338,92.23744292237443,10.045662100456621
17833_marine,324,169,278,90,493,85.80246913580247,27.77777777777778
17858_marine,65,47,53,10,112,81.53846153846153,15.384615384615385
17872_marine,41,33,36,6,74,87.8048780487805,14.634146341463413
17873_marine,184,126,123,112,310,66.84782608695652,60.86956521739131
17874_marine,148,80,93,104,228,62.83783783783784,70.27027027027027
17875_marine,141,71,87,101,212,61.702127659574465,71.63120567375887
17948_marine,174,58,134,91,232,77.01149425287356,52.29885057471264
17951_marine,108,34,90,33,142,83.33333333333334,30.555555555555557
17952_marine,70,20,63,15,90,90,21.428571428571427
17953_marine,67,19,60,10,86,89.55223880597015,14.925373134328357
17954_marine,66,23,59,9,89,89.39393939393939,13.636363636363635
17955_marine,71,23,65,8,94,91.54929577464789,11.267605633802818
17956_marine,71,25,66,7,96,92.95774647887323,9.859154929577464
17957_marine,74,21,69,7,95,93.24324324324324,9.45945945945946
17958_marine,84,25,77,11,109,91.66666666666666,13.095238095238097
17959_marine,153,47,131,33,200,85.62091503267973,21.568627450980394
17963_marine,200,102,175,44,302,87.5,22
17964_marine,127,74,116,23,201,91.33858267716536,18.11023622047244
17965_marine,107,46,100,13,153,93.45794392523365,12.149532710280374
17966_marine,94,29,89,11,123,94.68085106382979,11.702127659574469
17967_marine,89,30,84,10,119,94.3820224719101,11.235955056179774
17968_marine,83,29,78,9,112,93.97590361445783,10.843373493975903
17969_marine,81,30,76,10,111,93.82716049382715,12.345679012345679
17970_marine,74,29,69,9,103,93.24324324324324,12.162162162162163
17971_marine,73,27,68,7,100,93.15068493150685,9.58904109589041
17972_marine,71,27,66,5,98,92.95774647887323,7.042253521126761
17973_marine,65,27,60,4,92,92.3076923076923,6.153846153846154
17974_marine,63,27,58,4,90,92.06349206349206,6.349206349206349
17975_marine,63,27,58,4,90,92.06349206349206,6.349206349206349
17976_marine,64,27,59,4,91,92.1875,6.25
17977_marine,64,28,59,4,92,92.1875,6.25
17978_marine,64,28,59,4,92,92.1875,6.25
17979_marine,64,28,59,4,92,92.1875,6.25
17980_marine,64,27,59,4,91,92.1875,6.25
17981_marine,66,28,61,4,94,92.42424242424242,6.0606060606060606
17982_marine,66,27,61,4,93,92.42424242424242,6.0606060606060606
17983_marine,63,27,59,3,90,93.65079365079364,4.761904761904762
17984_marine,61,27,57,3,88,93.44262295081968,4.918032786885246
17985_marine,61,27,57,3,88,93.44262295081968,4.918032786885246
17986_marine,61,28,57,3,89,93.44262295081968,4.918032786885246
17987_marine,59,28,55,3,87,93.22033898305084,5.084745762711865
17988_marine,58,28,54,3,86,93.10344827586206,5.172413793103448
17989_marine,58,28,54,3,86,93.10344827586206,5.172413793103448
17990_marine,60,28,56,3,88,93.33333333333333,5
17991_marine,60,31,56,3,91,93.33333333333333,5
17992_marine,60,29,56,3,89,93.33333333333333,5
17993_marine,60,29,56,3,89,93.33333333333333,5
17994_marine,60,29,56,3,89,93.33333333333333,5
17995_marine,59,29,55,2,88,93.22033898305084,3.389830508474576
17996_marine,59,29,55,2,88,93.22033898305084,3.389830508474576
17997_marine,57,29,53,2,86,92.98245614035088,3.508771929824561
17998_marine,57,29,53,2,86,92.98245614035088,3.508771929824561
17999_marine,58,28,53,3,86,91.37931034482759,5.172413793103448
18000_marine,56,28,51,3,84,91.07142857142857,5.357142857142857
18001_marine,60,26,57,1,86,95,1.6666666666666667
18002_marine,59,26,56,1,85,94.91525423728814,1.694915254237288
18003_marine,57,27,54,1,84,94.73684210526315,1.7543859649122806
18004_marine,57,27,54,1,84,94.73684210526315,1.7543859649122806
18005_marine,59,27,56,3,86,94.91525423728814,5.084745762711865
18006_marine,59,27,56,3,86,94.91525423728814,5.084745762711865
18007_marine,57,27,54,3,84,94.73684210526315,5.263157894736842
18008_marine,57,28,54,3,85,94.73684210526315,5.263157894736842
18009_marine,57,28,54,3,85,94.73684210526315,5.263157894736842
18010_marine,57,28,54,3,85,94.73684210526315,5.263157894736842
18011_marine,57,28,54,3,85,94.73684210526315,5.263157894736842
18012_marine,57,29,54,3,86,94.73684210526315,5.263157894736842
18013_marine,57,29,54,3,86,94.73684210526315,5.263157894736842
18014_marine,57,29,54,3,86,94.73684210526315,5.263157894736842
18015_marine,57,28,54,3,85,94.73684210526315,5.263157894736842
18016_marine,57,28,54,3,85,94.73684210526315,5.263157894736842
18017_marine,57,28,54,3,85,94.73684210526315,5.263157894736842
18018_marine,57,28,54,3,85,94.73684210526315,5.263157894736842
18019_marine,61,28,58,3,89,95.08196721311475,4.918032786885246
18020_marine,59,28,56,3,87,94.91525423728814,5.084745762711865
18021_marine,59,28,56,3,87,94.91525423728814,5.084745762711865
18022_marine,59,28,56,3,87,94.91525423728814,5.084745762711865
18023_marine,61,29,58,3,90,95.08196721311475,4.918032786885246
18024_marine,61,29,58,3,90,95.08196721311475,4.918032786885246
18025_marine,62,29,58,4,91,93.54838709677419,6.451612903225806
18026_marine,62,29,58,4,91,93.54838709677419,6.451612903225806
18027_marine,62,29,58,4,91,93.54838709677419,6.451612903225806
18028_marine,62,29,58,4,91,93.54838709677419,6.451612903225806
18029_marine,60,29,56,4,89,93.33333333333333,6.666666666666667
18030_marine,60,29,56,4,89,93.33333333333333,6.666666666666667
18031_marine,60,29,56,4,89,93.33333333333333,6.666666666666667
18032_marine,60,29,56,4,89,93.33333333333333,6.666666666666667
18033_marine,60,29,56,4,89,93.33333333333333,6.666666666666667
18034_marine,60,29,56,4,89,93.33333333333333,6.666666666666667
18035_marine,60,29,56,4,89,93.33333333333333,6.666666666666667
18036_marine,60,28,56,4,88,93.33333333333333,6.666666666666667
18037_marine,60,28,56,4,88,93.33333333333333,6.666666666666667
18038_marine,59,28,55,4,87,93.22033898305084,6.779661016949152
18039_marine,58,28,54,4,86,93.10344827586206,6.896551724137931
18040_marine,58,28,54,4,86,93.10344827586206,6.896551724137931
18041_marine,58,28,54,4,86,93.10344827586206,6.896551724137931
18042_marine,58,28,54,4,86,93.10344827586206,6.896551724137931
18043_marine,57,28,53,4,85,92.98245614035088,7.017543859649122
18044_marine,54,28,50,5,82,92.5925925925926,9.25925925925926
18045_marine,54,28,50,5,82,92.5925925925926,9.25925925925926
18046_marine,57,28,52,6,85,91.22807017543859,10.526315789473683
18047_marine,59,31,54,6,90,91.52542372881356,10.16949152542373
18048_marine,57,29,54,6,86,94.73684210526315,10.526315789473683
18049_marine,57,28,54,6,85,94.73684210526315,10.526315789473683
18050_marine,60,30,57,6,90,95,10
18051_marine,67,29,62,8,96,92.53731343283582,11.940298507462686
18052_marine,72,29,67,8,101,93.05555555555556,11.11111111111111
18053_marine,80,29,75,9,109,93.75,11.25
18054_marine,82,31,78,8,113,95.1219512195122,9.75609756097561
18055_marine,134,70,122,20,204,91.04477611940298,14.925373134328357
18107_marine,217,115,188,42,332,86.63594470046083,19.35483870967742
18108_marine,204,125,184,30,329,90.19607843137256,14.705882352941178
18109_marine,191,128,174,24,319,91.09947643979058,12.56544502617801
18110_marine,129,100,119,13,229,92.24806201550388,10.077519379844961
18111_marine,157,119,144,17,276,91.71974522292994,10.828025477707007
18112_marine,109,80,101,8,189,92.66055045871559,7.339449541284404
18113_marine,96,70,87,9,166,90.625,9.375
18114_marine,85,51,79,6,136,92.94117647058823,7.0588235294117645
18115_marine,75,46,69,6,121,92,8
18116_marine,76,36,69,6,112,90.78947368421053,7.894736842105263
18117_marine,76,36,69,6,112,90.78947368421053,7.894736842105263
18118_marine,77,34,70,6,111,90.9090909090909,7.792207792207792
18119_marine,77,40,70,6,117,90.9090909090909,7.792207792207792
18120_marine,76,40,70,6,116,92.10526315789474,7.894736842105263
18121_marine,74,32,68,6,106,91.8918918918919,8.108108108108109
18122_marine,73,32,67,6,105,91.78082191780823,8.21917808219178
18123_marine,73,32,67,6,105,91.78082191780823,8.21917808219178
18124_marine,73,32,67,6,105,91.78082191780823,8.21917808219178
18125_marine,73,30,67,6,103,91.78082191780823,8.21917808219178
18126_marine,71,30,65,6,101,91.54929577464789,8.450704225352112
18127_marine,71,30,65,6,101,91.54929577464789,8.450704225352112
18128_marine,69,30,63,6,99,91.30434782608695,8.695652173913043
18129_marine,70,30,64,6,100,91.42857142857143,8.571428571428571
18130_marine,71,32,65,6,103,91.54929577464789,8.450704225352112
18131_marine,69,32,63,6,101,91.30434782608695,8.695652173913043
18132_marine,71,30,63,6,101,88.73239436619718,8.450704225352112
18133_marine,72,30,64,5,102,88.88888888888889,6.944444444444445
18134_marine,72,30,64,5,102,88.88888888888889,6.944444444444445
18135_marine,72,28,64,5,100,88.88888888888889,6.944444444444445
18136_marine,70,28,62,5,98,88.57142857142857,7.142857142857142
18137_marine,70,28,62,5,98,88.57142857142857,7.142857142857142
18138_marine,71,28,64,4,99,90.14084507042254,5.633802816901409
18139_marine,72,28,65,4,100,90.27777777777779,5.555555555555555
18140_marine,73,27,66,4,100,90.41095890410958,5.47945205479452
18141_marine,72,27,65,3,99,90.27777777777779,4.166666666666666
18142_marine,72,27,65,3,99,90.27777777777779,4.166666666666666
18143_marine,72,27,65,3,99,90.27777777777779,4.166666666666666
18144_marine,74,27,67,3,101,90.54054054054053,4.054054054054054
18145_marine,74,29,67,3,103,90.54054054054053,4.054054054054054
18146_marine,75,29,68,4,104,90.66666666666666,5.333333333333334
18147_marine,79,40,71,5,119,89.87341772151899,6.329113924050633
18148_marine,145,73,129,21,218,88.96551724137932,14.482758620689657
18149_marine,167,91,148,32,258,88.62275449101796,19.16167664670659
18150_marine,152,87,136,21,239,89.47368421052632,13.815789473684212
18151_marine,164,91,148,23,255,90.2439024390244,14.02439024390244
18152_marine,195,110,176,46,305,90.25641025641026,23.589743589743588
18153_marine,196,109,177,45,305,90.3061224489796,22.95918367346939
18154_marine,168,91,152,23,259,90.47619047619048,13.690476190476192
18155_marine,95,43,87,9,138,91.57894736842105,9.473684210526317
18156_marine,87,43,79,5,130,90.80459770114942,5.747126436781609
18157_marine,82,39,74,4,121,90.2439024390244,4.878048780487805
18158_marine,76,37,68,4,113,89.47368421052632,5.263157894736842
18159_marine,76,34,68,4,110,89.47368421052632,5.263157894736842
18160_marine,75,32,68,3,107,90.66666666666666,4
18161_marine,75,32,68,3,107,90.66666666666666,4
18162_marine,76,32,68,3,108,89.47368421052632,3.9473684210526314
18163_marine,78,32,70,5,110,89.74358974358975,6.41025641025641
18164_marine,78,34,70,5,112,89.74358974358975,6.41025641025641
18165_marine,82,34,74,5,116,90.2439024390244,6.097560975609756
18166_marine,89,34,81,6,123,91.01123595505618,6.741573033707865
18167_marine,90,35,81,7,125,90,7.777777777777778
18168_marine,94,35,85,8,129,90.42553191489363,8.51063829787234
18169_marine,98,37,88,9,135,89.79591836734694,9.183673469387756
18170_marine,272,167,245,31,439,90.07352941176471,11.397058823529411
18185_marine,362,175,298,122,537,82.32044198895028,33.70165745856354
18186_marine,199,90,182,23,289,91.4572864321608,11.557788944723619
18187_marine,73,25,64,8,98,87.67123287671232,10.95890410958904
18188_marine,206,98,188,25,304,91.2621359223301,12.135922330097088
18191_marine,206,92,188,25,298,91.2621359223301,12.135922330097088
18192_marine,87,39,76,8,126,87.356321839080465,9.195402298850574
18193_marine,226,122,209,22,348,92.47787610619469,9.734513274336283
18194_marine,229,120,212,22,349,92.57641921397381,9.606986899563319
18195_marine,242,134,225,24,376,92.97520661157024,9.917355371900827
18231_marine,45,35,40,9,80,88.88888888888889,20
18232_marine,40,34,36,6,74,90,15
18233_marine,178,117,121,107,295,67.97752808988764,60.1123595505618
18301_marine,160,53,139,38,213,86.875,23.75
18309_marine,329,141,248,198,470,75.37993920972644,60.182370820668694
18310_marine,126,37,107,36,163,84.92063492063492,28.57142857142857
18311_marine,111,26,96,27,137,86.48648648648648,24.324324324324326
18312_marine,71,19,64,13,90,90.14084507042254,18.30985915492958
18313_marine,70,19,64,8,89,91.42857142857143,11.428571428571429
18314_marine,76,25,70,8,101,92.10526315789474,10.526315789473683
18315_marine,83,27,77,8,110,92.7710843373494,9.63855421686747
18316_marine,95,32,88,13,127,92.63157894736842,13.684210526315791
18317_marine,123,50,112,19,173,91.05691056910568,15.447154471544716
18318_marine,175,56,146,40,231,83.42857142857143,22.857142857142858
18319_marine,194,75,165,44,269,85.05154639175258,22.68041237113402
18324_marine,128,55,118,17,183,92.1875,13.28125
18325_marine,105,34,100,11,139,95.23809523809523,10.476190476190476
18326_marine,95,30,90,9,125,94.73684210526315,9.473684210526317
18327_marine,91,28,86,9,119,94.5054945054945,9.89010989010989
18328_marine,87,30,82,9,117,94.25287356321839,10.344827586206897
18329_marine,85,30,80,7,115,94.11764705882352,8.235294117647058
18330_marine,80,27,75,6,107,93.75,7.5
18331_marine,78,27,73,5,105,93.58974358974359,6.41025641025641
18332_marine,75,27,70,4,102,93.33333333333333,5.333333333333334
18333_marine,75,27,70,4,102,93.33333333333333,5.333333333333334
18334_marine,72,27,67,4,99,93.05555555555556,5.555555555555555
18335_marine,72,28,67,4,100,93.05555555555556,5.555555555555555
18336_marine,71,28,66,4,99,92.95774647887323,5.633802816901409
18337_marine,68,28,64,3,96,94.11764705882352,4.411764705882353
18338_marine,70,28,66,3,98,94.28571428571428,4.285714285714286
18339_marine,70,29,66,3,99,94.28571428571428,4.285714285714286
18340_marine,68,29,64,3,97,94.11764705882352,4.411764705882353
18341_marine,67,28,63,3,95,94.02985074626866,4.477611940298507
18342_marine,67,27,63,3,94,94.02985074626866,4.477611940298507
18343_marine,67,27,63,3,94,94.02985074626866,4.477611940298507
18344_marine,65,27,61,3,92,93.84615384615384,4.615384615384616
18345_marine,64,27,60,3,91,93.75,4.6875
18346_marine,62,28,58,3,90,93.54838709677419,4.838709677419355
18347_marine,62,28,58,3,90,93.54838709677419,4.838709677419355
18348_marine,62,28,58,3,90,93.54838709677419,4.838709677419355
18349_marine,62,28,58,3,90,93.54838709677419,4.838709677419355
18350_marine,62,29,58,3,91,93.54838709677419,4.838709677419355
18351_marine,62,29,58,3,91,93.54838709677419,4.838709677419355
18352_marine,61,29,57,2,90,93.44262295081968,3.278688524590164
18353_marine,61,29,57,2,90,93.44262295081968,3.278688524590164
18354_marine,60,29,57,1,89,95,1.6666666666666667
18355_marine,60,29,57,1,89,95,1.6666666666666667
18356_marine,60,29,57,1,89,95,1.6666666666666667
18357_marine,60,27,57,1,87,95,1.6666666666666667
18358_marine,60,27,57,1,87,95,1.6666666666666667
18359_marine,62,27,59,1,89,95.16129032258065,1.6129032258064515
18360_marine,60,27,57,1,87,95,1.6666666666666667
18361_marine,62,28,59,1,90,95.16129032258065,1.6129032258064515
18362_marine,61,28,58,1,89,95.08196721311475,1.639344262295082
18363_marine,59,28,56,1,87,94.91525423728814,1.694915254237288
18364_marine,59,30,56,1,89,94.91525423728814,1.694915254237288
18365_marine,61,30,58,3,91,95.08196721311475,4.918032786885246
18366_marine,61,29,58,3,90,95.08196721311475,4.918032786885246
18367_marine,61,29,58,3,90,95.08196721311475,4.918032786885246
18368_marine,61,30,58,3,91,95.08196721311475,4.918032786885246
18369_marine,61,30,58,3,91,95.08196721311475,4.918032786885246
18370_marine,61,30,58,3,91,95.08196721311475,4.918032786885246
18371_marine,59,30,56,3,89,94.91525423728814,5.084745762711865
18372_marine,59,30,56,3,89,94.91525423728814,5.084745762711865
18373_marine,59,30,56,3,89,94.91525423728814,5.084745762711865
18374_marine,59,28,56,3,87,94.91525423728814,5.084745762711865
18375_marine,61,28,58,3,89,95.08196721311475,4.918032786885246
18376_marine,61,28,58,3,89,95.08196721311475,4.918032786885246
18377_marine,61,28,58,3,89,95.08196721311475,4.918032786885246
18378_marine,61,28,58,3,89,95.08196721311475,4.918032786885246
18379_marine,61,28,58,3,89,95.08196721311475,4.918032786885246
18380_marine,61,28,58,3,89,95.08196721311475,4.918032786885246
18381_marine,61,28,58,3,89,95.08196721311475,4.918032786885246
18382_marine,61,29,58,3,90,95.08196721311475,4.918032786885246
18383_marine,63,29,60,3,92,95.23809523809523,4.761904761904762
18384_marine,63,29,60,3,92,95.23809523809523,4.761904761904762
18385_marine,63,29,60,3,92,95.23809523809523,4.761904761904762
18386_marine,63,29,60,3,92,95.23809523809523,4.761904761904762
18387_marine,63,29,60,3,92,95.23809523809523,4.761904761904762
18388_marine,63,29,60,3,92,95.23809523809523,4.761904761904762
18389_marine,63,29,60,3,92,95.23809523809523,4.761904761904762
18390_marine,63,29,60,3,92,95.23809523809523,4.761904761904762
18391_marine,63,29,60,3,92,95.23809523809523,4.761904761904762
18392_marine,62,29,58,4,91,93.54838709677419,6.451612903225806
18393_marine,64,29,60,4,93,93.75,6.25
18394_marine,64,29,60,4,93,93.75,6.25
18395_marine,64,29,60,4,93,93.75,6.25
18396_marine,64,29,60,4,93,93.75,6.25
18397_marine,64,29,60,4,93,93.75,6.25
18398_marine,64,29,60,4,93,93.75,6.25
18399_marine,63,28,59,4,91,93.65079365079364,6.349206349206349
18400_marine,63,28,59,4,91,93.65079365079364,6.349206349206349
18401_marine,63,28,59,4,91,93.65079365079364,6.349206349206349
18402_marine,63,28,59,4,91,93.65079365079364,6.349206349206349
18403_marine,63,28,59,4,91,93.65079365079364,6.349206349206349
18404_marine,63,28,59,4,91,93.65079365079364,6.349206349206349
18405_marine,62,28,58,5,90,93.54838709677419,8.064516129032258
18406_marine,62,28,58,5,90,93.54838709677419,8.064516129032258
18407_marine,63,28,58,6,91,92.06349206349206,9.523809523809524
18408_marine,63,29,58,6,92,92.06349206349206,9.523809523809524
18409_marine,65,31,60,6,96,92.3076923076923,9.230769230769232
18410_marine,66,32,61,6,98,92.42424242424242,9.090909090909092
18411_marine,72,29,67,6,101,93.05555555555556,8.333333333333332
18412_marine,76,30,70,8,106,92.10526315789474,10.526315789473683
18413_marine,81,29,74,9,110,91.35802469135803,11.11111111111111
18414_marine,88,29,82,8,117,93.18181818181817,9.090909090909092
18415_marine,92,35,84,10,127,91.30434782608695,10.869565217391305
18416_marine,160,86,137,33,246,85.625,20.625
18467_marine,213,127,187,35,340,87.79342723004694,16.431924882629108
18468_marine,191,116,174,25,307,91.09947643979058,13.089005235602095
18469_marine,113,55,105,8,168,92.92035398230088,7.079646017699115
18470_marine,101,44,93,6,145,92.07920792079209,5.9405940594059405
18471_marine,96,44,88,6,140,91.66666666666666,6.25
18472_marine,86,44,79,6,130,91.86046511627907,6.976744186046512
18473_marine,78,40,70,7,118,89.74358974358975,8.974358974358974
18474_marine,77,38,68,7,115,88.31168831168831,9.090909090909092
18475_marine,77,38,68,7,115,88.31168831168831,9.090909090909092
18476_marine,72,38,65,5,110,90.27777777777779,6.944444444444445
18477_marine,72,38,65,5,110,90.27777777777779,6.944444444444445
18478_marine,72,34,66,5,106,91.66666666666666,6.944444444444445
18479_marine,72,34,66,5,106,91.66666666666666,6.944444444444445
18480_marine,73,36,67,6,109,91.78082191780823,8.21917808219178
18481_marine,73,32,67,6,105,91.78082191780823,8.21917808219178
18482_marine,73,32,67,6,105,91.78082191780823,8.21917808219178
18483_marine,73,32,67,6,105,91.78082191780823,8.21917808219178
18484_marine,73,32,67,6,105,91.78082191780823,8.21917808219178
18485_marine,75,32,69,6,107,92,8
18486_marine,75,32,69,6,107,92,8
18487_marine,75,32,69,6,107,92,8
18488_marine,73,32,67,6,105,91.78082191780823,8.21917808219178
18489_marine,74,32,68,6,106,91.8918918918919,8.108108108108109
18490_marine,75,32,69,6,107,92,8
18491_marine,75,32,69,6,107,92,8
18492_marine,76,30,68,5,106,89.47368421052632,6.578947368421052
18493_marine,76,30,68,5,106,89.47368421052632,6.578947368421052
18494_marine,72,30,64,5,102,88.88888888888889,6.944444444444445
18495_marine,72,28,64,5,100,88.88888888888889,6.944444444444445
18496_marine,72,28,64,5,100,88.88888888888889,6.944444444444445
18497_marine,72,28,64,5,100,88.88888888888889,6.944444444444445
18498_marine,72,28,64,5,100,88.88888888888889,6.944444444444445
18499_marine,73,27,66,4,100,90.41095890410958,5.47945205479452
18500_marine,72,27,65,3,99,90.27777777777779,4.166666666666666
18501_marine,72,27,65,3,99,90.27777777777779,4.166666666666666
18502_marine,72,29,65,3,101,90.27777777777779,4.166666666666666
18503_marine,73,29,66,3,102,90.41095890410958,4.10958904109589
18504_marine,76,29,69,3,105,90.78947368421053,3.9473684210526314
18505_marine,76,29,69,3,105,90.78947368421053,3.9473684210526314
18506_marine,79,31,72,4,110,91.13924050632912,5.063291139240507
18507_marine,85,44,78,4,129,91.76470588235294,4.705882352941177
18508_marine,143,73,127,20,216,88.81118881118881,13.986013986013987
18509_marine,150,81,134,20,231,89.33333333333333,13.333333333333334
18510_marine,152,83,136,21,235,89.47368421052632,13.815789473684212
18511_marine,166,89,150,23,255,90.36144578313254,13.855421686746988
18512_marine,197,114,177,48,311,89.84771573604061,24.36548223350254
18513_marine,199,114,179,48,313,89.9497487437186,24.120603015075375
18514_marine,169,97,153,23,266,90.53254437869822,13.609467455621301
18515_marine,167,93,151,23,260,90.41916167664671,13.77245508982036
18516_marine,161,85,145,21,246,90.06211180124224,13.043478260869565
18517_marine,83,41,75,5,124,90.36144578313254,6.024096385542169
18518_marine,79,37,72,3,116,91.13924050632912,3.79746835443038
18519_marine,77,34,70,3,111,90.9090909090909,3.896103896103896
18520_marine,77,32,70,3,109,90.9090909090909,3.896103896103896
18521_marine,76,32,68,3,108,89.47368421052632,3.9473684210526314
18522_marine,77,32,69,4,109,89.6103896103896,5.194805194805195
18523_marine,77,34,69,4,111,89.6103896103896,5.194805194805195
18524_marine,80,34,72,5,114,90,6.25
18525_marine,83,34,75,5,117,90.36144578313254,6.024096385542169
18526_marine,88,34,80,6,122,90.9090909090909,6.8181818181818175
18527_marine,93,40,84,7,133,90.32258064516128,7.526881720430108
18528_marine,92,35,83,8,127,90.21739130434783,8.695652173913043
18529_marine,100,38,89,8,138,89,8
18530_marine,269,167,244,31,436,90.70631970260223,11.524163568773234
18543_marine,228,120,206,29,348,90.35087719298247,12.719298245614036
18544_marine,218,100,198,27,318,90.82568807339449,12.385321100917432
18545_marine,204,90,187,24,294,91.66666666666666,11.76470588235294
18546_marine,87,29,78,8,116,89.65517241379311,9.195402298850574
18547_marine,94,33,81,10,127,86.17021276595744,10.638297872340425
18548_marine,214,102,194,24,316,90.65420560747664,11.214953271028037
18551_marine,250,130,229,26,380,91.60000000000001,10.4
18552_marine,243,128,225,25,371,92.5925925925926,10.2880658436214
18559_marine,218,109,200,23,327,91.74311926605505,10.550458715596331
18560_marine,226,112,207,28,338,91.5929203539823,12.389380530973451
18591_marine,43,34,38,8,77,88.37209302325581,18.6046511627907
18592_marine,40,35,36,6,75,90,15
18593_marine,43,35,39,9,78,90.69767441860465,20.930232558139537
18594_marine,217,136,146,140,353,67.2811059907834,64.51612903225806
18660_marine,157,58,137,37,215,87.26114649681529,23.56687898089172
18661_marine,249,87,205,105,336,82.32931726907631,42.168674698795186
18663_marine,164,60,143,37,224,87.1951219512195,22.5609756097561
18664_marine,163,61,143,35,224,87.73006134969326,21.472392638036812
18670_marine,163,48,143,40,211,87.73006134969326,24.539877300613497
18671_marine,138,39,123,30,177,89.13043478260869,21.73913043478261
18672_marine,126,43,114,26,169,90.47619047619048,20.634920634920633
18673_marine,125,39,113,24,164,90.4,19.2
18674_marine,86,29,79,11,115,91.86046511627907,12.790697674418606
18675_marine,91,32,85,10,123,93.4065934065934,10.989010989010989
18676_marine,92,26,86,11,118,93.47826086956522,11.956521739130435
18677_marine,209,79,179,45,288,85.64593301435407,21.5311004784689
18678_marine,212,91,181,51,303,85.37735849056604,24.056603773584907
18683_marine,220,111,196,43,331,89.0909090909091,19.545454545454547
18684_marine,129,58,120,14,187,93.02325581395348,10.852713178294573
18685_marine,105,36,101,9,141,96.19047619047619,8.571428571428571
18686_marine,96,33,91,8,129,94.79166666666666,8.333333333333332
18687_marine,89,31,84,8,120,94.3820224719101,8.98876404494382
18688_marine,89,31,84,7,120,94.3820224719101,7.865168539325842
18689_marine,86,29,81,6,115,94.18604651162791,6.976744186046512
18690_marine,85,29,80,6,114,94.11764705882352,7.0588235294117645
18691_marine,86,29,81,5,115,94.18604651162791,5.813953488372093
18692_marine,84,29,79,4,113,94.04761904761905,4.761904761904762
18693_marine,81,30,77,3,111,95.06172839506173,3.7037037037037033
18694_marine,80,30,76,3,110,95,3.75
18695_marine,78,30,74,3,108,94.87179487179486,3.8461538461538463
18696_marine,76,30,72,3,106,94.73684210526315,3.9473684210526314
18697_marine,76,30,72,3,106,94.73684210526315,3.9473684210526314
18698_marine,76,31,72,3,107,94.73684210526315,3.9473684210526314
18699_marine,76,31,72,3,107,94.73684210526315,3.9473684210526314
18700_marine,76,31,72,3,107,94.73684210526315,3.9473684210526314
18701_marine,74,31,70,3,105,94.5945945945946,4.054054054054054
18702_marine,74,30,70,3,104,94.5945945945946,4.054054054054054
18703_marine,74,29,70,3,103,94.5945945945946,4.054054054054054
18704_marine,72,27,68,3,99,94.44444444444444,4.166666666666666
18705_marine,70,28,66,3,98,94.28571428571428,4.285714285714286
18706_marine,70,28,66,3,98,94.28571428571428,4.285714285714286
18707_marine,70,28,66,3,98,94.28571428571428,4.285714285714286
18708_marine,69,29,66,2,98,95.65217391304348,2.898550724637681
18709_marine,69,29,66,2,98,95.65217391304348,2.898550724637681
18710_marine,68,29,65,1,97,95.58823529411765,1.4705882352941175
18711_marine,66,31,63,1,97,95.45454545454545,1.5151515151515151
18712_marine,66,31,63,1,97,95.45454545454545,1.5151515151515151
18713_marine,66,29,63,1,95,95.45454545454545,1.5151515151515151
18714_marine,66,29,63,1,95,95.45454545454545,1.5151515151515151
18715_marine,66,29,63,1,95,95.45454545454545,1.5151515151515151
18716_marine,64,29,61,1,93,95.3125,1.5625
18717_marine,64,29,61,1,93,95.3125,1.5625
18718_marine,64,29,61,1,93,95.3125,1.5625
18719_marine,64,29,61,1,93,95.3125,1.5625
18720_marine,62,29,59,1,91,95.16129032258065,1.6129032258064515
18721_marine,65,28,62,1,93,95.38461538461539,1.5384615384615385
18722_marine,63,28,60,1,91,95.23809523809523,1.5873015873015872
18723_marine,63,28,60,1,91,95.23809523809523,1.5873015873015872
18724_marine,63,30,60,1,93,95.23809523809523,1.5873015873015872
18725_marine,64,30,61,3,94,95.3125,4.6875
18726_marine,64,30,61,3,94,95.3125,4.6875
18727_marine,60,30,57,3,90,95,5
18728_marine,60,30,57,3,90,95,5
18729_marine,60,31,57,3,91,95,5
18730_marine,60,31,57,3,91,95,5
18731_marine,59,31,56,3,90,94.91525423728814,5.084745762711865
18732_marine,59,30,56,3,89,94.91525423728814,5.084745762711865
18733_marine,61,30,58,3,91,95.08196721311475,4.918032786885246
18734_marine,61,30,58,3,91,95.08196721311475,4.918032786885246
18735_marine,59,30,56,3,89,94.91525423728814,5.084745762711865
18736_marine,61,30,58,3,91,95.08196721311475,4.918032786885246
18737_marine,61,30,58,3,91,95.08196721311475,4.918032786885246
18738_marine,61,29,58,3,90,95.08196721311475,4.918032786885246
18739_marine,61,29,58,3,90,95.08196721311475,4.918032786885246
18740_marine,61,29,58,3,90,95.08196721311475,4.918032786885246
18741_marine,61,29,58,3,90,95.08196721311475,4.918032786885246
18742_marine,61,30,58,3,91,95.08196721311475,4.918032786885246
18743_marine,63,29,60,3,92,95.23809523809523,4.761904761904762
18744_marine,63,29,60,3,92,95.23809523809523,4.761904761904762
18745_marine,63,29,60,3,92,95.23809523809523,4.761904761904762
18746_marine,63,29,60,3,92,95.23809523809523,4.761904761904762
18747_marine,63,29,60,3,92,95.23809523809523,4.761904761904762
18748_marine,63,29,60,3,92,95.23809523809523,4.761904761904762
18749_marine,63,29,60,3,92,95.23809523809523,4.761904761904762
18750_marine,63,29,60,3,92,95.23809523809523,4.761904761904762
18751_marine,61,29,58,3,90,95.08196721311475,4.918032786885246
18752_marine,61,29,58,3,90,95.08196721311475,4.918032786885246
18753_marine,63,29,60,3,92,95.23809523809523,4.761904761904762
18754_marine,65,29,62,3,94,95.38461538461539,4.615384615384616
18755_marine,65,29,62,3,94,95.38461538461539,4.615384615384616
18756_marine,66,29,62,4,95,93.93939393939394,6.0606060606060606
18757_marine,68,29,64,4,97,94.11764705882352,5.88235294117647
18758_marine,66,29,62,4,95,93.93939393939394,6.0606060606060606
18759_marine,65,29,61,4,94,93.84615384615384,6.153846153846154
18760_marine,64,29,60,4,93,93.75,6.25
18761_marine,64,28,60,4,92,93.75,6.25
18762_marine,64,28,60,4,92,93.75,6.25
18763_marine,63,28,59,4,91,93.65079365079364,6.349206349206349
18764_marine,63,28,59,4,91,93.65079365079364,6.349206349206349
18765_marine,63,28,59,4,91,93.65079365079364,6.349206349206349
18766_marine,66,28,62,5,94,93.93939393939394,7.575757575757576
18767_marine,66,28,62,5,94,93.93939393939394,7.575757575757576
18768_marine,64,29,60,5,93,93.75,7.8125
18769_marine,65,28,60,6,93,92.3076923076923,9.230769230769232
18770_marine,65,27,60,6,92,92.3076923076923,9.230769230769232
18771_marine,70,31,65,6,101,92.85714285714286,8.571428571428571
18772_marine,75,31,69,7,106,92,9.333333333333334
18773_marine,78,31,72,8,109,92.3076923076923,10.256410256410255
18774_marine,84,30,79,8,114,94.04761904761905,9.523809523809524
18775_marine,88,31,82,7,119,93.18181818181817,7.954545454545454
18776_marine,149,73,131,23,222,87.91946308724832,15.436241610738255
18826_marine,234,136,202,45,370,86.32478632478633,19.230769230769234
18827_marine,196,114,173,29,310,88.26530612244898,14.795918367346939
18828_marine,110,50,102,6,160,92.72727272727272,5.454545454545454
18829_marine,98,42,90,6,140,91.83673469387756,6.122448979591836
18830_marine,91,42,84,5,133,92.3076923076923,5.4945054945054945
18831_marine,88,40,81,5,128,92.04545454545455,5.681818181818182
18832_marine,79,40,72,5,119,91.13924050632912,6.329113924050633
18833_marine,76,38,69,6,114,90.78947368421053,7.894736842105263
18834_marine,77,36,68,7,113,88.31168831168831,9.090909090909092
18835_marine,77,35,68,7,112,88.31168831168831,9.090909090909092
18836_marine,73,35,65,7,108,89.04109589041096,9.58904109589041
18837_marine,71,35,65,5,106,91.54929577464789,7.042253521126761
18838_marine,72,35,66,5,107,91.66666666666666,6.944444444444445
18839_marine,72,33,66,5,105,91.66666666666666,6.944444444444445
18840_marine,72,35,66,5,107,91.66666666666666,6.944444444444445
18841_marine,76,35,70,5,111,92.10526315789474,6.578947368421052
18842_marine,75,33,69,6,108,92,8
18843_marine,75,33,69,6,108,92,8
18844_marine,75,33,69,6,108,92,8
18845_marine,75,33,69,6,108,92,8
18846_marine,77,33,71,6,110,92.20779220779221,7.792207792207792
18847_marine,75,33,69,6,108,92,8
18848_marine,75,33,69,6,108,92,8
18849_marine,77,33,71,6,110,92.20779220779221,7.792207792207792
18850_marine,77,31,71,6,108,92.20779220779221,7.792207792207792
18851_marine,76,31,70,5,107,92.10526315789474,6.578947368421052
18852_marine,78,31,70,5,109,89.74358974358975,6.41025641025641
18853_marine,78,31,70,5,109,89.74358974358975,6.41025641025641
18854_marine,76,30,68,5,106,89.47368421052632,6.578947368421052
18855_marine,76,30,68,5,106,89.47368421052632,6.578947368421052
18856_marine,74,30,66,5,104,89.1891891891892,6.756756756756757
18857_marine,74,30,66,5,104,89.1891891891892,6.756756756756757
18858_marine,74,29,66,5,103,89.1891891891892,6.756756756756757
18859_marine,73,29,65,4,102,89.04109589041096,5.47945205479452
18860_marine,73,29,66,3,102,90.41095890410958,4.10958904109589
18861_marine,72,31,65,3,103,90.27777777777779,4.166666666666666
18862_marine,74,31,67,3,105,90.54054054054053,4.054054054054054
18863_marine,75,31,68,3,106,90.66666666666666,4
18864_marine,77,31,70,3,108,90.9090909090909,3.896103896103896
18865_marine,80,39,73,3,119,91.25,3.75
18866_marine,85,45,78,4,130,91.76470588235294,4.705882352941177
18867_marine,84,46,77,3,130,91.66666666666666,3.571428571428571
18868_marine,86,46,79,5,132,91.86046511627907,5.813953488372093
18869_marine,90,53,83,5,143,92.22222222222223,5.555555555555555
18870_marine,91,55,83,6,146,91.20879120879121,6.593406593406594
18871_marine,162,88,146,23,250,90.12345679012346,14.19753086419753
18872_marine,166,93,150,23,259,90.36144578313254,13.855421686746988
18873_marine,169,95,153,23,264,90.53254437869822,13.609467455621301
18874_marine,169,97,153,23,266,90.53254437869822,13.609467455621301
18875_marine,198,119,177,48,317,89.39393939393939,24.242424242424242
18876_marine,181,101,163,33,282,90.05524861878453,18.23204419889503
18877_marine,87,43,80,4,130,91.95402298850574,4.597701149425287
18878_marine,82,37,75,3,119,91.46341463414635,3.6585365853658534
18879_marine,77,36,70,3,113,90.9090909090909,3.896103896103896
18880_marine,77,34,70,3,111,90.9090909090909,3.896103896103896
18881_marine,78,32,70,3,110,89.74358974358975,3.8461538461538463
18882_marine,81,32,73,4,113,90.12345679012346,4.938271604938271
18883_marine,78,34,70,4,112,89.74358974358975,5.128205128205128
18884_marine,81,34,73,5,115,90.12345679012346,6.172839506172839
18885_marine,83,34,75,5,117,90.36144578313254,6.024096385542169
18886_marine,90,48,81,6,138,90,6.666666666666667
18887_marine,94,48,84,7,142,89.36170212765957,7.446808510638298
18888_marine,98,38,87,8,136,88.77551020408163,8.16326530612245
18889_marine,102,46,91,8,148,89.2156862745098,7.8431372549019605
18890_marine,252,137,231,26,389,91.66666666666666,10.317460317460316
18891_marine,285,175,259,35,460,90.87719298245615,12.280701754385964
18901_marine,265,129,242,26,394,91.32075471698113,9.811320754716983
18902_marine,256,117,234,25,373,91.40625,9.765625
18903_marine,261,117,238,27,378,91.18773946360153,10.344827586206897
18904_marine,262,113,238,28,375,90.83969465648855,10.687022900763358
18905_marine,259,111,236,27,370,91.11969111969111,10.424710424710424
18906_marine,260,117,237,29,377,91.15384615384615,11.153846153846155
18911_marine,525,239,414,213,764,78.85714285714286,40.57142857142857
18912_marine,486,243,386,183,729,79.42386831275721,37.65432098765432
18918_marine,216,109,200,22,325,92.5925925925926,10.185185185185185
18919_marine,65,24,57,5,89,87.6923076923077,7.6923076923076925
18920_marine,217,106,199,26,323,91.70506912442397,11.981566820276496
18952_marine,44,36,39,9,80,88.63636363636364,20.454545454545457
18953_marine,45,37,40,10,82,88.88888888888889,22.22222222222222
18955_marine,62,39,54,26,101,87.09677419354838,41.935483870967744
19024_marine,180,69,159,36,249,88.33333333333333,20
19029_marine,171,54,146,43,225,85.38011695906432,25.146198830409354
19031_marine,210,64,188,60,274,89.52380952380953,28.57142857142857
19032_marine,178,54,164,50,232,92.13483146067416,28.08988764044944
19033_marine,198,74,175,42,272,88.38383838383838,21.21212121212121
19034_marine,196,74,173,41,270,88.26530612244898,20.918367346938776
19035_marine,139,62,130,19,201,93.5251798561151,13.66906474820144
19036_marine,213,80,186,43,293,87.32394366197182,20.187793427230048
19043_marine,213,109,192,37,322,90.14084507042254,17.370892018779344
19044_marine,113,39,108,10,152,95.57522123893806,8.849557522123893
19045_marine,107,36,103,7,143,96.26168224299066,6.5420560747663545
19046_marine,96,33,92,6,129,95.83333333333334,6.25
19047_marine,93,29,89,6,122,95.6989247311828,6.451612903225806
19048_marine,92,29,88,5,121,95.65217391304348,5.434782608695652
19049_marine,88,29,84,5,117,95.45454545454545,5.681818181818182
19050_marine,86,30,83,3,116,96.51162790697676,3.488372093023256
19051_marine,85,30,82,2,115,96.47058823529412,2.3529411764705883
19052_marine,84,30,80,3,114,95.23809523809523,3.571428571428571
19053_marine,82,30,78,3,112,95.1219512195122,3.6585365853658534
19054_marine,82,30,78,3,112,95.1219512195122,3.6585365853658534
19055_marine,78,30,74,3,108,94.87179487179486,3.8461538461538463
19056_marine,79,30,75,3,109,94.9367088607595,3.79746835443038
19057_marine,79,30,75,3,109,94.9367088607595,3.79746835443038
19058_marine,79,29,75,3,108,94.9367088607595,3.79746835443038
19059_marine,79,29,75,3,108,94.9367088607595,3.79746835443038
19060_marine,78,29,74,3,107,94.87179487179486,3.8461538461538463
19061_marine,78,29,74,3,107,94.87179487179486,3.8461538461538463
19062_marine,75,28,72,2,103,96,2.666666666666667
19063_marine,75,28,72,2,103,96,2.666666666666667
19064_marine,75,28,72,2,103,96,2.666666666666667
19065_marine,71,28,68,2,99,95.77464788732394,2.8169014084507045
19066_marine,71,28,68,2,99,95.77464788732394,2.8169014084507045
19067_marine,70,29,67,1,99,95.71428571428572,1.4285714285714286
19068_marine,70,29,67,1,99,95.71428571428572,1.4285714285714286
19069_marine,70,29,67,1,99,95.71428571428572,1.4285714285714286
19070_marine,70,31,67,1,101,95.71428571428572,1.4285714285714286
19071_marine,70,35,67,1,105,95.71428571428572,1.4285714285714286
19072_marine,68,33,65,1,101,95.58823529411765,1.4705882352941175
19073_marine,68,33,65,1,101,95.58823529411765,1.4705882352941175
19074_marine,66,33,63,1,99,95.45454545454545,1.5151515151515151
19075_marine,66,33,63,1,99,95.45454545454545,1.5151515151515151
19076_marine,65,33,62,1,98,95.38461538461539,1.5384615384615385
19077_marine,65,33,62,1,98,95.38461538461539,1.5384615384615385
19078_marine,65,31,62,1,96,95.38461538461539,1.5384615384615385
19079_marine,63,31,60,1,94,95.23809523809523,1.5873015873015872
19080_marine,64,29,61,1,93,95.3125,1.5625
19081_marine,71,30,68,2,101,95.77464788732394,2.8169014084507045
19082_marine,70,30,67,2,100,95.71428571428572,2.857142857142857
19083_marine,68,30,65,2,98,95.58823529411765,2.941176470588235
19084_marine,66,30,63,2,96,95.45454545454545,3.0303030303030303
19085_marine,67,30,64,4,97,95.52238805970148,5.970149253731343
19086_marine,67,32,64,4,99,95.52238805970148,5.970149253731343
19087_marine,67,30,64,4,97,95.52238805970148,5.970149253731343
19088_marine,67,30,64,4,97,95.52238805970148,5.970149253731343
19089_marine,67,30,64,4,97,95.52238805970148,5.970149253731343
19090_marine,68,31,65,3,99,95.58823529411765,4.411764705882353
19091_marine,68,31,65,3,99,95.58823529411765,4.411764705882353
19092_marine,66,31,63,3,97,95.45454545454545,4.545454545454546
19093_marine,66,31,63,3,97,95.45454545454545,4.545454545454546
19094_marine,63,31,60,3,94,95.23809523809523,4.761904761904762
19095_marine,65,31,62,3,96,95.38461538461539,4.615384615384616
19096_marine,65,31,62,3,96,95.38461538461539,4.615384615384616
19097_marine,65,30,62,3,95,95.38461538461539,4.615384615384616
19098_marine,65,30,62,3,95,95.38461538461539,4.615384615384616
19099_marine,65,29,62,3,94,95.38461538461539,4.615384615384616
19100_marine,65,29,62,3,94,95.38461538461539,4.615384615384616
19101_marine,63,29,60,3,92,95.23809523809523,4.761904761904762
19102_marine,63,30,60,3,93,95.23809523809523,4.761904761904762
19103_marine,63,30,60,3,93,95.23809523809523,4.761904761904762
19104_marine,65,30,62,3,95,95.38461538461539,4.615384615384616
19105_marine,65,30,62,3,95,95.38461538461539,4.615384615384616
19106_marine,65,30,62,3,95,95.38461538461539,4.615384615384616
19107_marine,65,28,62,3,93,95.38461538461539,4.615384615384616
19108_marine,65,28,62,3,93,95.38461538461539,4.615384615384616
19109_marine,65,28,62,3,93,95.38461538461539,4.615384615384616
19110_marine,65,29,62,3,94,95.38461538461539,4.615384615384616
19111_marine,65,29,62,3,94,95.38461538461539,4.615384615384616
19112_marine,65,29,62,3,94,95.38461538461539,4.615384615384616
19113_marine,65,29,62,3,94,95.38461538461539,4.615384615384616
19114_marine,63,29,60,3,92,95.23809523809523,4.761904761904762
19115_marine,63,29,60,3,92,95.23809523809523,4.761904761904762
19116_marine,63,29,60,3,92,95.23809523809523,4.761904761904762
19117_marine,63,29,60,3,92,95.23809523809523,4.761904761904762
19118_marine,62,29,59,3,91,95.16129032258065,4.838709677419355
19119_marine,61,29,58,3,90,95.08196721311475,4.918032786885246
19120_marine,62,29,58,4,91,93.54838709677419,6.451612903225806
19121_marine,64,29,60,4,93,93.75,6.25
19122_marine,66,28,62,4,94,93.93939393939394,6.0606060606060606
19123_marine,70,28,66,4,98,94.28571428571428,5.714285714285714
19124_marine,70,28,66,4,98,94.28571428571428,5.714285714285714
19125_marine,67,28,63,4,95,94.02985074626866,5.970149253731343
19126_marine,68,30,64,5,98,94.11764705882352,7.352941176470589
19127_marine,68,29,64,5,97,94.11764705882352,7.352941176470589
19128_marine,68,29,64,5,97,94.11764705882352,7.352941176470589
19129_marine,70,30,66,5,100,94.28571428571428,7.142857142857142
19130_marine,70,30,66,5,100,94.28571428571428,7.142857142857142
19131_marine,73,29,68,6,102,93.15068493150685,8.21917808219178
19132_marine,77,33,72,6,110,93.5064935064935,7.792207792207792
19133_marine,78,34,72,7,112,92.3076923076923,8.974358974358974
19134_marine,85,33,80,7,118,94.11764705882352,8.235294117647058
19135_marine,94,34,87,7,128,92.5531914893617,7.446808510638298
19136_marine,107,40,97,13,147,90.65420560747664,12.149532710280374
19137_marine,173,94,149,31,267,86.1271676300578,17.91907514450867
19186_marine,236,148,210,35,384,88.98305084745762,14.83050847457627
19187_marine,119,47,107,9,166,89.91596638655463,7.563025210084033
19188_marine,100,42,93,5,142,93,5
19189_marine,88,39,81,5,127,92.04545454545455,5.681818181818182
19190_marine,87,39,80,5,126,91.95402298850574,5.747126436781609
19191_marine,83,39,76,5,122,91.56626506024097,6.024096385542169
19192_marine,81,39,74,5,120,91.35802469135803,6.172839506172839
19193_marine,76,37,68,5,113,89.47368421052632,6.578947368421052
19194_marine,76,35,68,5,111,89.47368421052632,6.578947368421052
19195_marine,75,35,68,5,110,90.66666666666666,6.666666666666667
19196_marine,79,35,72,5,114,91.13924050632912,6.329113924050633
19197_marine,78,35,70,6,113,89.74358974358975,7.6923076923076925
19198_marine,78,35,70,6,113,89.74358974358975,7.6923076923076925
19199_marine,77,35,71,4,112,92.20779220779221,5.194805194805195
19200_marine,76,35,70,5,111,92.10526315789474,6.578947368421052
19201_marine,76,35,70,5,111,92.10526315789474,6.578947368421052
19202_marine,76,33,70,5,109,92.10526315789474,6.578947368421052
19203_marine,75,33,69,6,108,92,8
19204_marine,77,33,71,6,110,92.20779220779221,7.792207792207792
19205_marine,77,33,71,6,110,92.20779220779221,7.792207792207792
19206_marine,77,33,71,6,110,92.20779220779221,7.792207792207792
19207_marine,77,31,71,6,108,92.20779220779221,7.792207792207792
19208_marine,77,31,71,6,108,92.20779220779221,7.792207792207792
19209_marine,77,31,71,6,108,92.20779220779221,7.792207792207792
19210_marine,78,31,72,5,109,92.3076923076923,6.41025641025641
19211_marine,78,31,72,5,109,92.3076923076923,6.41025641025641
19212_marine,78,31,70,5,109,89.74358974358975,6.41025641025641
19213_marine,78,31,70,5,109,89.74358974358975,6.41025641025641
19214_marine,78,31,70,5,109,89.74358974358975,6.41025641025641
19215_marine,76,31,68,5,107,89.47368421052632,6.578947368421052
19216_marine,76,31,68,5,107,89.47368421052632,6.578947368421052
19217_marine,76,29,68,5,105,89.47368421052632,6.578947368421052
19218_marine,76,29,68,4,105,89.47368421052632,5.263157894736842
19219_marine,76,29,68,4,105,89.47368421052632,5.263157894736842
19220_marine,74,29,67,3,103,90.54054054054053,4.054054054054054
19221_marine,76,29,69,3,105,90.78947368421053,3.9473684210526314
19222_marine,76,29,69,3,105,90.78947368421053,3.9473684210526314
19223_marine,77,29,70,3,106,90.9090909090909,3.896103896103896
19224_marine,79,33,72,3,112,91.13924050632912,3.79746835443038
19225_marine,82,43,75,3,125,91.46341463414635,3.6585365853658534
19226_marine,83,45,76,2,128,91.56626506024097,2.4096385542168677
19227_marine,84,45,77,3,129,91.66666666666666,3.571428571428571
19228_marine,84,46,77,3,130,91.66666666666666,3.571428571428571
19229_marine,86,47,79,3,133,91.86046511627907,3.488372093023256
19230_marine,84,41,77,3,125,91.66666666666666,3.571428571428571
19231_marine,85,39,78,3,124,91.76470588235294,3.5294117647058822
19232_marine,87,37,80,3,124,91.95402298850574,3.4482758620689653
19233_marine,93,53,84,7,146,90.32258064516128,7.526881720430108
19234_marine,150,82,135,20,232,90,13.333333333333334
19235_marine,190,114,172,42,304,90.52631578947368,22.105263157894736
19236_marine,162,95,147,20,257,90.74074074074075,12.345679012345679
19237_marine,85,45,78,4,130,91.76470588235294,4.705882352941177
19238_marine,80,35,73,3,115,91.25,3.75
19239_marine,78,36,71,3,114,91.02564102564102,3.8461538461538463
19240_marine,78,36,70,3,114,89.74358974358975,3.8461538461538463
19241_marine,80,34,72,3,114,90,3.75
19242_marine,81,36,73,4,117,90.12345679012346,4.938271604938271
19243_marine,80,36,72,4,116,90,5
19244_marine,84,34,75,6,118,89.28571428571429,7.142857142857142
19245_marine,87,42,77,6,129,88.50574712643679,6.896551724137931
19246_marine,89,48,79,6,137,88.76404494382022,6.741573033707865
19247_marine,97,43,86,7,140,88.65979381443299,7.216494845360824
19248_marine,98,48,87,8,146,88.77551020408163,8.16326530612245
19249_marine,150,74,137,12,224,91.33333333333333,8
19250_marine,119,62,106,12,181,89.07563025210085,10.084033613445378
19251_marine,286,171,260,33,457,90.9090909090909,11.538461538461538
19260_marine,272,131,248,28,403,91.17647058823529,10.294117647058822
19271_marine,514,242,399,206,756,77.62645914396887,40.07782101167315
19272_marine,500,247,394,193,747,78.8,38.6
19273_marine,296,159,263,48,455,88.85135135135135,16.216216216216218
19274_marine,243,115,225,25,358,92.5925925925926,10.2880658436214
19277_marine,218,99,202,22,317,92.66055045871559,10.091743119266056
19278_marine,68,24,60,4,92,88.23529411764706,5.88235294117647
19279_marine,67,24,59,5,91,88.05970149253731,7.462686567164178
19280_marine,66,24,56,7,90,84.84848484848484,10.606060606060606
19281_marine,227,106,209,27,333,92.07048458149781,11.894273127753303
19297_marine,261,121,229,57,382,87.73946360153256,21.839080459770116
19311_marine,66,42,54,25,108,81.81818181818183,37.878787878787875
19384_marine,190,76,170,33,266,89.47368421052632,17.36842105263158
19385_marine,185,67,167,31,252,90.27027027027027,16.756756756756758
19386_marine,273,102,232,106,375,84.98168498168498,38.82783882783883
19391_marine,214,67,187,43,281,87.38317757009347,20.093457943925234
19392_marine,213,76,190,44,289,89.2018779342723,20.657276995305164
19395_marine,238,90,208,47,328,87.39495798319328,19.747899159663866
19402_marine,267,137,225,57,404,84.26966292134831,21.34831460674157
19403_marine,145,67,133,18,212,91.72413793103448,12.413793103448276
19404_marine,113,40,108,9,153,95.57522123893806,7.964601769911504
19405_marine,102,38,98,6,140,96.07843137254902,5.88235294117647
19406_marine,96,35,92,6,131,95.83333333333334,6.25
19407_marine,92,33,89,5,125,96.73913043478261,5.434782608695652
19408_marine,90,33,87,5,123,96.66666666666667,5.555555555555555
19409_marine,87,33,84,3,120,96.55172413793103,3.4482758620689653
19410_marine,87,34,84,3,121,96.55172413793103,3.4482758620689653
19411_marine,87,34,84,3,121,96.55172413793103,3.4482758620689653
19412_marine,86,34,83,2,120,96.51162790697676,2.3255813953488373
19413_marine,85,32,82,2,117,96.47058823529412,2.3529411764705883
19414_marine,83,32,80,2,115,96.3855421686747,2.4096385542168677
19415_marine,80,32,77,2,112,96.25,2.5
19416_marine,80,32,77,2,112,96.25,2.5
19417_marine,77,33,74,2,110,96.1038961038961,2.5974025974025974
19418_marine,77,33,74,2,110,96.1038961038961,2.5974025974025974
19419_marine,77,31,74,2,108,96.1038961038961,2.5974025974025974
19420_marine,75,31,72,2,106,96,2.666666666666667
19421_marine,75,31,72,2,106,96,2.666666666666667
19422_marine,75,30,72,2,105,96,2.666666666666667
19423_marine,75,30,72,2,105,96,2.666666666666667
19424_marine,72,30,69,1,102,95.83333333333334,1.3888888888888888
19425_marine,72,33,69,1,105,95.83333333333334,1.3888888888888888
19426_marine,71,34,68,2,105,95.77464788732394,2.8169014084507045
19427_marine,71,34,68,2,105,95.77464788732394,2.8169014084507045
19428_marine,69,33,66,2,102,95.65217391304348,2.898550724637681
19429_marine,69,33,66,2,102,95.65217391304348,2.898550724637681
19430_marine,69,33,66,2,102,95.65217391304348,2.898550724637681
19431_marine,69,33,66,2,102,95.65217391304348,2.898550724637681
19432_marine,69,35,66,2,104,95.65217391304348,2.898550724637681
19433_marine,69,33,66,2,102,95.65217391304348,2.898550724637681
19434_marine,69,33,66,2,102,95.65217391304348,2.898550724637681
19435_marine,69,33,66,2,102,95.65217391304348,2.898550724637681
19436_marine,70,33,67,2,103,95.71428571428572,2.857142857142857
19437_marine,70,33,67,2,103,95.71428571428572,2.857142857142857
19438_marine,70,33,67,2,103,95.71428571428572,2.857142857142857
19439_marine,70,33,67,2,103,95.71428571428572,2.857142857142857
19440_marine,70,31,67,2,101,95.71428571428572,2.857142857142857
19441_marine,73,30,70,2,103,95.8904109589041,2.73972602739726
19442_marine,72,30,69,2,102,95.83333333333334,2.7777777777777777
19443_marine,74,30,71,2,104,95.94594594594594,2.7027027027027026
19444_marine,72,30,69,2,102,95.83333333333334,2.7777777777777777
19445_marine,70,30,67,2,100,95.71428571428572,2.857142857142857
19446_marine,72,30,69,4,102,95.83333333333334,5.555555555555555
19447_marine,74,30,71,4,104,95.94594594594594,5.405405405405405
19448_marine,74,32,71,4,106,95.94594594594594,5.405405405405405
19449_marine,76,32,73,4,108,96.05263157894737,5.263157894736842
19450_marine,75,31,72,4,106,96,5.333333333333334
19451_marine,73,31,70,4,104,95.8904109589041,5.47945205479452
19452_marine,72,31,69,4,103,95.83333333333334,5.555555555555555
19453_marine,71,31,68,3,102,95.77464788732394,4.225352112676056
19454_marine,69,31,66,3,100,95.65217391304348,4.3478260869565215
19455_marine,69,31,66,3,100,95.65217391304348,4.3478260869565215
19456_marine,69,32,66,3,101,95.65217391304348,4.3478260869565215
19457_marine,68,32,65,3,100,95.58823529411765,4.411764705882353
19458_marine,68,32,65,3,100,95.58823529411765,4.411764705882353
19459_marine,69,32,66,3,101,95.65217391304348,4.3478260869565215
19460_marine,69,31,66,3,100,95.65217391304348,4.3478260869565215
19461_marine,69,30,66,3,99,95.65217391304348,4.3478260869565215
19462_marine,67,31,64,3,98,95.52238805970148,4.477611940298507
19463_marine,67,31,64,3,98,95.52238805970148,4.477611940298507
19464_marine,69,31,66,3,100,95.65217391304348,4.3478260869565215
19465_marine,69,31,66,3,100,95.65217391304348,4.3478260869565215
19466_marine,69,31,66,3,100,95.65217391304348,4.3478260869565215
19467_marine,69,31,66,3,100,95.65217391304348,4.3478260869565215
19468_marine,69,31,66,3,100,95.65217391304348,4.3478260869565215
19469_marine,69,31,66,3,100,95.65217391304348,4.3478260869565215
19470_marine,69,31,66,3,100,95.65217391304348,4.3478260869565215
19471_marine,69,30,66,3,99,95.65217391304348,4.3478260869565215
19472_marine,69,28,66,3,97,95.65217391304348,4.3478260869565215
19473_marine,69,28,66,3,97,95.65217391304348,4.3478260869565215
19474_marine,69,28,66,3,97,95.65217391304348,4.3478260869565215
19475_marine,69,28,66,3,97,95.65217391304348,4.3478260869565215
19476_marine,68,28,65,3,96,95.58823529411765,4.411764705882353
19477_marine,68,28,65,3,96,95.58823529411765,4.411764705882353
19478_marine,66,28,63,3,94,95.45454545454545,4.545454545454546
19479_marine,65,30,62,3,95,95.38461538461539,4.615384615384616
19480_marine,65,30,62,3,95,95.38461538461539,4.615384615384616
19481_marine,65,30,62,3,95,95.38461538461539,4.615384615384616
19482_marine,65,30,62,3,95,95.38461538461539,4.615384615384616
19483_marine,65,29,62,3,94,95.38461538461539,4.615384615384616
19484_marine,66,29,62,4,95,93.93939393939394,6.0606060606060606
19485_marine,68,29,64,4,97,94.11764705882352,5.88235294117647
19486_marine,66,29,62,4,95,93.93939393939394,6.0606060606060606
19487_marine,68,29,64,5,97,94.11764705882352,7.352941176470589
19488_marine,68,29,64,5,97,94.11764705882352,7.352941176470589
19489_marine,69,29,65,5,98,94.20289855072464,7.246376811594203
19490_marine,71,30,67,5,101,94.36619718309859,7.042253521126761
19491_marine,71,30,67,5,101,94.36619718309859,7.042253521126761
19492_marine,75,31,70,6,106,93.33333333333333,8
19493_marine,77,33,73,4,110,94.8051948051948,5.194805194805195
19494_marine,81,33,75,5,114,92.5925925925926,6.172839506172839
19495_marine,93,33,87,6,126,93.54838709677419,6.451612903225806
19496_marine,101,35,93,9,136,92.07920792079209,8.91089108910891
19497_marine,112,43,102,14,155,91.07142857142857,12.5
19498_marine,207,122,176,39,329,85.02415458937197,18.84057971014493
19546_marine,242,152,209,43,394,86.36363636363636,17.768595041322314
19547_marine,117,44,105,10,161,89.74358974358975,8.547008547008547
19548_marine,94,40,87,6,134,92.5531914893617,6.382978723404255
19549_marine,87,39,80,5,126,91.95402298850574,5.747126436781609
19550_marine,85,37,78,5,122,91.76470588235294,5.88235294117647
19551_marine,85,37,78,5,122,91.76470588235294,5.88235294117647
19552_marine,81,35,73,4,116,90.12345679012346,4.938271604938271
19553_marine,83,33,76,5,116,91.56626506024097,6.024096385542169
19554_marine,79,33,72,5,112,91.13924050632912,6.329113924050633
19555_marine,79,33,72,5,112,91.13924050632912,6.329113924050633
19556_marine,78,33,71,5,111,91.02564102564102,6.41025641025641
19557_marine,78,33,71,5,111,91.02564102564102,6.41025641025641
19558_marine,77,33,70,5,110,90.9090909090909,6.493506493506493
19559_marine,77,33,70,5,110,90.9090909090909,6.493506493506493
19560_marine,75,33,70,3,108,93.33333333333333,4
19561_marine,75,33,70,3,108,93.33333333333333,4
19562_marine,73,33,68,3,106,93.15068493150685,4.10958904109589
19563_marine,74,33,69,4,107,93.24324324324324,5.405405405405405
19564_marine,75,35,70,4,110,93.33333333333333,5.333333333333334
19565_marine,77,33,71,6,110,92.20779220779221,7.792207792207792
19566_marine,77,31,71,6,108,92.20779220779221,7.792207792207792
19567_marine,77,31,71,6,108,92.20779220779221,7.792207792207792
19568_marine,77,31,71,6,108,92.20779220779221,7.792207792207792
19569_marine,76,31,70,5,107,92.10526315789474,6.578947368421052
19570_marine,78,31,72,5,109,92.3076923076923,6.41025641025641
19571_marine,78,31,72,5,109,92.3076923076923,6.41025641025641
19572_marine,80,31,72,5,111,90,6.25
19573_marine,78,31,70,5,109,89.74358974358975,6.41025641025641
19574_marine,78,31,70,5,109,89.74358974358975,6.41025641025641
19575_marine,78,31,70,5,109,89.74358974358975,6.41025641025641
19576_marine,81,30,73,5,111,90.12345679012346,6.172839506172839
19577_marine,78,30,70,4,108,89.74358974358975,5.128205128205128
19578_marine,78,29,70,4,107,89.74358974358975,5.128205128205128
19579_marine,76,29,68,3,105,89.47368421052632,3.9473684210526314
19580_marine,75,29,68,2,104,90.66666666666666,2.666666666666667
19581_marine,76,29,69,3,105,90.78947368421053,3.9473684210526314
19582_marine,77,29,70,3,106,90.9090909090909,3.896103896103896
19583_marine,81,35,74,3,116,91.35802469135803,3.7037037037037033
19584_marine,81,37,74,3,118,91.35802469135803,3.7037037037037033
19585_marine,82,41,75,3,123,91.46341463414635,3.6585365853658534
19586_marine,83,41,76,2,124,91.56626506024097,2.4096385542168677
19587_marine,83,41,76,2,124,91.56626506024097,2.4096385542168677
19588_marine,80,39,73,3,119,91.25,3.75
19589_marine,82,34,75,3,116,91.46341463414635,3.6585365853658534
19590_marine,82,33,75,3,115,91.46341463414635,3.6585365853658534
19591_marine,83,35,76,3,118,91.56626506024097,3.614457831325301
19592_marine,83,35,76,3,118,91.56626506024097,3.614457831325301
19593_marine,85,45,78,3,130,91.76470588235294,3.5294117647058822
19594_marine,85,39,78,3,124,91.76470588235294,3.5294117647058822
19595_marine,87,43,80,5,130,91.95402298850574,5.747126436781609
19596_marine,83,41,76,5,124,91.56626506024097,6.024096385542169
19597_marine,82,35,75,3,117,91.46341463414635,3.6585365853658534
19598_marine,80,34,73,3,114,91.25,3.75
19599_marine,80,34,73,3,114,91.25,3.75
19600_marine,81,34,73,3,115,90.12345679012346,3.7037037037037033
19601_marine,81,34,73,4,115,90.12345679012346,4.938271604938271
19602_marine,82,36,74,4,118,90.2439024390244,4.878048780487805
19603_marine,86,36,76,5,122,88.37209302325581,5.813953488372093
19604_marine,84,42,74,5,126,88.09523809523809,5.952380952380952
19605_marine,90,50,79,6,140,87.77777777777777,6.666666666666667
19606_marine,94,45,83,6,139,88.29787234042553,6.382978723404255
19607_marine,96,45,85,6,141,88.54166666666666,6.25
19608_marine,102,51,91,8,153,89.2156862745098,7.8431372549019605
19609_marine,106,52,95,8,158,89.62264150943396,7.547169811320755
19610_marine,108,40,97,8,148,89.81481481481481,7.4074074074074066
19611_marine,123,58,107,13,181,86.99186991869918,10.569105691056912
19612_marine,125,76,107,17,201,85.6,13.600000000000001
19613_marine,284,161,259,32,445,91.19718309859155,11.267605633802818
19617_marine,530,267,415,203,797,78.30188679245283,38.301886792452834
19618_marine,545,271,429,212,816,78.71559633027523,38.899082568807344
19620_marine,492,257,385,186,749,78.2520325203252,37.80487804878049
19631_marine,487,226,383,184,713,78.64476386036962,37.782340862423
19632_marine,484,218,387,181,702,79.9586776859504,37.39669421487603
19633_marine,290,144,255,46,434,87.93103448275862,15.862068965517242
19634_marine,243,115,225,23,358,92.5925925925926,9.465020576131687
19636_marine,230,110,213,23,340,92.6086956521739,10
19637_marine,79,38,71,5,117,89.87341772151899,6.329113924050633
19638_marine,68,22,60,4,90,88.23529411764706,5.88235294117647
19639_marine,65,22,57,4,87,87.6923076923077,6.153846153846154
19640_marine,65,24,57,4,89,87.6923076923077,6.153846153846154
19641_marine,66,24,57,4,90,86.36363636363636,6.0606060606060606
19642_marine,217,105,199,26,322,91.70506912442397,11.981566820276496
19643_marine,236,124,216,30,360,91.52542372881356,12.711864406779661
19649_marine,229,114,208,33,343,90.82969432314411,14.41048034934498
19650_marine,223,104,203,31,327,91.03139013452915,13.901345291479823
19651_marine,223,96,203,30,319,91.03139013452915,13.452914798206278
19652_marine,224,92,203,30,316,90.625,13.392857142857142
19742_marine,179,76,159,31,255,88.8268156424581,17.318435754189945
19743_marine,183,72,166,32,255,90.7103825136612,17.48633879781421
19744_marine,180,70,163,29,250,90.55555555555556,16.11111111111111
19745_marine,189,75,173,33,264,91.53439153439153,17.46031746031746
19746_marine,299,115,253,113,414,84.61538461538461,37.79264214046823
19751_marine,308,112,262,69,420,85.06493506493507,22.4025974025974
19752_marine,287,119,252,63,406,87.8048780487805,21.951219512195124
19762_marine,354,173,275,102,527,77.68361581920904,28.8135593220339
19763_marine,144,65,135,16,209,93.75,11.11111111111111
19764_marine,112,38,108,6,150,96.42857142857143,5.357142857142857
19765_marine,96,36,93,4,132,96.875,4.166666666666666
19766_marine,95,36,92,4,131,96.84210526315789,4.2105263157894735
19767_marine,89,33,86,4,122,96.62921348314607,4.49438202247191
19768_marine,86,33,83,3,119,96.51162790697676,3.488372093023256
19769_marine,86,33,83,3,119,96.51162790697676,3.488372093023256
19770_marine,85,31,82,3,116,96.47058823529412,3.5294117647058822
19771_marine,85,32,82,3,117,96.47058823529412,3.5294117647058822
19772_marine,85,32,82,3,117,96.47058823529412,3.5294117647058822
19773_marine,85,32,82,3,117,96.47058823529412,3.5294117647058822
19774_marine,83,32,80,3,115,96.3855421686747,3.614457831325301
19775_marine,81,32,78,3,113,96.29629629629629,3.7037037037037033
19776_marine,79,33,76,3,112,96.20253164556962,3.79746835443038
19777_marine,80,33,77,3,113,96.25,3.75
19778_marine,80,33,77,3,113,96.25,3.75
19779_marine,78,33,75,3,111,96.15384615384616,3.8461538461538463
19780_marine,78,33,75,3,111,96.15384615384616,3.8461538461538463
19781_marine,75,35,72,2,110,96,2.666666666666667
19782_marine,75,34,72,2,109,96,2.666666666666667
19783_marine,75,34,72,2,109,96,2.666666666666667
19784_marine,75,34,72,2,109,96,2.666666666666667
19785_marine,75,36,72,2,111,96,2.666666666666667
19786_marine,75,36,72,2,111,96,2.666666666666667
19787_marine,73,36,70,2,109,95.8904109589041,2.73972602739726
19788_marine,73,36,70,2,109,95.8904109589041,2.73972602739726
19789_marine,73,34,70,2,107,95.8904109589041,2.73972602739726
19790_marine,73,34,70,2,107,95.8904109589041,2.73972602739726
19791_marine,71,39,68,2,110,95.77464788732394,2.8169014084507045
19792_marine,71,39,68,2,110,95.77464788732394,2.8169014084507045
19793_marine,72,39,69,2,111,95.83333333333334,2.7777777777777777
19794_marine,72,35,69,2,107,95.83333333333334,2.7777777777777777
19795_marine,72,35,69,2,107,95.83333333333334,2.7777777777777777
19796_marine,72,34,69,2,106,95.83333333333334,2.7777777777777777
19797_marine,72,34,69,2,106,95.83333333333334,2.7777777777777777
19798_marine,72,33,69,2,105,95.83333333333334,2.7777777777777777
19799_marine,72,33,69,2,105,95.83333333333334,2.7777777777777777
19800_marine,72,33,69,2,105,95.83333333333334,2.7777777777777777
19801_marine,75,30,72,2,105,96,2.666666666666667
19802_marine,74,30,71,2,104,95.94594594594594,2.7027027027027026
19803_marine,76,30,73,2,106,96.05263157894737,2.631578947368421
19804_marine,76,30,73,2,106,96.05263157894737,2.631578947368421
19805_marine,78,30,75,2,108,96.15384615384616,2.564102564102564
19806_marine,78,30,75,4,108,96.15384615384616,5.128205128205128
19807_marine,76,30,73,4,106,96.05263157894737,5.263157894736842
19808_marine,76,30,73,4,106,96.05263157894737,5.263157894736842
19809_marine,76,30,73,4,106,96.05263157894737,5.263157894736842
19810_marine,76,30,73,4,106,96.05263157894737,5.263157894736842
19811_marine,76,31,73,4,107,96.05263157894737,5.263157894736842
19812_marine,76,33,73,4,109,96.05263157894737,5.263157894736842
19813_marine,76,31,73,4,107,96.05263157894737,5.263157894736842
19814_marine,76,31,73,4,107,96.05263157894737,5.263157894736842
19815_marine,74,32,71,4,106,95.94594594594594,5.405405405405405
19816_marine,69,32,66,3,101,95.65217391304348,4.3478260869565215
19817_marine,69,32,66,3,101,95.65217391304348,4.3478260869565215
19818_marine,69,32,66,3,101,95.65217391304348,4.3478260869565215
19819_marine,69,32,66,3,101,95.65217391304348,4.3478260869565215
19820_marine,68,32,65,3,100,95.58823529411765,4.411764705882353
19821_marine,68,33,65,3,101,95.58823529411765,4.411764705882353
19822_marine,68,32,65,3,100,95.58823529411765,4.411764705882353
19823_marine,70,32,67,3,102,95.71428571428572,4.285714285714286
19824_marine,70,32,67,3,102,95.71428571428572,4.285714285714286
19825_marine,70,32,67,3,102,95.71428571428572,4.285714285714286
19826_marine,71,31,68,3,102,95.77464788732394,4.225352112676056
19827_marine,71,31,68,3,102,95.77464788732394,4.225352112676056
19828_marine,71,31,68,3,102,95.77464788732394,4.225352112676056
19829_marine,71,31,68,3,102,95.77464788732394,4.225352112676056
19830_marine,71,31,68,3,102,95.77464788732394,4.225352112676056
19831_marine,71,31,68,3,102,95.77464788732394,4.225352112676056
19832_marine,70,31,67,3,101,95.71428571428572,4.285714285714286
19833_marine,70,31,67,3,101,95.71428571428572,4.285714285714286
19834_marine,68,31,65,3,99,95.58823529411765,4.411764705882353
19835_marine,68,31,65,3,99,95.58823529411765,4.411764705882353
19836_marine,68,31,65,3,99,95.58823529411765,4.411764705882353
19837_marine,69,31,66,3,100,95.65217391304348,4.3478260869565215
19838_marine,69,31,66,3,100,95.65217391304348,4.3478260869565215
19839_marine,68,30,65,3,98,95.58823529411765,4.411764705882353
19840_marine,68,30,65,3,98,95.58823529411765,4.411764705882353
19841_marine,66,30,63,3,96,95.45454545454545,4.545454545454546
19842_marine,66,30,63,3,96,95.45454545454545,4.545454545454546
19843_marine,66,30,63,3,96,95.45454545454545,4.545454545454546
19844_marine,68,30,65,3,98,95.58823529411765,4.411764705882353
19845_marine,68,29,65,3,97,95.58823529411765,4.411764705882353
19846_marine,66,29,63,3,95,95.45454545454545,4.545454545454546
19847_marine,67,29,63,4,96,94.02985074626866,5.970149253731343
19848_marine,67,29,63,5,96,94.02985074626866,7.462686567164178
19849_marine,69,29,65,5,98,94.20289855072464,7.246376811594203
19850_marine,69,30,65,5,99,94.20289855072464,7.246376811594203
19851_marine,69,30,65,5,99,94.20289855072464,7.246376811594203
19852_marine,68,30,64,4,98,94.11764705882352,5.88235294117647
19853_marine,75,31,71,3,106,94.66666666666667,4
19854_marine,78,31,73,4,109,93.58974358974359,5.128205128205128
19855_marine,89,33,83,6,122,93.25842696629213,6.741573033707865
19856_marine,97,36,91,8,133,93.81443298969072,8.24742268041237
19857_marine,101,36,93,9,137,92.07920792079209,8.91089108910891
19858_marine,125,57,107,16,182,85.6,12.8
19859_marine,230,141,196,41,371,85.21739130434783,17.82608695652174
19905_marine,286,157,245,61,443,85.66433566433567,21.328671328671327
19906_marine,227,107,195,37,334,85.90308370044053,16.299559471365637
19907_marine,109,38,97,10,147,88.9908256880734,9.174311926605505
19908_marine,90,38,83,6,128,92.22222222222223,6.666666666666667
19909_marine,85,37,78,5,122,91.76470588235294,5.88235294117647
19910_marine,86,37,78,5,123,90.69767441860465,5.813953488372093
19911_marine,83,35,75,4,118,90.36144578313254,4.819277108433735
19912_marine,81,35,73,4,116,90.12345679012346,4.938271604938271
19913_marine,82,33,75,4,115,91.46341463414635,4.878048780487805
19914_marine,81,33,74,5,114,91.35802469135803,6.172839506172839
19915_marine,79,33,72,5,112,91.13924050632912,6.329113924050633
19916_marine,78,35,71,5,113,91.02564102564102,6.41025641025641
19917_marine,78,33,71,5,111,91.02564102564102,6.41025641025641
19918_marine,78,33,71,5,111,91.02564102564102,6.41025641025641
19919_marine,78,33,71,5,111,91.02564102564102,6.41025641025641
19920_marine,76,33,69,5,109,90.78947368421053,6.578947368421052
19921_marine,75,33,70,3,108,93.33333333333333,4
19922_marine,73,33,68,3,106,93.15068493150685,4.10958904109589
19923_marine,73,31,68,3,104,93.15068493150685,4.10958904109589
19924_marine,73,31,68,3,104,93.15068493150685,4.10958904109589
19925_marine,74,31,69,4,105,93.24324324324324,5.405405405405405
19926_marine,74,31,69,4,105,93.24324324324324,5.405405405405405
19927_marine,76,31,70,5,107,92.10526315789474,6.578947368421052
19928_marine,76,31,70,5,107,92.10526315789474,6.578947368421052
19929_marine,76,31,70,5,107,92.10526315789474,6.578947368421052
19930_marine,78,29,72,5,107,92.3076923076923,6.41025641025641
19931_marine,78,29,72,5,107,92.3076923076923,6.41025641025641
19932_marine,81,29,73,5,110,90.12345679012346,6.172839506172839
19933_marine,83,29,75,5,112,90.36144578313254,6.024096385542169
19934_marine,82,29,74,4,111,90.2439024390244,4.878048780487805
19935_marine,80,28,72,4,108,90,5
19936_marine,80,28,72,4,108,90,5
19937_marine,80,28,72,4,108,90,5
19938_marine,78,27,70,3,105,89.74358974358975,3.8461538461538463
19939_marine,78,29,70,3,107,89.74358974358975,3.8461538461538463
19940_marine,77,29,70,2,106,90.9090909090909,2.5974025974025974
19941_marine,77,29,70,2,106,90.9090909090909,2.5974025974025974
19942_marine,81,37,74,3,118,91.35802469135803,3.7037037037037033
19943_marine,81,37,74,3,118,91.35802469135803,3.7037037037037033
19944_marine,81,37,74,3,118,91.35802469135803,3.7037037037037033
19945_marine,80,39,73,2,119,91.25,2.5
19946_marine,81,39,74,2,120,91.35802469135803,2.4691358024691357
19947_marine,79,31,72,2,110,91.13924050632912,2.5316455696202533
19948_marine,79,33,72,2,112,91.13924050632912,2.5316455696202533
19949_marine,80,39,73,3,119,91.25,3.75
19950_marine,80,42,73,3,122,91.25,3.75
19951_marine,81,40,74,3,121,91.35802469135803,3.7037037037037033
19952_marine,81,41,74,3,122,91.35802469135803,3.7037037037037033
19953_marine,81,41,74,3,122,91.35802469135803,3.7037037037037033
19954_marine,81,31,74,3,112,91.35802469135803,3.7037037037037033
19955_marine,81,31,74,3,112,91.35802469135803,3.7037037037037033
19956_marine,81,33,74,3,114,91.35802469135803,3.7037037037037033
19957_marine,81,32,74,3,113,91.35802469135803,3.7037037037037033
19958_marine,82,32,75,3,114,91.46341463414635,3.6585365853658534
19959_marine,81,32,73,3,113,90.12345679012346,3.7037037037037033
19960_marine,81,34,73,3,115,90.12345679012346,3.7037037037037033
19961_marine,84,34,76,4,118,90.47619047619048,4.761904761904762
19962_marine,83,38,74,5,121,89.1566265060241,6.024096385542169
19963_marine,88,40,78,7,128,88.63636363636364,7.954545454545454
19964_marine,188,88,167,19,276,88.82978723404256,10.106382978723403
19965_marine,108,49,95,6,157,87.96296296296296,5.555555555555555
19966_marine,104,59,93,6,163,89.42307692307693,5.769230769230769
19967_marine,102,45,91,6,147,89.2156862745098,5.88235294117647
19968_marine,107,45,96,7,152,89.7196261682243,6.5420560747663545
19969_marine,107,53,92,11,160,85.98130841121495,10.2803738317757
19970_marine,110,42,95,12,152,86.36363636363636,10.909090909090908
19971_marine,245,94,229,21,339,93.46938775510203,8.571428571428571
19972_marine,271,134,249,30,405,91.88191881918819,11.07011070110701
19973_marine,286,142,262,32,428,91.6083916083916,11.188811188811188
19974_marine,532,268,421,210,800,79.13533834586465,39.473684210526315
19991_marine,472,219,376,177,691,79.66101694915254,37.5
19992_marine,305,124,265,61,429,86.88524590163934,20
19993_marine,243,97,226,22,340,93.00411522633745,9.053497942386832
19994_marine,230,85,214,22,315,93.04347826086956,9.565217391304348
19995_marine,231,102,215,21,333,93.07359307359307,9.090909090909092
19996_marine,177,68,165,13,245,93.22033898305084,7.344632768361582
19997_marine,78,37,70,4,115,89.74358974358975,5.128205128205128
19998_marine,67,21,59,4,88,88.05970149253731,5.970149253731343
19999_marine,65,21,57,4,86,87.6923076923077,6.153846153846154
20000_marine,63,21,55,4,84,87.3015873015873,6.349206349206349
20001_marine,63,24,55,4,87,87.3015873015873,6.349206349206349
20002_marine,66,26,58,4,92,87.87878787878788,6.0606060606060606
20003_marine,191,78,177,23,269,92.67015706806284,12.041884816753926
20004_marine,253,112,221,61,365,87.35177865612648,24.110671936758894
20007_marine,252,135,211,59,387,83.73015873015873,23.41269841269841
20008_marine,196,85,182,23,281,92.85714285714286,11.73469387755102
20009_marine,74,29,63,9,103,85.13513513513513,12.162162162162163
20010_marine,67,25,57,8,92,85.07462686567165,11.940298507462686
20011_marine,62,19,54,6,81,87.09677419354838,9.67741935483871
20012_marine,193,54,173,24,247,89.63730569948186,12.435233160621761
20102_marine,187,72,169,35,259,90.37433155080214,18.71657754010695
20103_marine,181,74,163,31,255,90.05524861878453,17.12707182320442
20104_marine,177,73,160,26,250,90.3954802259887,14.689265536723164
20105_marine,215,90,197,38,305,91.62790697674419,17.674418604651162
20106_marine,353,136,293,133,489,83.0028328611898,37.6770538243626
20121_marine,600,267,385,283,867,64.16666666666667,47.16666666666667
20122_marine,319,150,245,97,469,76.8025078369906,30.407523510971785
20123_marine,130,60,122,12,190,93.84615384615384,9.230769230769232
20124_marine,98,36,94,6,134,95.91836734693877,6.122448979591836
20125_marine,92,36,89,4,128,96.73913043478261,4.3478260869565215
20126_marine,89,36,86,4,125,96.62921348314607,4.49438202247191
20127_marine,86,32,83,3,118,96.51162790697676,3.488372093023256
20128_marine,86,31,83,3,117,96.51162790697676,3.488372093023256
20129_marine,87,31,84,4,118,96.55172413793103,4.597701149425287
20130_marine,86,31,82,5,117,95.34883720930233,5.813953488372093
20131_marine,85,31,81,5,116,95.29411764705881,5.88235294117647
20132_marine,85,31,81,5,116,95.29411764705881,5.88235294117647
20133_marine,85,32,81,5,117,95.29411764705881,5.88235294117647
20134_marine,85,32,81,5,117,95.29411764705881,5.88235294117647
20135_marine,83,34,79,4,117,95.18072289156626,4.819277108433735
20136_marine,82,35,78,4,117,95.1219512195122,4.878048780487805
20137_marine,79,35,76,2,114,96.20253164556962,2.5316455696202533
20138_marine,79,35,76,2,114,96.20253164556962,2.5316455696202533
20139_marine,79,35,76,2,114,96.20253164556962,2.5316455696202533
20140_marine,79,35,76,2,114,96.20253164556962,2.5316455696202533
20141_marine,79,34,76,2,113,96.20253164556962,2.5316455696202533
20142_marine,77,34,74,2,111,96.1038961038961,2.5974025974025974
20143_marine,77,34,74,2,111,96.1038961038961,2.5974025974025974
20144_marine,77,33,74,2,110,96.1038961038961,2.5974025974025974
20145_marine,75,34,72,2,109,96,2.666666666666667
20146_marine,75,34,72,2,109,96,2.666666666666667
20147_marine,73,34,70,2,107,95.8904109589041,2.73972602739726
20148_marine,73,34,70,2,107,95.8904109589041,2.73972602739726
20149_marine,73,35,70,2,108,95.8904109589041,2.73972602739726
20150_marine,73,35,70,2,108,95.8904109589041,2.73972602739726
20151_marine,74,35,71,2,109,95.94594594594594,2.7027027027027026
20152_marine,74,39,71,2,113,95.94594594594594,2.7027027027027026
20153_marine,74,39,71,2,113,95.94594594594594,2.7027027027027026
20154_marine,74,33,71,2,107,95.94594594594594,2.7027027027027026
20155_marine,74,33,71,4,107,95.94594594594594,5.405405405405405
20156_marine,74,35,71,4,109,95.94594594594594,5.405405405405405
20157_marine,76,35,73,4,111,96.05263157894737,5.263157894736842
20158_marine,76,35,73,4,111,96.05263157894737,5.263157894736842
20159_marine,76,35,73,4,111,96.05263157894737,5.263157894736842
20160_marine,74,34,71,2,108,95.94594594594594,2.7027027027027026
20161_marine,71,32,68,2,103,95.77464788732394,2.8169014084507045
20162_marine,72,32,69,2,104,95.83333333333334,2.7777777777777777
20163_marine,74,31,71,2,105,95.94594594594594,2.7027027027027026
20164_marine,76,31,73,2,107,96.05263157894737,2.631578947368421
20165_marine,76,30,73,2,106,96.05263157894737,2.631578947368421
20166_marine,76,30,73,2,106,96.05263157894737,2.631578947368421
20167_marine,76,30,73,4,106,96.05263157894737,5.263157894736842
20168_marine,74,30,71,4,104,95.94594594594594,5.405405405405405
20169_marine,72,30,69,4,102,95.83333333333334,5.555555555555555
20170_marine,72,30,69,4,102,95.83333333333334,5.555555555555555
20171_marine,74,31,71,4,105,95.94594594594594,5.405405405405405
20172_marine,74,31,71,4,105,95.94594594594594,5.405405405405405
20173_marine,74,31,71,4,105,95.94594594594594,5.405405405405405
20174_marine,74,31,71,4,105,95.94594594594594,5.405405405405405
20175_marine,74,30,71,4,104,95.94594594594594,5.405405405405405
20176_marine,76,30,73,4,106,96.05263157894737,5.263157894736842
20177_marine,78,30,75,4,108,96.15384615384616,5.128205128205128
20178_marine,77,30,74,3,107,96.1038961038961,3.896103896103896
20179_marine,76,30,73,3,106,96.05263157894737,3.9473684210526314
20180_marine,72,30,69,3,102,95.83333333333334,4.166666666666666
20181_marine,74,31,71,3,105,95.94594594594594,4.054054054054054
20182_marine,74,31,71,3,105,95.94594594594594,4.054054054054054
20183_marine,73,30,70,3,103,95.8904109589041,4.10958904109589
20184_marine,73,30,70,3,103,95.8904109589041,4.10958904109589
20185_marine,73,30,70,3,103,95.8904109589041,4.10958904109589
20186_marine,73,30,70,3,103,95.8904109589041,4.10958904109589
20187_marine,73,30,70,3,103,95.8904109589041,4.10958904109589
20188_marine,71,32,68,3,103,95.77464788732394,4.225352112676056
20189_marine,71,31,68,3,102,95.77464788732394,4.225352112676056
20190_marine,71,31,68,3,102,95.77464788732394,4.225352112676056
20191_marine,71,31,68,3,102,95.77464788732394,4.225352112676056
20192_marine,71,31,68,3,102,95.77464788732394,4.225352112676056
20193_marine,71,31,68,3,102,95.77464788732394,4.225352112676056
20194_marine,71,31,68,3,102,95.77464788732394,4.225352112676056
20195_marine,71,31,68,3,102,95.77464788732394,4.225352112676056
20196_marine,71,31,68,3,102,95.77464788732394,4.225352112676056
20197_marine,71,31,68,3,102,95.77464788732394,4.225352112676056
20198_marine,73,29,70,3,102,95.8904109589041,4.10958904109589
20199_marine,72,29,69,3,101,95.83333333333334,4.166666666666666
20200_marine,72,29,69,3,101,95.83333333333334,4.166666666666666
20201_marine,72,29,69,3,101,95.83333333333334,4.166666666666666
20202_marine,72,29,69,3,101,95.83333333333334,4.166666666666666
20203_marine,70,28,67,3,98,95.71428571428572,4.285714285714286
20204_marine,70,30,67,3,100,95.71428571428572,4.285714285714286
20205_marine,70,30,67,3,100,95.71428571428572,4.285714285714286
20206_marine,68,29,65,3,97,95.58823529411765,4.411764705882353
20207_marine,68,29,65,3,97,95.58823529411765,4.411764705882353
20208_marine,68,29,65,3,97,95.58823529411765,4.411764705882353
20209_marine,67,29,64,3,96,95.52238805970148,4.477611940298507
20210_marine,67,29,64,3,96,95.52238805970148,4.477611940298507
20211_marine,67,30,64,3,97,95.52238805970148,4.477611940298507
20212_marine,70,30,66,3,100,94.28571428571428,4.285714285714286
20213_marine,70,31,66,3,101,94.28571428571428,4.285714285714286
20214_marine,77,33,73,3,110,94.8051948051948,3.896103896103896
20215_marine,82,32,77,4,114,93.90243902439023,4.878048780487805
20216_marine,94,34,88,6,128,93.61702127659575,6.382978723404255
20217_marine,101,36,94,7,137,93.06930693069307,6.9306930693069315
20218_marine,112,44,103,12,156,91.96428571428571,10.714285714285714
20219_marine,213,124,191,28,337,89.67136150234741,13.145539906103288
20264_marine,285,176,247,57,461,86.66666666666667,20
20265_marine,256,134,225,45,390,87.890625,17.578125
20266_marine,117,45,105,10,162,89.74358974358975,8.547008547008547
20267_marine,102,39,91,7,141,89.2156862745098,6.862745098039216
20268_marine,92,39,83,7,131,90.21739130434783,7.608695652173914
20269_marine,86,39,78,5,125,90.69767441860465,5.813953488372093
20270_marine,83,37,75,4,120,90.36144578313254,4.819277108433735
20271_marine,81,37,73,4,118,90.12345679012346,4.938271604938271
20272_marine,81,35,73,4,116,90.12345679012346,4.938271604938271
20273_marine,81,35,73,4,116,90.12345679012346,4.938271604938271
20274_marine,82,35,74,5,117,90.2439024390244,6.097560975609756
20275_marine,237,84,183,82,321,77.21518987341773,34.59915611814346
20276_marine,235,84,182,82,319,77.4468085106383,34.8936170212766
20277_marine,84,39,77,9,123,91.66666666666666,10.714285714285714
20278_marine,78,35,71,5,113,91.02564102564102,6.41025641025641
20279_marine,78,35,71,5,113,91.02564102564102,6.41025641025641
20280_marine,78,33,71,5,111,91.02564102564102,6.41025641025641
20281_marine,75,33,68,5,108,90.66666666666666,6.666666666666667
20282_marine,72,31,67,3,103,93.05555555555556,4.166666666666666
20283_marine,72,31,67,3,103,93.05555555555556,4.166666666666666
20284_marine,72,31,67,3,103,93.05555555555556,4.166666666666666
20285_marine,72,31,67,3,103,93.05555555555556,4.166666666666666
20286_marine,72,31,67,3,103,93.05555555555556,4.166666666666666
20287_marine,74,31,69,3,105,93.24324324324324,4.054054054054054
20288_marine,74,31,69,3,105,93.24324324324324,4.054054054054054
20289_marine,75,31,69,4,106,92,5.333333333333334
20290_marine,79,31,73,4,110,92.40506329113924,5.063291139240507
20291_marine,80,31,74,4,111,92.5,5
20292_marine,82,31,74,4,113,90.2439024390244,4.878048780487805
20293_marine,82,29,74,4,111,90.2439024390244,4.878048780487805
20294_marine,81,28,73,4,109,90.12345679012346,4.938271604938271
20295_marine,81,28,73,4,109,90.12345679012346,4.938271604938271
20296_marine,79,28,71,4,107,89.87341772151899,5.063291139240507
20297_marine,78,28,70,3,106,89.74358974358975,3.8461538461538463
20298_marine,78,27,70,3,105,89.74358974358975,3.8461538461538463
20299_marine,78,27,70,3,105,89.74358974358975,3.8461538461538463
20300_marine,81,33,74,2,114,91.35802469135803,2.4691358024691357
20301_marine,79,33,72,2,112,91.13924050632912,2.5316455696202533
20302_marine,80,35,73,2,115,91.25,2.5
20303_marine,79,35,73,1,114,92.40506329113924,1.2658227848101267
20304_marine,79,35,73,1,114,92.40506329113924,1.2658227848101267
20305_marine,77,29,71,1,106,92.20779220779221,1.2987012987012987
20306_marine,78,29,72,1,107,92.3076923076923,1.282051282051282
20307_marine,79,27,72,2,106,91.13924050632912,2.5316455696202533
20308_marine,79,27,72,2,106,91.13924050632912,2.5316455696202533
20309_marine,77,27,70,2,104,90.9090909090909,2.5974025974025974
20310_marine,78,38,71,3,116,91.02564102564102,3.8461538461538463
20311_marine,79,42,72,3,121,91.13924050632912,3.79746835443038
20312_marine,81,40,74,3,121,91.35802469135803,3.7037037037037033
20313_marine,81,30,74,3,111,91.35802469135803,3.7037037037037033
20314_marine,81,30,74,3,111,91.35802469135803,3.7037037037037033
20315_marine,81,30,74,3,111,91.35802469135803,3.7037037037037033
20316_marine,81,30,74,3,111,91.35802469135803,3.7037037037037033
20317_marine,83,32,76,3,115,91.56626506024097,3.614457831325301
20318_marine,84,32,76,3,116,90.47619047619048,3.571428571428571
20319_marine,83,32,75,3,115,90.36144578313254,3.614457831325301
20320_marine,82,32,74,4,114,90.2439024390244,4.878048780487805
20321_marine,84,34,75,5,118,89.28571428571429,5.952380952380952
20322_marine,185,79,166,19,264,89.72972972972974,10.27027027027027
20323_marine,201,93,180,22,294,89.55223880597015,10.945273631840797
20324_marine,241,118,214,45,359,88.79668049792531,18.672199170124482
20325_marine,211,85,190,22,296,90.04739336492891,10.42654028436019
20326_marine,136,77,123,12,213,90.44117647058823,8.823529411764707
20327_marine,104,45,93,6,149,89.42307692307693,5.769230769230769
20328_marine,107,37,96,7,144,89.7196261682243,6.5420560747663545
20329_marine,109,41,94,11,150,86.23853211009175,10.091743119266056
20330_marine,248,90,232,19,338,93.54838709677419,7.661290322580645
20331_marine,275,135,255,27,410,92.72727272727272,9.818181818181818
20332_marine,486,248,392,181,734,80.65843621399176,37.242798353909464
20333_marine,513,255,409,197,768,79.72709551656921,38.40155945419103
20334_marine,494,234,393,188,728,79.55465587044534,38.05668016194332
20351_marine,465,203,367,172,668,78.92473118279571,36.98924731182795
20352_marine,465,193,372,167,658,80,35.913978494623656
20353_marine,385,161,316,119,546,82.07792207792208,30.909090909090907
20354_marine,237,94,222,22,331,93.67088607594937,9.282700421940929
20355_marine,236,86,220,23,322,93.22033898305084,9.745762711864407
20356_marine,227,82,212,22,309,93.3920704845815,9.691629955947137
20357_marine,76,31,69,4,107,90.78947368421053,5.263157894736842
20358_marine,64,21,57,4,85,89.0625,6.25
20359_marine,64,21,57,4,85,89.0625,6.25
20360_marine,213,68,197,21,281,92.48826291079813,9.859154929577464
20361_marine,218,67,202,22,285,92.66055045871559,10.091743119266056
20362_marine,222,73,207,21,295,93.24324324324324,9.45945945945946
20363_marine,221,79,205,22,300,92.76018099547511,9.95475113122172
20364_marine,227,104,211,25,331,92.95154185022027,11.013215859030836
20365_marine,212,93,197,23,305,92.9245283018868,10.849056603773585
20366_marine,189,76,178,19,265,94.17989417989418,10.052910052910052
20367_marine,69,29,60,6,98,86.95652173913044,8.695652173913043
20368_marine,58,23,51,4,81,87.93103448275862,6.896551724137931
20369_marine,58,23,51,4,81,87.93103448275862,6.896551724137931
20370_marine,60,23,53,4,83,88.33333333333333,6.666666666666667
20371_marine,64,17,56,6,81,87.5,9.375
20372_marine,180,54,164,20,234,91.11111111111111,11.11111111111111
20373_marine,184,58,165,22,242,89.67391304347827,11.956521739130435
20374_marine,196,58,176,25,254,89.79591836734694,12.755102040816327
20375_marine,229,113,208,29,342,90.82969432314411,12.663755458515283
20462_marine,211,86,190,43,297,90.04739336492891,20.379146919431278
20463_marine,218,82,196,40,300,89.90825688073394,18.34862385321101
20464_marine,209,85,188,39,294,89.95215311004785,18.660287081339714
20465_marine,230,105,207,46,335,90,20
20466_marine,284,125,243,67,409,85.56338028169014,23.591549295774648
20468_marine,419,152,334,147,571,79.71360381861575,35.08353221957041
20469_marine,469,179,377,161,648,80.38379530916845,34.32835820895522
20478_marine,542,256,370,229,798,68.26568265682657,42.25092250922509
20479_marine,620,299,404,291,919,65.16129032258064,46.935483870967744
20480_marine,650,316,423,330,966,65.07692307692308,50.76923076923077
20481_marine,545,253,346,265,798,63.48623853211009,48.62385321100918
20482_marine,133,70,125,15,203,93.98496240601504,11.278195488721805
20483_marine,98,36,94,8,134,95.91836734693877,8.16326530612245
20484_marine,92,35,89,4,127,96.73913043478261,4.3478260869565215
20485_marine,91,34,88,5,125,96.7032967032967,5.4945054945054945
20486_marine,89,34,86,4,123,96.62921348314607,4.49438202247191
20487_marine,88,32,84,5,120,95.45454545454545,5.681818181818182
20488_marine,86,32,82,5,118,95.34883720930233,5.813953488372093
20489_marine,86,31,82,5,117,95.34883720930233,5.813953488372093
20490_marine,86,31,82,5,117,95.34883720930233,5.813953488372093
20491_marine,85,31,81,4,116,95.29411764705881,4.705882352941177
20492_marine,84,33,80,4,117,95.23809523809523,4.761904761904762
20493_marine,82,33,78,4,115,95.1219512195122,4.878048780487805
20494_marine,82,33,78,4,115,95.1219512195122,4.878048780487805
20495_marine,82,34,78,4,116,95.1219512195122,4.878048780487805
20496_marine,81,35,77,4,116,95.06172839506173,4.938271604938271
20497_marine,81,35,77,4,116,95.06172839506173,4.938271604938271
20498_marine,81,33,77,4,114,95.06172839506173,4.938271604938271
20499_marine,78,33,74,3,111,94.87179487179486,3.8461538461538463
20500_marine,77,33,74,2,110,96.1038961038961,2.5974025974025974
20501_marine,77,32,74,2,109,96.1038961038961,2.5974025974025974
20502_marine,77,32,74,2,109,96.1038961038961,2.5974025974025974
20503_marine,77,33,74,2,110,96.1038961038961,2.5974025974025974
20504_marine,75,33,72,2,108,96,2.666666666666667
20505_marine,75,34,72,2,109,96,2.666666666666667
20506_marine,73,34,70,2,107,95.8904109589041,2.73972602739726
20507_marine,71,34,68,2,105,95.77464788732394,2.8169014084507045
20508_marine,69,35,66,2,104,95.65217391304348,2.898550724637681
20509_marine,70,35,67,2,105,95.71428571428572,2.857142857142857
20510_marine,70,35,67,2,105,95.71428571428572,2.857142857142857
20511_marine,72,35,69,2,107,95.83333333333334,2.7777777777777777
20512_marine,72,39,69,2,111,95.83333333333334,2.7777777777777777
20513_marine,72,35,69,2,107,95.83333333333334,2.7777777777777777
20514_marine,72,35,69,2,107,95.83333333333334,2.7777777777777777
20515_marine,74,35,71,4,109,95.94594594594594,5.405405405405405
20516_marine,74,35,71,4,109,95.94594594594594,5.405405405405405
20517_marine,74,35,71,4,109,95.94594594594594,5.405405405405405
20518_marine,74,35,71,4,109,95.94594594594594,5.405405405405405
20519_marine,72,35,69,4,107,95.83333333333334,5.555555555555555
20520_marine,72,33,69,4,105,95.83333333333334,5.555555555555555
20521_marine,75,33,72,2,108,96,2.666666666666667
20522_marine,74,33,71,2,107,95.94594594594594,2.7027027027027026
20523_marine,76,33,73,2,109,96.05263157894737,2.631578947368421
20524_marine,76,33,73,2,109,96.05263157894737,2.631578947368421
20525_marine,76,30,73,2,106,96.05263157894737,2.631578947368421
20526_marine,76,31,73,2,107,96.05263157894737,2.631578947368421
20527_marine,78,31,75,4,109,96.15384615384616,5.128205128205128
20528_marine,75,31,72,3,106,96,4
20529_marine,75,30,72,3,105,96,4
20530_marine,73,30,70,3,103,95.8904109589041,4.10958904109589
20531_marine,71,30,68,3,101,95.77464788732394,4.225352112676056
20532_marine,71,31,68,3,102,95.77464788732394,4.225352112676056
20533_marine,73,33,70,3,106,95.8904109589041,4.10958904109589
20534_marine,73,33,70,3,106,95.8904109589041,4.10958904109589
20535_marine,73,34,70,3,107,95.8904109589041,4.10958904109589
20536_marine,73,34,70,3,107,95.8904109589041,4.10958904109589
20537_marine,73,32,70,3,105,95.8904109589041,4.10958904109589
20538_marine,73,32,70,3,105,95.8904109589041,4.10958904109589
20539_marine,73,32,70,3,105,95.8904109589041,4.10958904109589
20540_marine,72,32,69,2,104,95.83333333333334,2.7777777777777777
20541_marine,72,33,69,2,105,95.83333333333334,2.7777777777777777
20542_marine,72,33,69,2,105,95.83333333333334,2.7777777777777777
20543_marine,71,33,68,2,104,95.77464788732394,2.8169014084507045
20544_marine,69,32,66,2,101,95.65217391304348,2.898550724637681
20545_marine,69,32,66,2,101,95.65217391304348,2.898550724637681
20546_marine,70,32,67,2,102,95.71428571428572,2.857142857142857
20547_marine,70,32,67,2,102,95.71428571428572,2.857142857142857
20548_marine,70,32,67,2,102,95.71428571428572,2.857142857142857
20549_marine,70,32,67,2,102,95.71428571428572,2.857142857142857
20550_marine,70,31,67,2,101,95.71428571428572,2.857142857142857
20551_marine,70,31,67,2,101,95.71428571428572,2.857142857142857
20552_marine,70,31,67,2,101,95.71428571428572,2.857142857142857
20553_marine,68,31,65,2,99,95.58823529411765,2.941176470588235
20554_marine,70,30,67,2,100,95.71428571428572,2.857142857142857
20555_marine,70,30,67,2,100,95.71428571428572,2.857142857142857
20556_marine,70,30,67,2,100,95.71428571428572,2.857142857142857
20557_marine,70,30,67,2,100,95.71428571428572,2.857142857142857
20558_marine,70,30,67,2,100,95.71428571428572,2.857142857142857
20559_marine,69,30,66,2,99,95.65217391304348,2.898550724637681
20560_marine,71,28,68,2,99,95.77464788732394,2.8169014084507045
20561_marine,71,28,68,2,99,95.77464788732394,2.8169014084507045
20562_marine,71,28,68,2,99,95.77464788732394,2.8169014084507045
20563_marine,71,28,68,2,99,95.77464788732394,2.8169014084507045
20564_marine,71,28,68,2,99,95.77464788732394,2.8169014084507045
20565_marine,69,27,66,2,96,95.65217391304348,2.898550724637681
20566_marine,69,26,66,2,95,95.65217391304348,2.898550724637681
20567_marine,67,26,64,2,93,95.52238805970148,2.9850746268656714
20568_marine,67,29,64,2,96,95.52238805970148,2.9850746268656714
20569_marine,67,29,64,2,96,95.52238805970148,2.9850746268656714
20570_marine,68,31,65,3,99,95.58823529411765,4.411764705882353
20571_marine,69,32,65,4,101,94.20289855072464,5.797101449275362
20572_marine,69,32,65,4,101,94.20289855072464,5.797101449275362
20573_marine,69,32,65,4,101,94.20289855072464,5.797101449275362
20574_marine,75,31,71,4,106,94.66666666666667,5.333333333333334
20575_marine,79,30,75,4,109,94.9367088607595,5.063291139240507
20576_marine,84,32,80,2,116,95.23809523809523,2.380952380952381
20577_marine,95,36,91,4,131,95.78947368421052,4.2105263157894735
20578_marine,104,39,97,8,143,93.26923076923077,7.6923076923076925
20579_marine,117,52,109,10,169,93.16239316239316,8.547008547008547
20580_marine,219,137,196,28,356,89.49771689497716,12.785388127853881
20581_marine,237,149,205,41,386,86.49789029535864,17.29957805907173
20582_marine,350,192,251,148,542,71.71428571428572,42.285714285714285
20622_marine,309,199,259,85,508,83.81877022653723,27.508090614886733
20623_marine,282,174,243,62,456,86.17021276595744,21.98581560283688
20624_marine,125,77,114,10,202,91.2,8
20625_marine,115,47,104,8,162,90.43478260869566,6.956521739130435
20626_marine,104,39,93,8,143,89.42307692307693,7.6923076923076925
20627_marine,91,39,81,7,130,89.01098901098901,7.6923076923076925
20628_marine,88,39,80,6,127,90.9090909090909,6.8181818181818175
20629_marine,82,39,75,4,121,91.46341463414635,4.878048780487805
20630_marine,80,37,73,4,117,91.25,5
20631_marine,79,37,71,4,116,89.87341772151899,5.063291139240507
20632_marine,79,35,71,4,114,89.87341772151899,5.063291139240507
20633_marine,79,37,71,4,116,89.87341772151899,5.063291139240507
20634_marine,80,37,72,4,117,90,5
20635_marine,241,88,187,82,329,77.59336099585063,34.024896265560166
20636_marine,258,91,192,99,349,74.4186046511628,38.372093023255815
20637_marine,235,86,181,82,321,77.02127659574468,34.8936170212766
20638_marine,79,35,72,5,114,91.13924050632912,6.329113924050633
20639_marine,79,35,72,5,114,91.13924050632912,6.329113924050633
20640_marine,78,33,71,5,111,91.02564102564102,6.41025641025641
20641_marine,78,31,71,5,109,91.02564102564102,6.41025641025641
20642_marine,75,31,70,3,106,93.33333333333333,4
20643_marine,76,31,71,3,107,93.42105263157895,3.9473684210526314
20644_marine,76,31,71,3,107,93.42105263157895,3.9473684210526314
20645_marine,76,31,71,3,107,93.42105263157895,3.9473684210526314
20646_marine,74,31,69,2,105,93.24324324324324,2.7027027027027026
20647_marine,74,31,69,2,105,93.24324324324324,2.7027027027027026
20648_marine,74,31,69,2,105,93.24324324324324,2.7027027027027026
20649_marine,74,31,69,2,105,93.24324324324324,2.7027027027027026
20650_marine,76,31,70,3,107,92.10526315789474,3.9473684210526314
20651_marine,77,31,71,3,108,92.20779220779221,3.896103896103896
20652_marine,78,31,72,3,109,92.3076923076923,3.8461538461538463
20653_marine,80,31,72,3,111,90,3.75
20654_marine,80,30,72,3,110,90,3.75
20655_marine,80,30,72,3,110,90,3.75
20656_marine,80,30,72,3,110,90,3.75
20657_marine,80,28,72,3,108,90,3.75
20658_marine,78,28,70,3,106,89.74358974358975,3.8461538461538463
20659_marine,80,25,72,3,105,90,3.75
20660_marine,81,31,74,2,112,91.35802469135803,2.4691358024691357
20661_marine,79,31,72,2,110,91.13924050632912,2.5316455696202533
20662_marine,80,31,73,2,111,91.25,2.5
20663_marine,77,25,71,1,102,92.20779220779221,1.2987012987012987
20664_marine,76,25,70,0,101,92.10526315789474,0
20665_marine,79,25,73,1,104,92.40506329113924,1.2658227848101267
20666_marine,80,25,74,1,105,92.5,1.25
20667_marine,80,25,74,1,105,92.5,1.25
20668_marine,80,25,74,1,105,92.5,1.25
20669_marine,79,25,72,2,104,91.13924050632912,2.5316455696202533
20670_marine,80,26,73,3,106,91.25,3.75
20671_marine,81,26,74,3,107,91.35802469135803,3.7037037037037033
20672_marine,81,36,74,3,117,91.35802469135803,3.7037037037037033
20673_marine,81,36,74,3,117,91.35802469135803,3.7037037037037033
20674_marine,81,28,74,3,109,91.35802469135803,3.7037037037037033
20675_marine,83,30,76,3,113,91.56626506024097,3.614457831325301
20676_marine,83,30,76,3,113,91.56626506024097,3.614457831325301
20677_marine,83,30,76,3,113,91.56626506024097,3.614457831325301
20678_marine,84,32,76,3,116,90.47619047619048,3.571428571428571
20679_marine,84,32,76,3,116,90.47619047619048,3.571428571428571
20680_marine,81,32,73,4,113,90.12345679012346,4.938271604938271
20681_marine,84,34,75,5,118,89.28571428571429,5.952380952380952
20682_marine,190,81,170,19,271,89.47368421052632,10
20685_marine,211,80,190,22,291,90.04739336492891,10.42654028436019
20686_marine,120,46,109,8,166,90.83333333333333,6.666666666666667
20687_marine,120,56,109,6,176,90.83333333333333,5
20688_marine,107,38,97,6,145,90.65420560747664,5.607476635514018
20689_marine,120,50,108,9,170,90,7.5
20690_marine,276,116,257,24,392,93.11594202898551,8.695652173913043
20691_marine,485,237,398,171,722,82.06185567010309,35.25773195876289
20692_marine,441,202,362,160,643,82.08616780045351,36.281179138321995
20712_marine,147,67,92,96,214,62.585034013605444,65.3061224489796
20713_marine,373,151,304,120,524,81.50134048257372,32.171581769437
20714_marine,406,166,331,137,572,81.5270935960591,33.743842364532014
20715_marine,407,165,329,133,572,80.83538083538083,32.67813267813268
20716_marine,395,155,321,124,550,81.26582278481013,31.39240506329114
20717_marine,223,81,209,19,304,93.72197309417041,8.520179372197308
20718_marine,207,70,193,19,277,93.23671497584542,9.178743961352657
20719_marine,77,29,69,5,106,89.6103896103896,6.493506493506493
20720_marine,383,156,309,121,539,80.67885117493474,31.59268929503917
20721_marine,237,86,215,28,323,90.71729957805907,11.814345991561181
20722_marine,226,83,209,23,309,92.47787610619469,10.176991150442479
20723_marine,373,159,303,124,532,81.23324396782841,33.24396782841823
20724_marine,384,166,305,132,550,79.42708333333334,34.375
20725_marine,364,149,289,117,513,79.3956043956044,32.142857142857146
20726_marine,219,83,203,24,302,92.69406392694064,10.95890410958904
20727_marine,206,69,190,23,275,92.23300970873787,11.165048543689322
20728_marine,203,60,187,23,263,92.11822660098522,11.330049261083744
20729_marine,201,60,185,23,261,92.03980099502488,11.442786069651742
20730_marine,208,64,191,25,272,91.82692307692307,12.01923076923077
20731_marine,225,68,208,25,293,92.44444444444444,11.11111111111111
20732_marine,225,68,206,26,293,91.55555555555556,11.555555555555555
20733_marine,230,66,211,33,296,91.73913043478261,14.347826086956522
20734_marine,232,96,212,32,328,91.37931034482759,13.793103448275861
20823_marine,250,103,223,51,353,89.2,20.4
20824_marine,243,97,218,45,340,89.7119341563786,18.51851851851852
20825_marine,246,109,219,50,355,89.02439024390245,20.32520325203252
20826_marine,300,120,256,71,420,85.33333333333334,23.666666666666668
20827_marine,328,124,275,79,452,83.84146341463415,24.085365853658537
20828_marine,385,140,303,111,525,78.70129870129871,28.83116883116883
20835_marine,724,313,492,347,1037,67.95580110497238,47.928176795580114
20836_marine,660,271,456,310,931,69.0909090909091,46.96969696969697
20837_marine,598,250,415,275,848,69.39799331103679,45.9866220735786
20838_marine,131,51,126,11,182,96.18320610687023,8.396946564885496
20839_marine,409,163,250,227,572,61.12469437652812,55.501222493887525
20840_marine,452,193,284,245,645,62.83185840707964,54.20353982300885
20841_marine,402,169,240,229,571,59.70149253731343,56.96517412935324
20842_marine,105,63,100,7,168,95.23809523809523,6.666666666666667
20843_marine,92,37,89,8,129,96.73913043478261,8.695652173913043
20844_marine,88,35,85,4,123,96.5909090909091,4.545454545454546
20845_marine,89,35,86,4,124,96.62921348314607,4.49438202247191
20846_marine,88,34,84,5,122,95.45454545454545,5.681818181818182
20847_marine,87,32,83,4,119,95.40229885057471,4.597701149425287
20848_marine,85,34,81,4,119,95.29411764705881,4.705882352941177
20849_marine,85,33,81,4,118,95.29411764705881,4.705882352941177
20850_marine,85,33,81,4,118,95.29411764705881,4.705882352941177
20851_marine,83,33,79,4,116,95.18072289156626,4.819277108433735
20852_marine,83,31,79,4,114,95.18072289156626,4.819277108433735
20853_marine,82,31,78,4,113,95.1219512195122,4.878048780487805
20854_marine,82,31,78,4,113,95.1219512195122,4.878048780487805
20855_marine,82,31,78,4,113,95.1219512195122,4.878048780487805
20856_marine,79,33,75,4,112,94.9367088607595,5.063291139240507
20857_marine,79,33,75,4,112,94.9367088607595,5.063291139240507
20858_marine,80,33,76,4,113,95,5
20859_marine,79,34,75,4,113,94.9367088607595,5.063291139240507
20860_marine,79,33,75,4,112,94.9367088607595,5.063291139240507
20861_marine,76,33,72,3,109,94.73684210526315,3.9473684210526314
20862_marine,76,34,72,3,110,94.73684210526315,3.9473684210526314
20863_marine,76,34,72,3,110,94.73684210526315,3.9473684210526314
20864_marine,76,34,72,3,110,94.73684210526315,3.9473684210526314
20865_marine,76,35,72,3,111,94.73684210526315,3.9473684210526314
20866_marine,76,35,72,3,111,94.73684210526315,3.9473684210526314
20867_marine,75,35,72,2,110,96,2.666666666666667
20868_marine,76,36,73,2,112,96.05263157894737,2.631578947368421
20869_marine,74,35,71,2,109,95.94594594594594,2.7027027027027026
20870_marine,72,35,69,2,107,95.83333333333334,2.7777777777777777
20871_marine,72,35,69,2,107,95.83333333333334,2.7777777777777777
20872_marine,72,35,69,2,107,95.83333333333334,2.7777777777777777
20873_marine,72,37,69,2,109,95.83333333333334,2.7777777777777777
20874_marine,72,37,69,2,109,95.83333333333334,2.7777777777777777
20875_marine,74,35,71,4,109,95.94594594594594,5.405405405405405
20876_marine,74,35,71,4,109,95.94594594594594,5.405405405405405
20877_marine,74,34,71,4,108,95.94594594594594,5.405405405405405
20878_marine,74,34,71,4,108,95.94594594594594,5.405405405405405
20879_marine,74,34,71,4,108,95.94594594594594,5.405405405405405
20880_marine,76,34,73,4,110,96.05263157894737,5.263157894736842
20881_marine,74,33,71,1,107,95.94594594594594,1.3513513513513513
20882_marine,73,33,70,1,106,95.8904109589041,1.36986301369863
20883_marine,75,33,72,1,108,96,1.3333333333333335
20884_marine,75,33,72,1,108,96,1.3333333333333335
20885_marine,75,33,72,1,108,96,1.3333333333333335
20886_marine,75,33,72,1,108,96,1.3333333333333335
20887_marine,77,32,74,1,109,96.1038961038961,1.2987012987012987
20888_marine,79,32,76,3,111,96.20253164556962,3.79746835443038
20889_marine,77,33,74,3,110,96.1038961038961,3.896103896103896
20890_marine,77,33,74,3,110,96.1038961038961,3.896103896103896
20891_marine,77,33,74,3,110,96.1038961038961,3.896103896103896
20892_marine,73,34,70,3,107,95.8904109589041,4.10958904109589
20893_marine,73,33,70,3,106,95.8904109589041,4.10958904109589
20894_marine,73,33,70,3,106,95.8904109589041,4.10958904109589
20895_marine,73,34,70,3,107,95.8904109589041,4.10958904109589
20896_marine,73,34,70,3,107,95.8904109589041,4.10958904109589
20897_marine,73,33,70,3,106,95.8904109589041,4.10958904109589
20898_marine,73,33,70,3,106,95.8904109589041,4.10958904109589
20899_marine,73,33,70,3,106,95.8904109589041,4.10958904109589
20900_marine,73,32,70,3,105,95.8904109589041,4.10958904109589
20901_marine,73,32,70,3,105,95.8904109589041,4.10958904109589
20902_marine,72,32,69,2,104,95.83333333333334,2.7777777777777777
20903_marine,72,32,69,2,104,95.83333333333334,2.7777777777777777
20904_marine,72,32,69,2,104,95.83333333333334,2.7777777777777777
20905_marine,72,32,69,2,104,95.83333333333334,2.7777777777777777
20906_marine,74,31,71,2,105,95.94594594594594,2.7027027027027026
20907_marine,72,31,69,2,103,95.83333333333334,2.7777777777777777
20908_marine,71,31,68,2,102,95.77464788732394,2.8169014084507045
20909_marine,70,31,67,2,101,95.71428571428572,2.857142857142857
20910_marine,70,30,67,2,100,95.71428571428572,2.857142857142857
20911_marine,70,30,67,2,100,95.71428571428572,2.857142857142857
20912_marine,68,30,65,2,98,95.58823529411765,2.941176470588235
20913_marine,68,30,65,2,98,95.58823529411765,2.941176470588235
20914_marine,68,30,65,2,98,95.58823529411765,2.941176470588235
20915_marine,68,30,65,2,98,95.58823529411765,2.941176470588235
20916_marine,69,30,66,3,99,95.65217391304348,4.3478260869565215
20917_marine,69,30,66,3,99,95.65217391304348,4.3478260869565215
20918_marine,69,30,66,3,99,95.65217391304348,4.3478260869565215
20919_marine,68,30,65,3,98,95.58823529411765,4.411764705882353
20920_marine,68,30,65,3,98,95.58823529411765,4.411764705882353
20921_marine,68,30,65,3,98,95.58823529411765,4.411764705882353
20922_marine,68,30,65,3,98,95.58823529411765,4.411764705882353
20923_marine,68,30,65,3,98,95.58823529411765,4.411764705882353
20924_marine,70,28,67,3,98,95.71428571428572,4.285714285714286
20925_marine,74,28,71,3,102,95.94594594594594,4.054054054054054
20926_marine,74,30,71,3,104,95.94594594594594,4.054054054054054
20927_marine,72,29,69,3,101,95.83333333333334,4.166666666666666
20928_marine,70,28,67,3,98,95.71428571428572,4.285714285714286
20929_marine,70,28,67,3,98,95.71428571428572,4.285714285714286
20930_marine,70,29,67,3,99,95.71428571428572,4.285714285714286
20931_marine,72,30,68,4,102,94.44444444444444,5.555555555555555
20932_marine,71,32,67,4,103,94.36619718309859,5.633802816901409
20933_marine,73,32,69,4,105,94.52054794520548,5.47945205479452
20934_marine,78,32,74,4,110,94.87179487179486,5.128205128205128
20935_marine,76,31,72,2,107,94.73684210526315,2.631578947368421
20936_marine,85,31,81,2,116,95.29411764705881,2.3529411764705883
20937_marine,87,34,83,2,121,95.40229885057471,2.2988505747126435
20938_marine,96,37,92,4,133,95.83333333333334,4.166666666666666
20939_marine,102,39,96,7,141,94.11764705882352,6.862745098039216
20940_marine,124,70,109,12,194,87.90322580645162,9.67741935483871
20941_marine,186,119,161,26,305,86.55913978494624,13.978494623655912
20942_marine,224,150,200,34,374,89.28571428571429,15.178571428571427
20943_marine,250,158,216,49,408,86.4,19.6
20981_marine,316,199,264,90,515,83.54430379746836,28.48101265822785
20982_marine,122,89,112,13,211,91.80327868852459,10.655737704918032
20983_marine,119,73,108,8,192,90.75630252100841,6.722689075630252
20984_marine,108,50,97,8,158,89.81481481481481,7.4074074074074066
20985_marine,103,40,92,8,143,89.32038834951457,7.766990291262135
20986_marine,95,39,84,8,134,88.42105263157895,8.421052631578947
20987_marine,91,39,81,7,130,89.01098901098901,7.6923076923076925
20988_marine,84,39,77,4,123,91.66666666666666,4.761904761904762
20989_marine,82,37,75,4,119,91.46341463414635,4.878048780487805
20990_marine,82,37,75,4,119,91.46341463414635,4.878048780487805
20991_marine,81,35,73,4,116,90.12345679012346,4.938271604938271
20992_marine,80,35,72,4,115,90,5
20993_marine,79,37,71,4,116,89.87341772151899,5.063291139240507
20994_marine,81,37,73,4,118,90.12345679012346,4.938271604938271
20995_marine,239,88,185,82,327,77.40585774058577,34.30962343096235
20996_marine,238,86,184,82,324,77.31092436974791,34.45378151260504
20997_marine,236,86,182,82,322,77.11864406779661,34.74576271186441
20998_marine,76,37,68,5,113,89.47368421052632,6.578947368421052
20999_marine,76,35,68,5,111,89.47368421052632,6.578947368421052
21000_marine,77,33,70,5,110,90.9090909090909,6.493506493506493
21001_marine,79,33,72,5,112,91.13924050632912,6.329113924050633
21002_marine,79,33,72,5,112,91.13924050632912,6.329113924050633
21003_marine,80,31,75,3,111,93.75,3.75
21004_marine,78,31,73,3,109,93.58974358974359,3.8461538461538463
21005_marine,77,31,72,2,108,93.5064935064935,2.5974025974025974
21006_marine,77,31,72,2,108,93.5064935064935,2.5974025974025974
21007_marine,75,31,70,2,106,93.33333333333333,2.666666666666667
21008_marine,75,31,70,2,106,93.33333333333333,2.666666666666667
21009_marine,74,31,69,2,105,93.24324324324324,2.7027027027027026
21010_marine,75,31,70,2,106,93.33333333333333,2.666666666666667
21011_marine,77,31,71,3,108,92.20779220779221,3.896103896103896
21012_marine,77,31,71,3,108,92.20779220779221,3.896103896103896
21013_marine,79,30,71,3,109,89.87341772151899,3.79746835443038
21014_marine,80,28,72,3,108,90,3.75
21015_marine,82,28,74,3,110,90.2439024390244,3.6585365853658534
21016_marine,82,28,74,3,110,90.2439024390244,3.6585365853658534
21017_marine,82,28,74,3,110,90.2439024390244,3.6585365853658534
21018_marine,82,28,74,3,110,90.2439024390244,3.6585365853658534
21019_marine,84,31,76,3,115,90.47619047619048,3.571428571428571
21020_marine,85,33,78,2,118,91.76470588235294,2.3529411764705883
21021_marine,81,31,74,2,112,91.35802469135803,2.4691358024691357
21022_marine,80,25,73,2,105,91.25,2.5
21023_marine,78,25,72,0,103,92.3076923076923,0
21024_marine,78,25,72,0,103,92.3076923076923,0
21025_marine,79,25,73,1,104,92.40506329113924,1.2658227848101267
21026_marine,80,25,74,1,105,92.5,1.25
21027_marine,80,25,74,1,105,92.5,1.25
21028_marine,80,25,74,1,105,92.5,1.25
21029_marine,78,25,72,1,103,92.3076923076923,1.282051282051282
21030_marine,79,26,72,2,105,91.13924050632912,2.5316455696202533
21031_marine,81,28,74,3,109,91.35802469135803,3.7037037037037033
21032_marine,81,34,74,3,115,91.35802469135803,3.7037037037037033
21033_marine,81,34,74,3,115,91.35802469135803,3.7037037037037033
21034_marine,81,25,74,3,106,91.35802469135803,3.7037037037037033
21035_marine,83,27,76,3,110,91.56626506024097,3.614457831325301
21036_marine,84,27,76,3,111,90.47619047619048,3.571428571428571
21037_marine,84,27,76,3,111,90.47619047619048,3.571428571428571
21038_marine,84,29,76,3,113,90.47619047619048,3.571428571428571
21039_marine,85,31,77,4,116,90.58823529411765,4.705882352941177
21040_marine,85,33,76,5,118,89.41176470588236,5.88235294117647
21041_marine,87,33,78,5,120,89.65517241379311,5.747126436781609
21042_marine,97,38,87,7,135,89.69072164948454,7.216494845360824
21043_marine,210,79,189,22,289,90,10.476190476190476
21044_marine,260,100,239,24,360,91.92307692307692,9.230769230769232
21045_marine,252,97,233,21,349,92.46031746031747,8.333333333333332
21046_marine,119,46,109,8,165,91.59663865546219,6.722689075630252
21047_marine,189,92,179,12,281,94.70899470899471,6.349206349206349
21048_marine,127,80,117,8,207,92.1259842519685,6.299212598425196
21049_marine,128,72,116,11,200,90.625,8.59375
21050_marine,287,126,266,28,413,92.6829268292683,9.75609756097561
21076_marine,380,143,310,116,523,81.57894736842105,30.526315789473685
21077_marine,342,138,290,87,480,84.7953216374269,25.438596491228072
21078_marine,334,136,282,83,470,84.4311377245509,24.850299401197603
21079_marine,224,84,210,19,308,93.75,8.482142857142858
21080_marine,385,162,310,121,547,80.51948051948052,31.428571428571427
21081_marine,360,144,292,109,504,81.11111111111111,30.277777777777775
21085_marine,349,137,281,110,486,80.51575931232091,31.51862464183381
21086_marine,363,154,289,117,517,79.61432506887053,32.231404958677686
21087_marine,344,154,274,107,498,79.65116279069767,31.1046511627907
21088_marine,363,151,287,114,514,79.06336088154269,31.40495867768595
21095_marine,280,120,247,54,400,88.21428571428571,19.28571428571429
21183_marine,301,123,273,63,424,90.69767441860465,20.930232558139537
21184_marine,286,115,255,57,401,89.16083916083916,19.93006993006993
21185_marine,271,107,236,60,378,87.08487084870849,22.14022140221402
21186_marine,283,114,249,55,397,87.98586572438163,19.434628975265017
21187_marine,317,116,266,76,433,83.91167192429022,23.974763406940063
21188_marine,369,144,289,106,513,78.31978319783198,28.72628726287263
21189_marine,569,234,416,224,803,73.11072056239016,39.36731107205624
21193_marine,805,309,539,410,1114,66.95652173913044,50.931677018633536
21194_marine,730,271,495,367,1001,67.8082191780822,50.273972602739725
21195_marine,135,50,131,13,185,97.03703703703704,9.62962962962963
21196_marine,125,44,121,8,169,96.8,6.4
21197_marine,119,45,116,6,164,97.47899159663865,5.042016806722689
21198_marine,113,43,110,6,156,97.34513274336283,5.3097345132743365
21199_marine,372,129,224,210,501,60.215053763440864,56.451612903225815
21200_marine,410,151,254,229,561,61.951219512195124,55.85365853658537
21201_marine,401,148,247,228,549,61.59600997506235,56.85785536159601
21202_marine,340,92,210,192,432,61.76470588235294,56.470588235294116
21203_marine,91,38,88,5,129,96.7032967032967,5.4945054945054945
21204_marine,88,37,85,6,125,96.5909090909091,6.8181818181818175
21205_marine,87,38,83,4,125,95.40229885057471,4.597701149425287
21206_marine,87,38,83,4,125,95.40229885057471,4.597701149425287
21207_marine,87,36,83,4,123,95.40229885057471,4.597701149425287
21208_marine,87,36,83,4,123,95.40229885057471,4.597701149425287
21209_marine,87,36,83,4,123,95.40229885057471,4.597701149425287
21210_marine,87,36,83,4,123,95.40229885057471,4.597701149425287
21211_marine,85,34,81,4,119,95.29411764705881,4.705882352941177
21212_marine,85,34,81,4,119,95.29411764705881,4.705882352941177
21213_marine,84,34,80,4,118,95.23809523809523,4.761904761904762
21214_marine,82,34,78,4,116,95.1219512195122,4.878048780487805
21215_marine,82,34,78,4,116,95.1219512195122,4.878048780487805
21216_marine,82,35,78,4,117,95.1219512195122,4.878048780487805
21217_marine,81,35,77,4,116,95.06172839506173,4.938271604938271
21218_marine,80,35,76,4,115,95,5
21219_marine,80,34,76,4,114,95,5
21220_marine,80,33,76,4,113,95,5
21221_marine,79,34,75,4,113,94.9367088607595,5.063291139240507
21222_marine,79,34,75,4,113,94.9367088607595,5.063291139240507
21223_marine,79,34,75,4,113,94.9367088607595,5.063291139240507
21224_marine,77,34,73,4,111,94.8051948051948,5.194805194805195
21225_marine,76,35,72,3,111,94.73684210526315,3.9473684210526314
21226_marine,76,36,72,3,112,94.73684210526315,3.9473684210526314
21227_marine,77,37,73,3,114,94.8051948051948,3.896103896103896
21228_marine,77,37,73,3,114,94.8051948051948,3.896103896103896
21229_marine,76,37,73,2,113,96.05263157894737,2.631578947368421
21230_marine,76,37,73,2,113,96.05263157894737,2.631578947368421
21231_marine,74,37,71,2,111,95.94594594594594,2.7027027027027026
21232_marine,72,37,69,2,109,95.83333333333334,2.7777777777777777
21233_marine,72,37,69,2,109,95.83333333333334,2.7777777777777777
21234_marine,72,39,69,2,111,95.83333333333334,2.7777777777777777
21235_marine,74,37,71,4,111,95.94594594594594,5.405405405405405
21236_marine,76,36,73,4,112,96.05263157894737,5.263157894736842
21237_marine,76,36,73,4,112,96.05263157894737,5.263157894736842
21238_marine,75,36,72,3,111,96,4
21239_marine,75,35,72,3,110,96,4
21240_marine,75,34,72,3,109,96,4
21241_marine,78,36,75,4,114,96.15384615384616,5.128205128205128
21242_marine,77,36,74,4,113,96.1038961038961,5.194805194805195
21243_marine,78,35,75,3,113,96.15384615384616,3.8461538461538463
21244_marine,78,35,75,3,113,96.15384615384616,3.8461538461538463
21245_marine,78,34,75,3,112,96.15384615384616,3.8461538461538463
21246_marine,78,34,75,3,112,96.15384615384616,3.8461538461538463
21247_marine,80,35,77,3,115,96.25,3.75
21248_marine,81,34,78,5,115,96.29629629629629,6.172839506172839
21249_marine,81,33,78,5,114,96.29629629629629,6.172839506172839
21250_marine,81,33,78,5,114,96.29629629629629,6.172839506172839
21251_marine,79,33,76,5,112,96.20253164556962,6.329113924050633
21252_marine,79,34,76,5,113,96.20253164556962,6.329113924050633
21253_marine,77,35,74,5,112,96.1038961038961,6.493506493506493
21254_marine,75,35,72,5,110,96,6.666666666666667
21255_marine,74,34,71,4,108,95.94594594594594,5.405405405405405
21256_marine,74,34,71,4,108,95.94594594594594,5.405405405405405
21257_marine,74,33,71,4,107,95.94594594594594,5.405405405405405
21258_marine,76,33,73,4,109,96.05263157894737,5.263157894736842
21259_marine,76,33,73,4,109,96.05263157894737,5.263157894736842
21260_marine,76,34,73,4,110,96.05263157894737,5.263157894736842
21261_marine,76,34,73,4,110,96.05263157894737,5.263157894736842
21262_marine,76,32,73,4,108,96.05263157894737,5.263157894736842
21263_marine,76,32,73,4,108,96.05263157894737,5.263157894736842
21264_marine,75,32,72,3,107,96,4
21265_marine,75,32,72,3,107,96,4
21266_marine,75,32,72,3,107,96,4
21267_marine,75,31,72,3,106,96,4
21268_marine,75,31,72,3,106,96,4
21269_marine,75,31,72,3,106,96,4
21270_marine,73,30,70,3,103,95.8904109589041,4.10958904109589
21271_marine,73,30,70,3,103,95.8904109589041,4.10958904109589
21272_marine,71,30,68,3,101,95.77464788732394,4.225352112676056
21273_marine,69,30,66,3,99,95.65217391304348,4.3478260869565215
21274_marine,69,30,66,3,99,95.65217391304348,4.3478260869565215
21275_marine,69,30,66,3,99,95.65217391304348,4.3478260869565215
21276_marine,69,30,66,3,99,95.65217391304348,4.3478260869565215
21277_marine,73,30,70,3,103,95.8904109589041,4.10958904109589
21278_marine,72,30,69,3,102,95.83333333333334,4.166666666666666
21279_marine,72,30,69,3,102,95.83333333333334,4.166666666666666
21280_marine,72,30,69,3,102,95.83333333333334,4.166666666666666
21281_marine,72,30,69,3,102,95.83333333333334,4.166666666666666
21282_marine,72,30,69,3,102,95.83333333333334,4.166666666666666
21283_marine,72,32,69,3,104,95.83333333333334,4.166666666666666
21284_marine,72,32,69,3,104,95.83333333333334,4.166666666666666
21285_marine,72,32,69,3,104,95.83333333333334,4.166666666666666
21286_marine,72,32,69,3,104,95.83333333333334,4.166666666666666
21287_marine,72,32,69,3,104,95.83333333333334,4.166666666666666
21288_marine,74,29,71,3,103,95.94594594594594,4.054054054054054
21289_marine,72,29,69,3,101,95.83333333333334,4.166666666666666
21290_marine,72,30,69,3,102,95.83333333333334,4.166666666666666
21291_marine,75,30,71,3,105,94.66666666666667,4
21292_marine,77,31,73,4,108,94.8051948051948,5.194805194805195
21293_marine,76,31,72,4,107,94.73684210526315,5.263157894736842
21294_marine,78,30,74,4,108,94.87179487179486,5.128205128205128
21295_marine,77,31,73,2,108,94.8051948051948,2.5974025974025974
21296_marine,77,31,73,2,108,94.8051948051948,2.5974025974025974
21297_marine,85,31,81,2,116,95.29411764705881,2.3529411764705883
21298_marine,87,36,83,2,123,95.40229885057471,2.2988505747126435
21299_marine,95,37,90,3,132,94.73684210526315,3.1578947368421053
21300_marine,105,43,99,7,148,94.28571428571428,6.666666666666667
21301_marine,113,48,106,11,161,93.80530973451327,9.734513274336283
21302_marine,135,78,126,19,213,93.33333333333333,14.074074074074074
21303_marine,238,156,210,44,394,88.23529411764706,18.487394957983195
21306_marine,432,405,273,211,837,63.19444444444444,48.842592592592595
21340_marine,331,204,271,98,535,81.87311178247734,29.607250755287005
21341_marine,312,194,262,87,506,83.97435897435898,27.884615384615387
21342_marine,118,62,109,10,180,92.37288135593221,8.47457627118644
21343_marine,112,58,101,8,170,90.17857142857143,7.142857142857142
21344_marine,105,51,94,8,156,89.52380952380953,7.6190476190476195
21345_marine,96,41,85,8,137,88.54166666666666,8.333333333333332
21346_marine,95,39,84,8,134,88.42105263157895,8.421052631578947
21347_marine,93,39,83,6,132,89.24731182795699,6.451612903225806
21348_marine,86,39,78,5,125,90.69767441860465,5.813953488372093
21349_marine,83,37,76,4,120,91.56626506024097,4.819277108433735
21350_marine,84,37,77,4,121,91.66666666666666,4.761904761904762
21351_marine,82,35,75,4,117,91.46341463414635,4.878048780487805
21352_marine,83,35,75,4,118,90.36144578313254,4.819277108433735
21353_marine,83,35,75,4,118,90.36144578313254,4.819277108433735
21354_marine,83,35,75,4,118,90.36144578313254,4.819277108433735
21355_marine,82,37,74,4,119,90.2439024390244,4.878048780487805
21356_marine,83,37,75,5,120,90.36144578313254,6.024096385542169
21357_marine,82,37,74,5,119,90.2439024390244,6.097560975609756
21358_marine,82,33,74,5,115,90.2439024390244,6.097560975609756
21359_marine,82,33,74,5,115,90.2439024390244,6.097560975609756
21360_marine,80,33,72,5,113,90,6.25
21361_marine,77,33,70,5,110,90.9090909090909,6.493506493506493
21362_marine,81,33,74,5,114,91.35802469135803,6.172839506172839
21363_marine,81,33,74,5,114,91.35802469135803,6.172839506172839
21364_marine,79,33,74,2,112,93.67088607594937,2.5316455696202533
21365_marine,77,33,72,2,110,93.5064935064935,2.5974025974025974
21366_marine,77,33,72,2,110,93.5064935064935,2.5974025974025974
21367_marine,77,33,72,2,110,93.5064935064935,2.5974025974025974
21368_marine,77,33,72,2,110,93.5064935064935,2.5974025974025974
21369_marine,77,31,72,2,108,93.5064935064935,2.5974025974025974
21370_marine,77,29,72,2,106,93.5064935064935,2.5974025974025974
21371_marine,77,29,72,2,106,93.5064935064935,2.5974025974025974
21372_marine,78,29,73,2,107,93.58974358974359,2.564102564102564
21373_marine,79,28,73,3,107,92.40506329113924,3.79746835443038
21374_marine,81,28,73,3,109,90.12345679012346,3.7037037037037033
21375_marine,81,28,73,3,109,90.12345679012346,3.7037037037037033
21376_marine,82,28,74,3,110,90.2439024390244,3.6585365853658534
21377_marine,82,28,74,3,110,90.2439024390244,3.6585365853658534
21378_marine,84,32,76,3,116,90.47619047619048,3.571428571428571
21379_marine,84,31,76,3,115,90.47619047619048,3.571428571428571
21380_marine,85,31,78,2,116,91.76470588235294,2.3529411764705883
21381_marine,81,27,74,2,108,91.35802469135803,2.4691358024691357
21382_marine,80,27,74,0,107,92.5,0
21383_marine,80,27,74,0,107,92.5,0
21384_marine,78,27,72,0,105,92.3076923076923,0
21385_marine,78,25,72,0,103,92.3076923076923,0
21386_marine,80,24,74,1,104,92.5,1.25
21387_marine,80,24,74,1,104,92.5,1.25
21388_marine,80,24,74,1,104,92.5,1.25
21389_marine,80,24,74,1,104,92.5,1.25
21390_marine,78,25,72,1,103,92.3076923076923,1.282051282051282
21391_marine,81,25,74,3,106,91.35802469135803,3.7037037037037033
21392_marine,81,31,74,3,112,91.35802469135803,3.7037037037037033
21393_marine,81,25,74,3,106,91.35802469135803,3.7037037037037033
21394_marine,83,25,76,3,108,91.56626506024097,3.614457831325301
21395_marine,84,25,76,3,109,90.47619047619048,3.571428571428571
21396_marine,84,25,76,3,109,90.47619047619048,3.571428571428571
21397_marine,86,27,78,3,113,90.69767441860465,3.488372093023256
21398_marine,88,27,80,4,115,90.9090909090909,4.545454545454546
21399_marine,88,29,80,4,117,90.9090909090909,4.545454545454546
21400_marine,91,31,82,7,122,90.10989010989012,7.6923076923076925
21401_marine,101,35,92,7,136,91.0891089108911,6.9306930693069315
21402_marine,106,38,96,7,144,90.56603773584906,6.60377358490566
21403_marine,111,42,101,7,153,90.990990990991,6.306306306306306
21404_marine,253,124,234,28,377,92.4901185770751,11.067193675889328
21405_marine,273,131,249,42,404,91.20879120879121,15.384615384615385
21406_marine,254,107,234,26,361,92.1259842519685,10.236220472440944
21407_marine,262,125,242,26,387,92.36641221374046,9.923664122137405
21408_marine,266,125,244,28,391,91.72932330827066,10.526315789473683
21409_marine,127,75,116,11,202,91.33858267716536,8.661417322834646
21410_marine,283,128,263,29,411,92.93286219081273,10.247349823321555
21438_marine,329,126,276,80,455,83.89057750759878,24.316109422492403
21439_marine,339,144,278,84,483,82.00589970501476,24.778761061946902
21440_marine,340,147,279,85,487,82.05882352941177,25
21441_marine,241,83,219,25,324,90.87136929460581,10.37344398340249
21450_marine,224,67,204,27,291,91.07142857142857,12.053571428571429
21468_marine,429,183,308,206,612,71.7948717948718,48.01864801864802
21544_marine,319,128,282,73,447,88.40125391849529,22.884012539184955
21545_marine,286,119,251,66,405,87.76223776223776,23.076923076923077
21546_marine,292,122,252,69,414,86.3013698630137,23.63013698630137
21547_marine,290,112,250,71,402,86.20689655172413,24.482758620689655
21548_marine,303,122,261,74,425,86.13861386138613,24.422442244224424
21549_marine,838,282,539,445,1120,64.31980906921241,53.10262529832935
21550_marine,937,377,620,504,1314,66.16862326574173,53.788687299893276
21553_marine,715,247,486,362,962,67.97202797202797,50.62937062937063
21554_marine,128,45,124,10,173,96.875,7.8125
21555_marine,123,40,120,6,163,97.5609756097561,4.878048780487805
21556_marine,115,41,112,6,156,97.3913043478261,5.217391304347826
21557_marine,110,37,107,6,147,97.27272727272728,5.454545454545454
21558_marine,101,38,98,5,139,97.02970297029702,4.9504950495049505
21559_marine,101,53,98,5,154,97.02970297029702,4.9504950495049505
21560_marine,348,115,214,195,463,61.49425287356321,56.03448275862068
21561_marine,369,118,230,207,487,62.33062330623306,56.09756097560976
21562_marine,340,91,210,194,431,61.76470588235294,57.05882352941176
21563_marine,91,37,88,7,128,96.7032967032967,7.6923076923076925
21564_marine,90,36,86,8,126,95.55555555555556,8.88888888888889
21565_marine,87,37,83,4,124,95.40229885057471,4.597701149425287
21566_marine,89,36,85,5,125,95.50561797752809,5.617977528089887
21567_marine,89,37,85,5,126,95.50561797752809,5.617977528089887
21568_marine,88,37,84,4,125,95.45454545454545,4.545454545454546
21569_marine,88,37,84,4,125,95.45454545454545,4.545454545454546
21570_marine,88,37,84,4,125,95.45454545454545,4.545454545454546
21571_marine,88,36,84,4,124,95.45454545454545,4.545454545454546
21572_marine,88,36,84,4,124,95.45454545454545,4.545454545454546
21573_marine,88,36,84,4,124,95.45454545454545,4.545454545454546
21574_marine,85,36,81,4,121,95.29411764705881,4.705882352941177
21575_marine,85,36,81,4,121,95.29411764705881,4.705882352941177
21576_marine,83,37,79,4,120,95.18072289156626,4.819277108433735
21577_marine,82,37,78,4,119,95.1219512195122,4.878048780487805
21578_marine,83,36,79,4,119,95.18072289156626,4.819277108433735
21579_marine,83,34,79,4,117,95.18072289156626,4.819277108433735
21580_marine,82,35,78,5,117,95.1219512195122,6.097560975609756
21581_marine,82,35,78,5,117,95.1219512195122,6.097560975609756
21582_marine,81,35,77,5,116,95.06172839506173,6.172839506172839
21583_marine,81,35,77,5,116,95.06172839506173,6.172839506172839
21584_marine,81,35,77,5,116,95.06172839506173,6.172839506172839
21585_marine,81,36,77,5,117,95.06172839506173,6.172839506172839
21586_marine,82,36,78,5,118,95.1219512195122,6.097560975609756
21587_marine,82,37,78,5,119,95.1219512195122,6.097560975609756
21588_marine,82,37,78,5,119,95.1219512195122,6.097560975609756
21589_marine,82,36,78,5,118,95.1219512195122,6.097560975609756
21590_marine,78,36,74,3,114,94.87179487179486,3.8461538461538463
21591_marine,78,36,74,3,114,94.87179487179486,3.8461538461538463
21592_marine,78,36,74,3,114,94.87179487179486,3.8461538461538463
21593_marine,78,36,74,3,114,94.87179487179486,3.8461538461538463
21594_marine,76,36,72,3,112,94.73684210526315,3.9473684210526314
21595_marine,76,35,72,3,111,94.73684210526315,3.9473684210526314
21596_marine,76,35,72,3,111,94.73684210526315,3.9473684210526314
21597_marine,78,35,74,5,113,94.87179487179486,6.41025641025641
21598_marine,78,36,74,5,114,94.87179487179486,6.41025641025641
21599_marine,78,37,74,5,115,94.87179487179486,6.41025641025641
21600_marine,76,37,73,3,113,96.05263157894737,3.9473684210526314
21601_marine,254,80,182,143,334,71.65354330708661,56.2992125984252
21602_marine,253,80,181,143,333,71.54150197628458,56.52173913043478
21603_marine,255,82,183,143,337,71.76470588235294,56.07843137254902
21604_marine,255,81,183,143,336,71.76470588235294,56.07843137254902
21605_marine,83,42,78,6,125,93.97590361445783,7.228915662650602
21606_marine,83,39,78,6,122,93.97590361445783,7.228915662650602
21607_marine,85,39,80,6,124,94.11764705882352,7.0588235294117645
21608_marine,85,37,80,6,122,94.11764705882352,7.0588235294117645
21609_marine,87,37,82,8,124,94.25287356321839,9.195402298850574
21610_marine,87,36,82,8,123,94.25287356321839,9.195402298850574
21611_marine,86,36,81,7,122,94.18604651162791,8.13953488372093
21612_marine,86,34,81,7,120,94.18604651162791,8.13953488372093
21613_marine,84,33,79,7,117,94.04761904761905,8.333333333333332
21614_marine,83,35,79,6,118,95.18072289156626,7.228915662650602
21615_marine,81,36,77,6,117,95.06172839506173,7.4074074074074066
21616_marine,78,36,74,6,114,94.87179487179486,7.6923076923076925
21617_marine,77,36,74,5,113,96.1038961038961,6.493506493506493
21618_marine,78,36,75,4,114,96.15384615384616,5.128205128205128
21619_marine,80,36,77,4,116,96.25,5
21620_marine,80,35,77,4,115,96.25,5
21621_marine,80,34,77,4,114,96.25,5
21622_marine,80,34,77,4,114,96.25,5
21623_marine,80,34,77,4,114,96.25,5
21624_marine,80,32,77,4,112,96.25,5
21625_marine,80,32,77,4,112,96.25,5
21626_marine,80,32,77,4,112,96.25,5
21627_marine,79,32,76,3,111,96.20253164556962,3.79746835443038
21628_marine,79,31,76,3,110,96.20253164556962,3.79746835443038
21629_marine,79,31,76,3,110,96.20253164556962,3.79746835443038
21630_marine,79,30,76,3,109,96.20253164556962,3.79746835443038
21631_marine,81,30,78,3,111,96.29629629629629,3.7037037037037033
21632_marine,81,30,78,3,111,96.29629629629629,3.7037037037037033
21633_marine,79,30,76,3,109,96.20253164556962,3.79746835443038
21634_marine,77,30,74,3,107,96.1038961038961,3.896103896103896
21635_marine,77,30,74,3,107,96.1038961038961,3.896103896103896
21636_marine,75,30,72,3,105,96,4
21637_marine,75,30,72,3,105,96,4
21638_marine,74,30,71,3,104,95.94594594594594,4.054054054054054
21639_marine,74,32,71,3,106,95.94594594594594,4.054054054054054
21640_marine,72,32,69,3,104,95.83333333333334,4.166666666666666
21641_marine,72,32,69,3,104,95.83333333333334,4.166666666666666
21642_marine,72,32,69,3,104,95.83333333333334,4.166666666666666
21643_marine,72,32,69,3,104,95.83333333333334,4.166666666666666
21644_marine,72,32,69,3,104,95.83333333333334,4.166666666666666
21645_marine,72,32,69,3,104,95.83333333333334,4.166666666666666
21646_marine,72,32,69,3,104,95.83333333333334,4.166666666666666
21647_marine,72,33,69,3,105,95.83333333333334,4.166666666666666
21648_marine,72,33,69,3,105,95.83333333333334,4.166666666666666
21649_marine,74,32,71,3,106,95.94594594594594,4.054054054054054
21650_marine,73,32,69,3,105,94.52054794520548,4.10958904109589
21651_marine,75,33,70,4,108,93.33333333333333,5.333333333333334
21652_marine,77,31,72,4,108,93.5064935064935,5.194805194805195
21653_marine,75,30,71,3,105,94.66666666666667,4
21654_marine,75,29,71,4,104,94.66666666666667,5.333333333333334
21655_marine,77,28,73,2,105,94.8051948051948,2.5974025974025974
21656_marine,77,30,73,2,107,94.8051948051948,2.5974025974025974
21657_marine,81,31,77,2,112,95.06172839506173,2.4691358024691357
21658_marine,87,36,83,2,123,95.40229885057471,2.2988505747126435
21659_marine,92,36,88,2,128,95.65217391304348,2.1739130434782608
21660_marine,100,43,95,6,143,95,6
21661_marine,122,64,114,14,186,93.44262295081968,11.475409836065573
21662_marine,166,81,141,45,247,84.93975903614458,27.10843373493976
21663_marine,137,80,128,19,217,93.43065693430657,13.86861313868613
21664_marine,252,163,216,53,415,85.71428571428571,21.03174603174603
21667_marine,454,422,293,217,876,64.53744493392071,47.797356828193834
21693_marine,315,242,250,91,557,79.36507936507937,28.888888888888886
21694_marine,316,233,249,97,549,78.79746835443038,30.69620253164557
21701_marine,329,211,262,101,540,79.63525835866263,30.69908814589666
21702_marine,114,70,105,10,184,92.10526315789474,8.771929824561402
21703_marine,110,59,99,10,169,90,9.090909090909092
21704_marine,105,55,94,8,160,89.52380952380953,7.6190476190476195
21705_marine,95,41,84,8,136,88.42105263157895,8.421052631578947
21706_marine,90,41,80,7,131,88.88888888888889,7.777777777777778
21707_marine,87,42,77,5,129,88.50574712643679,5.747126436781609
21708_marine,84,40,76,5,124,90.47619047619048,5.952380952380952
21709_marine,84,37,77,4,121,91.66666666666666,4.761904761904762
21710_marine,84,37,77,4,121,91.66666666666666,4.761904761904762
21711_marine,82,35,75,4,117,91.46341463414635,4.878048780487805
21712_marine,83,35,75,4,118,90.36144578313254,4.819277108433735
21713_marine,83,35,75,4,118,90.36144578313254,4.819277108433735
21714_marine,83,35,75,4,118,90.36144578313254,4.819277108433735
21715_marine,82,33,74,4,115,90.2439024390244,4.878048780487805
21716_marine,80,33,72,4,113,90,5
21717_marine,80,33,72,5,113,90,6.25
21718_marine,80,33,72,5,113,90,6.25
21719_marine,80,33,72,5,113,90,6.25
21720_marine,80,33,72,5,113,90,6.25
21721_marine,78,33,70,5,111,89.74358974358975,6.41025641025641
21722_marine,77,31,69,4,108,89.6103896103896,5.194805194805195
21723_marine,79,31,71,4,110,89.87341772151899,5.063291139240507
21724_marine,79,31,71,4,110,89.87341772151899,5.063291139240507
21725_marine,77,31,71,2,108,92.20779220779221,2.5974025974025974
21726_marine,78,31,72,2,109,92.3076923076923,2.564102564102564
21727_marine,74,31,68,2,105,91.8918918918919,2.7027027027027026
21728_marine,74,31,68,2,105,91.8918918918919,2.7027027027027026
21729_marine,78,31,72,2,109,92.3076923076923,2.564102564102564
21730_marine,79,31,73,2,110,92.40506329113924,2.5316455696202533
21731_marine,78,31,72,2,109,92.3076923076923,2.564102564102564
21732_marine,79,30,73,2,109,92.40506329113924,2.5316455696202533
21733_marine,77,30,71,2,107,92.20779220779221,2.5974025974025974
21734_marine,78,30,71,3,108,91.02564102564102,3.8461538461538463
21735_marine,80,30,71,3,110,88.75,3.75
21736_marine,80,30,71,3,110,88.75,3.75
21737_marine,81,31,72,3,112,88.88888888888889,3.7037037037037033
21738_marine,83,33,74,3,116,89.1566265060241,3.614457831325301
21739_marine,81,28,72,3,109,88.88888888888889,3.7037037037037033
21740_marine,82,28,74,2,110,90.2439024390244,2.4390243902439024
21741_marine,77,28,71,0,105,92.20779220779221,0
21742_marine,78,28,72,0,106,92.3076923076923,0
21743_marine,78,28,72,0,106,92.3076923076923,0
21744_marine,78,28,72,0,106,92.3076923076923,0
21745_marine,78,28,72,0,106,92.3076923076923,0
21746_marine,79,28,73,0,107,92.40506329113924,0
21747_marine,78,28,72,1,106,92.3076923076923,1.282051282051282
21748_marine,78,28,72,1,106,92.3076923076923,1.282051282051282
21749_marine,78,28,72,1,106,92.3076923076923,1.282051282051282
21750_marine,76,27,70,1,103,92.10526315789474,1.3157894736842104
21751_marine,77,33,71,1,110,92.20779220779221,1.2987012987012987
21752_marine,79,33,72,3,112,91.13924050632912,3.79746835443038
21753_marine,80,27,72,3,107,90,3.75
21754_marine,82,27,74,3,109,90.2439024390244,3.6585365853658534
21755_marine,81,27,73,3,108,90.12345679012346,3.7037037037037033
21756_marine,85,27,77,3,112,90.58823529411765,3.5294117647058822
21757_marine,85,27,77,3,112,90.58823529411765,3.5294117647058822
21758_marine,86,27,78,4,113,90.69767441860465,4.651162790697675
21759_marine,87,31,78,5,118,89.65517241379311,5.747126436781609
21760_marine,95,33,86,7,128,90.52631578947368,7.368421052631578
21761_marine,103,39,94,7,142,91.2621359223301,6.796116504854369
21762_marine,252,90,232,25,342,92.06349206349206,9.920634920634921
21763_marine,258,108,238,25,366,92.24806201550388,9.689922480620156
21764_marine,263,110,243,26,373,92.39543726235742,9.885931558935361
21765_marine,261,108,241,26,369,92.33716475095785,9.961685823754788
21766_marine,263,114,243,26,377,92.39543726235742,9.885931558935361
21767_marine,353,162,310,86,515,87.81869688385268,24.362606232294617
21768_marine,302,149,280,33,451,92.71523178807946,10.927152317880795
21769_marine,281,142,263,30,423,93.59430604982207,10.676156583629894
21813_marine,745,329,492,420,1074,66.04026845637584,56.375838926174495
21814_marine,535,226,365,265,761,68.22429906542055,49.532710280373834
21815_marine,689,331,436,379,1020,63.28011611030478,55.00725689404935
21828_marine,458,212,330,225,670,72.0524017467249,49.12663755458515
21904_marine,348,139,307,78,487,88.2183908045977,22.413793103448278
21905_marine,307,125,269,71,432,87.62214983713355,23.12703583061889
21906_marine,289,121,253,71,410,87.5432525951557,24.567474048442904
21907_marine,283,121,245,71,404,86.57243816254417,25.08833922261484
21908_marine,294,140,252,74,434,85.71428571428571,25.170068027210885
21909_marine,937,353,574,532,1290,61.259338313767344,56.77694770544291
21910_marine,1090,463,694,600,1553,63.6697247706422,55.04587155963303
21911_marine,984,383,622,530,1367,63.21138211382114,53.86178861788618
21912_marine,748,274,484,403,1022,64.70588235294117,53.87700534759359
21913_marine,145,64,138,16,209,95.17241379310344,11.03448275862069
21914_marine,116,38,113,7,154,97.41379310344827,6.0344827586206895
21915_marine,103,34,100,5,137,97.0873786407767,4.854368932038835
21916_marine,96,35,93,4,131,96.875,4.166666666666666
21917_marine,93,35,90,4,128,96.7741935483871,4.301075268817205
21918_marine,90,36,87,4,126,96.66666666666667,4.444444444444445
21919_marine,90,38,87,4,128,96.66666666666667,4.444444444444445
21920_marine,342,90,210,194,432,61.40350877192983,56.72514619883041
21921_marine,358,109,224,203,467,62.56983240223464,56.70391061452514
21922_marine,343,92,213,196,435,62.09912536443149,57.14285714285714
21923_marine,95,38,92,10,133,96.84210526315789,10.526315789473683
21924_marine,96,38,92,11,134,95.83333333333334,11.458333333333332
21925_marine,96,38,92,12,134,95.83333333333334,12.5
21926_marine,91,36,87,7,127,95.6043956043956,7.6923076923076925
21927_marine,89,37,85,5,126,95.50561797752809,5.617977528089887
21928_marine,90,37,86,6,127,95.55555555555556,6.666666666666667
21929_marine,90,37,86,6,127,95.55555555555556,6.666666666666667
21930_marine,90,37,86,6,127,95.55555555555556,6.666666666666667
21931_marine,90,36,86,6,126,95.55555555555556,6.666666666666667
21932_marine,90,36,86,6,126,95.55555555555556,6.666666666666667
21933_marine,90,36,86,6,126,95.55555555555556,6.666666666666667
21934_marine,90,36,86,6,126,95.55555555555556,6.666666666666667
21935_marine,89,36,85,6,125,95.50561797752809,6.741573033707865
21936_marine,89,37,85,6,126,95.50561797752809,6.741573033707865
21937_marine,88,36,84,6,124,95.45454545454545,6.8181818181818175
21938_marine,87,36,83,6,123,95.40229885057471,6.896551724137931
21939_marine,85,37,81,6,122,95.29411764705881,7.0588235294117645
21940_marine,85,37,81,6,122,95.29411764705881,7.0588235294117645
21941_marine,85,37,81,6,122,95.29411764705881,7.0588235294117645
21942_marine,83,35,79,6,118,95.18072289156626,7.228915662650602
21943_marine,82,35,78,5,117,95.1219512195122,6.097560975609756
21944_marine,81,35,77,5,116,95.06172839506173,6.172839506172839
21945_marine,82,36,78,5,118,95.1219512195122,6.097560975609756
21946_marine,82,36,78,5,118,95.1219512195122,6.097560975609756
21947_marine,82,37,78,5,119,95.1219512195122,6.097560975609756
21948_marine,82,37,78,5,119,95.1219512195122,6.097560975609756
21949_marine,82,37,78,5,119,95.1219512195122,6.097560975609756
21950_marine,82,37,78,5,119,95.1219512195122,6.097560975609756
21951_marine,82,37,78,5,119,95.1219512195122,6.097560975609756
21952_marine,82,37,78,5,119,95.1219512195122,6.097560975609756
21953_marine,82,37,78,5,119,95.1219512195122,6.097560975609756
21954_marine,82,36,78,5,118,95.1219512195122,6.097560975609756
21955_marine,81,36,77,4,117,95.06172839506173,4.938271604938271
21956_marine,79,36,75,4,115,94.9367088607595,5.063291139240507
21957_marine,79,36,75,4,115,94.9367088607595,5.063291139240507
21958_marine,79,37,75,4,116,94.9367088607595,5.063291139240507
21959_marine,79,37,75,4,116,94.9367088607595,5.063291139240507
21960_marine,80,37,75,5,117,93.75,6.25
21961_marine,255,85,183,144,340,71.76470588235294,56.470588235294116
21962_marine,287,92,211,161,379,73.5191637630662,56.09756097560976
21963_marine,304,95,223,175,399,73.35526315789474,57.56578947368421
21964_marine,259,87,187,144,346,72.2007722007722,55.5984555984556
21965_marine,94,49,87,14,143,92.5531914893617,14.893617021276595
21966_marine,86,43,81,8,129,94.18604651162791,9.30232558139535
21967_marine,87,39,82,8,126,94.25287356321839,9.195402298850574
21968_marine,87,39,82,8,126,94.25287356321839,9.195402298850574
21969_marine,87,37,82,8,124,94.25287356321839,9.195402298850574
21970_marine,87,37,82,8,124,94.25287356321839,9.195402298850574
21971_marine,87,37,82,8,124,94.25287356321839,9.195402298850574
21972_marine,87,37,82,8,124,94.25287356321839,9.195402298850574
21973_marine,87,37,82,8,124,94.25287356321839,9.195402298850574
21974_marine,87,37,82,8,124,94.25287356321839,9.195402298850574
21975_marine,89,37,84,8,126,94.3820224719101,8.98876404494382
21976_marine,91,37,86,8,128,94.5054945054945,8.791208791208792
21977_marine,89,37,84,8,126,94.3820224719101,8.98876404494382
21978_marine,86,37,81,7,123,94.18604651162791,8.13953488372093
21979_marine,86,37,81,7,123,94.18604651162791,8.13953488372093
21980_marine,86,38,81,7,124,94.18604651162791,8.13953488372093
21981_marine,85,37,80,6,122,94.11764705882352,7.0588235294117645
21982_marine,84,37,80,5,121,95.23809523809523,5.952380952380952
21983_marine,84,37,80,5,121,95.23809523809523,5.952380952380952
21984_marine,83,36,79,5,119,95.18072289156626,6.024096385542169
21985_marine,85,36,81,5,121,95.29411764705881,5.88235294117647
21986_marine,85,37,81,5,122,95.29411764705881,5.88235294117647
21987_marine,85,37,81,5,122,95.29411764705881,5.88235294117647
21988_marine,83,35,79,5,118,95.18072289156626,6.024096385542169
21989_marine,82,33,78,4,115,95.1219512195122,4.878048780487805
21990_marine,82,33,78,4,115,95.1219512195122,4.878048780487805
21991_marine,82,32,78,4,114,95.1219512195122,4.878048780487805
21992_marine,82,31,78,4,113,95.1219512195122,4.878048780487805
21993_marine,82,31,78,4,113,95.1219512195122,4.878048780487805
21994_marine,80,31,76,4,111,95,5
21995_marine,80,33,76,4,113,95,5
21996_marine,78,33,74,4,111,94.87179487179486,5.128205128205128
21997_marine,78,33,74,4,111,94.87179487179486,5.128205128205128
21998_marine,77,33,73,4,110,94.8051948051948,5.194805194805195
21999_marine,75,33,71,4,108,94.66666666666667,5.333333333333334
22000_marine,75,33,71,4,108,94.66666666666667,5.333333333333334
22001_marine,75,33,71,4,108,94.66666666666667,5.333333333333334
22002_marine,75,33,71,4,108,94.66666666666667,5.333333333333334
22003_marine,75,34,71,4,109,94.66666666666667,5.333333333333334
22004_marine,75,34,71,4,109,94.66666666666667,5.333333333333334
22005_marine,75,34,71,4,109,94.66666666666667,5.333333333333334
22006_marine,75,34,71,4,109,94.66666666666667,5.333333333333334
22007_marine,75,34,71,4,109,94.66666666666667,5.333333333333334
22008_marine,75,34,71,4,109,94.66666666666667,5.333333333333334
22009_marine,75,33,71,4,108,94.66666666666667,5.333333333333334
22010_marine,78,33,74,4,111,94.87179487179486,5.128205128205128
22011_marine,79,33,74,4,112,93.67088607594937,5.063291139240507
22012_marine,78,34,73,4,112,93.58974358974359,5.128205128205128
22013_marine,76,33,71,4,109,93.42105263157895,5.263157894736842
22014_marine,76,35,71,2,111,93.42105263157895,2.631578947368421
22015_marine,78,31,73,3,109,93.58974358974359,3.8461538461538463
22016_marine,78,30,73,3,108,93.58974358974359,3.8461538461538463
22017_marine,80,29,75,3,109,93.75,3.75
22018_marine,85,34,80,3,119,94.11764705882352,3.5294117647058822
22019_marine,86,40,81,3,126,94.18604651162791,3.488372093023256
22020_marine,95,42,89,5,137,93.6842105263158,5.263157894736842
22021_marine,114,63,105,12,177,92.10526315789474,10.526315789473683
22022_marine,155,82,132,41,237,85.16129032258064,26.451612903225808
22023_marine,132,70,123,18,202,93.18181818181817,13.636363636363635
22024_marine,248,157,214,51,405,86.29032258064517,20.56451612903226
22025_marine,303,229,235,98,532,77.55775577557755,32.34323432343234
22027_marine,435,410,279,200,845,64.13793103448275,45.97701149425287
22046_marine,308,178,241,100,486,78.24675324675324,32.467532467532465
22047_marine,314,182,246,101,496,78.343949044586,32.1656050955414
22048_marine,310,185,243,97,495,78.38709677419354,31.290322580645164
22049_marine,310,200,241,98,510,77.74193548387098,31.61290322580645
22050_marine,299,223,232,90,522,77.59197324414716,30.100334448160538
22052_marine,294,223,229,86,517,77.89115646258503,29.25170068027211
22053_marine,117,81,107,14,198,91.45299145299145,11.965811965811966
22054_marine,121,105,112,15,226,92.56198347107438,12.396694214876034
22055_marine,320,221,254,100,541,79.375,31.25
22056_marine,336,208,266,104,544,79.16666666666666,30.952380952380953
22057_marine,344,183,270,111,527,78.48837209302324,32.26744186046512
22061_marine,379,265,297,120,644,78.3641160949868,31.6622691292876
22062_marine,318,233,230,121,551,72.32704402515722,38.05031446540881
22063_marine,307,214,218,121,521,71.00977198697068,39.413680781758956
22064_marine,98,53,87,10,151,88.77551020408163,10.204081632653061
22065_marine,97,41,86,10,138,88.65979381443299,10.309278350515463
22066_marine,91,41,81,6,132,89.01098901098901,6.593406593406594
22067_marine,88,40,78,5,128,88.63636363636364,5.681818181818182
22068_marine,84,40,76,5,124,90.47619047619048,5.952380952380952
22069_marine,85,36,77,5,121,90.58823529411765,5.88235294117647
22070_marine,84,32,77,4,116,91.66666666666666,4.761904761904762
22071_marine,82,34,75,4,116,91.46341463414635,4.878048780487805
22072_marine,82,33,75,4,115,91.46341463414635,4.878048780487805
22073_marine,83,33,75,4,116,90.36144578313254,4.819277108433735
22074_marine,82,33,74,4,115,90.2439024390244,4.878048780487805
22075_marine,82,33,74,4,115,90.2439024390244,4.878048780487805
22076_marine,82,31,74,4,113,90.2439024390244,4.878048780487805
22077_marine,83,31,75,5,114,90.36144578313254,6.024096385542169
22078_marine,83,31,75,5,114,90.36144578313254,6.024096385542169
22079_marine,83,31,75,5,114,90.36144578313254,6.024096385542169
22080_marine,82,31,74,5,113,90.2439024390244,6.097560975609756
22081_marine,83,31,75,4,114,90.36144578313254,4.819277108433735
22082_marine,81,31,73,4,112,90.12345679012346,4.938271604938271
22083_marine,79,31,71,4,110,89.87341772151899,5.063291139240507
22084_marine,79,31,71,4,110,89.87341772151899,5.063291139240507
22085_marine,81,31,73,4,112,90.12345679012346,4.938271604938271
22086_marine,79,31,73,2,110,92.40506329113924,2.5316455696202533
22087_marine,78,31,72,2,109,92.3076923076923,2.564102564102564
22088_marine,78,31,72,2,109,92.3076923076923,2.564102564102564
22089_marine,76,30,70,2,106,92.10526315789474,2.631578947368421
22090_marine,77,30,71,2,107,92.20779220779221,2.5974025974025974
22091_marine,78,30,72,2,108,92.3076923076923,2.564102564102564
22092_marine,78,29,72,2,107,92.3076923076923,2.564102564102564
22093_marine,79,29,73,2,108,92.40506329113924,2.5316455696202533
22094_marine,79,29,73,2,108,92.40506329113924,2.5316455696202533
22095_marine,79,29,73,2,108,92.40506329113924,2.5316455696202533
22096_marine,79,29,73,2,108,92.40506329113924,2.5316455696202533
22097_marine,82,31,73,3,113,89.02439024390245,3.6585365853658534
22098_marine,81,28,72,3,109,88.88888888888889,3.7037037037037033
22099_marine,82,28,74,2,110,90.2439024390244,2.4390243902439024
22100_marine,80,28,73,0,108,91.25,0
22101_marine,79,28,72,0,107,91.13924050632912,0
22102_marine,79,28,72,0,107,91.13924050632912,0
22103_marine,79,28,72,0,107,91.13924050632912,0
22104_marine,79,28,72,0,107,91.13924050632912,0
22105_marine,78,28,72,0,106,92.3076923076923,0
22106_marine,79,28,73,0,107,92.40506329113924,0
22107_marine,79,28,73,0,107,92.40506329113924,0
22108_marine,80,28,74,1,108,92.5,1.25
22109_marine,80,28,74,1,108,92.5,1.25
22110_marine,79,29,72,1,108,91.13924050632912,1.2658227848101267
22111_marine,80,29,73,1,109,91.25,1.25
22112_marine,80,29,73,2,109,91.25,2.5
22113_marine,81,29,73,3,110,90.12345679012346,3.7037037037037033
22114_marine,83,29,75,3,112,90.36144578313254,3.614457831325301
22115_marine,84,27,76,3,111,90.47619047619048,3.571428571428571
22116_marine,86,27,78,3,113,90.69767441860465,3.488372093023256
22117_marine,86,27,78,3,113,90.69767441860465,3.488372093023256
22118_marine,87,27,79,4,114,90.80459770114942,4.597701149425287
22119_marine,86,29,77,5,115,89.53488372093024,5.813953488372093
22120_marine,102,33,93,7,135,91.17647058823529,6.862745098039216
22121_marine,249,88,230,25,337,92.3694779116466,10.040160642570282
22126_marine,369,170,326,92,539,88.34688346883469,24.932249322493224
22127_marine,395,191,348,103,586,88.10126582278481,26.075949367088608
22128_marine,453,240,373,137,693,82.33995584988962,30.242825607064017
22129_marine,471,221,379,158,692,80.46709129511677,33.54564755838641
22173_marine,653,290,433,345,943,66.3093415007657,52.833078101071976
22174_marine,708,324,462,388,1032,65.2542372881356,54.80225988700565
22175_marine,692,328,452,372,1020,65.3179190751445,53.75722543352601
22176_marine,625,278,410,328,903,65.60000000000001,52.480000000000004
22189_marine,414,202,297,186,616,71.73913043478261,44.927536231884055
22190_marine,257,123,204,71,380,79.37743190661479,27.626459143968873
22263_marine,492,205,413,170,697,83.94308943089432,34.552845528455286
22264_marine,353,142,303,86,495,85.8356940509915,24.362606232294617
22265_marine,306,128,268,68,434,87.58169934640523,22.22222222222222
22266_marine,288,122,250,72,410,86.80555555555556,25
22267_marine,281,150,243,73,431,86.47686832740213,25.97864768683274
22268_marine,995,388,630,562,1383,63.31658291457286,56.48241206030151
22269_marine,1013,403,632,592,1416,62.38894373149062,58.440276406712734
22272_marine,138,60,129,18,198,93.47826086956522,13.043478260869565
22273_marine,101,37,98,6,138,97.02970297029702,5.9405940594059405
22274_marine,98,34,95,5,132,96.93877551020408,5.1020408163265305
22275_marine,95,34,92,5,129,96.84210526315789,5.263157894736842
22276_marine,94,34,91,5,128,96.80851063829788,5.319148936170213
22277_marine,93,35,90,5,128,96.7741935483871,5.376344086021505
22278_marine,91,36,88,5,127,96.7032967032967,5.4945054945054945
22279_marine,91,36,88,5,127,96.7032967032967,5.4945054945054945
22280_marine,94,38,91,7,132,96.80851063829788,7.446808510638298
22281_marine,95,42,92,8,137,96.84210526315789,8.421052631578947
22282_marine,568,128,362,352,696,63.732394366197184,61.97183098591549
22283_marine,569,129,362,353,698,63.620386643233736,62.038664323374334
22284_marine,567,119,362,351,686,63.844797178130506,61.904761904761905
22285_marine,96,40,92,12,136,95.83333333333334,12.5
22286_marine,92,38,88,8,130,95.65217391304348,8.695652173913043
22287_marine,90,37,86,6,127,95.55555555555556,6.666666666666667
22288_marine,90,37,86,6,127,95.55555555555556,6.666666666666667
22289_marine,90,37,86,6,127,95.55555555555556,6.666666666666667
22290_marine,89,37,85,5,126,95.50561797752809,5.617977528089887
22291_marine,89,36,85,5,125,95.50561797752809,5.617977528089887
22292_marine,89,36,85,5,125,95.50561797752809,5.617977528089887
22293_marine,89,36,85,5,125,95.50561797752809,5.617977528089887
22294_marine,89,36,85,5,125,95.50561797752809,5.617977528089887
22295_marine,89,35,85,5,124,95.50561797752809,5.617977528089887
22296_marine,88,36,84,5,124,95.45454545454545,5.681818181818182
22297_marine,88,36,84,5,124,95.45454545454545,5.681818181818182
22298_marine,87,36,83,5,123,95.40229885057471,5.747126436781609
22299_marine,88,37,84,5,125,95.45454545454545,5.681818181818182
22300_marine,88,37,84,5,125,95.45454545454545,5.681818181818182
22301_marine,88,37,84,5,125,95.45454545454545,5.681818181818182
22302_marine,84,37,80,5,121,95.23809523809523,5.952380952380952
22303_marine,84,37,80,5,121,95.23809523809523,5.952380952380952
22304_marine,83,37,79,5,120,95.18072289156626,6.024096385542169
22305_marine,83,35,79,5,118,95.18072289156626,6.024096385542169
22306_marine,82,36,78,5,118,95.1219512195122,6.097560975609756
22307_marine,82,37,78,5,119,95.1219512195122,6.097560975609756
22308_marine,82,37,78,5,119,95.1219512195122,6.097560975609756
22309_marine,82,37,78,5,119,95.1219512195122,6.097560975609756
22310_marine,82,37,78,5,119,95.1219512195122,6.097560975609756
22311_marine,82,37,78,5,119,95.1219512195122,6.097560975609756
22312_marine,82,38,78,5,120,95.1219512195122,6.097560975609756
22313_marine,82,37,78,5,119,95.1219512195122,6.097560975609756
22314_marine,82,37,78,5,119,95.1219512195122,6.097560975609756
22315_marine,82,37,78,5,119,95.1219512195122,6.097560975609756
22316_marine,83,37,79,6,120,95.18072289156626,7.228915662650602
22317_marine,81,38,77,6,119,95.06172839506173,7.4074074074074066
22318_marine,81,38,77,6,119,95.06172839506173,7.4074074074074066
22319_marine,81,38,77,6,119,95.06172839506173,7.4074074074074066
22320_marine,82,38,77,7,120,93.90243902439023,8.536585365853659
22321_marine,255,83,183,144,338,71.76470588235294,56.470588235294116
22322_marine,255,86,183,144,341,71.76470588235294,56.470588235294116
22323_marine,254,89,182,143,343,71.65354330708661,56.2992125984252
22324_marine,258,91,186,143,349,72.09302325581395,55.42635658914728
22325_marine,97,55,90,13,152,92.78350515463917,13.402061855670103
22326_marine,246,79,174,136,325,70.73170731707317,55.28455284552846
22327_marine,248,77,176,136,325,70.96774193548387,54.83870967741935
22328_marine,89,43,84,8,132,94.3820224719101,8.98876404494382
22329_marine,89,41,84,10,130,94.3820224719101,11.235955056179774
22330_marine,89,41,84,10,130,94.3820224719101,11.235955056179774
22331_marine,89,38,84,10,127,94.3820224719101,11.235955056179774
22332_marine,90,38,85,9,128,94.44444444444444,10
22333_marine,90,37,85,9,127,94.44444444444444,10
22334_marine,91,39,86,10,130,94.5054945054945,10.989010989010989
22335_marine,91,41,86,10,132,94.5054945054945,10.989010989010989
22336_marine,93,41,88,10,134,94.6236559139785,10.75268817204301
22337_marine,93,41,88,10,134,94.6236559139785,10.75268817204301
22338_marine,91,40,86,8,131,94.5054945054945,8.791208791208792
22339_marine,89,42,84,8,131,94.3820224719101,8.98876404494382
22340_marine,91,42,86,8,133,94.5054945054945,8.791208791208792
22341_marine,91,41,86,8,132,94.5054945054945,8.791208791208792
22342_marine,88,41,83,7,129,94.31818181818183,7.954545454545454
22343_marine,87,41,82,6,128,94.25287356321839,6.896551724137931
22344_marine,86,41,82,5,127,95.34883720930233,5.813953488372093
22345_marine,86,41,82,5,127,95.34883720930233,5.813953488372093
22346_marine,86,40,82,5,126,95.34883720930233,5.813953488372093
22347_marine,86,37,82,5,123,95.34883720930233,5.813953488372093
22348_marine,86,37,82,5,123,95.34883720930233,5.813953488372093
22349_marine,86,37,82,5,123,95.34883720930233,5.813953488372093
22350_marine,83,37,79,5,120,95.18072289156626,6.024096385542169
22351_marine,82,36,78,4,118,95.1219512195122,4.878048780487805
22352_marine,82,36,78,4,118,95.1219512195122,4.878048780487805
22353_marine,82,36,78,4,118,95.1219512195122,4.878048780487805
22354_marine,82,36,78,4,118,95.1219512195122,4.878048780487805
22355_marine,80,36,76,4,116,95,5
22356_marine,80,36,76,4,116,95,5
22357_marine,80,36,76,4,116,95,5
22358_marine,79,36,75,4,115,94.9367088607595,5.063291139240507
22359_marine,79,36,75,4,115,94.9367088607595,5.063291139240507
22360_marine,77,36,73,4,113,94.8051948051948,5.194805194805195
22361_marine,77,36,73,4,113,94.8051948051948,5.194805194805195
22362_marine,75,34,71,4,109,94.66666666666667,5.333333333333334
22363_marine,75,34,71,4,109,94.66666666666667,5.333333333333334
22364_marine,75,34,71,4,109,94.66666666666667,5.333333333333334
22365_marine,75,34,71,4,109,94.66666666666667,5.333333333333334
22366_marine,75,34,71,4,109,94.66666666666667,5.333333333333334
22367_marine,77,34,73,4,111,94.8051948051948,5.194805194805195
22368_marine,77,36,73,4,113,94.8051948051948,5.194805194805195
22369_marine,78,36,74,4,114,94.87179487179486,5.128205128205128
22370_marine,77,35,73,4,112,94.8051948051948,5.194805194805195
22371_marine,78,35,73,4,113,93.58974358974359,5.128205128205128
22372_marine,78,35,73,4,113,93.58974358974359,5.128205128205128
22373_marine,78,36,73,2,114,93.58974358974359,2.564102564102564
22374_marine,78,36,73,2,114,93.58974358974359,2.564102564102564
22375_marine,77,38,72,2,115,93.5064935064935,2.5974025974025974
22376_marine,78,36,73,3,114,93.58974358974359,3.8461538461538463
22377_marine,80,35,75,3,115,93.75,3.75
22378_marine,80,35,75,3,115,93.75,3.75
22379_marine,85,39,80,3,124,94.11764705882352,3.5294117647058822
22380_marine,90,42,85,4,132,94.44444444444444,4.444444444444445
22381_marine,97,44,91,7,141,93.81443298969072,7.216494845360824
22382_marine,116,68,107,12,184,92.24137931034483,10.344827586206897
22383_marine,125,70,116,15,195,92.80000000000001,12
22384_marine,231,145,201,49,376,87.01298701298701,21.21212121212121
22385_marine,444,339,285,210,783,64.1891891891892,47.2972972972973
22386_marine,461,350,292,221,811,63.34056399132321,47.939262472885034
22404_marine,496,272,296,280,768,59.67741935483871,56.451612903225815
22405_marine,283,205,223,84,488,78.79858657243817,29.681978798586574
22406_marine,298,204,238,90,502,79.86577181208054,30.201342281879196
22407_marine,307,207,242,97,514,78.82736156351791,31.596091205211724
22408_marine,297,209,234,93,506,78.78787878787878,31.313131313131315
22409_marine,286,203,227,83,489,79.37062937062937,29.02097902097902
22410_marine,269,190,212,76,459,78.81040892193309,28.25278810408922
22411_marine,118,103,108,14,221,91.52542372881356,11.864406779661017
22412_marine,110,72,102,12,182,92.72727272727272,10.909090909090908
22413_marine,92,36,84,9,128,91.30434782608695,9.782608695652174
22414_marine,98,62,90,7,160,91.83673469387756,7.142857142857142
22415_marine,110,95,102,7,205,92.72727272727272,6.363636363636363
22416_marine,334,212,265,101,546,79.34131736526946,30.239520958083833
22417_marine,357,196,281,112,553,78.71148459383754,31.372549019607842
22421_marine,416,365,312,145,781,75,34.855769230769226
22422_marine,446,314,279,235,760,62.5560538116592,52.690582959641254
22423_marine,435,297,268,234,732,61.60919540229885,53.79310344827586
22424_marine,315,218,223,129,533,70.7936507936508,40.95238095238095
22425_marine,97,38,86,9,135,88.65979381443299,9.278350515463918
22426_marine,93,38,83,8,131,89.24731182795699,8.60215053763441
22427_marine,90,38,80,5,128,88.88888888888889,5.555555555555555
22428_marine,88,39,78,5,127,88.63636363636364,5.681818181818182
22429_marine,85,37,77,5,122,90.58823529411765,5.88235294117647
22430_marine,84,33,76,5,117,90.47619047619048,5.952380952380952
22431_marine,84,33,77,4,117,91.66666666666666,4.761904761904762
22432_marine,82,33,75,4,115,91.46341463414635,4.878048780487805
22433_marine,81,33,74,4,114,91.35802469135803,4.938271604938271
22434_marine,84,33,76,4,117,90.47619047619048,4.761904761904762
22435_marine,84,33,76,4,117,90.47619047619048,4.761904761904762
22436_marine,84,32,76,4,116,90.47619047619048,4.761904761904762
22437_marine,84,32,76,4,116,90.47619047619048,4.761904761904762
22438_marine,85,32,77,5,117,90.58823529411765,5.88235294117647
22439_marine,85,32,77,5,117,90.58823529411765,5.88235294117647
22440_marine,84,32,76,4,116,90.47619047619048,4.761904761904762
22441_marine,84,31,76,4,115,90.47619047619048,4.761904761904762
22442_marine,83,30,75,4,113,90.36144578313254,4.819277108433735
22443_marine,83,30,75,4,113,90.36144578313254,4.819277108433735
22444_marine,83,30,75,4,113,90.36144578313254,4.819277108433735
22445_marine,81,30,73,4,111,90.12345679012346,4.938271604938271
22446_marine,83,30,75,4,113,90.36144578313254,4.819277108433735
22447_marine,79,30,73,2,109,92.40506329113924,2.5316455696202533
22448_marine,80,30,74,2,110,92.5,2.5
22449_marine,80,30,74,2,110,92.5,2.5
22450_marine,80,30,74,2,110,92.5,2.5
22451_marine,78,30,72,2,108,92.3076923076923,2.564102564102564
22452_marine,78,29,72,2,107,92.3076923076923,2.564102564102564
22453_marine,78,29,72,2,107,92.3076923076923,2.564102564102564
22454_marine,79,29,73,2,108,92.40506329113924,2.5316455696202533
22455_marine,79,29,73,2,108,92.40506329113924,2.5316455696202533
22456_marine,79,29,73,2,108,92.40506329113924,2.5316455696202533
22457_marine,79,29,73,2,108,92.40506329113924,2.5316455696202533
22458_marine,83,28,75,2,111,90.36144578313254,2.4096385542168677
22459_marine,82,28,75,0,110,91.46341463414635,0
22460_marine,82,28,75,0,110,91.46341463414635,0
22461_marine,81,28,74,0,109,91.35802469135803,0
22462_marine,79,28,72,0,107,91.13924050632912,0
22463_marine,79,28,72,0,107,91.13924050632912,0
22464_marine,79,28,72,0,107,91.13924050632912,0
22465_marine,79,28,72,0,107,91.13924050632912,0
22466_marine,79,28,72,0,107,91.13924050632912,0
22467_marine,80,28,73,0,108,91.25,0
22468_marine,81,28,74,1,109,91.35802469135803,1.2345679012345678
22469_marine,81,28,74,1,109,91.35802469135803,1.2345679012345678
22470_marine,78,29,71,1,107,91.02564102564102,1.282051282051282
22471_marine,79,29,72,1,108,91.13924050632912,1.2658227848101267
22472_marine,79,29,72,1,108,91.13924050632912,1.2658227848101267
22473_marine,81,29,74,2,110,91.35802469135803,2.4691358024691357
22474_marine,86,29,78,3,115,90.69767441860465,3.488372093023256
22475_marine,86,29,78,3,115,90.69767441860465,3.488372093023256
22476_marine,86,29,78,3,115,90.69767441860465,3.488372093023256
22477_marine,89,29,81,4,118,91.01123595505618,4.49438202247191
22478_marine,89,27,81,4,116,91.01123595505618,4.49438202247191
22479_marine,92,29,83,5,121,90.21739130434783,5.434782608695652
22480_marine,104,31,95,7,135,91.34615384615384,6.730769230769231
22481_marine,254,86,234,26,340,92.1259842519685,10.236220472440944
22482_marine,336,154,296,77,490,88.09523809523809,22.916666666666664
22483_marine,340,156,301,78,496,88.52941176470588,22.941176470588236
22486_marine,311,160,289,32,471,92.92604501607717,10.289389067524116
22487_marine,455,235,376,132,690,82.63736263736263,29.010989010989015
22488_marine,419,193,346,129,612,82.57756563245823,30.787589498806682
22534_marine,711,333,468,387,1044,65.82278481012658,54.43037974683544
22535_marine,666,324,434,350,990,65.16516516516516,52.552552552552555
22536_marine,627,280,410,329,907,65.39074960127593,52.472089314194584
22549_marine,377,192,264,162,569,70.026525198939,42.97082228116711
22550_marine,400,198,281,176,598,70.25,44
22551_marine,269,131,217,74,400,80.66914498141264,27.509293680297397
22623_marine,418,182,352,110,600,84.21052631578947,26.31578947368421
22624_marine,388,157,326,103,545,84.02061855670104,26.54639175257732
22625_marine,352,152,290,101,504,82.38636363636364,28.693181818181817
22626_marine,289,154,251,71,443,86.85121107266436,24.567474048442904
22627_marine,1013,411,637,574,1424,62.88252714708786,56.66337611056268
22631_marine,882,309,526,528,1191,59.63718820861678,59.863945578231295
22632_marine,107,35,104,11,142,97.19626168224299,10.2803738317757
22633_marine,92,33,89,5,125,96.73913043478261,5.434782608695652
22634_marine,92,34,89,5,126,96.73913043478261,5.434782608695652
22635_marine,95,32,90,7,127,94.73684210526315,7.368421052631578
22636_marine,95,33,90,7,128,94.73684210526315,7.368421052631578
22637_marine,93,35,90,5,128,96.7741935483871,5.376344086021505
22638_marine,94,36,91,6,130,96.80851063829788,6.382978723404255
22639_marine,93,36,90,6,129,96.7741935483871,6.451612903225806
22640_marine,98,37,95,7,135,96.93877551020408,7.142857142857142
22641_marine,109,45,104,12,154,95.41284403669725,11.009174311926607
22642_marine,574,130,364,356,704,63.41463414634146,62.02090592334495
22643_marine,594,150,380,365,744,63.97306397306397,61.44781144781145
22644_marine,569,119,362,353,688,63.620386643233736,62.038664323374334
22645_marine,95,42,91,12,137,95.78947368421052,12.631578947368421
22646_marine,94,40,90,10,134,95.74468085106383,10.638297872340425
22647_marine,92,38,88,8,130,95.65217391304348,8.695652173913043
22648_marine,90,38,86,6,128,95.55555555555556,6.666666666666667
22649_marine,90,37,86,6,127,95.55555555555556,6.666666666666667
22650_marine,90,37,86,6,127,95.55555555555556,6.666666666666667
22651_marine,90,36,86,6,126,95.55555555555556,6.666666666666667
22652_marine,90,36,86,6,126,95.55555555555556,6.666666666666667
22653_marine,89,36,85,5,125,95.50561797752809,5.617977528089887
22654_marine,89,35,85,5,124,95.50561797752809,5.617977528089887
22655_marine,89,35,85,5,124,95.50561797752809,5.617977528089887
22656_marine,89,36,85,5,125,95.50561797752809,5.617977528089887
22657_marine,88,36,84,5,124,95.45454545454545,5.681818181818182
22658_marine,87,36,83,5,123,95.40229885057471,5.747126436781609
22659_marine,88,37,84,5,125,95.45454545454545,5.681818181818182
22660_marine,88,37,84,5,125,95.45454545454545,5.681818181818182
22661_marine,88,37,84,5,125,95.45454545454545,5.681818181818182
22662_marine,88,37,84,5,125,95.45454545454545,5.681818181818182
22663_marine,89,37,85,5,126,95.50561797752809,5.617977528089887
22664_marine,89,37,85,5,126,95.50561797752809,5.617977528089887
22665_marine,89,37,85,5,126,95.50561797752809,5.617977528089887
22666_marine,85,38,81,5,123,95.29411764705881,5.88235294117647
22667_marine,83,39,79,5,122,95.18072289156626,6.024096385542169
22668_marine,82,39,78,5,121,95.1219512195122,6.097560975609756
22669_marine,82,37,78,5,119,95.1219512195122,6.097560975609756
22670_marine,82,38,78,5,120,95.1219512195122,6.097560975609756
22671_marine,83,38,79,5,121,95.18072289156626,6.024096385542169
22672_marine,84,38,80,6,122,95.23809523809523,7.142857142857142
22673_marine,84,37,80,6,121,95.23809523809523,7.142857142857142
22674_marine,84,37,80,6,121,95.23809523809523,7.142857142857142
22675_marine,84,38,80,6,122,95.23809523809523,7.142857142857142
22676_marine,84,38,80,6,122,95.23809523809523,7.142857142857142
22677_marine,84,38,80,6,122,95.23809523809523,7.142857142857142
22678_marine,84,38,80,6,122,95.23809523809523,7.142857142857142
22679_marine,83,38,78,7,121,93.97590361445783,8.433734939759036
22680_marine,83,39,78,7,122,93.97590361445783,8.433734939759036
22681_marine,84,40,79,7,124,94.04761904761905,8.333333333333332
22682_marine,83,40,78,8,123,93.97590361445783,9.63855421686747
22683_marine,83,44,78,8,127,93.97590361445783,9.63855421686747
22684_marine,93,51,86,13,144,92.47311827956989,13.978494623655912
22685_marine,87,51,82,7,138,94.25287356321839,8.045977011494253
22686_marine,272,94,192,151,366,70.58823529411765,55.51470588235294
22687_marine,303,102,216,173,405,71.28712871287128,57.0957095709571
22688_marine,276,87,192,155,363,69.56521739130434,56.15942028985508
22689_marine,276,89,192,155,365,69.56521739130434,56.15942028985508
22690_marine,278,87,194,157,365,69.7841726618705,56.4748201438849
22691_marine,94,47,89,10,141,94.68085106382979,10.638297872340425
22692_marine,93,47,88,10,140,94.6236559139785,10.75268817204301
22693_marine,93,51,88,10,144,94.6236559139785,10.75268817204301
22694_marine,93,44,88,12,137,94.6236559139785,12.903225806451612
22695_marine,93,40,88,12,133,94.6236559139785,12.903225806451612
22696_marine,96,41,91,11,137,94.79166666666666,11.458333333333332
22697_marine,95,42,90,10,137,94.73684210526315,10.526315789473683
22698_marine,95,42,90,10,137,94.73684210526315,10.526315789473683
22699_marine,95,44,90,10,139,94.73684210526315,10.526315789473683
22700_marine,94,44,88,8,138,93.61702127659575,8.51063829787234
22701_marine,92,42,86,8,134,93.47826086956522,8.695652173913043
22702_marine,92,42,86,8,134,93.47826086956522,8.695652173913043
22703_marine,90,42,84,8,132,93.33333333333333,8.88888888888889
22704_marine,89,42,83,7,131,93.25842696629213,7.865168539325842
22705_marine,88,42,83,7,130,94.31818181818183,7.954545454545454
22706_marine,86,41,82,5,127,95.34883720930233,5.813953488372093
22707_marine,86,41,82,5,127,95.34883720930233,5.813953488372093
22708_marine,86,40,82,5,126,95.34883720930233,5.813953488372093
22709_marine,86,40,82,5,126,95.34883720930233,5.813953488372093
22710_marine,86,39,82,5,125,95.34883720930233,5.813953488372093
22711_marine,84,38,80,5,122,95.23809523809523,5.952380952380952
22712_marine,83,38,79,4,121,95.18072289156626,4.819277108433735
22713_marine,83,38,79,4,121,95.18072289156626,4.819277108433735
22714_marine,83,38,79,4,121,95.18072289156626,4.819277108433735
22715_marine,83,38,79,4,121,95.18072289156626,4.819277108433735
22716_marine,81,38,77,4,119,95.06172839506173,4.938271604938271
22717_marine,79,36,75,4,115,94.9367088607595,5.063291139240507
22718_marine,79,36,75,4,115,94.9367088607595,5.063291139240507
22719_marine,79,36,75,4,115,94.9367088607595,5.063291139240507
22720_marine,79,36,75,4,115,94.9367088607595,5.063291139240507
22721_marine,79,36,75,4,115,94.9367088607595,5.063291139240507
22722_marine,79,36,75,4,115,94.9367088607595,5.063291139240507
22723_marine,77,38,73,4,115,94.8051948051948,5.194805194805195
22724_marine,79,38,75,4,117,94.9367088607595,5.063291139240507
22725_marine,78,38,74,4,116,94.87179487179486,5.128205128205128
22726_marine,77,39,73,4,116,94.8051948051948,5.194805194805195
22727_marine,77,39,73,4,116,94.8051948051948,5.194805194805195
22728_marine,77,39,73,4,116,94.8051948051948,5.194805194805195
22729_marine,77,39,73,4,116,94.8051948051948,5.194805194805195
22730_marine,77,38,73,4,115,94.8051948051948,5.194805194805195
22731_marine,80,37,75,4,117,93.75,5
22732_marine,78,38,73,2,116,93.58974358974359,2.564102564102564
22733_marine,78,38,73,2,116,93.58974358974359,2.564102564102564
22734_marine,78,38,73,2,116,93.58974358974359,2.564102564102564
22735_marine,78,39,73,2,117,93.58974358974359,2.564102564102564
22736_marine,79,39,74,2,118,93.67088607594937,2.5316455696202533
22737_marine,80,37,75,3,117,93.75,3.75
22738_marine,80,38,75,3,118,93.75,3.75
22739_marine,85,41,80,3,126,94.11764705882352,3.5294117647058822
22740_marine,88,41,83,4,129,94.31818181818183,4.545454545454546
22741_marine,93,43,87,5,136,93.54838709677419,5.376344086021505
22742_marine,99,43,93,7,142,93.93939393939394,7.07070707070707
22743_marine,107,52,100,8,159,93.45794392523365,7.476635514018691
22744_marine,116,57,109,10,173,93.96551724137932,8.620689655172415
22745_marine,250,163,207,60,413,82.8,24
22746_marine,441,335,283,205,776,64.17233560090703,46.48526077097506
22747_marine,462,353,293,222,815,63.41991341991342,48.05194805194805
22748_marine,498,438,325,221,936,65.26104417670683,44.377510040160644
22750_marine,325,303,264,80,628,81.23076923076923,24.615384615384617
22764_marine,287,190,223,84,477,77.70034843205575,29.268292682926827
22765_marine,115,86,107,12,201,93.04347826086956,10.434782608695652
22766_marine,112,63,104,11,175,92.85714285714286,9.821428571428571
22767_marine,118,65,104,19,183,88.13559322033898,16.101694915254235
22768_marine,114,63,100,17,177,87.71929824561403,14.912280701754385
22769_marine,102,55,94,7,157,92.15686274509804,6.862745098039216
22770_marine,94,45,84,7,139,89.36170212765957,7.446808510638298
22771_marine,88,37,80,7,125,90.9090909090909,7.954545454545454
22772_marine,88,36,80,7,124,90.9090909090909,7.954545454545454
22773_marine,86,36,78,7,122,90.69767441860465,8.13953488372093
22774_marine,86,36,78,7,122,90.69767441860465,8.13953488372093
22775_marine,104,67,96,7,171,92.3076923076923,6.730769230769231
22776_marine,339,207,272,104,546,80.23598820058997,30.678466076696164
22777_marine,350,191,282,107,541,80.57142857142857,30.571428571428573
22781_marine,432,377,317,159,809,73.37962962962963,36.80555555555556
22785_marine,312,205,223,121,517,71.47435897435898,38.782051282051285
22786_marine,104,37,93,11,141,89.42307692307693,10.576923076923077
22787_marine,98,36,87,9,134,88.77551020408163,9.183673469387756
22788_marine,94,36,84,5,130,89.36170212765957,5.319148936170213
22789_marine,86,37,78,5,123,90.69767441860465,5.813953488372093
22790_marine,87,37,79,5,124,90.80459770114942,5.747126436781609
22791_marine,87,35,79,5,122,90.80459770114942,5.747126436781609
22792_marine,83,32,75,5,115,90.36144578313254,6.024096385542169
22793_marine,82,34,75,4,116,91.46341463414635,4.878048780487805
22794_marine,83,34,76,4,117,91.56626506024097,4.819277108433735
22795_marine,84,34,76,4,118,90.47619047619048,4.761904761904762
22796_marine,84,34,76,4,118,90.47619047619048,4.761904761904762
22797_marine,84,34,76,4,118,90.47619047619048,4.761904761904762
22798_marine,83,33,75,3,116,90.36144578313254,3.614457831325301
22799_marine,84,33,76,4,117,90.47619047619048,4.761904761904762
22800_marine,84,33,76,4,117,90.47619047619048,4.761904761904762
22801_marine,84,33,76,4,117,90.47619047619048,4.761904761904762
22802_marine,84,33,76,4,117,90.47619047619048,4.761904761904762
22803_marine,84,33,76,4,117,90.47619047619048,4.761904761904762
22804_marine,84,33,76,4,117,90.47619047619048,4.761904761904762
22805_marine,84,33,76,4,117,90.47619047619048,4.761904761904762
22806_marine,83,33,75,4,116,90.36144578313254,4.819277108433735
22807_marine,81,33,73,4,114,90.12345679012346,4.938271604938271
22808_marine,81,33,73,4,114,90.12345679012346,4.938271604938271
22809_marine,79,30,73,2,109,92.40506329113924,2.5316455696202533
22810_marine,80,30,74,2,110,92.5,2.5
22811_marine,80,30,74,2,110,92.5,2.5
22812_marine,80,29,74,2,109,92.5,2.5
22813_marine,80,29,74,2,109,92.5,2.5
22814_marine,83,29,77,2,112,92.7710843373494,2.4096385542168677
22815_marine,83,29,77,2,112,92.7710843373494,2.4096385542168677
22816_marine,83,29,77,2,112,92.7710843373494,2.4096385542168677
22817_marine,83,29,77,2,112,92.7710843373494,2.4096385542168677
22818_marine,81,28,76,0,109,93.82716049382715,0
22819_marine,81,28,76,0,109,93.82716049382715,0
22820_marine,85,28,78,0,113,91.76470588235294,0
22821_marine,85,28,78,0,113,91.76470588235294,0
22822_marine,83,28,76,0,111,91.56626506024097,0
22823_marine,83,28,76,0,111,91.56626506024097,0
22824_marine,83,28,76,0,111,91.56626506024097,0
22825_marine,83,28,76,0,111,91.56626506024097,0
22826_marine,82,28,75,0,110,91.46341463414635,0
22827_marine,82,28,75,0,110,91.46341463414635,0
22828_marine,83,28,76,1,111,91.56626506024097,1.2048192771084338
22829_marine,82,28,75,1,110,91.46341463414635,1.2195121951219512
22830_marine,82,29,75,1,111,91.46341463414635,1.2195121951219512
22831_marine,80,29,73,1,109,91.25,1.25
22832_marine,82,29,75,1,111,91.46341463414635,1.2195121951219512
22833_marine,83,29,76,2,112,91.56626506024097,2.4096385542168677
22834_marine,83,29,76,2,112,91.56626506024097,2.4096385542168677
22835_marine,84,29,76,3,113,90.47619047619048,3.571428571428571
22836_marine,86,29,78,3,115,90.69767441860465,3.488372093023256
22837_marine,89,29,81,4,118,91.01123595505618,4.49438202247191
22838_marine,92,31,83,5,123,90.21739130434783,5.434782608695652
22839_marine,99,31,89,6,130,89.8989898989899,6.0606060606060606
22840_marine,105,39,95,6,144,90.47619047619048,5.714285714285714
22841_marine,113,35,103,6,148,91.1504424778761,5.3097345132743365
22842_marine,257,97,236,26,354,91.82879377431907,10.116731517509727
22843_marine,257,91,236,26,348,91.82879377431907,10.116731517509727
22844_marine,263,109,242,28,372,92.01520912547528,10.646387832699618
22845_marine,307,151,284,33,458,92.50814332247556,10.749185667752444
22846_marine,400,204,336,99,604,84,24.75
22847_marine,408,200,339,109,608,83.08823529411765,26.715686274509803
22894_marine,653,282,432,351,935,66.15620214395099,53.751914241960186
22895_marine,660,289,437,352,949,66.21212121212122,53.333333333333336
22896_marine,615,280,402,322,895,65.3658536585366,52.357723577235774
22897_marine,618,274,406,326,892,65.69579288025889,52.75080906148867
22912_marine,388,189,284,159,577,73.19587628865979,40.97938144329897
22913_marine,272,127,216,74,399,79.41176470588235,27.205882352941174
22982_marine,739,281,568,274,1020,76.86062246278755,37.07713125845737
22983_marine,967,324,690,461,1291,71.35470527404343,47.673216132368154
22984_marine,929,318,639,473,1247,68.78363832077503,50.91496232508074
22985_marine,893,316,601,477,1209,67.30123180291153,53.41545352743561
22986_marine,1018,400,647,571,1418,63.555992141453835,56.09037328094303
22990_marine,930,332,571,554,1262,61.39784946236559,59.56989247311828
22991_marine,338,65,236,178,403,69.8224852071006,52.662721893491124
22992_marine,330,63,229,172,393,69.39393939393939,52.121212121212125
22993_marine,318,57,217,168,375,68.23899371069182,52.83018867924528
22994_marine,93,32,90,5,125,96.7741935483871,5.376344086021505
22995_marine,94,33,89,8,127,94.68085106382979,8.51063829787234
22996_marine,95,35,90,8,130,94.73684210526315,8.421052631578947
22997_marine,96,36,91,8,132,94.79166666666666,8.333333333333332
22998_marine,94,36,91,6,130,96.80851063829788,6.382978723404255
22999_marine,98,37,95,5,135,96.93877551020408,5.1020408163265305
23000_marine,99,36,96,6,135,96.96969696969697,6.0606060606060606
23001_marine,420,78,265,259,498,63.095238095238095,61.66666666666667
23002_marine,580,128,371,358,708,63.96551724137931,61.724137931034484
23003_marine,596,148,380,368,744,63.758389261744966,61.74496644295302
23004_marine,569,119,362,353,688,63.620386643233736,62.038664323374334
23005_marine,95,41,91,12,136,95.78947368421052,12.631578947368421
23006_marine,94,40,90,10,134,95.74468085106383,10.638297872340425
23007_marine,92,38,88,8,130,95.65217391304348,8.695652173913043
23008_marine,90,37,86,6,127,95.55555555555556,6.666666666666667
23009_marine,90,37,86,6,127,95.55555555555556,6.666666666666667
23010_marine,90,37,86,6,127,95.55555555555556,6.666666666666667
23011_marine,90,36,86,6,126,95.55555555555556,6.666666666666667
23012_marine,90,35,86,6,125,95.55555555555556,6.666666666666667
23013_marine,90,35,86,6,125,95.55555555555556,6.666666666666667
23014_marine,90,35,86,6,125,95.55555555555556,6.666666666666667
23015_marine,90,35,86,6,125,95.55555555555556,6.666666666666667
23016_marine,90,36,86,6,126,95.55555555555556,6.666666666666667
23017_marine,89,36,85,5,125,95.50561797752809,5.617977528089887
23018_marine,88,36,84,5,124,95.45454545454545,5.681818181818182
23019_marine,88,37,84,5,125,95.45454545454545,5.681818181818182
23020_marine,88,37,84,5,125,95.45454545454545,5.681818181818182
23021_marine,88,37,84,5,125,95.45454545454545,5.681818181818182
23022_marine,88,37,84,5,125,95.45454545454545,5.681818181818182
23023_marine,89,37,85,5,126,95.50561797752809,5.617977528089887
23024_marine,89,37,85,5,126,95.50561797752809,5.617977528089887
23025_marine,89,37,85,5,126,95.50561797752809,5.617977528089887
23026_marine,89,38,85,5,127,95.50561797752809,5.617977528089887
23027_marine,87,39,83,5,126,95.40229885057471,5.747126436781609
23028_marine,88,39,84,5,127,95.45454545454545,5.681818181818182
23029_marine,89,40,85,6,129,95.50561797752809,6.741573033707865
23030_marine,88,40,84,6,128,95.45454545454545,6.8181818181818175
23031_marine,86,40,82,6,126,95.34883720930233,6.976744186046512
23032_marine,86,40,82,6,126,95.34883720930233,6.976744186046512
23033_marine,86,37,82,6,123,95.34883720930233,6.976744186046512
23034_marine,86,38,82,6,124,95.34883720930233,6.976744186046512
23035_marine,86,38,82,6,124,95.34883720930233,6.976744186046512
23036_marine,86,38,82,6,124,95.34883720930233,6.976744186046512
23037_marine,86,40,82,6,126,95.34883720930233,6.976744186046512
23038_marine,85,40,80,7,125,94.11764705882352,8.235294117647058
23039_marine,85,41,80,7,126,94.11764705882352,8.235294117647058
23040_marine,85,41,80,7,126,94.11764705882352,8.235294117647058
23041_marine,90,39,85,7,129,94.44444444444444,7.777777777777778
23042_marine,89,39,84,7,128,94.3820224719101,7.865168539325842
23043_marine,89,40,84,8,129,94.3820224719101,8.98876404494382
23044_marine,89,44,84,8,133,94.3820224719101,8.98876404494382
23045_marine,91,46,86,8,137,94.5054945054945,8.791208791208792
23046_marine,270,93,190,151,363,70.37037037037037,55.925925925925924
23047_marine,276,93,196,151,369,71.01449275362319,54.710144927536234
23048_marine,284,95,200,155,379,70.4225352112676,54.5774647887324
23049_marine,314,104,222,178,418,70.70063694267516,56.68789808917197
23050_marine,286,96,202,157,382,70.62937062937063,54.89510489510489
23051_marine,107,60,100,17,167,93.45794392523365,15.887850467289718
23052_marine,107,62,100,17,169,93.45794392523365,15.887850467289718
23053_marine,109,62,102,17,171,93.57798165137615,15.59633027522936
23054_marine,101,50,96,13,151,95.04950495049505,12.871287128712872
23055_marine,97,44,92,12,141,94.84536082474226,12.371134020618557
23056_marine,99,46,94,12,145,94.94949494949495,12.121212121212121
23057_marine,99,45,94,12,144,94.94949494949495,12.121212121212121
23058_marine,98,42,93,11,140,94.89795918367348,11.224489795918368
23059_marine,99,43,93,11,142,93.93939393939394,11.11111111111111
23060_marine,98,43,92,10,141,93.87755102040816,10.204081632653061
23061_marine,96,44,90,8,140,93.75,8.333333333333332
23062_marine,94,43,88,8,137,93.61702127659575,8.51063829787234
23063_marine,92,43,86,8,135,93.47826086956522,8.695652173913043
23064_marine,92,43,86,8,135,93.47826086956522,8.695652173913043
23065_marine,90,43,84,8,133,93.33333333333333,8.88888888888889
23066_marine,89,43,83,7,132,93.25842696629213,7.865168539325842
23067_marine,88,43,83,7,131,94.31818181818183,7.954545454545454
23068_marine,87,43,83,6,130,95.40229885057471,6.896551724137931
23069_marine,87,43,83,6,130,95.40229885057471,6.896551724137931
23070_marine,86,42,82,5,128,95.34883720930233,5.813953488372093
23071_marine,86,40,82,5,126,95.34883720930233,5.813953488372093
23072_marine,84,40,80,5,124,95.23809523809523,5.952380952380952
23073_marine,84,40,80,5,124,95.23809523809523,5.952380952380952
23074_marine,83,40,79,4,123,95.18072289156626,4.819277108433735
23075_marine,83,40,79,4,123,95.18072289156626,4.819277108433735
23076_marine,81,39,77,4,120,95.06172839506173,4.938271604938271
23077_marine,80,39,76,4,119,95,5
23078_marine,80,39,76,4,119,95,5
23079_marine,80,39,76,4,119,95,5
23080_marine,80,39,76,4,119,95,5
23081_marine,82,39,78,4,121,95.1219512195122,4.878048780487805
23082_marine,82,39,78,4,121,95.1219512195122,4.878048780487805
23083_marine,81,39,77,4,120,95.06172839506173,4.938271604938271
23084_marine,81,39,77,4,120,95.06172839506173,4.938271604938271
23085_marine,81,39,77,4,120,95.06172839506173,4.938271604938271
23086_marine,80,39,76,4,119,95,5
23087_marine,81,39,77,4,120,95.06172839506173,4.938271604938271
23088_marine,80,40,76,4,120,95,5
23089_marine,82,39,78,4,121,95.1219512195122,4.878048780487805
23090_marine,79,39,75,2,118,94.9367088607595,2.5316455696202533
23091_marine,79,38,75,2,117,94.9367088607595,2.5316455696202533
23092_marine,80,38,75,2,118,93.75,2.5
23093_marine,80,39,75,2,119,93.75,2.5
23094_marine,80,39,75,2,119,93.75,2.5
23095_marine,80,39,75,2,119,93.75,2.5
23096_marine,82,38,77,2,120,93.90243902439023,2.4390243902439024
23097_marine,83,40,78,2,123,93.97590361445783,2.4096385542168677
23098_marine,83,39,78,2,122,93.97590361445783,2.4096385542168677
23099_marine,84,40,79,3,124,94.04761904761905,3.571428571428571
23100_marine,92,42,87,4,134,94.56521739130434,4.3478260869565215
23101_marine,92,42,87,4,134,94.56521739130434,4.3478260869565215
23102_marine,97,43,91,5,140,93.81443298969072,5.154639175257731
23103_marine,103,43,97,7,146,94.1747572815534,6.796116504854369
23104_marine,114,53,107,9,167,93.85964912280701,7.894736842105263
23105_marine,124,71,117,11,195,94.35483870967742,8.870967741935484
23106_marine,255,171,212,59,426,83.13725490196079,23.137254901960784
23107_marine,272,196,229,63,468,84.19117647058823,23.161764705882355
23108_marine,475,409,305,220,884,64.21052631578948,46.31578947368421
23110_marine,517,488,331,230,1005,64.02321083172147,44.48742746615087
23124_marine,271,178,211,78,449,77.85977859778598,28.782287822878228
23125_marine,104,71,96,8,175,92.3076923076923,7.6923076923076925
23126_marine,97,37,89,8,134,91.75257731958763,8.24742268041237
23127_marine,96,37,88,7,133,91.66666666666666,7.291666666666667
23128_marine,90,41,82,7,131,91.11111111111111,7.777777777777778
23129_marine,88,35,80,7,123,90.9090909090909,7.954545454545454
23130_marine,96,49,88,11,145,91.66666666666666,11.458333333333332
23131_marine,88,37,80,7,125,90.9090909090909,7.954545454545454
23132_marine,92,37,84,7,129,91.30434782608695,7.608695652173914
23133_marine,88,37,80,7,125,90.9090909090909,7.954545454545454
23134_marine,88,36,80,7,124,90.9090909090909,7.954545454545454
23135_marine,100,43,92,7,143,92,7.000000000000001
23136_marine,327,188,260,100,515,79.51070336391437,30.58103975535168
23137_marine,363,199,291,107,562,80.16528925619835,29.476584022038566
23138_marine,408,240,310,137,648,75.98039215686273,33.57843137254902
23141_marine,548,419,353,273,967,64.41605839416059,49.81751824817518
23145_marine,316,213,223,129,529,70.56962025316456,40.822784810126585
23146_marine,310,204,222,120,514,71.61290322580646,38.70967741935484
23147_marine,109,38,98,11,147,89.90825688073394,10.091743119266056
23148_marine,103,36,92,11,139,89.32038834951457,10.679611650485436
23149_marine,99,35,88,9,134,88.88888888888889,9.090909090909092
23150_marine,88,36,79,6,124,89.77272727272727,6.8181818181818175
23151_marine,86,34,78,5,120,90.69767441860465,5.813953488372093
23152_marine,86,34,78,5,120,90.69767441860465,5.813953488372093
23153_marine,83,32,75,5,115,90.36144578313254,6.024096385542169
23154_marine,82,34,75,4,116,91.46341463414635,4.878048780487805
23155_marine,83,34,76,4,117,91.56626506024097,4.819277108433735
23156_marine,83,34,75,3,117,90.36144578313254,3.614457831325301
23157_marine,83,34,75,3,117,90.36144578313254,3.614457831325301
23158_marine,83,34,75,3,117,90.36144578313254,3.614457831325301
23159_marine,83,34,75,3,117,90.36144578313254,3.614457831325301
23160_marine,84,33,76,4,117,90.47619047619048,4.761904761904762
23161_marine,84,33,76,4,117,90.47619047619048,4.761904761904762
23162_marine,84,33,76,4,117,90.47619047619048,4.761904761904762
23163_marine,84,33,76,4,117,90.47619047619048,4.761904761904762
23164_marine,84,33,76,4,117,90.47619047619048,4.761904761904762
23165_marine,84,33,76,4,117,90.47619047619048,4.761904761904762
23166_marine,84,33,76,4,117,90.47619047619048,4.761904761904762
23167_marine,82,33,74,4,115,90.2439024390244,4.878048780487805
23168_marine,84,33,76,4,117,90.47619047619048,4.761904761904762
23169_marine,83,33,75,4,116,90.36144578313254,4.819277108433735
23170_marine,78,33,72,2,111,92.3076923076923,2.564102564102564
23171_marine,80,33,74,2,113,92.5,2.5
23172_marine,80,31,74,2,111,92.5,2.5
23173_marine,80,31,74,2,111,92.5,2.5
23174_marine,81,31,75,2,112,92.5925925925926,2.4691358024691357
23175_marine,83,31,77,2,114,92.7710843373494,2.4096385542168677
23176_marine,84,31,78,1,115,92.85714285714286,1.1904761904761905
23177_marine,84,31,78,1,115,92.85714285714286,1.1904761904761905
23178_marine,83,30,78,0,113,93.97590361445783,0
23179_marine,83,30,78,0,113,93.97590361445783,0
23180_marine,85,30,80,0,115,94.11764705882352,0
23181_marine,85,30,80,0,115,94.11764705882352,0
23182_marine,85,28,78,0,113,91.76470588235294,0
23183_marine,85,28,78,0,113,91.76470588235294,0
23184_marine,85,28,78,0,113,91.76470588235294,0
23185_marine,86,28,79,0,114,91.86046511627907,0
23186_marine,86,28,79,0,114,91.86046511627907,0
23187_marine,85,28,78,0,113,91.76470588235294,0
23188_marine,85,28,78,0,113,91.76470588235294,0
23189_marine,86,28,79,1,114,91.86046511627907,1.1627906976744187
23190_marine,84,29,77,1,113,91.66666666666666,1.1904761904761905
23191_marine,85,29,78,1,114,91.76470588235294,1.1764705882352942
23192_marine,84,29,77,1,113,91.66666666666666,1.1904761904761905
23193_marine,85,29,78,2,114,91.76470588235294,2.3529411764705883
23194_marine,86,29,79,3,115,91.86046511627907,3.488372093023256
23195_marine,87,29,79,4,116,90.80459770114942,4.597701149425287
23196_marine,87,29,79,4,116,90.80459770114942,4.597701149425287
23197_marine,92,29,84,5,121,91.30434782608695,5.434782608695652
23198_marine,96,31,86,7,127,89.58333333333334,7.291666666666667
23199_marine,99,31,89,6,130,89.8989898989899,6.0606060606060606
23200_marine,105,39,95,6,144,90.47619047619048,5.714285714285714
23201_marine,111,51,101,6,162,90.990990990991,5.405405405405405
23202_marine,110,41,99,6,151,90,5.454545454545454
23203_marine,116,50,105,6,166,90.51724137931035,5.172413793103448
23204_marine,260,127,245,21,387,94.23076923076923,8.076923076923077
23205_marine,276,129,259,24,405,93.84057971014492,8.695652173913043
23206_marine,389,168,323,95,557,83.03341902313625,24.42159383033419
23255_marine,657,280,435,349,937,66.21004566210046,53.12024353120244
23256_marine,500,212,344,249,712,68.8,49.8
23257_marine,621,274,412,325,895,66.34460547504025,52.33494363929147
23258_marine,613,269,405,321,882,66.06851549755302,52.36541598694943
23272_marine,403,191,295,172,594,73.20099255583126,42.67990074441687
23273_marine,324,158,250,111,482,77.1604938271605,34.25925925925926
23274_marine,268,131,214,71,399,79.8507462686567,26.492537313432834
23275_marine,347,170,275,124,517,79.2507204610951,35.73487031700288
23276_marine,487,244,351,231,731,72.07392197125256,47.43326488706365
23277_marine,573,308,428,251,881,74.69458987783595,43.80453752181501
23341_marine,1143,440,828,549,1583,72.44094488188976,48.031496062992126
23344_marine,1080,436,717,575,1516,66.38888888888889,53.24074074074075
23345_marine,1026,417,661,581,1443,64.42495126705653,56.627680311890835
23346_marine,991,412,615,573,1403,62.058526740666,57.820383451059534
23347_marine,987,415,608,570,1402,61.60081053698075,57.75075987841946
23348_marine,977,400,603,567,1377,61.719549641760494,58.034800409416576
23349_marine,951,364,583,559,1315,61.30389064143007,58.78023133543638
23350_marine,125,49,119,15,174,95.19999999999999,12
23351_marine,329,59,228,171,388,69.30091185410335,51.97568389057751
23353_marine,322,59,221,169,381,68.63354037267081,52.484472049689444
23354_marine,94,33,91,6,127,96.80851063829788,6.382978723404255
23355_marine,97,31,92,8,128,94.84536082474226,8.24742268041237
23356_marine,95,33,90,8,128,94.73684210526315,8.421052631578947
23357_marine,95,37,90,8,132,94.73684210526315,8.421052631578947
23358_marine,96,37,93,5,133,96.875,5.208333333333334
23359_marine,98,36,95,5,134,96.93877551020408,5.1020408163265305
23360_marine,100,36,96,7,136,96,7.000000000000001
23361_marine,419,76,264,258,495,63.0071599045346,61.575178997613364
23362_marine,596,134,381,364,730,63.92617449664429,61.07382550335571
23363_marine,574,119,367,352,693,63.937282229965156,61.32404181184668
23364_marine,95,43,91,8,138,95.78947368421052,8.421052631578947
23365_marine,93,41,89,8,134,95.6989247311828,8.60215053763441
23366_marine,92,41,88,8,133,95.65217391304348,8.695652173913043
23367_marine,92,40,88,8,132,95.65217391304348,8.695652173913043
23368_marine,90,37,86,6,127,95.55555555555556,6.666666666666667
23369_marine,90,36,86,6,126,95.55555555555556,6.666666666666667
23370_marine,90,37,86,6,127,95.55555555555556,6.666666666666667
23371_marine,90,35,86,6,125,95.55555555555556,6.666666666666667
23372_marine,90,35,86,6,125,95.55555555555556,6.666666666666667
23373_marine,90,36,86,6,126,95.55555555555556,6.666666666666667
23374_marine,165,51,135,63,216,81.81818181818183,38.18181818181819
23375_marine,165,51,135,63,216,81.81818181818183,38.18181818181819
23376_marine,90,36,86,6,126,95.55555555555556,6.666666666666667
23377_marine,90,36,86,6,126,95.55555555555556,6.666666666666667
23378_marine,90,36,86,6,126,95.55555555555556,6.666666666666667
23379_marine,91,37,87,6,128,95.6043956043956,6.593406593406594
23380_marine,90,37,86,6,127,95.55555555555556,6.666666666666667
23381_marine,89,37,85,5,126,95.50561797752809,5.617977528089887
23382_marine,90,35,86,5,125,95.55555555555556,5.555555555555555
23383_marine,90,35,86,5,125,95.55555555555556,5.555555555555555
23384_marine,90,35,86,5,125,95.55555555555556,5.555555555555555
23385_marine,90,35,86,5,125,95.55555555555556,5.555555555555555
23386_marine,90,36,86,5,126,95.55555555555556,5.555555555555555
23387_marine,92,38,88,6,130,95.65217391304348,6.521739130434782
23388_marine,92,38,88,6,130,95.65217391304348,6.521739130434782
23389_marine,90,38,86,6,128,95.55555555555556,6.666666666666667
23390_marine,90,38,86,6,128,95.55555555555556,6.666666666666667
23391_marine,90,38,86,6,128,95.55555555555556,6.666666666666667
23392_marine,89,38,85,6,127,95.50561797752809,6.741573033707865
23393_marine,88,39,84,6,127,95.45454545454545,6.8181818181818175
23394_marine,88,38,84,6,126,95.45454545454545,6.8181818181818175
23395_marine,88,38,84,6,126,95.45454545454545,6.8181818181818175
23396_marine,87,38,82,7,125,94.25287356321839,8.045977011494253
23397_marine,87,38,82,7,125,94.25287356321839,8.045977011494253
23398_marine,87,40,82,7,127,94.25287356321839,8.045977011494253
23399_marine,87,40,82,7,127,94.25287356321839,8.045977011494253
23400_marine,89,40,84,7,129,94.3820224719101,7.865168539325842
23401_marine,92,38,87,7,130,94.56521739130434,7.608695652173914
23402_marine,91,38,86,7,129,94.5054945054945,7.6923076923076925
23403_marine,89,38,84,7,127,94.3820224719101,7.865168539325842
23404_marine,88,38,83,7,126,94.31818181818183,7.954545454545454
23405_marine,89,38,84,8,127,94.3820224719101,8.98876404494382
23406_marine,91,42,86,8,133,94.5054945054945,8.791208791208792
23407_marine,93,44,88,8,137,94.6236559139785,8.60215053763441
23408_marine,280,82,196,156,362,70,55.714285714285715
23409_marine,281,82,197,156,363,70.1067615658363,55.51601423487544
23410_marine,97,48,92,7,145,94.84536082474226,7.216494845360824
23411_marine,101,48,96,9,149,95.04950495049505,8.91089108910891
23412_marine,113,60,106,17,173,93.80530973451327,15.04424778761062
23413_marine,302,100,212,167,402,70.19867549668875,55.29801324503312
23414_marine,300,101,210,167,401,70,55.666666666666664
23415_marine,302,102,210,171,404,69.5364238410596,56.622516556291394
23416_marine,302,94,210,171,396,69.5364238410596,56.622516556291394
23417_marine,305,95,213,172,400,69.83606557377048,56.393442622950815
23418_marine,301,88,206,169,389,68.43853820598007,56.14617940199336
23419_marine,301,89,206,169,390,68.43853820598007,56.14617940199336
23420_marine,120,49,114,14,169,95,11.666666666666666
23421_marine,115,47,109,11,162,94.78260869565217,9.565217391304348
23422_marine,114,46,108,10,160,94.73684210526315,8.771929824561402
23423_marine,110,44,104,10,154,94.54545454545455,9.090909090909092
23424_marine,102,43,96,8,145,94.11764705882352,7.8431372549019605
23425_marine,98,43,92,8,141,93.87755102040816,8.16326530612245
23426_marine,94,43,88,8,137,93.61702127659575,8.51063829787234
23427_marine,93,43,87,7,136,93.54838709677419,7.526881720430108
23428_marine,90,43,85,7,133,94.44444444444444,7.777777777777778
23429_marine,89,43,85,6,132,95.50561797752809,6.741573033707865
23430_marine,89,43,85,6,132,95.50561797752809,6.741573033707865
23431_marine,89,41,85,6,130,95.50561797752809,6.741573033707865
23432_marine,87,41,83,6,128,95.40229885057471,6.896551724137931
23433_marine,84,40,80,5,124,95.23809523809523,5.952380952380952
23434_marine,84,40,80,5,124,95.23809523809523,5.952380952380952
23435_marine,83,40,79,4,123,95.18072289156626,4.819277108433735
23436_marine,82,40,78,4,122,95.1219512195122,4.878048780487805
23437_marine,82,40,78,4,122,95.1219512195122,4.878048780487805
23438_marine,80,40,76,4,120,95,5
23439_marine,80,40,76,4,120,95,5
23440_marine,82,40,78,4,122,95.1219512195122,4.878048780487805
23441_marine,82,40,78,4,122,95.1219512195122,4.878048780487805
23442_marine,82,40,78,4,122,95.1219512195122,4.878048780487805
23443_marine,82,40,78,4,122,95.1219512195122,4.878048780487805
23444_marine,81,40,77,4,121,95.06172839506173,4.938271604938271
23445_marine,82,40,78,4,122,95.1219512195122,4.878048780487805
23446_marine,82,40,78,4,122,95.1219512195122,4.878048780487805
23447_marine,82,39,78,2,121,95.1219512195122,2.4390243902439024
23448_marine,81,39,77,2,120,95.06172839506173,2.4691358024691357
23449_marine,79,39,75,2,118,94.9367088607595,2.5316455696202533
23450_marine,78,39,74,2,117,94.87179487179486,2.564102564102564
23451_marine,78,39,74,2,117,94.87179487179486,2.564102564102564
23452_marine,79,38,74,2,117,93.67088607594937,2.5316455696202533
23453_marine,79,38,74,2,117,93.67088607594937,2.5316455696202533
23454_marine,79,38,74,2,117,93.67088607594937,2.5316455696202533
23455_marine,83,38,78,2,121,93.97590361445783,2.4096385542168677
23456_marine,83,40,78,2,123,93.97590361445783,2.4096385542168677
23457_marine,85,40,80,2,125,94.11764705882352,2.3529411764705883
23458_marine,86,39,81,2,125,94.18604651162791,2.3255813953488373
23459_marine,85,39,80,2,124,94.11764705882352,2.3529411764705883
23460_marine,87,43,82,3,130,94.25287356321839,3.4482758620689653
23461_marine,91,43,86,3,134,94.5054945054945,3.296703296703297
23462_marine,95,43,90,4,138,94.73684210526315,4.2105263157894735
23463_marine,99,44,93,5,143,93.93939393939394,5.05050505050505
23464_marine,103,53,97,7,156,94.1747572815534,6.796116504854369
23465_marine,129,69,122,12,198,94.57364341085271,9.30232558139535
23466_marine,130,77,119,16,207,91.53846153846153,12.307692307692308
23467_marine,268,170,220,67,438,82.08955223880598,25
23468_marine,501,417,330,229,918,65.86826347305389,45.70858283433134
23469_marine,502,416,328,232,918,65.33864541832669,46.21513944223107
23470_marine,560,520,362,250,1080,64.64285714285715,44.642857142857146
23471_marine,526,483,341,238,1009,64.82889733840305,45.247148288973385
23483_marine,246,147,194,72,393,78.86178861788618,29.268292682926827
23484_marine,247,151,196,68,398,79.35222672064778,27.530364372469634
23485_marine,102,49,94,8,151,92.15686274509804,7.8431372549019605
23486_marine,90,38,82,8,128,91.11111111111111,8.88888888888889
23487_marine,89,37,81,6,126,91.01123595505618,6.741573033707865
23488_marine,89,35,81,6,124,91.01123595505618,6.741573033707865
23489_marine,87,37,79,6,124,90.80459770114942,6.896551724137931
23490_marine,105,40,97,8,145,92.38095238095238,7.6190476190476195
23491_marine,103,41,95,8,144,92.23300970873787,7.766990291262135
23492_marine,314,173,241,100,487,76.75159235668791,31.84713375796178
23493_marine,97,55,89,8,152,91.75257731958763,8.24742268041237
23494_marine,97,47,89,8,144,91.75257731958763,8.24742268041237
23495_marine,101,41,92,10,142,91.0891089108911,9.900990099009901
23496_marine,321,181,253,103,502,78.81619937694704,32.087227414330215
23497_marine,400,259,311,127,659,77.75,31.75
23498_marine,569,353,370,282,922,65.02636203866432,49.56063268892794
23499_marine,603,424,384,308,1027,63.681592039801,51.07794361525705
23501_marine,408,337,297,150,745,72.79411764705883,36.76470588235294
23507_marine,313,199,225,121,512,71.8849840255591,38.65814696485623
23508_marine,105,35,94,11,140,89.52380952380953,10.476190476190476
23509_marine,101,36,90,11,137,89.10891089108911,10.891089108910892
23510_marine,98,37,87,11,135,88.77551020408163,11.224489795918368
23511_marine,94,36,83,7,130,88.29787234042553,7.446808510638298
23512_marine,86,34,77,7,120,89.53488372093024,8.13953488372093
23513_marine,86,34,78,6,120,90.69767441860465,6.976744186046512
23514_marine,83,34,75,4,117,90.36144578313254,4.819277108433735
23515_marine,81,34,73,4,115,90.12345679012346,4.938271604938271
23516_marine,80,34,73,3,114,91.25,3.75
23517_marine,82,34,75,3,116,91.46341463414635,3.6585365853658534
23518_marine,83,34,75,3,117,90.36144578313254,3.614457831325301
23519_marine,83,34,75,3,117,90.36144578313254,3.614457831325301
23520_marine,83,34,75,3,117,90.36144578313254,3.614457831325301
23521_marine,84,34,76,4,118,90.47619047619048,4.761904761904762
23522_marine,84,33,76,4,117,90.47619047619048,4.761904761904762
23523_marine,84,33,76,4,117,90.47619047619048,4.761904761904762
23524_marine,84,33,76,4,117,90.47619047619048,4.761904761904762
23525_marine,84,33,76,4,117,90.47619047619048,4.761904761904762
23526_marine,84,33,76,4,117,90.47619047619048,4.761904761904762
23527_marine,84,33,76,4,117,90.47619047619048,4.761904761904762
23528_marine,80,33,72,4,113,90,5
23529_marine,80,33,72,4,113,90,5
23530_marine,82,33,74,4,115,90.2439024390244,4.878048780487805
23531_marine,80,33,74,2,113,92.5,2.5
23532_marine,80,32,74,2,112,92.5,2.5
23533_marine,81,32,75,2,113,92.5925925925926,2.4691358024691357
23534_marine,83,31,77,1,114,92.7710843373494,1.2048192771084338
23535_marine,81,31,75,1,112,92.5925925925926,1.2345679012345678
23536_marine,81,31,75,1,112,92.5925925925926,1.2345679012345678
23537_marine,80,31,75,0,111,93.75,0
23538_marine,83,30,78,0,113,93.97590361445783,0
23539_marine,84,30,79,0,114,94.04761904761905,0
23540_marine,84,30,79,0,114,94.04761904761905,0
23541_marine,85,30,80,0,115,94.11764705882352,0
23542_marine,85,30,80,0,115,94.11764705882352,0
23543_marine,83,30,78,0,113,93.97590361445783,0
23544_marine,84,30,79,0,114,94.04761904761905,0
23545_marine,85,30,78,0,115,91.76470588235294,0
23546_marine,85,30,78,0,115,91.76470588235294,0
23547_marine,85,30,78,0,115,91.76470588235294,0
23548_marine,85,30,78,0,115,91.76470588235294,0
23549_marine,86,30,79,1,116,91.86046511627907,1.1627906976744187
23550_marine,87,31,80,1,118,91.95402298850574,1.1494252873563218
23551_marine,88,31,81,2,119,92.04545454545455,2.272727272727273
23552_marine,87,31,80,2,118,91.95402298850574,2.2988505747126435
23553_marine,88,31,81,3,119,92.04545454545455,3.4090909090909087
23554_marine,86,31,79,3,117,91.86046511627907,3.488372093023256
23555_marine,86,31,79,3,117,91.86046511627907,3.488372093023256
23556_marine,89,31,81,4,120,91.01123595505618,4.49438202247191
23557_marine,95,33,86,6,128,90.52631578947368,6.315789473684211
23558_marine,98,33,88,7,131,89.79591836734694,7.142857142857142
23559_marine,100,33,90,7,133,90,7.000000000000001
23560_marine,107,41,97,8,148,90.65420560747664,7.476635514018691
23561_marine,111,35,101,8,146,90.990990990991,7.207207207207207
23562_marine,110,37,100,7,147,90.9090909090909,6.363636363636363
23563_marine,129,72,119,8,201,92.24806201550388,6.2015503875969
23564_marine,277,135,259,26,412,93.50180505415162,9.386281588447654
23565_marine,395,170,329,100,565,83.29113924050633,25.31645569620253
23566_marine,380,159,316,93,539,83.15789473684211,24.47368421052632
23615_marine,633,271,421,333,904,66.5086887835703,52.60663507109005
23616_marine,646,281,427,337,927,66.09907120743034,52.1671826625387
23617_marine,490,198,335,244,688,68.36734693877551,49.795918367346935
23618_marine,625,270,410,331,895,65.60000000000001,52.959999999999994
23619_marine,618,268,407,324,886,65.85760517799353,52.42718446601942
23631_marine,393,190,284,162,583,72.264631043257,41.221374045801525
23632_marine,442,212,321,205,654,72.62443438914026,46.380090497737555
23633_marine,445,209,322,209,654,72.35955056179775,46.96629213483146
23634_marine,448,207,326,215,655,72.76785714285714,47.99107142857143
23635_marine,477,229,339,232,706,71.0691823899371,48.63731656184486
23636_marine,333,146,260,121,479,78.07807807807808,36.33633633633634
23637_marine,525,281,393,214,806,74.85714285714286,40.76190476190476
23638_marine,404,196,327,121,600,80.94059405940595,29.950495049504948
23639_marine,402,192,325,118,594,80.84577114427861,29.35323383084577
23640_marine,393,195,316,113,588,80.40712468193384,28.75318066157761
23641_marine,310,159,264,74,469,85.16129032258064,23.870967741935484
23642_marine,343,181,296,69,524,86.29737609329446,20.11661807580175
23643_marine,331,191,287,67,522,86.70694864048339,20.241691842900302
23644_marine,321,195,277,67,516,86.29283489096574,20.87227414330218
23645_marine,321,194,277,67,515,86.29283489096574,20.87227414330218
23646_marine,307,185,260,63,492,84.69055374592834,20.521172638436482
23707_marine,904,343,559,534,1247,61.83628318584071,59.070796460176986
23708_marine,127,54,123,15,181,96.8503937007874,11.811023622047244
23709_marine,104,33,101,11,137,97.11538461538461,10.576923076923077
23710_marine,98,29,95,8,127,96.93877551020408,8.16326530612245
23711_marine,325,59,224,169,384,68.92307692307692,52
23712_marine,354,70,247,186,424,69.77401129943502,52.54237288135594
23713_marine,287,51,206,143,338,71.77700348432056,49.825783972125436
23714_marine,95,31,92,6,126,96.84210526315789,6.315789473684211
23715_marine,97,31,92,8,128,94.84536082474226,8.24742268041237
23716_marine,97,29,92,8,126,94.84536082474226,8.24742268041237
23717_marine,94,30,91,5,124,96.80851063829788,5.319148936170213
23718_marine,97,33,94,5,130,96.90721649484536,5.154639175257731
23719_marine,98,36,94,6,134,95.91836734693877,6.122448979591836
23720_marine,97,36,93,7,133,95.87628865979381,7.216494845360824
23721_marine,415,82,262,255,497,63.132530120481924,61.44578313253012
23722_marine,441,99,279,271,540,63.26530612244898,61.451247165532884
23723_marine,415,74,262,255,489,63.132530120481924,61.44578313253012
23724_marine,91,36,87,6,127,95.6043956043956,6.593406593406594
23725_marine,93,36,89,8,129,95.6989247311828,8.60215053763441
23726_marine,92,37,88,8,129,95.65217391304348,8.695652173913043
23727_marine,90,35,86,6,125,95.55555555555556,6.666666666666667
23728_marine,90,35,86,6,125,95.55555555555556,6.666666666666667
23729_marine,90,35,86,6,125,95.55555555555556,6.666666666666667
23730_marine,90,33,86,6,123,95.55555555555556,6.666666666666667
23731_marine,90,34,86,6,124,95.55555555555556,6.666666666666667
23732_marine,90,34,86,6,124,95.55555555555556,6.666666666666667
23733_marine,91,36,87,6,127,95.6043956043956,6.593406593406594
23734_marine,184,57,152,72,241,82.6086956521739,39.130434782608695
23735_marine,166,51,136,63,217,81.92771084337349,37.95180722891566
23736_marine,91,37,87,6,128,95.6043956043956,6.593406593406594
23737_marine,91,36,87,6,127,95.6043956043956,6.593406593406594
23738_marine,91,35,87,6,126,95.6043956043956,6.593406593406594
23739_marine,90,36,86,6,126,95.55555555555556,6.666666666666667
23740_marine,90,36,86,6,126,95.55555555555556,6.666666666666667
23741_marine,91,35,87,6,126,95.6043956043956,6.593406593406594
23742_marine,92,35,88,6,127,95.65217391304348,6.521739130434782
23743_marine,93,35,89,7,128,95.6989247311828,7.526881720430108
23744_marine,93,35,89,7,128,95.6989247311828,7.526881720430108
23745_marine,92,35,88,7,127,95.65217391304348,7.608695652173914
23746_marine,91,37,87,6,128,95.6043956043956,6.593406593406594
23747_marine,93,38,89,6,131,95.6989247311828,6.451612903225806
23748_marine,93,38,89,6,131,95.6989247311828,6.451612903225806
23749_marine,93,38,89,6,131,95.6989247311828,6.451612903225806
23750_marine,93,38,89,6,131,95.6989247311828,6.451612903225806
23751_marine,91,39,87,6,130,95.6043956043956,6.593406593406594
23752_marine,92,39,88,6,131,95.65217391304348,6.521739130434782
23753_marine,92,39,88,6,131,95.65217391304348,6.521739130434782
23754_marine,92,38,87,7,130,94.56521739130434,7.608695652173914
23755_marine,92,39,87,7,131,94.56521739130434,7.608695652173914
23756_marine,92,39,87,7,131,94.56521739130434,7.608695652173914
23757_marine,92,39,87,7,131,94.56521739130434,7.608695652173914
23758_marine,92,40,87,7,132,94.56521739130434,7.608695652173914
23759_marine,91,39,86,7,130,94.5054945054945,7.6923076923076925
23760_marine,91,39,86,7,130,94.5054945054945,7.6923076923076925
23761_marine,92,38,87,7,130,94.56521739130434,7.608695652173914
23762_marine,92,38,87,7,130,94.56521739130434,7.608695652173914
23763_marine,94,38,89,7,132,94.68085106382979,7.446808510638298
23764_marine,93,39,88,7,132,94.6236559139785,7.526881720430108
23765_marine,92,39,87,7,131,94.56521739130434,7.608695652173914
23766_marine,92,39,87,7,131,94.56521739130434,7.608695652173914
23767_marine,92,39,87,7,131,94.56521739130434,7.608695652173914
23768_marine,94,39,89,7,133,94.68085106382979,7.446808510638298
23769_marine,99,39,94,8,138,94.94949494949495,8.080808080808081
23770_marine,99,39,94,8,138,94.94949494949495,8.080808080808081
23771_marine,101,39,96,10,140,95.04950495049505,9.900990099009901
23772_marine,103,49,98,9,152,95.14563106796116,8.737864077669903
23773_marine,298,94,208,167,392,69.79865771812081,56.04026845637584
23774_marine,338,110,241,191,448,71.30177514792899,56.50887573964497
23775_marine,310,102,218,171,412,70.3225806451613,55.16129032258065
23776_marine,341,113,244,194,454,71.5542521994135,56.89149560117303
23777_marine,314,107,222,171,421,70.70063694267516,54.45859872611465
23778_marine,341,112,236,183,453,69.20821114369502,53.665689149560116
23779_marine,373,127,263,206,500,70.50938337801608,55.22788203753352
23780_marine,357,137,246,192,494,68.90756302521008,53.78151260504202
23781_marine,357,138,246,192,495,68.90756302521008,53.78151260504202
23782_marine,354,136,245,190,490,69.2090395480226,53.672316384180796
23783_marine,125,48,117,13,173,93.60000000000001,10.4
23784_marine,122,49,114,12,171,93.44262295081968,9.836065573770492
23785_marine,118,46,110,10,164,93.22033898305084,8.47457627118644
23786_marine,106,43,98,8,149,92.45283018867924,7.547169811320755
23787_marine,106,43,98,8,149,92.45283018867924,7.547169811320755
23788_marine,101,43,95,7,144,94.05940594059405,6.9306930693069315
23789_marine,95,43,91,6,138,95.78947368421052,6.315789473684211
23790_marine,93,43,89,6,136,95.6989247311828,6.451612903225806
23791_marine,91,42,87,6,133,95.6043956043956,6.593406593406594
23792_marine,89,41,85,6,130,95.50561797752809,6.741573033707865
23793_marine,87,41,83,6,128,95.40229885057471,6.896551724137931
23794_marine,87,40,83,6,127,95.40229885057471,6.896551724137931
23795_marine,84,40,80,5,124,95.23809523809523,5.952380952380952
23796_marine,82,40,78,4,122,95.1219512195122,4.878048780487805
23797_marine,82,41,78,4,123,95.1219512195122,4.878048780487805
23798_marine,82,41,78,4,123,95.1219512195122,4.878048780487805
23799_marine,78,41,74,2,119,94.87179487179486,2.564102564102564
23800_marine,78,41,74,2,119,94.87179487179486,2.564102564102564
23801_marine,78,40,74,2,118,94.87179487179486,2.564102564102564
23802_marine,80,40,76,2,120,95,2.5
23803_marine,79,40,75,2,119,94.9367088607595,2.5316455696202533
23804_marine,80,40,76,2,120,95,2.5
23805_marine,80,39,76,2,119,95,2.5
23806_marine,82,39,78,2,121,95.1219512195122,2.4390243902439024
23807_marine,82,39,78,2,121,95.1219512195122,2.4390243902439024
23808_marine,80,39,76,2,119,95,2.5
23809_marine,80,39,76,2,119,95,2.5
23810_marine,80,39,76,2,119,95,2.5
23811_marine,80,38,76,2,118,95,2.5
23812_marine,83,37,78,2,120,93.97590361445783,2.4096385542168677
23813_marine,82,37,77,2,119,93.90243902439023,2.4390243902439024
23814_marine,82,38,77,2,120,93.90243902439023,2.4390243902439024
23815_marine,83,38,78,2,121,93.97590361445783,2.4096385542168677
23816_marine,83,40,78,2,123,93.97590361445783,2.4096385542168677
23817_marine,85,40,80,2,125,94.11764705882352,2.3529411764705883
23818_marine,84,40,79,2,124,94.04761904761905,2.380952380952381
23819_marine,84,39,79,2,123,94.04761904761905,2.380952380952381
23820_marine,87,42,82,3,129,94.25287356321839,3.4482758620689653
23821_marine,88,44,83,3,132,94.31818181818183,3.4090909090909087
23822_marine,94,44,89,4,138,94.68085106382979,4.25531914893617
23823_marine,98,44,92,5,142,93.87755102040816,5.1020408163265305
23824_marine,105,49,97,10,154,92.38095238095238,9.523809523809524
23825_marine,106,49,98,10,155,92.45283018867924,9.433962264150944
23826_marine,119,55,107,15,174,89.91596638655463,12.605042016806722
23827_marine,133,76,120,18,209,90.22556390977444,13.533834586466165
23828_marine,306,223,254,77,529,83.00653594771242,25.163398692810457
23829_marine,312,227,258,80,539,82.6923076923077,25.64102564102564
23832_marine,335,298,270,92,633,80.59701492537313,27.46268656716418
23844_marine,233,117,186,64,350,79.82832618025752,27.467811158798284
23845_marine,87,38,80,7,125,91.95402298850574,8.045977011494253
23846_marine,87,36,80,7,123,91.95402298850574,8.045977011494253
23847_marine,86,36,78,6,122,90.69767441860465,6.976744186046512
23848_marine,103,36,95,6,139,92.23300970873787,5.825242718446602
23849_marine,315,149,244,90,464,77.46031746031747,28.57142857142857
23850_marine,329,173,256,102,502,77.81155015197568,31.00303951367781
23851_marine,343,179,270,108,522,78.71720116618076,31.486880466472307
23852_marine,342,191,269,108,533,78.65497076023392,31.57894736842105
23853_marine,336,195,263,106,531,78.27380952380952,31.547619047619047
23854_marine,102,57,93,9,159,91.17647058823529,8.823529411764707
23855_marine,345,183,259,122,528,75.07246376811594,35.36231884057971
23856_marine,366,192,274,131,558,74.86338797814209,35.79234972677596
23861_marine,503,319,328,247,822,65.20874751491054,49.10536779324055
23862_marine,371,280,272,140,651,73.31536388140162,37.735849056603776
23867_marine,443,272,270,245,715,60.94808126410835,55.30474040632054
23868_marine,314,189,229,121,503,72.92993630573248,38.53503184713376
23869_marine,113,36,102,12,149,90.2654867256637,10.619469026548673
23870_marine,104,36,93,11,140,89.42307692307693,10.576923076923077
23871_marine,102,37,91,11,139,89.2156862745098,10.784313725490197
23872_marine,97,37,86,10,134,88.65979381443299,10.309278350515463
23873_marine,91,36,82,6,127,90.10989010989012,6.593406593406594
23874_marine,86,36,78,5,122,90.69767441860465,5.813953488372093
23875_marine,83,36,75,5,119,90.36144578313254,6.024096385542169
23876_marine,81,34,73,5,115,90.12345679012346,6.172839506172839
23877_marine,82,34,74,5,116,90.2439024390244,6.097560975609756
23878_marine,83,34,75,5,117,90.36144578313254,6.024096385542169
23879_marine,83,34,75,4,117,90.36144578313254,4.819277108433735
23880_marine,82,34,74,3,116,90.2439024390244,3.6585365853658534
23881_marine,82,34,74,3,116,90.2439024390244,3.6585365853658534
23882_marine,82,34,74,3,116,90.2439024390244,3.6585365853658534
23883_marine,82,33,74,4,115,90.2439024390244,4.878048780487805
23884_marine,83,33,75,4,116,90.36144578313254,4.819277108433735
23885_marine,82,33,74,4,115,90.2439024390244,4.878048780487805
23886_marine,82,33,74,4,115,90.2439024390244,4.878048780487805
23887_marine,82,33,74,4,115,90.2439024390244,4.878048780487805
23888_marine,82,33,74,4,115,90.2439024390244,4.878048780487805
23889_marine,80,33,72,4,113,90,5
23890_marine,80,33,72,4,113,90,5
23891_marine,83,33,75,4,116,90.36144578313254,4.819277108433735
23892_marine,81,33,75,1,114,92.5925925925926,1.2345679012345678
23893_marine,81,32,75,1,113,92.5925925925926,1.2345679012345678
23894_marine,83,32,77,1,115,92.7710843373494,1.2048192771084338
23895_marine,83,31,77,1,114,92.7710843373494,1.2048192771084338
23896_marine,82,31,77,0,113,93.90243902439023,0
23897_marine,82,30,77,0,112,93.90243902439023,0
23898_marine,82,30,77,0,112,93.90243902439023,0
23899_marine,83,30,78,0,113,93.97590361445783,0
23900_marine,85,30,80,0,115,94.11764705882352,0
23901_marine,85,30,80,0,115,94.11764705882352,0
23902_marine,87,30,82,0,117,94.25287356321839,0
23903_marine,87,30,82,0,117,94.25287356321839,0
23904_marine,85,30,80,0,115,94.11764705882352,0
23905_marine,85,30,80,0,115,94.11764705882352,0
23906_marine,85,30,80,0,115,94.11764705882352,0
23907_marine,83,30,78,0,113,93.97590361445783,0
23908_marine,84,30,79,0,114,94.04761904761905,0
23909_marine,84,31,79,0,115,94.04761904761905,0
23910_marine,88,31,81,2,119,92.04545454545455,2.272727272727273
23911_marine,88,31,81,2,119,92.04545454545455,2.272727272727273
23912_marine,89,31,82,2,120,92.13483146067416,2.247191011235955
23913_marine,88,31,81,3,119,92.04545454545455,3.4090909090909087
23914_marine,88,31,81,3,119,92.04545454545455,3.4090909090909087
23915_marine,90,31,83,3,121,92.22222222222223,3.3333333333333335
23916_marine,90,31,82,5,121,91.11111111111111,5.555555555555555
23917_marine,96,33,87,7,129,90.625,7.291666666666667
23918_marine,97,33,87,8,130,89.69072164948454,8.24742268041237
23919_marine,99,33,89,8,132,89.8989898989899,8.080808080808081
23920_marine,105,41,95,8,146,90.47619047619048,7.6190476190476195
23921_marine,110,35,100,8,145,90.9090909090909,7.2727272727272725
23922_marine,116,47,108,8,163,93.10344827586206,6.896551724137931
23923_marine,259,129,246,21,388,94.98069498069498,8.108108108108109
23924_marine,398,185,335,103,583,84.17085427135679,25.879396984924625
23925_marine,384,160,322,100,544,83.85416666666666,26.041666666666668
23976_marine,647,288,431,335,935,66.61514683153014,51.777434312210204
23977_marine,529,226,361,266,755,68.24196597353497,50.2835538752363
23978_marine,527,219,354,271,746,67.17267552182163,51.423149905123346
23979_marine,627,275,414,329,902,66.02870813397129,52.472089314194584
23992_marine,381,180,279,161,561,73.22834645669292,42.25721784776903
23993_marine,382,178,281,162,560,73.56020942408377,42.40837696335078
23998_marine,532,274,397,211,806,74.62406015037594,39.661654135338345
23999_marine,451,208,360,138,659,79.82261640798227,30.598669623059866
24000_marine,418,195,336,120,613,80.38277511961722,28.708133971291865
24001_marine,386,168,309,111,554,80.05181347150258,28.756476683937827
24002_marine,117,41,111,13,158,94.87179487179486,11.11111111111111
24003_marine,109,37,104,11,146,95.41284403669725,10.091743119266056
24004_marine,107,36,102,11,143,95.32710280373831,10.2803738317757
24005_marine,102,35,98,10,137,96.07843137254902,9.803921568627452
24006_marine,105,41,101,8,146,96.19047619047619,7.6190476190476195
24007_marine,306,192,261,59,498,85.29411764705883,19.28104575163399
24059_marine,656,280,515,234,936,78.5060975609756,35.670731707317074
24060_marine,1185,464,843,583,1649,71.13924050632912,49.19831223628692
24063_marine,1062,435,707,558,1497,66.57250470809792,52.54237288135594
24064_marine,929,364,587,536,1293,63.18622174381054,57.69644779332616
24065_marine,903,337,557,539,1240,61.683277962347724,59.68992248062015
24066_marine,894,331,549,535,1225,61.40939597315436,59.8434004474273
24067_marine,877,310,537,530,1187,61.23147092360319,60.43329532497149
24068_marine,100,31,97,8,131,97,8
24069_marine,96,27,93,6,123,96.875,6.25
24070_marine,96,27,93,6,123,96.875,6.25
24071_marine,290,51,209,143,341,72.06896551724138,49.310344827586206
24072_marine,289,51,208,143,340,71.97231833910035,49.48096885813148
24073_marine,96,30,93,6,126,96.875,6.25
24074_marine,95,29,92,6,124,96.84210526315789,6.315789473684211
24075_marine,94,29,91,5,123,96.80851063829788,5.319148936170213
24076_marine,94,29,91,5,123,96.80851063829788,5.319148936170213
24077_marine,94,29,91,5,123,96.80851063829788,5.319148936170213
24078_marine,97,31,94,5,128,96.90721649484536,5.154639175257731
24079_marine,98,31,94,6,129,95.91836734693877,6.122448979591836
24080_marine,98,31,94,6,129,95.91836734693877,6.122448979591836
24081_marine,411,68,262,251,479,63.74695863746959,61.0705596107056
24082_marine,411,75,262,251,486,63.74695863746959,61.0705596107056
24083_marine,411,69,262,251,480,63.74695863746959,61.0705596107056
24084_marine,92,33,88,6,125,95.65217391304348,6.521739130434782
24085_marine,90,33,86,6,123,95.55555555555556,6.666666666666667
24086_marine,89,33,85,6,122,95.50561797752809,6.741573033707865
24087_marine,89,33,85,6,122,95.50561797752809,6.741573033707865
24088_marine,91,32,87,6,123,95.6043956043956,6.593406593406594
24089_marine,91,33,87,6,124,95.6043956043956,6.593406593406594
24090_marine,91,31,87,6,122,95.6043956043956,6.593406593406594
24091_marine,91,32,87,6,123,95.6043956043956,6.593406593406594
24092_marine,91,34,87,6,125,95.6043956043956,6.593406593406594
24093_marine,91,35,87,6,126,95.6043956043956,6.593406593406594
24094_marine,165,49,135,63,214,81.81818181818183,38.18181818181819
24095_marine,165,49,135,63,214,81.81818181818183,38.18181818181819
24096_marine,90,35,86,6,125,95.55555555555556,6.666666666666667
24097_marine,90,35,86,6,125,95.55555555555556,6.666666666666667
24098_marine,105,42,97,15,147,92.38095238095238,14.285714285714285
24099_marine,94,38,90,7,132,95.74468085106383,7.446808510638298
24100_marine,95,35,91,7,130,95.78947368421052,7.368421052631578
24101_marine,95,35,91,7,130,95.78947368421052,7.368421052631578
24102_marine,96,35,92,7,131,95.83333333333334,7.291666666666667
24103_marine,95,35,91,7,130,95.78947368421052,7.368421052631578
24104_marine,95,34,91,7,129,95.78947368421052,7.368421052631578
24105_marine,96,36,92,7,132,95.83333333333334,7.291666666666667
24106_marine,94,36,90,7,130,95.74468085106383,7.446808510638298
24107_marine,94,38,90,7,132,95.74468085106383,7.446808510638298
24108_marine,94,38,90,7,132,95.74468085106383,7.446808510638298
24109_marine,93,37,89,6,130,95.6989247311828,6.451612903225806
24110_marine,93,38,89,6,131,95.6989247311828,6.451612903225806
24111_marine,93,38,89,6,131,95.6989247311828,6.451612903225806
24112_marine,92,38,87,7,130,94.56521739130434,7.608695652173914
24113_marine,94,39,89,7,133,94.68085106382979,7.446808510638298
24114_marine,94,39,89,7,133,94.68085106382979,7.446808510638298
24115_marine,94,38,89,7,132,94.68085106382979,7.446808510638298
24116_marine,93,38,88,7,131,94.6236559139785,7.526881720430108
24117_marine,93,39,88,7,132,94.6236559139785,7.526881720430108
24118_marine,94,39,89,7,133,94.68085106382979,7.446808510638298
24119_marine,94,39,89,7,133,94.68085106382979,7.446808510638298
24120_marine,94,39,89,7,133,94.68085106382979,7.446808510638298
24121_marine,93,39,88,7,132,94.6236559139785,7.526881720430108
24122_marine,93,39,88,7,132,94.6236559139785,7.526881720430108
24123_marine,93,39,88,7,132,94.6236559139785,7.526881720430108
24124_marine,94,39,89,7,133,94.68085106382979,7.446808510638298
24125_marine,93,39,88,7,132,94.6236559139785,7.526881720430108
24126_marine,93,39,88,7,132,94.6236559139785,7.526881720430108
24127_marine,95,39,90,7,134,94.73684210526315,7.368421052631578
24128_marine,94,39,89,7,133,94.68085106382979,7.446808510638298
24129_marine,96,39,91,7,135,94.79166666666666,7.291666666666667
24130_marine,98,39,93,7,137,94.89795918367348,7.142857142857142
24131_marine,101,39,96,8,140,95.04950495049505,7.920792079207921
24132_marine,103,40,98,8,143,95.14563106796116,7.766990291262135
24133_marine,103,42,98,8,145,95.14563106796116,7.766990291262135
24134_marine,300,90,210,165,390,70,55.00000000000001
24135_marine,304,92,212,169,396,69.73684210526315,55.5921052631579
24136_marine,308,96,216,171,404,70.12987012987013,55.519480519480524
24137_marine,316,97,224,171,413,70.88607594936708,54.11392405063291
24138_marine,337,113,232,183,450,68.84272997032642,54.3026706231454
24139_marine,366,151,255,193,517,69.67213114754098,52.732240437158474
24140_marine,398,174,278,219,572,69.84924623115577,55.0251256281407
24142_marine,375,159,252,206,534,67.2,54.93333333333334
24143_marine,373,159,252,204,532,67.5603217158177,54.6916890080429
24144_marine,364,139,249,198,503,68.4065934065934,54.395604395604394
24145_marine,124,50,116,14,174,93.54838709677419,11.29032258064516
24146_marine,120,49,112,10,169,93.33333333333333,8.333333333333332
24147_marine,110,42,102,8,152,92.72727272727272,7.2727272727272725
24148_marine,106,41,100,8,147,94.33962264150944,7.547169811320755
24149_marine,95,43,91,6,138,95.78947368421052,6.315789473684211
24150_marine,95,43,91,6,138,95.78947368421052,6.315789473684211
24151_marine,95,42,91,6,137,95.78947368421052,6.315789473684211
24152_marine,93,42,89,6,135,95.6989247311828,6.451612903225806
24153_marine,91,41,87,6,132,95.6043956043956,6.593406593406594
24154_marine,89,41,85,6,130,95.50561797752809,6.741573033707865
24155_marine,88,40,84,6,128,95.45454545454545,6.8181818181818175
24156_marine,88,41,84,6,129,95.45454545454545,6.8181818181818175
24157_marine,82,41,78,2,123,95.1219512195122,2.4390243902439024
24158_marine,82,41,78,2,123,95.1219512195122,2.4390243902439024
24159_marine,82,41,78,2,123,95.1219512195122,2.4390243902439024
24160_marine,82,41,78,2,123,95.1219512195122,2.4390243902439024
24161_marine,82,41,78,2,123,95.1219512195122,2.4390243902439024
24162_marine,81,40,77,2,121,95.06172839506173,2.4691358024691357
24163_marine,80,40,76,2,120,95,2.5
24164_marine,80,39,76,2,119,95,2.5
24165_marine,82,39,78,2,121,95.1219512195122,2.4390243902439024
24166_marine,82,39,78,2,121,95.1219512195122,2.4390243902439024
24167_marine,82,39,78,2,121,95.1219512195122,2.4390243902439024
24168_marine,84,39,80,2,123,95.23809523809523,2.380952380952381
24169_marine,84,38,80,2,122,95.23809523809523,2.380952380952381
24170_marine,84,38,80,2,122,95.23809523809523,2.380952380952381
24171_marine,86,38,82,2,124,95.34883720930233,2.3255813953488373
24172_marine,86,38,82,2,124,95.34883720930233,2.3255813953488373
24173_marine,87,37,82,2,124,94.25287356321839,2.2988505747126435
24174_marine,87,37,82,2,124,94.25287356321839,2.2988505747126435
24175_marine,86,40,81,2,126,94.18604651162791,2.3255813953488373
24176_marine,87,40,82,3,127,94.25287356321839,3.4482758620689653
24177_marine,89,40,84,3,129,94.3820224719101,3.3707865168539324
24178_marine,89,40,84,3,129,94.3820224719101,3.3707865168539324
24179_marine,88,40,83,3,128,94.31818181818183,3.4090909090909087
24180_marine,89,43,84,4,132,94.3820224719101,4.49438202247191
24181_marine,89,42,84,4,131,94.3820224719101,4.49438202247191
24182_marine,91,44,86,5,135,94.5054945054945,5.4945054945054945
24183_marine,96,44,91,5,140,94.79166666666666,5.208333333333334
24184_marine,98,45,90,8,143,91.83673469387756,8.16326530612245
24185_marine,104,47,96,10,151,92.3076923076923,9.615384615384617
24186_marine,108,50,100,10,158,92.5925925925926,9.25925925925926
24187_marine,115,56,107,11,171,93.04347826086956,9.565217391304348
24188_marine,126,71,115,16,197,91.26984126984127,12.698412698412698
24189_marine,296,197,245,74,493,82.77027027027027,25
24192_marine,314,262,251,88,576,79.93630573248409,28.02547770700637
24193_marine,310,250,252,80,560,81.29032258064515,25.806451612903224
24204_marine,271,132,215,80,403,79.33579335793358,29.520295202952028
24205_marine,86,37,79,6,123,91.86046511627907,6.976744186046512
24206_marine,87,36,80,7,123,91.95402298850574,8.045977011494253
24207_marine,101,38,94,7,139,93.06930693069307,6.9306930693069315
24208_marine,318,176,247,90,494,77.67295597484278,28.30188679245283
24209_marine,351,204,268,106,555,76.35327635327636,30.1994301994302
24210_marine,345,198,272,106,543,78.84057971014494,30.72463768115942
24211_marine,369,199,281,130,568,76.15176151761518,35.230352303523034
24212_marine,339,182,266,109,521,78.46607669616519,32.15339233038348
24213_marine,346,204,269,113,550,77.74566473988439,32.65895953757225
24214_marine,347,207,269,114,554,77.52161383285303,32.85302593659942
24215_marine,369,211,275,133,580,74.52574525745257,36.043360433604335
24224_marine,358,265,262,132,623,73.18435754189943,36.87150837988827
24225_marine,453,300,284,235,753,62.69315673289183,51.87637969094923
24228_marine,446,272,275,247,718,61.65919282511211,55.381165919282516
24229_marine,319,190,230,126,509,72.10031347962382,39.49843260188088
24230_marine,310,169,226,117,479,72.90322580645162,37.74193548387097
24231_marine,104,34,93,11,138,89.42307692307693,10.576923076923077
24232_marine,102,37,91,11,139,89.2156862745098,10.784313725490197
24233_marine,102,37,91,11,139,89.2156862745098,10.784313725490197
24234_marine,96,37,87,10,133,90.625,10.416666666666668
24235_marine,90,38,81,8,128,90,8.88888888888889
24236_marine,87,38,79,5,125,90.80459770114942,5.747126436781609
24237_marine,83,36,75,5,119,90.36144578313254,6.024096385542169
24238_marine,81,34,73,5,115,90.12345679012346,6.172839506172839
24239_marine,82,34,74,5,116,90.2439024390244,6.097560975609756
24240_marine,82,34,74,5,116,90.2439024390244,6.097560975609756
24241_marine,82,34,74,4,116,90.2439024390244,4.878048780487805
24242_marine,82,34,74,4,116,90.2439024390244,4.878048780487805
24243_marine,81,34,73,4,115,90.12345679012346,4.938271604938271
24244_marine,81,34,73,4,115,90.12345679012346,4.938271604938271
24245_marine,80,33,72,3,113,90,3.75
24246_marine,81,33,73,4,114,90.12345679012346,4.938271604938271
24247_marine,81,33,73,4,114,90.12345679012346,4.938271604938271
24248_marine,82,33,74,4,115,90.2439024390244,4.878048780487805
24249_marine,81,33,73,3,114,90.12345679012346,3.7037037037037033
24250_marine,81,33,73,3,114,90.12345679012346,3.7037037037037033
24251_marine,82,33,74,3,115,90.2439024390244,3.6585365853658534
24252_marine,82,33,74,3,115,90.2439024390244,3.6585365853658534
24253_marine,81,32,75,1,113,92.5925925925926,1.2345679012345678
24254_marine,84,32,78,1,116,92.85714285714286,1.1904761904761905
24255_marine,83,31,78,0,114,93.97590361445783,0
24256_marine,83,31,78,0,114,93.97590361445783,0
24257_marine,83,30,78,0,113,93.97590361445783,0
24258_marine,84,30,79,0,114,94.04761904761905,0
24259_marine,84,30,79,0,114,94.04761904761905,0
24260_marine,84,30,79,0,114,94.04761904761905,0
24261_marine,85,30,80,0,115,94.11764705882352,0
24262_marine,86,30,81,0,116,94.18604651162791,0
24263_marine,88,30,83,0,118,94.31818181818183,0
24264_marine,88,30,83,0,118,94.31818181818183,0
24265_marine,88,30,83,0,118,94.31818181818183,0
24266_marine,86,30,81,0,116,94.18604651162791,0
24267_marine,86,30,81,0,116,94.18604651162791,0
24268_marine,87,30,82,0,117,94.25287356321839,0
24269_marine,88,31,83,1,119,94.31818181818183,1.1363636363636365
24270_marine,89,31,84,2,120,94.3820224719101,2.247191011235955
24271_marine,89,31,84,2,120,94.3820224719101,2.247191011235955
24272_marine,90,31,85,2,121,94.44444444444444,2.2222222222222223
24273_marine,89,31,84,2,120,94.3820224719101,2.247191011235955
24274_marine,89,31,84,4,120,94.3820224719101,4.49438202247191
24275_marine,91,31,86,4,122,94.5054945054945,4.395604395604396
24276_marine,90,31,84,5,121,93.33333333333333,5.555555555555555
24277_marine,98,33,91,7,131,92.85714285714286,7.142857142857142
24278_marine,97,33,89,8,130,91.75257731958763,8.24742268041237
24279_marine,99,33,91,8,132,91.91919191919192,8.080808080808081
24280_marine,108,33,100,8,141,92.5925925925926,7.4074074074074066
24281_marine,110,33,102,8,143,92.72727272727272,7.2727272727272725
24282_marine,119,53,112,7,172,94.11764705882352,5.88235294117647
24283_marine,279,133,264,27,412,94.6236559139785,9.67741935483871
24284_marine,394,164,332,98,558,84.26395939086294,24.873096446700508
24336_marine,636,272,423,330,908,66.50943396226415,51.886792452830186
24337_marine,654,280,435,341,934,66.5137614678899,52.14067278287462
24338_marine,502,205,347,245,707,69.12350597609563,48.80478087649402
24339_marine,631,286,417,332,917,66.08557844690966,52.6148969889065
24340_marine,639,294,420,339,933,65.72769953051643,53.051643192488264
24360_marine,566,279,413,228,845,72.96819787985865,40.282685512367486
24361_marine,411,179,319,128,590,77.61557177615572,31.143552311435524
24362_marine,107,41,101,12,148,94.39252336448598,11.214953271028037
24363_marine,96,40,92,9,136,95.83333333333334,9.375
24364_marine,93,35,89,8,128,95.6989247311828,8.60215053763441
24365_marine,90,34,86,5,124,95.55555555555556,5.555555555555555
24366_marine,94,32,90,5,126,95.74468085106383,5.319148936170213
24367_marine,102,38,98,8,140,96.07843137254902,7.8431372549019605
24368_marine,308,165,264,64,473,85.71428571428571,20.77922077922078
24418_marine,561,255,447,199,816,79.67914438502673,35.47237076648842
24419_marine,644,258,504,229,902,78.26086956521739,35.55900621118012
24420_marine,1104,463,761,539,1567,68.93115942028986,48.822463768115945
24423_marine,1026,367,682,540,1393,66.47173489278752,52.63157894736842
24424_marine,130,36,126,16,166,96.92307692307692,12.307692307692308
24425_marine,117,32,114,10,149,97.43589743589743,8.547008547008547
24426_marine,106,31,103,7,137,97.16981132075472,6.60377358490566
24427_marine,103,31,100,5,134,97.0873786407767,4.854368932038835
24428_marine,97,29,94,5,126,96.90721649484536,5.154639175257731
24429_marine,96,27,93,6,123,96.875,6.25
24430_marine,96,27,93,6,123,96.875,6.25
24431_marine,94,26,91,5,120,96.80851063829788,5.319148936170213
24432_marine,90,26,87,5,116,96.66666666666667,5.555555555555555
24433_marine,93,28,90,5,121,96.7741935483871,5.376344086021505
24434_marine,93,28,90,5,121,96.7741935483871,5.376344086021505
24435_marine,92,29,89,5,121,96.73913043478261,5.434782608695652
24436_marine,92,29,89,5,121,96.73913043478261,5.434782608695652
24437_marine,92,29,89,5,121,96.73913043478261,5.434782608695652
24438_marine,95,29,91,7,124,95.78947368421052,7.368421052631578
24439_marine,99,31,95,7,130,95.95959595959596,7.07070707070707
24440_marine,99,31,95,7,130,95.95959595959596,7.07070707070707
24441_marine,99,31,95,7,130,95.95959595959596,7.07070707070707
24442_marine,100,33,95,8,133,95,8
24443_marine,97,33,92,8,130,94.84536082474226,8.24742268041237
24444_marine,97,33,92,8,130,94.84536082474226,8.24742268041237
24445_marine,97,36,92,8,133,94.84536082474226,8.24742268041237
24446_marine,95,36,90,8,131,94.73684210526315,8.421052631578947
24447_marine,94,33,89,8,127,94.68085106382979,8.51063829787234
24448_marine,92,32,87,8,124,94.56521739130434,8.695652173913043
24449_marine,91,33,86,8,124,94.5054945054945,8.791208791208792
24450_marine,93,32,88,8,125,94.6236559139785,8.60215053763441
24451_marine,93,32,88,8,125,94.6236559139785,8.60215053763441
24452_marine,93,33,88,8,126,94.6236559139785,8.60215053763441
24453_marine,93,33,88,8,126,94.6236559139785,8.60215053763441
24454_marine,92,33,88,7,125,95.65217391304348,7.608695652173914
24455_marine,92,33,88,7,125,95.65217391304348,7.608695652173914
24456_marine,92,34,88,7,126,95.65217391304348,7.608695652173914
24457_marine,92,34,88,7,126,95.65217391304348,7.608695652173914
24458_marine,95,36,91,7,131,95.78947368421052,7.368421052631578
24459_marine,94,37,90,7,131,95.74468085106383,7.446808510638298
24460_marine,95,35,91,7,130,95.78947368421052,7.368421052631578
24461_marine,96,35,92,7,131,95.83333333333334,7.291666666666667
24462_marine,96,34,92,7,130,95.83333333333334,7.291666666666667
24463_marine,96,34,92,7,130,95.83333333333334,7.291666666666667
24464_marine,96,35,92,7,131,95.83333333333334,7.291666666666667
24465_marine,96,35,92,7,131,95.83333333333334,7.291666666666667
24466_marine,96,34,92,7,130,95.83333333333334,7.291666666666667
24467_marine,95,35,90,8,130,94.73684210526315,8.421052631578947
24468_marine,97,37,92,8,134,94.84536082474226,8.24742268041237
24469_marine,95,37,90,8,132,94.73684210526315,8.421052631578947
24470_marine,94,37,89,7,131,94.68085106382979,7.446808510638298
24471_marine,96,38,91,7,134,94.79166666666666,7.291666666666667
24472_marine,96,38,91,7,134,94.79166666666666,7.291666666666667
24473_marine,94,38,89,7,132,94.68085106382979,7.446808510638298
24474_marine,94,38,89,7,132,94.68085106382979,7.446808510638298
24475_marine,94,38,89,7,132,94.68085106382979,7.446808510638298
24476_marine,94,38,89,7,132,94.68085106382979,7.446808510638298
24477_marine,94,38,89,7,132,94.68085106382979,7.446808510638298
24478_marine,94,38,89,7,132,94.68085106382979,7.446808510638298
24479_marine,95,40,90,7,135,94.73684210526315,7.368421052631578
24480_marine,95,40,90,7,135,94.73684210526315,7.368421052631578
24481_marine,94,38,89,7,132,94.68085106382979,7.446808510638298
24482_marine,94,39,89,7,133,94.68085106382979,7.446808510638298
24483_marine,93,39,88,7,132,94.6236559139785,7.526881720430108
24484_marine,93,39,88,7,132,94.6236559139785,7.526881720430108
24485_marine,94,39,89,7,133,94.68085106382979,7.446808510638298
24486_marine,94,39,89,7,133,94.68085106382979,7.446808510638298
24487_marine,97,39,92,7,136,94.84536082474226,7.216494845360824
24488_marine,97,39,92,7,136,94.84536082474226,7.216494845360824
24489_marine,99,39,94,7,138,94.94949494949495,7.07070707070707
24490_marine,99,39,94,7,138,94.94949494949495,7.07070707070707
24491_marine,100,40,95,7,140,95,7.000000000000001
24492_marine,102,40,97,7,142,95.09803921568627,6.862745098039216
24493_marine,103,41,98,8,144,95.14563106796116,7.766990291262135
24494_marine,103,41,98,8,144,95.14563106796116,7.766990291262135
24495_marine,102,43,97,7,145,95.09803921568627,6.862745098039216
24496_marine,104,44,99,9,148,95.1923076923077,8.653846153846153
24497_marine,116,47,111,13,163,95.6896551724138,11.206896551724139
24498_marine,126,48,118,13,174,93.65079365079364,10.317460317460316
24499_marine,356,146,245,191,502,68.82022471910112,53.65168539325843
24505_marine,367,147,250,200,514,68.11989100817438,54.495912806539515
24506_marine,132,64,124,14,196,93.93939393939394,10.606060606060606
24507_marine,125,50,117,13,175,93.60000000000001,10.4
24508_marine,109,45,103,9,154,94.4954128440367,8.256880733944955
24509_marine,106,41,101,8,147,95.28301886792453,7.547169811320755
24510_marine,95,41,91,6,136,95.78947368421052,6.315789473684211
24511_marine,95,40,91,6,135,95.78947368421052,6.315789473684211
24512_marine,93,42,89,6,135,95.6989247311828,6.451612903225806
24513_marine,93,42,89,6,135,95.6989247311828,6.451612903225806
24514_marine,89,41,85,6,130,95.50561797752809,6.741573033707865
24515_marine,88,41,84,6,129,95.45454545454545,6.8181818181818175
24516_marine,88,41,84,6,129,95.45454545454545,6.8181818181818175
24517_marine,86,41,82,4,127,95.34883720930233,4.651162790697675
24518_marine,84,41,80,2,125,95.23809523809523,2.380952380952381
24519_marine,84,41,80,2,125,95.23809523809523,2.380952380952381
24520_marine,84,41,80,2,125,95.23809523809523,2.380952380952381
24521_marine,83,41,79,2,124,95.18072289156626,2.4096385542168677
24522_marine,85,41,81,3,126,95.29411764705881,3.5294117647058822
24523_marine,85,40,81,3,125,95.29411764705881,3.5294117647058822
24524_marine,87,39,83,3,126,95.40229885057471,3.4482758620689653
24525_marine,87,39,83,3,126,95.40229885057471,3.4482758620689653
24526_marine,87,39,83,3,126,95.40229885057471,3.4482758620689653
24527_marine,87,38,83,3,125,95.40229885057471,3.4482758620689653
24528_marine,87,38,83,3,125,95.40229885057471,3.4482758620689653
24529_marine,87,38,83,3,125,95.40229885057471,3.4482758620689653
24530_marine,87,38,83,3,125,95.40229885057471,3.4482758620689653
24531_marine,87,38,83,3,125,95.40229885057471,3.4482758620689653
24532_marine,87,38,83,3,125,95.40229885057471,3.4482758620689653
24533_marine,87,37,83,3,124,95.40229885057471,3.4482758620689653
24534_marine,87,37,83,3,124,95.40229885057471,3.4482758620689653
24535_marine,88,40,83,3,128,94.31818181818183,3.4090909090909087
24536_marine,88,40,83,3,128,94.31818181818183,3.4090909090909087
24537_marine,87,40,82,3,127,94.25287356321839,3.4482758620689653
24538_marine,89,40,84,3,129,94.3820224719101,3.3707865168539324
24539_marine,90,40,85,3,130,94.44444444444444,3.3333333333333335
24540_marine,90,42,85,4,132,94.44444444444444,4.444444444444445
24541_marine,91,43,86,4,134,94.5054945054945,4.395604395604396
24542_marine,93,42,88,5,135,94.6236559139785,5.376344086021505
24543_marine,94,44,89,7,138,94.68085106382979,7.446808510638298
24544_marine,100,46,94,8,146,94,8
24545_marine,103,50,95,10,153,92.23300970873787,9.70873786407767
24546_marine,104,51,98,8,155,94.23076923076923,7.6923076923076925
24547_marine,106,52,100,8,158,94.33962264150944,7.547169811320755
24548_marine,112,54,105,11,166,93.75,9.821428571428571
24549_marine,118,56,111,11,174,94.0677966101695,9.322033898305085
24550_marine,281,197,230,71,478,81.85053380782918,25.26690391459075
24551_marine,283,206,233,72,489,82.3321554770318,25.4416961130742
24552_marine,122,54,115,13,176,94.26229508196722,10.655737704918032
24553_marine,297,231,240,75,528,80.8080808080808,25.252525252525253
24554_marine,386,356,281,142,742,72.7979274611399,36.787564766839374
24564_marine,294,171,233,88,465,79.25170068027211,29.931972789115648
24565_marine,96,40,89,6,136,92.70833333333334,6.25
24566_marine,86,35,79,6,121,91.86046511627907,6.976744186046512
24567_marine,102,35,95,6,137,93.13725490196079,5.88235294117647
24568_marine,327,185,256,89,512,78.2874617737003,27.217125382262996
24569_marine,335,181,264,94,516,78.80597014925374,28.059701492537314
24570_marine,391,206,290,146,597,74.16879795396419,37.34015345268542
24571_marine,387,196,285,150,583,73.64341085271317,38.759689922480625
24575_marine,390,239,295,134,629,75.64102564102564,34.35897435897436
24579_marine,484,239,306,249,723,63.22314049586777,51.446280991735534
24586_marine,348,219,253,133,567,72.70114942528735,38.2183908045977
24590_marine,320,192,233,126,512,72.8125,39.375
24591_marine,112,37,101,11,149,90.17857142857143,9.821428571428571
24592_marine,111,34,100,12,145,90.09009009009009,10.81081081081081
24593_marine,105,34,94,12,139,89.52380952380953,11.428571428571429
24594_marine,103,35,92,12,138,89.32038834951457,11.650485436893204
24595_marine,100,39,89,11,139,89,11
24596_marine,95,39,86,9,134,90.52631578947368,9.473684210526317
24597_marine,91,38,83,8,129,91.20879120879121,8.791208791208792
24598_marine,87,36,79,6,123,90.80459770114942,6.896551724137931
24599_marine,86,34,78,6,120,90.69767441860465,6.976744186046512
24600_marine,82,34,74,5,116,90.2439024390244,6.097560975609756
24601_marine,82,34,74,5,116,90.2439024390244,6.097560975609756
24602_marine,82,34,73,5,116,89.02439024390245,6.097560975609756
24603_marine,82,34,73,5,116,89.02439024390245,6.097560975609756
24604_marine,81,34,73,4,115,90.12345679012346,4.938271604938271
24605_marine,81,34,73,4,115,90.12345679012346,4.938271604938271
24606_marine,81,34,73,4,115,90.12345679012346,4.938271604938271
24607_marine,81,33,73,4,114,90.12345679012346,4.938271604938271
24608_marine,80,33,72,3,113,90,3.75
24609_marine,80,33,72,3,113,90,3.75
24610_marine,80,33,72,3,113,90,3.75
24611_marine,83,33,75,3,116,90.36144578313254,3.614457831325301
24612_marine,83,33,75,3,116,90.36144578313254,3.614457831325301
24613_marine,82,32,76,1,114,92.6829268292683,1.2195121951219512
24614_marine,80,32,75,0,112,93.75,0
24615_marine,80,31,75,0,111,93.75,0
24616_marine,82,31,77,0,113,93.90243902439023,0
24617_marine,82,30,77,0,112,93.90243902439023,0
24618_marine,83,30,78,0,113,93.97590361445783,0
24619_marine,83,30,78,0,113,93.97590361445783,0
24620_marine,84,30,79,0,114,94.04761904761905,0
24621_marine,84,30,79,0,114,94.04761904761905,0
24622_marine,85,30,80,0,115,94.11764705882352,0
24623_marine,85,30,80,0,115,94.11764705882352,0
24624_marine,85,30,80,0,115,94.11764705882352,0
24625_marine,85,30,80,0,115,94.11764705882352,0
24626_marine,87,30,82,0,117,94.25287356321839,0
24627_marine,88,30,83,0,118,94.31818181818183,0
24628_marine,89,30,84,1,119,94.3820224719101,1.1235955056179776
24629_marine,89,31,84,1,120,94.3820224719101,1.1235955056179776
24630_marine,89,31,84,1,120,94.3820224719101,1.1235955056179776
24631_marine,90,31,85,2,121,94.44444444444444,2.2222222222222223
24632_marine,92,31,87,3,123,94.56521739130434,3.260869565217391
24633_marine,91,31,86,3,122,94.5054945054945,3.296703296703297
24634_marine,94,31,89,4,125,94.68085106382979,4.25531914893617
24635_marine,92,31,87,4,123,94.56521739130434,4.3478260869565215
24636_marine,91,31,85,5,122,93.4065934065934,5.4945054945054945
24637_marine,99,33,92,7,132,92.92929292929293,7.07070707070707
24638_marine,100,33,92,8,133,92,8
24639_marine,103,33,95,8,136,92.23300970873787,7.766990291262135
24640_marine,107,33,99,8,140,92.5233644859813,7.476635514018691
24641_marine,112,33,105,7,145,93.75,6.25
24642_marine,132,63,123,11,195,93.18181818181817,8.333333333333332
24643_marine,428,194,359,117,622,83.8785046728972,27.33644859813084
24644_marine,419,170,350,118,589,83.53221957040573,28.162291169451077
24697_marine,651,278,430,341,929,66.05222734254991,52.38095238095239
24698_marine,655,275,433,343,930,66.10687022900763,52.36641221374045
24699_marine,641,291,421,340,932,65.6786271450858,53.042121684867396
24700_marine,644,302,422,345,946,65.527950310559,53.57142857142857
24719_marine,545,273,388,229,818,71.19266055045873,42.018348623853214
24720_marine,574,279,409,242,853,71.25435540069687,42.1602787456446
24721_marine,398,169,304,129,567,76.38190954773869,32.41206030150754
24722_marine,100,40,95,10,140,95,10
24723_marine,92,36,88,7,128,95.65217391304348,7.608695652173914
24724_marine,85,34,81,6,119,95.29411764705881,7.0588235294117645
24725_marine,83,31,79,4,114,95.18072289156626,4.819277108433735
24726_marine,89,32,85,4,121,95.50561797752809,4.49438202247191
24727_marine,99,34,95,8,133,95.95959595959596,8.080808080808081
24728_marine,111,40,106,10,151,95.4954954954955,9.00900900900901
24729_marine,336,178,279,73,514,83.03571428571429,21.726190476190478
24767_marine,722,268,534,403,990,73.9612188365651,55.81717451523546
24775_marine,725,302,569,318,1027,78.48275862068965,43.862068965517246
24776_marine,703,235,542,321,938,77.0981507823613,45.66145092460882
24777_marine,708,237,537,318,945,75.84745762711864,44.91525423728814
24778_marine,701,238,528,314,939,75.320970042796,44.79315263908702
24779_marine,144,56,137,19,200,95.13888888888889,13.194444444444445
24780_marine,1028,362,693,535,1390,67.41245136186771,52.04280155642024
24782_marine,1174,522,786,623,1696,66.95059625212947,53.0664395229983
24783_marine,1010,395,655,548,1405,64.85148514851485,54.25742574257426
24784_marine,122,32,118,14,154,96.72131147540983,11.475409836065573
24785_marine,106,28,102,9,134,96.22641509433963,8.49056603773585
24786_marine,102,29,98,7,131,96.07843137254902,6.862745098039216
24787_marine,96,29,92,7,125,95.83333333333334,7.291666666666667
24788_marine,96,28,92,7,124,95.83333333333334,7.291666666666667
24789_marine,95,26,91,7,121,95.78947368421052,7.368421052631578
24790_marine,95,26,91,7,121,95.78947368421052,7.368421052631578
24791_marine,94,26,90,7,120,95.74468085106383,7.446808510638298
24792_marine,92,28,89,6,120,96.73913043478261,6.521739130434782
24793_marine,93,28,90,6,121,96.7741935483871,6.451612903225806
24794_marine,94,28,91,6,122,96.80851063829788,6.382978723404255
24795_marine,94,29,91,6,123,96.80851063829788,6.382978723404255
24796_marine,93,29,90,6,122,96.7741935483871,6.451612903225806
24797_marine,94,29,90,7,123,95.74468085106383,7.446808510638298
24798_marine,95,29,91,7,124,95.78947368421052,7.368421052631578
24799_marine,97,30,92,8,127,94.84536082474226,8.24742268041237
24800_marine,97,30,92,8,127,94.84536082474226,8.24742268041237
24801_marine,97,30,92,8,127,94.84536082474226,8.24742268041237
24802_marine,97,32,92,8,129,94.84536082474226,8.24742268041237
24803_marine,97,32,92,8,129,94.84536082474226,8.24742268041237
24804_marine,96,33,91,8,129,94.79166666666666,8.333333333333332
24805_marine,333,73,237,186,406,71.17117117117117,55.85585585585585
24806_marine,333,72,237,186,405,71.17117117117117,55.85585585585585
24807_marine,97,35,92,10,132,94.84536082474226,10.309278350515463
24808_marine,97,33,92,10,130,94.84536082474226,10.309278350515463
24809_marine,95,33,90,8,128,94.73684210526315,8.421052631578947
24810_marine,95,33,90,8,128,94.73684210526315,8.421052631578947
24811_marine,93,33,88,8,126,94.6236559139785,8.60215053763441
24812_marine,93,32,88,8,125,94.6236559139785,8.60215053763441
24813_marine,93,33,88,8,126,94.6236559139785,8.60215053763441
24814_marine,93,33,88,8,126,94.6236559139785,8.60215053763441
24815_marine,93,33,88,8,126,94.6236559139785,8.60215053763441
24816_marine,93,34,88,8,127,94.6236559139785,8.60215053763441
24817_marine,92,34,88,7,126,95.65217391304348,7.608695652173914
24818_marine,94,34,90,7,128,95.74468085106383,7.446808510638298
24819_marine,95,35,91,7,130,95.78947368421052,7.368421052631578
24820_marine,95,35,91,7,130,95.78947368421052,7.368421052631578
24821_marine,96,35,92,7,131,95.83333333333334,7.291666666666667
24822_marine,96,35,92,7,131,95.83333333333334,7.291666666666667
24823_marine,96,36,92,7,132,95.83333333333334,7.291666666666667
24824_marine,97,36,93,7,133,95.87628865979381,7.216494845360824
24825_marine,97,36,92,8,133,94.84536082474226,8.24742268041237
24826_marine,97,36,92,8,133,94.84536082474226,8.24742268041237
24827_marine,97,36,92,8,133,94.84536082474226,8.24742268041237
24828_marine,97,38,92,8,135,94.84536082474226,8.24742268041237
24829_marine,97,38,92,8,135,94.84536082474226,8.24742268041237
24830_marine,97,38,92,8,135,94.84536082474226,8.24742268041237
24831_marine,96,38,91,7,134,94.79166666666666,7.291666666666667
24832_marine,96,38,91,7,134,94.79166666666666,7.291666666666667
24833_marine,96,38,91,7,134,94.79166666666666,7.291666666666667
24834_marine,98,38,93,7,136,94.89795918367348,7.142857142857142
24835_marine,96,39,91,7,135,94.79166666666666,7.291666666666667
24836_marine,96,39,91,7,135,94.79166666666666,7.291666666666667
24837_marine,96,40,91,7,136,94.79166666666666,7.291666666666667
24838_marine,96,39,91,7,135,94.79166666666666,7.291666666666667
24839_marine,96,39,91,7,135,94.79166666666666,7.291666666666667
24840_marine,96,39,91,7,135,94.79166666666666,7.291666666666667
24841_marine,94,38,89,7,132,94.68085106382979,7.446808510638298
24842_marine,96,38,91,7,134,94.79166666666666,7.291666666666667
24843_marine,98,38,93,7,136,94.89795918367348,7.142857142857142
24844_marine,98,38,93,7,136,94.89795918367348,7.142857142857142
24845_marine,98,39,93,7,137,94.89795918367348,7.142857142857142
24846_marine,96,39,91,7,135,94.79166666666666,7.291666666666667
24847_marine,96,39,91,7,135,94.79166666666666,7.291666666666667
24848_marine,98,39,93,7,137,94.89795918367348,7.142857142857142
24849_marine,98,41,93,7,139,94.89795918367348,7.142857142857142
24850_marine,99,41,94,7,140,94.94949494949495,7.07070707070707
24851_marine,99,41,94,7,140,94.94949494949495,7.07070707070707
24852_marine,101,41,96,7,142,95.04950495049505,6.9306930693069315
24853_marine,100,41,95,7,141,95,7.000000000000001
24854_marine,103,41,98,8,144,95.14563106796116,7.766990291262135
24855_marine,103,41,98,8,144,95.14563106796116,7.766990291262135
24856_marine,103,43,98,8,146,95.14563106796116,7.766990291262135
24857_marine,110,43,105,7,153,95.45454545454545,6.363636363636363
24858_marine,118,48,111,9,166,94.0677966101695,7.627118644067797
24859_marine,353,142,242,189,495,68.55524079320114,53.54107648725213
24860_marine,356,141,245,191,497,68.82022471910112,53.65168539325843
24861_marine,362,146,245,197,508,67.67955801104972,54.41988950276243
24862_marine,374,165,251,205,539,67.11229946524064,54.81283422459893
24866_marine,366,150,249,198,516,68.0327868852459,54.09836065573771
24867_marine,131,64,123,14,195,93.89312977099237,10.687022900763358
24868_marine,121,46,115,13,167,95.0413223140496,10.743801652892563
24869_marine,108,45,103,8,153,95.37037037037037,7.4074074074074066
24870_marine,101,43,96,8,144,95.04950495049505,7.920792079207921
24871_marine,98,41,94,7,139,95.91836734693877,7.142857142857142
24872_marine,94,40,90,7,134,95.74468085106383,7.446808510638298
24873_marine,94,42,90,7,136,95.74468085106383,7.446808510638298
24874_marine,91,42,87,7,133,95.6043956043956,7.6923076923076925
24875_marine,89,41,85,7,130,95.50561797752809,7.865168539325842
24876_marine,87,42,83,5,129,95.40229885057471,5.747126436781609
24877_marine,87,41,83,5,128,95.40229885057471,5.747126436781609
24878_marine,86,41,82,4,127,95.34883720930233,4.651162790697675
24879_marine,85,41,81,3,126,95.29411764705881,3.5294117647058822
24880_marine,85,41,81,3,126,95.29411764705881,3.5294117647058822
24881_marine,85,41,81,3,126,95.29411764705881,3.5294117647058822
24882_marine,85,41,81,3,126,95.29411764705881,3.5294117647058822
24883_marine,87,40,83,3,127,95.40229885057471,3.4482758620689653
24884_marine,87,39,83,3,126,95.40229885057471,3.4482758620689653
24885_marine,87,39,83,3,126,95.40229885057471,3.4482758620689653
24886_marine,87,38,83,3,125,95.40229885057471,3.4482758620689653
24887_marine,87,38,83,3,125,95.40229885057471,3.4482758620689653
24888_marine,87,38,83,3,125,95.40229885057471,3.4482758620689653
24889_marine,87,38,83,3,125,95.40229885057471,3.4482758620689653
24890_marine,87,38,83,3,125,95.40229885057471,3.4482758620689653
24891_marine,87,38,83,3,125,95.40229885057471,3.4482758620689653
24892_marine,87,38,83,3,125,95.40229885057471,3.4482758620689653
24893_marine,87,38,83,3,125,95.40229885057471,3.4482758620689653
24894_marine,87,39,83,3,126,95.40229885057471,3.4482758620689653
24895_marine,87,39,83,3,126,95.40229885057471,3.4482758620689653
24896_marine,88,40,83,3,128,94.31818181818183,3.4090909090909087
24897_marine,88,40,83,3,128,94.31818181818183,3.4090909090909087
24898_marine,91,40,86,3,131,94.5054945054945,3.296703296703297
24899_marine,91,40,86,3,131,94.5054945054945,3.296703296703297
24900_marine,91,42,86,4,133,94.5054945054945,4.395604395604396
24901_marine,91,43,86,4,134,94.5054945054945,4.395604395604396
24902_marine,94,43,89,7,137,94.68085106382979,7.446808510638298
24903_marine,94,43,89,7,137,94.68085106382979,7.446808510638298
24904_marine,95,46,90,7,141,94.73684210526315,7.368421052631578
24905_marine,95,50,89,8,145,93.6842105263158,8.421052631578947
24906_marine,101,50,95,8,151,94.05940594059405,7.920792079207921
24907_marine,105,49,99,8,154,94.28571428571428,7.6190476190476195
24908_marine,104,50,98,8,154,94.23076923076923,7.6923076923076925
24909_marine,149,77,134,25,226,89.93288590604027,16.778523489932887
24910_marine,157,79,142,26,236,90.44585987261146,16.560509554140125
24911_marine,117,54,110,11,171,94.01709401709401,9.401709401709402
24912_marine,116,50,108,12,166,93.10344827586206,10.344827586206897
24913_marine,296,227,237,76,523,80.06756756756756,25.675675675675674
24914_marine,308,263,246,85,571,79.87012987012987,27.5974025974026
24925_marine,293,131,240,79,424,81.91126279863481,26.96245733788396
24926_marine,88,39,81,6,127,92.04545454545455,6.8181818181818175
24927_marine,100,51,93,6,151,93,6
24928_marine,344,206,266,97,550,77.32558139534885,28.197674418604652
24929_marine,350,194,267,103,544,76.28571428571429,29.428571428571427
24935_marine,370,214,280,126,584,75.67567567567568,34.054054054054056
24936_marine,347,152,261,122,499,75.21613832853026,35.158501440922194
24937_marine,346,152,260,122,498,75.14450867052022,35.26011560693642
24938_marine,348,185,260,124,533,74.71264367816092,35.63218390804598
24939_marine,351,185,263,124,536,74.92877492877493,35.32763532763533
24940_marine,346,187,257,123,533,74.27745664739885,35.54913294797688
24941_marine,485,240,310,244,725,63.91752577319587,50.30927835051546
24948_marine,450,307,288,234,757,64,52
24949_marine,334,239,244,130,573,73.05389221556887,38.92215568862276
24950_marine,332,239,245,125,571,73.79518072289156,37.65060240963856
24951_marine,336,222,251,122,558,74.70238095238095,36.30952380952381
24952_marine,335,212,252,119,547,75.22388059701493,35.52238805970149
24953_marine,111,35,101,12,146,90.990990990991,10.81081081081081
24954_marine,107,34,97,12,141,90.65420560747664,11.214953271028037
24955_marine,104,36,93,13,140,89.42307692307693,12.5
24956_marine,102,37,93,13,139,91.17647058823529,12.745098039215685
24957_marine,101,37,92,14,138,91.0891089108911,13.861386138613863
24958_marine,98,38,90,11,136,91.83673469387756,11.224489795918368
24959_marine,90,38,82,9,128,91.11111111111111,10
24960_marine,88,34,80,7,122,90.9090909090909,7.954545454545454
24961_marine,86,34,78,6,120,90.69767441860465,6.976744186046512
24962_marine,84,34,76,6,118,90.47619047619048,7.142857142857142
24963_marine,82,34,73,5,116,89.02439024390245,6.097560975609756
24964_marine,82,34,73,5,116,89.02439024390245,6.097560975609756
24965_marine,81,34,73,4,115,90.12345679012346,4.938271604938271
24966_marine,81,34,73,4,115,90.12345679012346,4.938271604938271
24967_marine,81,34,73,4,115,90.12345679012346,4.938271604938271
24968_marine,81,34,73,4,115,90.12345679012346,4.938271604938271
24969_marine,82,33,74,4,115,90.2439024390244,4.878048780487805
24970_marine,82,33,74,4,115,90.2439024390244,4.878048780487805
24971_marine,81,33,73,3,114,90.12345679012346,3.7037037037037033
24972_marine,81,33,73,3,114,90.12345679012346,3.7037037037037033
24973_marine,82,33,75,2,115,91.46341463414635,2.4390243902439024
24974_marine,80,32,75,0,112,93.75,0
24975_marine,80,32,75,0,112,93.75,0
24976_marine,80,31,75,0,111,93.75,0
24977_marine,83,30,78,0,113,93.97590361445783,0
24978_marine,83,30,78,0,113,93.97590361445783,0
24979_marine,84,30,79,0,114,94.04761904761905,0
24980_marine,84,30,79,0,114,94.04761904761905,0
24981_marine,84,30,79,0,114,94.04761904761905,0
24982_marine,84,30,79,0,114,94.04761904761905,0
24983_marine,85,30,80,0,115,94.11764705882352,0
24984_marine,85,30,80,0,115,94.11764705882352,0
24985_marine,85,30,80,0,115,94.11764705882352,0
24986_marine,85,30,80,0,115,94.11764705882352,0
24987_marine,86,30,81,0,116,94.18604651162791,0
24988_marine,87,31,82,1,118,94.25287356321839,1.1494252873563218
24989_marine,87,31,82,1,118,94.25287356321839,1.1494252873563218
24990_marine,89,31,84,1,120,94.3820224719101,1.1235955056179776
24991_marine,91,31,86,3,122,94.5054945054945,3.296703296703297
24992_marine,92,31,87,3,123,94.56521739130434,3.260869565217391
24993_marine,94,31,89,4,125,94.68085106382979,4.25531914893617
24994_marine,95,31,90,5,126,94.73684210526315,5.263157894736842
24995_marine,96,31,90,6,127,93.75,6.25
24996_marine,98,31,92,6,129,93.87755102040816,6.122448979591836
24997_marine,99,33,93,7,132,93.93939393939394,7.07070707070707
24998_marine,104,33,96,9,137,92.3076923076923,8.653846153846153
24999_marine,106,33,98,9,139,92.45283018867924,8.49056603773585
25000_marine,108,33,100,9,141,92.5925925925926,8.333333333333332
25001_marine,117,33,110,8,150,94.01709401709401,6.837606837606838
25002_marine,251,116,239,22,367,95.2191235059761,8.764940239043826
25003_marine,429,209,359,113,638,83.68298368298368,26.340326340326342
25004_marine,444,213,369,128,657,83.1081081081081,28.82882882882883
25058_marine,668,294,438,354,962,65.5688622754491,52.99401197604791
25059_marine,486,196,324,249,682,66.66666666666666,51.23456790123457
25060_marine,644,305,417,344,949,64.75155279503106,53.41614906832298
25061_marine,644,303,415,344,947,64.44099378881988,53.41614906832298
25078_marine,570,265,406,244,835,71.2280701754386,42.80701754385965
25079_marine,598,286,426,256,884,71.23745819397993,42.80936454849498
25080_marine,447,204,342,154,651,76.51006711409396,34.45190156599553
25081_marine,374,162,286,126,536,76.47058823529412,33.68983957219251
25082_marine,95,38,91,10,133,95.78947368421052,10.526315789473683
25083_marine,88,34,84,7,122,95.45454545454545,7.954545454545454
25084_marine,85,34,81,4,119,95.29411764705881,4.705882352941177
25085_marine,81,32,77,4,113,95.06172839506173,4.938271604938271
25086_marine,82,31,78,5,113,95.1219512195122,6.097560975609756
25087_marine,83,34,79,6,117,95.18072289156626,7.228915662650602
25088_marine,102,39,98,8,141,96.07843137254902,7.8431372549019605
25089_marine,282,138,239,59,420,84.75177304964538,20.921985815602838
25090_marine,338,182,279,74,520,82.54437869822485,21.893491124260358
25109_marine,317,154,256,73,471,80.7570977917981,23.02839116719243
25110_marine,303,151,243,71,454,80.19801980198021,23.432343234323433
25112_marine,341,179,260,98,520,76.24633431085044,28.739002932551323
25129_marine,451,211,354,155,662,78.49223946784922,34.368070953436806
25132_marine,483,218,384,173,701,79.5031055900621,35.81780538302277
25133_marine,477,188,378,174,665,79.24528301886792,36.477987421383645
25134_marine,511,196,403,199,707,78.86497064579257,38.94324853228962
25135_marine,520,204,413,195,724,79.42307692307692,37.5
25136_marine,669,215,512,299,884,76.5321375186846,44.69357249626308
25137_marine,588,182,424,303,770,72.10884353741497,51.53061224489795
25138_marine,534,165,381,271,699,71.34831460674157,50.749063670411985
25139_marine,124,45,118,12,169,95.16129032258065,9.67741935483871
25140_marine,126,36,120,15,162,95.23809523809523,11.904761904761903
25141_marine,967,354,615,551,1321,63.598759048603924,56.98035160289555
25142_marine,1063,465,686,598,1528,64.53433678269049,56.25587958607714
25143_marine,977,399,619,567,1376,63.357215967246674,58.034800409416576
25144_marine,836,273,512,501,1109,61.24401913875598,59.928229665071775
25145_marine,107,27,103,10,134,96.26168224299066,9.345794392523365
25146_marine,102,27,98,7,129,96.07843137254902,6.862745098039216
25147_marine,96,28,92,7,124,95.83333333333334,7.291666666666667
25148_marine,94,28,90,7,122,95.74468085106383,7.446808510638298
25149_marine,94,26,90,7,120,95.74468085106383,7.446808510638298
25150_marine,94,26,90,7,120,95.74468085106383,7.446808510638298
25151_marine,93,27,89,7,120,95.6989247311828,7.526881720430108
25152_marine,93,28,89,7,121,95.6989247311828,7.526881720430108
25153_marine,94,28,90,7,122,95.74468085106383,7.446808510638298
25154_marine,94,28,90,7,122,95.74468085106383,7.446808510638298
25155_marine,96,29,92,7,125,95.83333333333334,7.291666666666667
25156_marine,96,29,92,7,125,95.83333333333334,7.291666666666667
25157_marine,99,31,94,9,130,94.94949494949495,9.090909090909092
25158_marine,98,29,93,8,127,94.89795918367348,8.16326530612245
25159_marine,97,29,92,8,126,94.84536082474226,8.24742268041237
25160_marine,96,30,91,8,126,94.79166666666666,8.333333333333332
25161_marine,96,30,91,8,126,94.79166666666666,8.333333333333332
25162_marine,96,31,91,8,127,94.79166666666666,8.333333333333332
25163_marine,96,33,91,8,129,94.79166666666666,8.333333333333332
25164_marine,335,68,239,188,403,71.34328358208955,56.11940298507463
25165_marine,382,97,269,215,479,70.41884816753927,56.282722513089
25166_marine,388,98,275,219,486,70.87628865979381,56.44329896907217
25167_marine,356,71,248,208,427,69.66292134831461,58.42696629213483
25168_marine,97,33,92,10,130,94.84536082474226,10.309278350515463
25169_marine,95,33,90,8,128,94.73684210526315,8.421052631578947
25170_marine,95,33,90,8,128,94.73684210526315,8.421052631578947
25171_marine,95,33,90,8,128,94.73684210526315,8.421052631578947
25172_marine,95,33,90,8,128,94.73684210526315,8.421052631578947
25173_marine,95,33,90,8,128,94.73684210526315,8.421052631578947
25174_marine,95,33,90,8,128,94.73684210526315,8.421052631578947
25175_marine,95,33,90,8,128,94.73684210526315,8.421052631578947
25176_marine,93,34,88,8,127,94.6236559139785,8.60215053763441
25177_marine,93,34,88,8,127,94.6236559139785,8.60215053763441
25178_marine,93,34,88,8,127,94.6236559139785,8.60215053763441
25179_marine,93,34,88,8,127,94.6236559139785,8.60215053763441
25180_marine,92,35,88,7,127,95.65217391304348,7.608695652173914
25181_marine,96,35,92,7,131,95.83333333333334,7.291666666666667
25182_marine,95,36,90,8,131,94.73684210526315,8.421052631578947
25183_marine,97,36,92,8,133,94.84536082474226,8.24742268041237
25184_marine,98,36,93,8,134,94.89795918367348,8.16326530612245
25185_marine,99,37,94,9,136,94.94949494949495,9.090909090909092
25186_marine,265,61,194,151,326,73.20754716981132,56.9811320754717
25187_marine,307,73,225,175,380,73.28990228013029,57.00325732899023
25188_marine,307,74,225,175,381,73.28990228013029,57.00325732899023
25189_marine,99,38,94,8,137,94.94949494949495,8.080808080808081
25190_marine,99,38,94,8,137,94.94949494949495,8.080808080808081
25191_marine,99,38,94,8,137,94.94949494949495,8.080808080808081
25192_marine,98,38,93,7,136,94.89795918367348,7.142857142857142
25193_marine,98,39,93,7,137,94.89795918367348,7.142857142857142
25194_marine,98,39,93,7,137,94.89795918367348,7.142857142857142
25195_marine,98,39,93,7,137,94.89795918367348,7.142857142857142
25196_marine,96,39,91,7,135,94.79166666666666,7.291666666666667
25197_marine,96,40,91,7,136,94.79166666666666,7.291666666666667
25198_marine,96,40,91,7,136,94.79166666666666,7.291666666666667
25199_marine,96,40,91,7,136,94.79166666666666,7.291666666666667
25200_marine,96,40,91,7,136,94.79166666666666,7.291666666666667
25201_marine,96,39,91,7,135,94.79166666666666,7.291666666666667
25202_marine,96,39,91,7,135,94.79166666666666,7.291666666666667
25203_marine,96,39,91,7,135,94.79166666666666,7.291666666666667
25204_marine,96,38,91,7,134,94.79166666666666,7.291666666666667
25205_marine,96,38,91,7,134,94.79166666666666,7.291666666666667
25206_marine,99,38,94,9,137,94.94949494949495,9.090909090909092
25207_marine,99,39,94,9,138,94.94949494949495,9.090909090909092
25208_marine,98,40,93,9,138,94.89795918367348,9.183673469387756
25209_marine,96,41,91,7,137,94.79166666666666,7.291666666666667
25210_marine,96,41,91,7,137,94.79166666666666,7.291666666666667
25211_marine,96,41,91,7,137,94.79166666666666,7.291666666666667
25212_marine,97,41,92,7,138,94.84536082474226,7.216494845360824
25213_marine,99,41,94,7,140,94.94949494949495,7.07070707070707
25214_marine,99,41,94,7,140,94.94949494949495,7.07070707070707
25215_marine,98,42,93,7,140,94.89795918367348,7.142857142857142
25216_marine,101,42,96,8,143,95.04950495049505,7.920792079207921
25217_marine,107,44,102,8,151,95.32710280373831,7.476635514018691
25218_marine,113,44,106,8,157,93.80530973451327,7.079646017699115
25219_marine,114,48,107,7,162,93.85964912280701,6.140350877192982
25220_marine,117,51,109,7,168,93.16239316239316,5.982905982905983
25221_marine,118,51,110,9,169,93.22033898305084,7.627118644067797
25222_marine,128,65,120,13,193,93.75,10.15625
25223_marine,363,143,246,199,506,67.76859504132231,54.82093663911846
25227_marine,360,140,245,196,500,68.05555555555556,54.44444444444444
25228_marine,119,46,113,13,165,94.9579831932773,10.92436974789916
25229_marine,111,46,105,9,157,94.5945945945946,8.108108108108109
25230_marine,98,45,93,8,143,94.89795918367348,8.16326530612245
25231_marine,95,42,91,7,137,95.78947368421052,7.368421052631578
25232_marine,94,42,90,7,136,95.74468085106383,7.446808510638298
25233_marine,92,42,88,7,134,95.65217391304348,7.608695652173914
25234_marine,87,40,83,5,127,95.40229885057471,5.747126436781609
25235_marine,87,42,83,5,129,95.40229885057471,5.747126436781609
25236_marine,87,42,83,5,129,95.40229885057471,5.747126436781609
25237_marine,87,42,83,5,129,95.40229885057471,5.747126436781609
25238_marine,88,41,84,5,129,95.45454545454545,5.681818181818182
25239_marine,86,41,82,4,127,95.34883720930233,4.651162790697675
25240_marine,85,41,81,3,126,95.29411764705881,3.5294117647058822
25241_marine,85,41,81,3,126,95.29411764705881,3.5294117647058822
25242_marine,85,41,81,3,126,95.29411764705881,3.5294117647058822
25243_marine,85,41,81,3,126,95.29411764705881,3.5294117647058822
25244_marine,85,40,81,3,125,95.29411764705881,3.5294117647058822
25245_marine,85,39,81,3,124,95.29411764705881,3.5294117647058822
25246_marine,85,38,81,3,123,95.29411764705881,3.5294117647058822
25247_marine,85,38,81,3,123,95.29411764705881,3.5294117647058822
25248_marine,85,38,81,3,123,95.29411764705881,3.5294117647058822
25249_marine,85,38,81,3,123,95.29411764705881,3.5294117647058822
25250_marine,85,38,81,3,123,95.29411764705881,3.5294117647058822
25251_marine,85,38,81,3,123,95.29411764705881,3.5294117647058822
25252_marine,85,38,81,3,123,95.29411764705881,3.5294117647058822
25253_marine,85,38,81,3,123,95.29411764705881,3.5294117647058822
25254_marine,85,39,81,3,124,95.29411764705881,3.5294117647058822
25255_marine,85,39,81,3,124,95.29411764705881,3.5294117647058822
25256_marine,85,39,81,3,124,95.29411764705881,3.5294117647058822
25257_marine,88,40,83,3,128,94.31818181818183,3.4090909090909087
25258_marine,88,40,83,3,128,94.31818181818183,3.4090909090909087
25259_marine,90,40,85,3,130,94.44444444444444,3.3333333333333335
25260_marine,92,42,87,5,134,94.56521739130434,5.434782608695652
25261_marine,92,42,87,6,134,94.56521739130434,6.521739130434782
25262_marine,92,44,87,7,136,94.56521739130434,7.608695652173914
25263_marine,91,42,86,7,133,94.5054945054945,7.6923076923076925
25264_marine,92,44,87,7,136,94.56521739130434,7.608695652173914
25265_marine,119,60,112,16,179,94.11764705882352,13.445378151260504
25266_marine,120,62,112,17,182,93.33333333333333,14.166666666666666
25267_marine,111,65,103,16,176,92.7927927927928,14.414414414414415
25268_marine,200,114,155,63,314,77.5,31.5
25269_marine,198,117,152,61,315,76.76767676767676,30.808080808080806
25270_marine,164,90,143,40,254,87.1951219512195,24.390243902439025
25271_marine,149,74,134,26,223,89.93288590604027,17.449664429530202
25272_marine,105,46,97,9,151,92.38095238095238,8.571428571428571
25273_marine,112,50,104,13,162,92.85714285714286,11.607142857142858
25274_marine,291,237,233,74,528,80.06872852233677,25.42955326460481
25286_marine,309,178,244,93,487,78.96440129449837,30.097087378640776
25287_marine,306,174,243,90,480,79.41176470588235,29.411764705882355
25288_marine,329,201,255,97,530,77.50759878419453,29.48328267477204
25289_marine,341,191,261,103,532,76.53958944281524,30.205278592375368
25294_marine,346,228,263,120,574,76.01156069364163,34.68208092485549
25295_marine,110,38,102,11,148,92.72727272727272,10
25296_marine,99,33,90,10,132,90.9090909090909,10.1010101010101
25297_marine,98,34,89,12,132,90.81632653061224,12.244897959183673
25298_marine,300,160,223,113,460,74.33333333333333,37.666666666666664
25302_marine,347,208,257,125,555,74.06340057636888,36.023054755043226
25307_marine,476,357,307,248,833,64.49579831932773,52.10084033613446
25308_marine,477,385,308,251,862,64.57023060796647,52.620545073375254
25313_marine,352,230,263,126,582,74.7159090909091,35.79545454545455
25314_marine,353,223,264,126,576,74.78753541076487,35.69405099150141
25315_marine,353,238,264,128,591,74.78753541076487,36.26062322946176
25316_marine,353,229,265,129,582,75.07082152974505,36.54390934844193
25317_marine,351,232,264,128,583,75.21367521367522,36.46723646723647
25318_marine,325,207,243,123,532,74.76923076923076,37.84615384615385
25319_marine,102,37,93,12,139,91.17647058823529,11.76470588235294
25320_marine,95,38,87,9,133,91.57894736842105,9.473684210526317
25321_marine,88,34,80,8,122,90.9090909090909,9.090909090909092
25322_marine,86,34,78,6,120,90.69767441860465,6.976744186046512
25323_marine,85,34,76,6,119,89.41176470588236,7.0588235294117645
25324_marine,83,34,74,6,117,89.1566265060241,7.228915662650602
25325_marine,82,34,73,5,116,89.02439024390245,6.097560975609756
25326_marine,81,34,73,4,115,90.12345679012346,4.938271604938271
25327_marine,81,34,73,4,115,90.12345679012346,4.938271604938271
25328_marine,82,34,74,4,116,90.2439024390244,4.878048780487805
25329_marine,82,34,74,4,116,90.2439024390244,4.878048780487805
25330_marine,81,34,73,4,115,90.12345679012346,4.938271604938271
25331_marine,81,33,73,4,114,90.12345679012346,4.938271604938271
25332_marine,81,33,74,3,114,91.35802469135803,3.7037037037037033
25333_marine,83,33,76,3,116,91.56626506024097,3.614457831325301
25334_marine,81,33,76,1,114,93.82716049382715,1.2345679012345678
25335_marine,82,32,77,0,114,93.90243902439023,0
25336_marine,82,32,77,0,114,93.90243902439023,0
25337_marine,83,30,78,0,113,93.97590361445783,0
25338_marine,84,30,79,0,114,94.04761904761905,0
25339_marine,84,30,79,0,114,94.04761904761905,0
25340_marine,86,30,81,0,116,94.18604651162791,0
25341_marine,86,30,81,0,116,94.18604651162791,0
25342_marine,86,30,81,0,116,94.18604651162791,0
25343_marine,87,30,82,0,117,94.25287356321839,0
25344_marine,87,30,82,0,117,94.25287356321839,0
25345_marine,87,30,82,0,117,94.25287356321839,0
25346_marine,87,30,82,0,117,94.25287356321839,0
25347_marine,89,31,84,1,120,94.3820224719101,1.1235955056179776
25348_marine,89,31,84,1,120,94.3820224719101,1.1235955056179776
25349_marine,90,31,85,2,121,94.44444444444444,2.2222222222222223
25350_marine,90,31,85,2,121,94.44444444444444,2.2222222222222223
25351_marine,91,31,86,3,122,94.5054945054945,3.296703296703297
25352_marine,93,31,88,4,124,94.6236559139785,4.301075268817205
25353_marine,97,31,92,5,128,94.84536082474226,5.154639175257731
25354_marine,101,31,96,7,132,95.04950495049505,6.9306930693069315
25355_marine,100,31,94,8,131,94,8
25356_marine,102,33,96,6,135,94.11764705882352,5.88235294117647
25357_marine,105,35,99,6,140,94.28571428571428,5.714285714285714
25358_marine,108,33,100,9,141,92.5925925925926,8.333333333333332
25359_marine,114,33,106,9,147,92.98245614035088,7.894736842105263
25360_marine,113,33,106,8,146,93.80530973451327,7.079646017699115
25361_marine,118,33,111,8,151,94.0677966101695,6.779661016949152
25362_marine,129,49,121,11,178,93.7984496124031,8.527131782945736
25363_marine,303,153,281,34,456,92.73927392739274,11.221122112211221
25364_marine,473,216,388,138,689,82.02959830866807,29.175475687103592
25418_marine,693,307,449,375,1000,64.79076479076478,54.112554112554115
25419_marine,501,213,340,247,714,67.86427145708582,49.30139720558882
25420_marine,516,211,352,251,727,68.21705426356588,48.643410852713174
25421_marine,651,308,423,346,959,64.97695852534562,53.149001536098304
25422_marine,642,301,415,342,943,64.64174454828661,53.271028037383175
25438_marine,584,269,418,256,853,71.57534246575342,43.83561643835616
25439_marine,468,207,358,171,675,76.49572649572649,36.53846153846153
25440_marine,414,186,313,149,600,75.60386473429952,35.990338164251206
25441_marine,98,38,93,10,136,94.89795918367348,10.204081632653061
25442_marine,91,36,87,8,127,95.6043956043956,8.791208791208792
25443_marine,85,34,81,5,119,95.29411764705881,5.88235294117647
25444_marine,81,32,77,5,113,95.06172839506173,6.172839506172839
25445_marine,80,32,76,4,112,95,5
25446_marine,81,32,77,5,113,95.06172839506173,6.172839506172839
25447_marine,83,33,79,6,116,95.18072289156626,7.228915662650602
25448_marine,85,35,81,8,120,95.29411764705881,9.411764705882353
25449_marine,100,40,96,8,140,96,8
25450_marine,311,154,264,66,465,84.88745980707395,21.221864951768488
25451_marine,326,152,277,71,478,84.96932515337423,21.779141104294478
25452_marine,331,154,280,73,485,84.59214501510573,22.054380664652566
25468_marine,328,154,248,96,482,75.60975609756098,29.268292682926827
25488_marine,435,179,337,158,614,77.47126436781609,36.321839080459775
25493_marine,457,178,361,167,635,78.99343544857767,36.542669584245075
25494_marine,461,176,365,165,637,79.17570498915401,35.791757049891544
25495_marine,118,59,112,11,177,94.91525423728814,9.322033898305085
25496_marine,114,51,108,11,165,94.73684210526315,9.649122807017543
25497_marine,496,135,351,263,631,70.76612903225806,53.0241935483871
25498_marine,495,133,354,260,628,71.51515151515152,52.52525252525253
25499_marine,115,35,109,12,150,94.78260869565217,10.434782608695652
25500_marine,968,303,609,555,1271,62.913223140495866,57.33471074380165
25501_marine,997,350,625,571,1347,62.68806419257773,57.27181544633901
25502_marine,1184,512,753,695,1696,63.59797297297297,58.69932432432432
25503_marine,1089,448,696,610,1537,63.91184573002755,56.014692378328746
25504_marine,920,290,566,549,1210,61.52173913043478,59.673913043478265
25505_marine,105,27,101,10,132,96.19047619047619,9.523809523809524
25506_marine,95,27,91,8,122,95.78947368421052,8.421052631578947
25507_marine,95,28,91,8,123,95.78947368421052,8.421052631578947
25508_marine,95,28,91,8,123,95.78947368421052,8.421052631578947
25509_marine,93,27,89,8,120,95.6989247311828,8.60215053763441
25510_marine,92,27,88,7,119,95.65217391304348,7.608695652173914
25511_marine,91,27,87,7,118,95.6043956043956,7.6923076923076925
25512_marine,91,30,87,7,121,95.6043956043956,7.6923076923076925
25513_marine,91,30,87,7,121,95.6043956043956,7.6923076923076925
25514_marine,92,30,88,7,122,95.65217391304348,7.608695652173914
25515_marine,94,28,90,7,122,95.74468085106383,7.446808510638298
25516_marine,94,29,89,8,123,94.68085106382979,8.51063829787234
25517_marine,94,29,89,8,123,94.68085106382979,8.51063829787234
25518_marine,94,29,89,8,123,94.68085106382979,8.51063829787234
25519_marine,95,29,90,8,124,94.73684210526315,8.421052631578947
25520_marine,95,29,90,8,124,94.73684210526315,8.421052631578947
25521_marine,95,30,90,8,125,94.73684210526315,8.421052631578947
25522_marine,95,30,90,8,125,94.73684210526315,8.421052631578947
25523_marine,95,31,90,8,126,94.73684210526315,8.421052631578947
25524_marine,97,32,92,10,129,94.84536082474226,10.309278350515463
25525_marine,475,105,325,290,580,68.42105263157895,61.05263157894737
25526_marine,507,131,350,303,638,69.0335305719921,59.76331360946746
25527_marine,475,105,323,292,580,68,61.473684210526315
25528_marine,98,33,93,12,131,94.89795918367348,12.244897959183673
25529_marine,94,33,89,8,127,94.68085106382979,8.51063829787234
25530_marine,94,33,89,8,127,94.68085106382979,8.51063829787234
25531_marine,94,33,89,8,127,94.68085106382979,8.51063829787234
25532_marine,94,33,89,8,127,94.68085106382979,8.51063829787234
25533_marine,94,33,89,8,127,94.68085106382979,8.51063829787234
25534_marine,93,34,88,8,127,94.6236559139785,8.60215053763441
25535_marine,93,33,88,8,126,94.6236559139785,8.60215053763441
25536_marine,93,34,88,8,127,94.6236559139785,8.60215053763441
25537_marine,93,34,88,8,127,94.6236559139785,8.60215053763441
25538_marine,93,34,88,8,127,94.6236559139785,8.60215053763441
25539_marine,93,34,88,8,127,94.6236559139785,8.60215053763441
25540_marine,92,35,87,8,127,94.56521739130434,8.695652173913043
25541_marine,112,39,100,23,151,89.28571428571429,20.535714285714285
25542_marine,95,37,90,8,132,94.73684210526315,8.421052631578947
25543_marine,96,37,91,8,133,94.79166666666666,8.333333333333332
25544_marine,98,37,93,8,135,94.89795918367348,8.16326530612245
25545_marine,99,37,94,9,136,94.94949494949495,9.090909090909092
25546_marine,306,72,224,174,378,73.20261437908496,56.86274509803921
25547_marine,326,94,242,185,420,74.23312883435584,56.74846625766872
25548_marine,309,74,227,175,383,73.46278317152104,56.63430420711975
25549_marine,98,39,93,9,137,94.89795918367348,9.183673469387756
25550_marine,97,39,92,8,136,94.84536082474226,8.24742268041237
25551_marine,97,39,92,8,136,94.84536082474226,8.24742268041237
25552_marine,97,39,92,8,136,94.84536082474226,8.24742268041237
25553_marine,96,39,91,7,135,94.79166666666666,7.291666666666667
25554_marine,96,39,91,7,135,94.79166666666666,7.291666666666667
25555_marine,96,39,91,7,135,94.79166666666666,7.291666666666667
25556_marine,96,40,91,7,136,94.79166666666666,7.291666666666667
25557_marine,96,40,91,7,136,94.79166666666666,7.291666666666667
25558_marine,96,40,91,7,136,94.79166666666666,7.291666666666667
25559_marine,96,40,91,7,136,94.79166666666666,7.291666666666667
25560_marine,96,40,91,7,136,94.79166666666666,7.291666666666667
25561_marine,96,39,91,7,135,94.79166666666666,7.291666666666667
25562_marine,96,39,91,7,135,94.79166666666666,7.291666666666667
25563_marine,96,39,91,7,135,94.79166666666666,7.291666666666667
25564_marine,98,39,93,7,137,94.89795918367348,7.142857142857142
25565_marine,98,39,93,7,137,94.89795918367348,7.142857142857142
25566_marine,100,41,95,9,141,95,9
25567_marine,99,41,94,9,140,94.94949494949495,9.090909090909092
25568_marine,99,40,94,9,139,94.94949494949495,9.090909090909092
25569_marine,99,40,94,9,139,94.94949494949495,9.090909090909092
25570_marine,97,40,92,7,137,94.84536082474226,7.216494845360824
25571_marine,97,40,92,7,137,94.84536082474226,7.216494845360824
25572_marine,97,40,92,7,137,94.84536082474226,7.216494845360824
25573_marine,97,40,92,7,137,94.84536082474226,7.216494845360824
25574_marine,97,40,92,7,137,94.84536082474226,7.216494845360824
25575_marine,99,41,94,7,140,94.94949494949495,7.07070707070707
25576_marine,99,41,94,7,140,94.94949494949495,7.07070707070707
25577_marine,100,43,95,7,143,95,7.000000000000001
25578_marine,103,43,96,8,146,93.20388349514563,7.766990291262135
25579_marine,109,42,102,8,151,93.57798165137615,7.339449541284404
25580_marine,108,42,101,8,150,93.51851851851852,7.4074074074074066
25581_marine,109,45,101,8,154,92.66055045871559,7.339449541284404
25582_marine,119,61,111,10,180,93.27731092436974,8.403361344537815
25583_marine,123,55,115,12,178,93.4959349593496,9.75609756097561
25584_marine,365,147,246,201,512,67.3972602739726,55.06849315068493
25586_marine,365,145,248,200,510,67.94520547945206,54.794520547945204
25587_marine,122,52,116,14,174,95.08196721311475,11.475409836065573
25588_marine,119,46,113,13,165,94.9579831932773,10.92436974789916
25589_marine,107,46,101,9,153,94.39252336448598,8.411214953271028
25590_marine,98,46,93,8,144,94.89795918367348,8.16326530612245
25591_marine,95,44,91,8,139,95.78947368421052,8.421052631578947
25592_marine,91,42,87,5,133,95.6043956043956,5.4945054945054945
25593_marine,91,42,87,5,133,95.6043956043956,5.4945054945054945
25594_marine,87,42,83,5,129,95.40229885057471,5.747126436781609
25595_marine,87,42,83,5,129,95.40229885057471,5.747126436781609
25596_marine,88,40,84,5,128,95.45454545454545,5.681818181818182
25597_marine,87,42,83,5,129,95.40229885057471,5.747126436781609
25598_marine,87,42,83,5,129,95.40229885057471,5.747126436781609
25599_marine,87,41,83,5,128,95.40229885057471,5.747126436781609
25600_marine,85,39,81,3,124,95.29411764705881,3.5294117647058822
25601_marine,85,39,81,3,124,95.29411764705881,3.5294117647058822
25602_marine,85,39,81,3,124,95.29411764705881,3.5294117647058822
25603_marine,85,39,81,3,124,95.29411764705881,3.5294117647058822
25604_marine,85,39,81,3,124,95.29411764705881,3.5294117647058822
25605_marine,85,39,81,3,124,95.29411764705881,3.5294117647058822
25606_marine,85,36,81,3,121,95.29411764705881,3.5294117647058822
25607_marine,85,36,81,3,121,95.29411764705881,3.5294117647058822
25608_marine,85,36,81,3,121,95.29411764705881,3.5294117647058822
25609_marine,85,36,81,3,121,95.29411764705881,3.5294117647058822
25610_marine,85,36,81,3,121,95.29411764705881,3.5294117647058822
25611_marine,85,36,81,3,121,95.29411764705881,3.5294117647058822
25612_marine,85,36,81,3,121,95.29411764705881,3.5294117647058822
25613_marine,85,38,81,3,123,95.29411764705881,3.5294117647058822
25614_marine,85,38,81,3,123,95.29411764705881,3.5294117647058822
25615_marine,86,37,82,3,123,95.34883720930233,3.488372093023256
25616_marine,87,37,83,3,124,95.40229885057471,3.4482758620689653
25617_marine,87,37,83,3,124,95.40229885057471,3.4482758620689653
25618_marine,88,38,83,3,126,94.31818181818183,3.4090909090909087
25619_marine,90,38,85,3,128,94.44444444444444,3.3333333333333335
25620_marine,92,40,87,5,132,94.56521739130434,5.434782608695652
25621_marine,93,41,88,6,134,94.6236559139785,6.451612903225806
25622_marine,92,41,87,7,133,94.56521739130434,7.608695652173914
25623_marine,92,42,87,7,134,94.56521739130434,7.608695652173914
25624_marine,91,43,86,7,134,94.5054945054945,7.6923076923076925
25625_marine,119,62,112,16,181,94.11764705882352,13.445378151260504
25626_marine,137,70,124,30,207,90.51094890510949,21.897810218978105
25627_marine,122,65,114,17,187,93.44262295081968,13.934426229508196
25628_marine,197,111,152,64,308,77.15736040609137,32.48730964467005
25629_marine,222,129,167,81,351,75.22522522522522,36.486486486486484
25630_marine,170,98,146,45,268,85.88235294117646,26.47058823529412
25631_marine,141,73,126,23,214,89.36170212765957,16.312056737588655
25632_marine,101,44,93,9,145,92.07920792079209,8.91089108910891
25633_marine,105,46,97,12,151,92.38095238095238,11.428571428571429
25634_marine,107,44,99,13,151,92.5233644859813,12.149532710280374
25635_marine,286,235,227,72,521,79.37062937062937,25.174825174825177
25654_marine,343,259,262,117,602,76.38483965014578,34.11078717201166
25655_marine,102,37,94,11,139,92.15686274509804,10.784313725490197
25656_marine,302,160,228,104,462,75.49668874172185,34.437086092715234
25657_marine,301,163,226,105,464,75.08305647840533,34.883720930232556
25658_marine,302,162,225,113,464,74.50331125827815,37.41721854304636
25659_marine,305,163,226,116,468,74.09836065573771,38.0327868852459
25660_marine,304,163,225,115,467,74.01315789473685,37.82894736842105
25661_marine,334,178,252,118,512,75.44910179640718,35.32934131736527
25662_marine,476,330,300,250,806,63.02521008403361,52.52100840336135
25664_marine,470,340,292,251,810,62.12765957446808,53.404255319148945
25665_marine,357,241,257,138,598,71.98879551820728,38.655462184873954
25667_marine,476,392,305,252,868,64.07563025210085,52.94117647058824
25670_marine,465,366,301,245,831,64.73118279569893,52.68817204301075
25679_marine,325,210,241,121,535,74.15384615384616,37.230769230769226
25680_marine,322,201,239,119,523,74.22360248447205,36.95652173913043
25681_marine,95,36,87,11,131,91.57894736842105,11.578947368421053
25682_marine,89,35,81,7,124,91.01123595505618,7.865168539325842
25683_marine,89,34,81,7,123,91.01123595505618,7.865168539325842
25684_marine,88,34,79,7,122,89.77272727272727,7.954545454545454
25685_marine,85,34,76,6,119,89.41176470588236,7.0588235294117645
25686_marine,84,34,76,5,118,90.47619047619048,5.952380952380952
25687_marine,84,34,76,4,118,90.47619047619048,4.761904761904762
25688_marine,84,34,76,4,118,90.47619047619048,4.761904761904762
25689_marine,83,34,75,4,117,90.36144578313254,4.819277108433735
25690_marine,83,34,75,4,117,90.36144578313254,4.819277108433735
25691_marine,82,34,75,3,116,91.46341463414635,3.6585365853658534
25692_marine,83,34,76,3,117,91.56626506024097,3.614457831325301
25693_marine,85,33,78,3,118,91.76470588235294,3.5294117647058822
25694_marine,83,33,78,1,116,93.97590361445783,1.2048192771084338
25695_marine,82,33,77,1,115,93.90243902439023,1.2195121951219512
25696_marine,83,33,78,1,116,93.97590361445783,1.2048192771084338
25697_marine,85,32,80,1,117,94.11764705882352,1.1764705882352942
25698_marine,84,32,79,0,116,94.04761904761905,0
25699_marine,84,31,79,0,115,94.04761904761905,0
25700_marine,84,31,79,0,115,94.04761904761905,0
25701_marine,84,30,79,0,114,94.04761904761905,0
25702_marine,86,30,81,0,116,94.18604651162791,0
25703_marine,87,30,82,0,117,94.25287356321839,0
25704_marine,87,30,82,0,117,94.25287356321839,0
25705_marine,87,31,82,0,118,94.25287356321839,0
25706_marine,87,31,82,0,118,94.25287356321839,0
25707_marine,89,31,84,1,120,94.3820224719101,1.1235955056179776
25708_marine,90,31,85,2,121,94.44444444444444,2.2222222222222223
25709_marine,90,31,85,2,121,94.44444444444444,2.2222222222222223
25710_marine,90,31,85,2,121,94.44444444444444,2.2222222222222223
25711_marine,90,31,85,2,121,94.44444444444444,2.2222222222222223
25712_marine,93,31,88,4,124,94.6236559139785,4.301075268817205
25713_marine,98,31,93,5,129,94.89795918367348,5.1020408163265305
25714_marine,101,33,95,9,134,94.05940594059405,8.91089108910891
25715_marine,211,81,188,32,292,89.0995260663507,15.165876777251185
25716_marine,213,81,190,32,294,89.2018779342723,15.023474178403756
25717_marine,108,35,102,9,143,94.44444444444444,8.333333333333332
25718_marine,109,35,102,10,144,93.57798165137615,9.174311926605505
25719_marine,114,35,106,9,149,92.98245614035088,7.894736842105263
25720_marine,115,33,108,8,148,93.91304347826087,6.956521739130435
25721_marine,118,33,111,8,151,94.0677966101695,6.779661016949152
25722_marine,121,33,113,11,154,93.38842975206612,9.090909090909092
25723_marine,287,132,266,32,419,92.6829268292683,11.149825783972126
25724_marine,464,215,384,131,679,82.75862068965517,28.23275862068966
25778_marine,704,313,454,380,1017,64.48863636363636,53.97727272727273
25779_marine,707,318,458,381,1025,64.78076379066479,53.88967468175389
25780_marine,486,189,325,248,675,66.8724279835391,51.028806584362144
25781_marine,523,214,360,255,737,68.83365200764818,48.75717017208413
25782_marine,662,313,427,357,975,64.50151057401813,53.92749244712991
25797_marine,603,274,425,271,877,70.48092868988391,44.94195688225539
25798_marine,611,272,436,270,883,71.35842880523732,44.189852700491
25799_marine,453,197,347,167,650,76.60044150110376,36.86534216335541
25800_marine,110,38,103,13,148,93.63636363636364,11.818181818181818
25801_marine,95,38,91,10,133,95.78947368421052,10.526315789473683
25802_marine,87,34,83,7,121,95.40229885057471,8.045977011494253
25803_marine,79,34,75,5,113,94.9367088607595,6.329113924050633
25804_marine,77,32,73,3,109,94.8051948051948,3.896103896103896
25805_marine,74,32,70,2,106,94.5945945945946,2.7027027027027026
25806_marine,73,31,69,3,104,94.52054794520548,4.10958904109589
25807_marine,76,33,72,6,109,94.73684210526315,7.894736842105263
25808_marine,79,33,75,6,112,94.9367088607595,7.59493670886076
25809_marine,90,35,86,5,125,95.55555555555556,5.555555555555555
25810_marine,104,42,100,5,146,96.15384615384616,4.807692307692308
25811_marine,321,152,274,67,473,85.35825545171339,20.87227414330218
25812_marine,331,155,279,73,486,84.29003021148036,22.054380664652566
25826_marine,368,193,279,114,561,75.81521739130434,30.978260869565215
25827_marine,311,134,236,97,445,75.88424437299035,31.189710610932476
25832_marine,89,32,86,2,121,96.62921348314607,2.247191011235955
25833_marine,314,130,229,108,444,72.92993630573248,34.394904458598724
25848_marine,451,183,346,165,634,76.71840354767184,36.58536585365854
25852_marine,456,198,351,173,654,76.97368421052632,37.93859649122807
25853_marine,413,144,320,154,557,77.4818401937046,37.28813559322034
25854_marine,108,49,102,10,157,94.44444444444444,9.25925925925926
25855_marine,107,37,101,9,144,94.39252336448598,8.411214953271028
25856_marine,100,29,94,9,129,94,9
25857_marine,103,29,97,10,132,94.1747572815534,9.70873786407767
25858_marine,105,29,99,10,134,94.28571428571428,9.523809523809524
25859_marine,113,31,107,14,144,94.69026548672566,12.389380530973451
25860_marine,997,332,624,571,1329,62.58776328986961,57.27181544633901
25864_marine,982,311,606,574,1293,61.710794297352344,58.45213849287168
25865_marine,110,29,105,13,139,95.45454545454545,11.818181818181818
25866_marine,95,27,91,8,122,95.78947368421052,8.421052631578947
25867_marine,95,27,91,8,122,95.78947368421052,8.421052631578947
25868_marine,96,29,92,8,125,95.83333333333334,8.333333333333332
25869_marine,94,27,90,8,121,95.74468085106383,8.51063829787234
25870_marine,94,27,90,8,121,95.74468085106383,8.51063829787234
25871_marine,92,28,88,7,120,95.65217391304348,7.608695652173914
25872_marine,93,30,89,7,123,95.6989247311828,7.526881720430108
25873_marine,90,30,86,7,120,95.55555555555556,7.777777777777778
25874_marine,91,30,87,7,121,95.6043956043956,7.6923076923076925
25875_marine,92,28,87,8,120,94.56521739130434,8.695652173913043
25876_marine,93,29,88,8,122,94.6236559139785,8.60215053763441
25877_marine,93,29,88,8,122,94.6236559139785,8.60215053763441
25878_marine,93,29,88,8,122,94.6236559139785,8.60215053763441
25879_marine,94,29,89,8,123,94.68085106382979,8.51063829787234
25880_marine,95,29,90,8,124,94.73684210526315,8.421052631578947
25881_marine,95,29,90,8,124,94.73684210526315,8.421052631578947
25882_marine,95,28,90,8,123,94.73684210526315,8.421052631578947
25883_marine,95,31,90,8,126,94.73684210526315,8.421052631578947
25884_marine,98,34,93,11,132,94.89795918367348,11.224489795918368
25885_marine,501,119,333,310,620,66.46706586826348,61.876247504990026
25886_marine,542,157,365,329,699,67.34317343173431,60.70110701107011
25887_marine,507,130,335,318,637,66.07495069033531,62.721893491124256
25888_marine,101,33,96,13,134,95.04950495049505,12.871287128712872
25889_marine,96,33,91,8,129,94.79166666666666,8.333333333333332
25890_marine,94,32,89,8,126,94.68085106382979,8.51063829787234
25891_marine,94,33,89,8,127,94.68085106382979,8.51063829787234
25892_marine,94,33,89,8,127,94.68085106382979,8.51063829787234
25893_marine,94,33,89,8,127,94.68085106382979,8.51063829787234
25894_marine,94,33,89,8,127,94.68085106382979,8.51063829787234
25895_marine,94,34,89,8,128,94.68085106382979,8.51063829787234
25896_marine,94,34,89,8,128,94.68085106382979,8.51063829787234
25897_marine,94,35,89,8,129,94.68085106382979,8.51063829787234
25898_marine,94,35,89,8,129,94.68085106382979,8.51063829787234
25899_marine,94,35,89,8,129,94.68085106382979,8.51063829787234
25900_marine,93,36,88,8,129,94.6236559139785,8.60215053763441
25901_marine,95,37,90,8,132,94.73684210526315,8.421052631578947
25902_marine,98,37,93,10,135,94.89795918367348,10.204081632653061
25903_marine,98,37,93,10,135,94.89795918367348,10.204081632653061
25904_marine,100,37,95,10,137,95,10
25905_marine,101,37,96,11,138,95.04950495049505,10.891089108910892
25906_marine,307,72,225,174,379,73.28990228013029,56.67752442996743
25907_marine,306,72,224,174,378,73.20261437908496,56.86274509803921
25908_marine,306,74,224,174,380,73.20261437908496,56.86274509803921
25909_marine,98,39,93,9,137,94.89795918367348,9.183673469387756
25910_marine,98,39,93,9,137,94.89795918367348,9.183673469387756
25911_marine,97,39,92,8,136,94.84536082474226,8.24742268041237
25912_marine,97,39,92,8,136,94.84536082474226,8.24742268041237
25913_marine,96,39,91,7,135,94.79166666666666,7.291666666666667
25914_marine,96,39,91,7,135,94.79166666666666,7.291666666666667
25915_marine,96,39,91,7,135,94.79166666666666,7.291666666666667
25916_marine,96,40,91,7,136,94.79166666666666,7.291666666666667
25917_marine,96,40,91,7,136,94.79166666666666,7.291666666666667
25918_marine,94,40,89,7,134,94.68085106382979,7.446808510638298
25919_marine,96,40,91,7,136,94.79166666666666,7.291666666666667
25920_marine,96,40,91,7,136,94.79166666666666,7.291666666666667
25921_marine,98,39,93,7,137,94.89795918367348,7.142857142857142
25922_marine,98,39,93,7,137,94.89795918367348,7.142857142857142
25923_marine,98,39,93,7,137,94.89795918367348,7.142857142857142
25924_marine,98,40,93,7,138,94.89795918367348,7.142857142857142
25925_marine,98,41,93,7,139,94.89795918367348,7.142857142857142
25926_marine,100,41,95,9,141,95,9
25927_marine,99,41,94,9,140,94.94949494949495,9.090909090909092
25928_marine,99,41,94,9,140,94.94949494949495,9.090909090909092
25929_marine,99,41,94,9,140,94.94949494949495,9.090909090909092
25930_marine,285,68,194,165,353,68.0701754385965,57.89473684210527
25931_marine,285,70,194,165,355,68.0701754385965,57.89473684210527
25932_marine,285,68,194,165,353,68.0701754385965,57.89473684210527
25933_marine,97,40,92,7,137,94.84536082474226,7.216494845360824
25934_marine,97,40,92,7,137,94.84536082474226,7.216494845360824
25935_marine,97,41,92,7,138,94.84536082474226,7.216494845360824
25936_marine,98,41,93,7,139,94.89795918367348,7.142857142857142
25937_marine,100,43,95,7,143,95,7.000000000000001
25938_marine,104,43,97,7,147,93.26923076923077,6.730769230769231
25939_marine,102,42,95,7,144,93.13725490196079,6.862745098039216
25940_marine,103,42,96,7,145,93.20388349514563,6.796116504854369
25941_marine,105,42,98,7,147,93.33333333333333,6.666666666666667
25942_marine,108,42,100,7,150,92.5925925925926,6.481481481481481
25943_marine,113,47,105,12,160,92.92035398230088,10.619469026548673
25944_marine,118,49,110,12,167,93.22033898305084,10.16949152542373
25945_marine,324,127,219,177,451,67.5925925925926,54.629629629629626
25946_marine,115,49,107,11,164,93.04347826086956,9.565217391304348
25947_marine,113,46,107,11,159,94.69026548672566,9.734513274336283
25948_marine,107,44,101,7,151,94.39252336448598,6.5420560747663545
25949_marine,103,44,97,7,147,94.1747572815534,6.796116504854369
25950_marine,95,44,91,6,139,95.78947368421052,6.315789473684211
25951_marine,93,42,89,6,135,95.6989247311828,6.451612903225806
25952_marine,91,42,87,5,133,95.6043956043956,5.4945054945054945
25953_marine,90,41,86,5,131,95.55555555555556,5.555555555555555
25954_marine,92,41,88,5,133,95.65217391304348,5.434782608695652
25955_marine,88,41,84,5,129,95.45454545454545,5.681818181818182
25956_marine,87,40,83,5,127,95.40229885057471,5.747126436781609
25957_marine,87,40,83,5,127,95.40229885057471,5.747126436781609
25958_marine,87,40,83,5,127,95.40229885057471,5.747126436781609
25959_marine,87,40,83,5,127,95.40229885057471,5.747126436781609
25960_marine,86,39,82,4,125,95.34883720930233,4.651162790697675
25961_marine,85,39,81,3,124,95.29411764705881,3.5294117647058822
25962_marine,85,39,81,3,124,95.29411764705881,3.5294117647058822
25963_marine,85,39,81,3,124,95.29411764705881,3.5294117647058822
25964_marine,85,39,81,3,124,95.29411764705881,3.5294117647058822
25965_marine,85,39,81,3,124,95.29411764705881,3.5294117647058822
25966_marine,85,38,81,3,123,95.29411764705881,3.5294117647058822
25967_marine,85,38,81,3,123,95.29411764705881,3.5294117647058822
25968_marine,85,37,81,3,122,95.29411764705881,3.5294117647058822
25969_marine,85,37,81,3,122,95.29411764705881,3.5294117647058822
25970_marine,85,36,81,3,121,95.29411764705881,3.5294117647058822
25971_marine,85,36,81,3,121,95.29411764705881,3.5294117647058822
25972_marine,85,36,81,3,121,95.29411764705881,3.5294117647058822
25973_marine,86,38,82,3,124,95.34883720930233,3.488372093023256
25974_marine,86,38,82,3,124,95.34883720930233,3.488372093023256
25975_marine,87,38,83,3,125,95.40229885057471,3.4482758620689653
25976_marine,87,37,83,3,124,95.40229885057471,3.4482758620689653
25977_marine,87,37,83,3,124,95.40229885057471,3.4482758620689653
25978_marine,87,37,83,3,124,95.40229885057471,3.4482758620689653
25979_marine,87,37,83,3,124,95.40229885057471,3.4482758620689653
25980_marine,92,40,87,5,132,94.56521739130434,5.434782608695652
25981_marine,92,41,87,5,133,94.56521739130434,5.434782608695652
25982_marine,93,41,88,7,134,94.6236559139785,7.526881720430108
25983_marine,93,42,88,7,135,94.6236559139785,7.526881720430108
25984_marine,92,42,87,7,134,94.56521739130434,7.608695652173914
25985_marine,119,60,112,16,179,94.11764705882352,13.445378151260504
25986_marine,118,62,111,16,180,94.0677966101695,13.559322033898304
25987_marine,118,62,111,16,180,94.0677966101695,13.559322033898304
25988_marine,97,48,91,8,145,93.81443298969072,8.24742268041237
25989_marine,139,77,125,24,216,89.92805755395683,17.26618705035971
25990_marine,138,76,124,24,214,89.85507246376811,17.391304347826086
25991_marine,96,46,90,6,142,93.75,6.25
25992_marine,95,43,88,7,138,92.63157894736842,7.368421052631578
25993_marine,101,42,93,8,143,92.07920792079209,7.920792079207921
25994_marine,104,43,96,12,147,92.3076923076923,11.538461538461538
25995_marine,106,44,98,14,150,92.45283018867924,13.20754716981132
25996_marine,278,235,220,70,513,79.13669064748201,25.179856115107913
25997_marine,282,240,219,75,522,77.6595744680851,26.595744680851062
26014_marine,349,267,264,120,616,75.64469914040114,34.38395415472779
26015_marine,338,226,255,117,564,75.44378698224851,34.61538461538461
26016_marine,302,176,228,106,478,75.49668874172185,35.099337748344375
26017_marine,308,191,229,108,499,74.35064935064936,35.064935064935064
26018_marine,108,49,98,11,157,90.74074074074075,10.185185185185185
26019_marine,106,51,95,10,157,89.62264150943396,9.433962264150944
26020_marine,117,56,106,16,173,90.5982905982906,13.675213675213676
26021_marine,335,188,254,117,523,75.82089552238806,34.92537313432836
26022_marine,342,208,257,124,550,75.14619883040936,36.25730994152047
26024_marine,476,335,301,251,811,63.23529411764706,52.73109243697479
26025_marine,342,226,255,122,568,74.56140350877193,35.67251461988304
26026_marine,334,216,251,122,550,75.1497005988024,36.52694610778443
26027_marine,329,205,246,123,534,74.77203647416414,37.38601823708207
26028_marine,328,202,245,122,530,74.6951219512195,37.19512195121951
26030_marine,329,212,246,122,541,74.77203647416414,37.08206686930091
26031_marine,335,215,252,123,550,75.22388059701493,36.71641791044776
26032_marine,347,239,260,128,586,74.92795389048992,36.887608069164266
26039_marine,414,321,282,209,735,68.11594202898551,50.48309178743962
26040_marine,327,206,244,120,533,74.61773700305811,36.69724770642202
26041_marine,98,37,89,12,135,90.81632653061224,12.244897959183673
26042_marine,90,36,82,7,126,91.11111111111111,7.777777777777778
26043_marine,89,35,81,7,124,91.01123595505618,7.865168539325842
26044_marine,87,35,79,7,122,90.80459770114942,8.045977011494253
26045_marine,86,34,77,7,120,89.53488372093024,8.13953488372093
26046_marine,85,34,77,6,119,90.58823529411765,7.0588235294117645
26047_marine,86,34,78,6,120,90.69767441860465,6.976744186046512
26048_marine,83,34,75,4,117,90.36144578313254,4.819277108433735
26049_marine,83,34,75,4,117,90.36144578313254,4.819277108433735
26050_marine,83,34,75,4,117,90.36144578313254,4.819277108433735
26051_marine,82,34,75,3,116,91.46341463414635,3.6585365853658534
26052_marine,83,34,76,3,117,91.56626506024097,3.614457831325301
26053_marine,85,34,78,3,119,91.76470588235294,3.5294117647058822
26054_marine,85,34,78,3,119,91.76470588235294,3.5294117647058822
26055_marine,82,33,77,1,115,93.90243902439023,1.2195121951219512
26056_marine,84,33,79,1,117,94.04761904761905,1.1904761904761905
26057_marine,85,32,80,1,117,94.11764705882352,1.1764705882352942
26058_marine,85,32,80,1,117,94.11764705882352,1.1764705882352942
26059_marine,85,32,80,1,117,94.11764705882352,1.1764705882352942
26060_marine,85,31,80,1,116,94.11764705882352,1.1764705882352942
26061_marine,84,31,79,0,115,94.04761904761905,0
26062_marine,84,31,79,0,115,94.04761904761905,0
26063_marine,84,31,79,0,115,94.04761904761905,0
26064_marine,87,31,82,0,118,94.25287356321839,0
26065_marine,87,31,82,0,118,94.25287356321839,0
26066_marine,88,31,83,0,119,94.31818181818183,0
26067_marine,90,31,85,2,121,94.44444444444444,2.2222222222222223
26068_marine,90,31,85,2,121,94.44444444444444,2.2222222222222223
26069_marine,90,31,85,2,121,94.44444444444444,2.2222222222222223
26070_marine,90,31,85,2,121,94.44444444444444,2.2222222222222223
26071_marine,90,31,85,2,121,94.44444444444444,2.2222222222222223
26072_marine,91,31,86,3,122,94.5054945054945,3.296703296703297
26073_marine,101,31,96,6,132,95.04950495049505,5.9405940594059405
26074_marine,213,81,190,32,294,89.2018779342723,15.023474178403756
26077_marine,215,83,192,31,298,89.30232558139535,14.418604651162791
26078_marine,217,89,193,33,306,88.94009216589862,15.207373271889402
26079_marine,115,41,108,10,156,93.91304347826087,8.695652173913043
26080_marine,112,33,105,8,145,93.75,7.142857142857142
26081_marine,118,33,111,8,151,94.0677966101695,6.779661016949152
26082_marine,123,35,114,13,158,92.6829268292683,10.569105691056912
26083_marine,284,128,263,33,412,92.6056338028169,11.619718309859154
26084_marine,511,233,399,171,744,78.08219178082192,33.46379647749511
26139_marine,735,317,471,397,1052,64.08163265306122,54.01360544217687
26140_marine,510,215,345,254,725,67.64705882352942,49.80392156862745
26141_marine,508,208,343,252,716,67.51968503937007,49.60629921259843
26142_marine,667,318,430,357,985,64.46776611694153,53.52323838080959
26143_marine,671,321,434,360,992,64.6795827123696,53.65126676602087
26155_marine,618,284,432,289,902,69.90291262135922,46.763754045307444
26156_marine,636,298,441,297,934,69.33962264150944,46.69811320754717
26157_marine,614,282,431,273,896,70.19543973941367,44.462540716612374
26158_marine,479,205,359,186,684,74.94780793319416,38.83089770354906
26159_marine,111,39,103,14,150,92.7927927927928,12.612612612612612
26160_marine,99,38,95,10,137,95.95959595959596,10.1010101010101
26161_marine,94,36,90,10,130,95.74468085106383,10.638297872340425
26162_marine,81,33,77,7,114,95.06172839506173,8.641975308641975
26163_marine,75,31,71,3,106,94.66666666666667,4
26164_marine,73,31,69,3,104,94.52054794520548,4.10958904109589
26165_marine,72,31,68,2,103,94.44444444444444,2.7777777777777777
26166_marine,73,30,69,3,103,94.52054794520548,4.10958904109589
26167_marine,74,32,70,4,106,94.5945945945946,5.405405405405405
26168_marine,76,31,72,6,107,94.73684210526315,7.894736842105263
26169_marine,78,30,74,5,108,94.87179487179486,6.41025641025641
26170_marine,97,32,93,5,129,95.87628865979381,5.154639175257731
26171_marine,316,148,269,67,464,85.12658227848101,21.202531645569618
26172_marine,331,157,280,72,488,84.59214501510573,21.75226586102719
26173_marine,376,180,310,96,556,82.4468085106383,25.53191489361702
26185_marine,386,201,298,113,587,77.2020725388601,29.274611398963728
26186_marine,327,143,248,105,470,75.84097859327217,32.11009174311927
26192_marine,85,31,82,2,116,96.47058823529412,2.3529411764705883
26193_marine,89,37,86,2,126,96.62921348314607,2.247191011235955
26194_marine,344,141,251,128,485,72.96511627906976,37.2093023255814
26209_marine,482,196,356,194,678,73.85892116182573,40.24896265560166
26210_marine,467,206,355,175,673,76.017130620985,37.47323340471092
26211_marine,538,216,388,243,754,72.11895910780669,45.16728624535316
26212_marine,525,170,375,245,695,71.42857142857143,46.666666666666664
26213_marine,451,138,316,232,589,70.06651884700665,51.44124168514412
26214_marine,433,124,298,228,557,68.82217090069284,52.65588914549654
26215_marine,102,31,94,12,133,92.15686274509804,11.76470588235294
26216_marine,103,29,95,12,132,92.23300970873787,11.650485436893204
26217_marine,107,29,99,12,136,92.5233644859813,11.214953271028037
26218_marine,107,29,101,10,136,94.39252336448598,9.345794392523365
26219_marine,119,37,113,14,156,94.9579831932773,11.76470588235294
26220_marine,1005,342,624,580,1347,62.089552238805965,57.711442786069654
26224_marine,1001,338,621,580,1339,62.03796203796203,57.94205794205794
26225_marine,118,31,113,13,149,95.76271186440678,11.016949152542372
26226_marine,102,30,98,10,132,96.07843137254902,9.803921568627452
26227_marine,96,28,92,8,124,95.83333333333334,8.333333333333332
26228_marine,96,28,92,8,124,95.83333333333334,8.333333333333332
26229_marine,93,27,89,8,120,95.6989247311828,8.60215053763441
26230_marine,93,27,89,8,120,95.6989247311828,8.60215053763441
26231_marine,92,28,88,8,120,95.65217391304348,8.695652173913043
26232_marine,92,30,88,7,122,95.65217391304348,7.608695652173914
26233_marine,92,30,88,7,122,95.65217391304348,7.608695652173914
26234_marine,90,30,86,7,120,95.55555555555556,7.777777777777778
26235_marine,92,28,87,8,120,94.56521739130434,8.695652173913043
26236_marine,92,28,87,8,120,94.56521739130434,8.695652173913043
26237_marine,93,28,88,8,121,94.6236559139785,8.60215053763441
26238_marine,93,29,88,8,122,94.6236559139785,8.60215053763441
26239_marine,93,29,88,8,122,94.6236559139785,8.60215053763441
26240_marine,94,28,89,8,122,94.68085106382979,8.51063829787234
26241_marine,94,28,89,8,122,94.68085106382979,8.51063829787234
26242_marine,94,29,89,8,123,94.68085106382979,8.51063829787234
26243_marine,94,31,89,8,125,94.68085106382979,8.51063829787234
26244_marine,100,33,95,11,133,95,11
26245_marine,514,129,334,325,643,64.98054474708171,63.22957198443579
26246_marine,558,170,368,344,728,65.94982078853047,61.648745519713266
26247_marine,524,144,340,331,668,64.8854961832061,63.167938931297705
26248_marine,101,33,96,13,134,95.04950495049505,12.871287128712872
26249_marine,96,33,91,8,129,94.79166666666666,8.333333333333332
26250_marine,94,32,89,8,126,94.68085106382979,8.51063829787234
26251_marine,94,33,89,8,127,94.68085106382979,8.51063829787234
26252_marine,94,33,89,8,127,94.68085106382979,8.51063829787234
26253_marine,113,37,101,23,150,89.38053097345133,20.353982300884958
26254_marine,94,33,89,8,127,94.68085106382979,8.51063829787234
26255_marine,94,33,89,8,127,94.68085106382979,8.51063829787234
26256_marine,94,34,89,8,128,94.68085106382979,8.51063829787234
26257_marine,94,34,89,8,128,94.68085106382979,8.51063829787234
26258_marine,94,35,89,8,129,94.68085106382979,8.51063829787234
26259_marine,94,35,89,8,129,94.68085106382979,8.51063829787234
26260_marine,95,36,90,10,131,94.73684210526315,10.526315789473683
26261_marine,98,37,93,10,135,94.89795918367348,10.204081632653061
26262_marine,100,37,95,10,137,95,10
26263_marine,101,37,96,10,138,95.04950495049505,9.900990099009901
26264_marine,102,37,97,11,139,95.09803921568627,10.784313725490197
26265_marine,102,37,97,11,139,95.09803921568627,10.784313725490197
26266_marine,101,37,96,10,138,95.04950495049505,9.900990099009901
26267_marine,99,38,94,8,137,94.94949494949495,8.080808080808081
26268_marine,98,39,93,8,137,94.89795918367348,8.16326530612245
26269_marine,97,39,92,8,136,94.84536082474226,8.24742268041237
26270_marine,98,38,93,9,136,94.89795918367348,9.183673469387756
26271_marine,98,38,93,9,136,94.89795918367348,9.183673469387756
26272_marine,97,38,92,8,135,94.84536082474226,8.24742268041237
26273_marine,97,38,92,8,135,94.84536082474226,8.24742268041237
26274_marine,96,38,91,7,134,94.79166666666666,7.291666666666667
26275_marine,96,38,91,7,134,94.79166666666666,7.291666666666667
26276_marine,96,39,91,7,135,94.79166666666666,7.291666666666667
26277_marine,98,39,93,7,137,94.89795918367348,7.142857142857142
26278_marine,98,40,93,7,138,94.89795918367348,7.142857142857142
26279_marine,98,40,93,7,138,94.89795918367348,7.142857142857142
26280_marine,98,40,93,7,138,94.89795918367348,7.142857142857142
26281_marine,98,38,93,7,136,94.89795918367348,7.142857142857142
26282_marine,98,38,93,7,136,94.89795918367348,7.142857142857142
26283_marine,98,39,93,7,137,94.89795918367348,7.142857142857142
26284_marine,98,40,93,7,138,94.89795918367348,7.142857142857142
26285_marine,98,40,93,7,138,94.89795918367348,7.142857142857142
26286_marine,100,40,95,9,140,95,9
26287_marine,100,40,95,9,140,95,9
26288_marine,99,40,94,9,139,94.94949494949495,9.090909090909092
26289_marine,97,40,92,7,137,94.84536082474226,7.216494845360824
26290_marine,285,69,194,165,354,68.0701754385965,57.89473684210527
26291_marine,295,76,204,167,371,69.15254237288136,56.61016949152542
26292_marine,285,68,194,165,353,68.0701754385965,57.89473684210527
26293_marine,97,41,92,7,138,94.84536082474226,7.216494845360824
26294_marine,97,42,92,7,139,94.84536082474226,7.216494845360824
26295_marine,97,42,92,7,139,94.84536082474226,7.216494845360824
26296_marine,97,42,92,7,139,94.84536082474226,7.216494845360824
26297_marine,97,43,92,7,140,94.84536082474226,7.216494845360824
26298_marine,97,44,92,7,141,94.84536082474226,7.216494845360824
26299_marine,103,42,96,7,145,93.20388349514563,6.796116504854369
26300_marine,103,42,96,7,145,93.20388349514563,6.796116504854369
26301_marine,103,42,96,7,145,93.20388349514563,6.796116504854369
26302_marine,104,42,97,7,146,93.26923076923077,6.730769230769231
26303_marine,109,43,102,7,152,93.57798165137615,6.422018348623854
26304_marine,109,45,102,7,154,93.57798165137615,6.422018348623854
26305_marine,109,45,102,7,154,93.57798165137615,6.422018348623854
26306_marine,108,43,102,7,151,94.44444444444444,6.481481481481481
26307_marine,107,44,102,7,151,95.32710280373831,6.5420560747663545
26308_marine,103,44,98,7,147,95.14563106796116,6.796116504854369
26309_marine,101,44,96,7,145,95.04950495049505,6.9306930693069315
26310_marine,96,44,92,6,140,95.83333333333334,6.25
26311_marine,94,43,90,6,137,95.74468085106383,6.382978723404255
26312_marine,92,42,88,6,134,95.65217391304348,6.521739130434782
26313_marine,91,41,87,5,132,95.6043956043956,5.4945054945054945
26314_marine,91,41,87,5,132,95.6043956043956,5.4945054945054945
26315_marine,87,41,83,5,128,95.40229885057471,5.747126436781609
26316_marine,87,40,83,5,127,95.40229885057471,5.747126436781609
26317_marine,87,40,83,5,127,95.40229885057471,5.747126436781609
26318_marine,88,40,84,5,128,95.45454545454545,5.681818181818182
26319_marine,88,40,84,5,128,95.45454545454545,5.681818181818182
26320_marine,88,39,84,5,127,95.45454545454545,5.681818181818182
26321_marine,84,41,80,3,125,95.23809523809523,3.571428571428571
26322_marine,84,39,80,3,123,95.23809523809523,3.571428571428571
26323_marine,86,39,82,3,125,95.34883720930233,3.488372093023256
26324_marine,86,39,82,3,125,95.34883720930233,3.488372093023256
26325_marine,85,39,81,3,124,95.29411764705881,3.5294117647058822
26326_marine,85,38,81,3,123,95.29411764705881,3.5294117647058822
26327_marine,85,38,81,3,123,95.29411764705881,3.5294117647058822
26328_marine,85,38,81,3,123,95.29411764705881,3.5294117647058822
26329_marine,85,38,81,3,123,95.29411764705881,3.5294117647058822
26330_marine,85,38,81,3,123,95.29411764705881,3.5294117647058822
26331_marine,85,38,81,3,123,95.29411764705881,3.5294117647058822
26332_marine,86,40,82,3,126,95.34883720930233,3.488372093023256
26333_marine,86,39,82,3,125,95.34883720930233,3.488372093023256
26334_marine,87,38,83,3,125,95.40229885057471,3.4482758620689653
26335_marine,87,38,83,3,125,95.40229885057471,3.4482758620689653
26336_marine,85,37,81,3,122,95.29411764705881,3.5294117647058822
26337_marine,85,37,81,3,122,95.29411764705881,3.5294117647058822
26338_marine,85,37,81,3,122,95.29411764705881,3.5294117647058822
26339_marine,85,38,81,3,123,95.29411764705881,3.5294117647058822
26340_marine,87,39,83,5,126,95.40229885057471,5.747126436781609
26341_marine,89,41,84,5,130,94.3820224719101,5.617977528089887
26342_marine,90,41,85,6,131,94.44444444444444,6.666666666666667
26343_marine,90,41,85,6,131,94.44444444444444,6.666666666666667
26344_marine,92,42,87,7,134,94.56521739130434,7.608695652173914
26345_marine,88,43,83,5,131,94.31818181818183,5.681818181818182
26346_marine,91,42,86,7,133,94.5054945054945,7.6923076923076925
26347_marine,90,44,85,7,134,94.44444444444444,7.777777777777778
26348_marine,90,44,85,7,134,94.44444444444444,7.777777777777778
26349_marine,91,44,85,8,135,93.4065934065934,8.791208791208792
26350_marine,93,44,87,8,137,93.54838709677419,8.60215053763441
26351_marine,90,43,84,6,133,93.33333333333333,6.666666666666667
26352_marine,91,44,84,7,135,92.3076923076923,7.6923076923076925
26353_marine,94,43,87,7,137,92.5531914893617,7.446808510638298
26354_marine,96,44,89,7,140,92.70833333333334,7.291666666666667
26355_marine,100,45,93,8,145,93,8
26356_marine,103,44,95,12,147,92.23300970873787,11.650485436893204
26357_marine,105,44,96,13,149,91.42857142857143,12.380952380952381
26358_marine,276,232,217,69,508,78.62318840579711,25
26359_marine,279,234,217,72,513,77.77777777777779,25.806451612903224
26373_marine,385,338,283,138,723,73.50649350649351,35.84415584415584
26376_marine,351,279,263,123,630,74.92877492877493,35.04273504273504
26377_marine,344,261,263,114,605,76.45348837209302,33.13953488372093
26378_marine,321,227,243,111,548,75.70093457943925,34.57943925233645
26379_marine,317,211,239,109,528,75.39432176656152,34.38485804416404
26380_marine,317,201,238,108,518,75.0788643533123,34.06940063091483
26381_marine,116,63,105,16,179,90.51724137931035,13.793103448275861
26382_marine,334,198,252,120,532,75.44910179640718,35.92814371257485
26383_marine,339,192,255,123,531,75.22123893805309,36.283185840707965
26384_marine,337,174,255,118,511,75.66765578635015,35.01483679525222
26385_marine,111,42,102,12,153,91.8918918918919,10.81081081081081
26386_marine,103,34,94,12,137,91.2621359223301,11.650485436893204
26387_marine,106,34,97,12,140,91.50943396226415,11.320754716981133
26388_marine,333,195,253,117,528,75.97597597597597,35.13513513513514
26389_marine,333,197,253,117,530,75.97597597597597,35.13513513513514
26390_marine,333,193,253,117,526,75.97597597597597,35.13513513513514
26391_marine,105,33,96,12,138,91.42857142857143,11.428571428571429
26392_marine,105,33,96,12,138,91.42857142857143,11.428571428571429
26393_marine,111,38,102,14,149,91.8918918918919,12.612612612612612
26394_marine,352,226,265,125,578,75.2840909090909,35.51136363636363
26395_marine,351,219,263,124,570,74.92877492877493,35.32763532763533
26396_marine,355,220,267,126,575,75.21126760563381,35.49295774647888
26397_marine,330,224,247,122,554,74.84848484848486,36.96969696969697
26399_marine,460,369,298,245,829,64.78260869565217,53.2608695652174
26400_marine,350,255,256,136,605,73.14285714285714,38.857142857142854
26401_marine,99,39,90,12,138,90.9090909090909,12.121212121212121
26402_marine,98,35,89,10,133,90.81632653061224,10.204081632653061
26403_marine,90,34,82,7,124,91.11111111111111,7.777777777777778
26404_marine,87,35,79,7,122,90.80459770114942,8.045977011494253
26405_marine,87,35,79,7,122,90.80459770114942,8.045977011494253
26406_marine,85,34,77,6,119,90.58823529411765,7.0588235294117645
26407_marine,86,34,78,6,120,90.69767441860465,6.976744186046512
26408_marine,85,34,77,6,119,90.58823529411765,7.0588235294117645
26409_marine,83,34,75,4,117,90.36144578313254,4.819277108433735
26410_marine,83,34,75,4,117,90.36144578313254,4.819277108433735
26411_marine,82,34,75,3,116,91.46341463414635,3.6585365853658534
26412_marine,82,34,75,3,116,91.46341463414635,3.6585365853658534
26413_marine,85,34,78,3,119,91.76470588235294,3.5294117647058822
26414_marine,85,34,78,3,119,91.76470588235294,3.5294117647058822
26415_marine,83,34,78,1,117,93.97590361445783,1.2048192771084338
26416_marine,84,34,79,1,118,94.04761904761905,1.1904761904761905
26417_marine,84,32,79,1,116,94.04761904761905,1.1904761904761905
26418_marine,84,32,79,1,116,94.04761904761905,1.1904761904761905
26419_marine,85,32,80,1,117,94.11764705882352,1.1764705882352942
26420_marine,85,32,80,1,117,94.11764705882352,1.1764705882352942
26421_marine,85,32,80,1,117,94.11764705882352,1.1764705882352942
26422_marine,85,31,80,1,116,94.11764705882352,1.1764705882352942
26423_marine,85,31,80,1,116,94.11764705882352,1.1764705882352942
26424_marine,86,31,81,1,117,94.18604651162791,1.1627906976744187
26425_marine,85,31,80,0,116,94.11764705882352,0
26426_marine,89,31,84,1,120,94.3820224719101,1.1235955056179776
26427_marine,90,31,85,2,121,94.44444444444444,2.2222222222222223
26428_marine,90,31,85,2,121,94.44444444444444,2.2222222222222223
26429_marine,90,31,85,2,121,94.44444444444444,2.2222222222222223
26430_marine,90,31,85,2,121,94.44444444444444,2.2222222222222223
26431_marine,91,31,86,3,122,94.5054945054945,3.296703296703297
26432_marine,93,31,88,3,124,94.6236559139785,3.225806451612903
26433_marine,101,31,96,6,132,95.04950495049505,5.9405940594059405
26434_marine,212,81,189,31,293,89.15094339622641,14.622641509433961
26437_marine,215,89,192,31,304,89.30232558139535,14.418604651162791
26439_marine,222,85,199,32,307,89.63963963963964,14.414414414414415
26440_marine,110,33,104,6,143,94.54545454545455,5.454545454545454
26441_marine,119,37,113,7,156,94.9579831932773,5.88235294117647
26442_marine,122,37,114,14,159,93.44262295081968,11.475409836065573
26443_marine,339,150,311,45,489,91.74041297935102,13.274336283185843
26444_marine,353,174,323,51,527,91.5014164305949,14.44759206798867
26500_marine,816,351,495,467,1167,60.66176470588235,57.23039215686274
26501_marine,551,239,367,278,790,66.60617059891108,50.45372050816697
26502_marine,576,254,386,290,830,67.01388888888889,50.34722222222222
26503_marine,688,332,446,374,1020,64.82558139534885,54.360465116279066
26513_marine,496,205,358,211,701,72.17741935483872,42.54032258064516
26514_marine,627,297,437,289,924,69.6969696969697,46.09250398724083
26515_marine,621,287,434,290,908,69.88727858293076,46.69887278582931
26516_marine,511,212,377,209,723,73.77690802348337,40.90019569471624
26517_marine,470,187,345,190,657,73.40425531914893,40.42553191489361
26518_marine,450,183,339,180,633,75.33333333333333,40
26519_marine,100,38,95,11,138,95,11
26520_marine,94,38,90,10,132,95.74468085106383,10.638297872340425
26521_marine,83,33,79,7,116,95.18072289156626,8.433734939759036
26522_marine,75,31,71,3,106,94.66666666666667,4
26523_marine,73,31,69,3,104,94.52054794520548,4.10958904109589
26524_marine,73,31,69,3,104,94.52054794520548,4.10958904109589
26525_marine,73,31,69,3,104,94.52054794520548,4.10958904109589
26526_marine,73,30,69,3,103,94.52054794520548,4.10958904109589
26527_marine,74,30,70,4,104,94.5945945945946,5.405405405405405
26528_marine,73,30,69,3,103,94.52054794520548,4.10958904109589
26529_marine,77,29,73,5,106,94.8051948051948,6.493506493506493
26530_marine,87,28,83,5,115,95.40229885057471,5.747126436781609
26531_marine,101,34,97,5,135,96.03960396039604,4.9504950495049505
26532_marine,112,46,108,9,158,96.42857142857143,8.035714285714286
26533_marine,371,184,304,90,555,81.94070080862534,24.258760107816713
26544_marine,375,183,288,112,558,76.8,29.86666666666667
26545_marine,99,37,95,5,136,95.95959595959596,5.05050505050505
26552_marine,87,29,84,2,116,96.55172413793103,2.2988505747126435
26553_marine,90,37,87,5,127,96.66666666666667,5.555555555555555
26554_marine,359,143,255,140,502,71.03064066852369,38.99721448467967
26570_marine,568,192,408,263,760,71.83098591549296,46.30281690140845
26571_marine,438,126,305,220,564,69.63470319634703,50.2283105022831
26572_marine,469,138,331,244,607,70.57569296375267,52.02558635394456
26573_marine,531,149,371,308,680,69.86817325800376,58.00376647834275
26574_marine,436,128,299,231,564,68.57798165137615,52.981651376146786
26575_marine,123,51,107,24,174,86.99186991869918,19.51219512195122
26576_marine,104,33,96,12,137,92.3076923076923,11.538461538461538
26577_marine,109,29,101,12,138,92.66055045871559,11.009174311926607
26578_marine,624,162,409,373,786,65.5448717948718,59.77564102564102
26579_marine,963,328,594,561,1291,61.6822429906542,58.25545171339564
26584_marine,1007,344,621,588,1351,61.668321747765646,58.39126117179742
26585_marine,133,38,128,18,171,96.2406015037594,13.533834586466165
26586_marine,117,34,113,14,151,96.58119658119658,11.965811965811966
26587_marine,93,30,89,8,123,95.6989247311828,8.60215053763441
26588_marine,95,28,91,8,123,95.78947368421052,8.421052631578947
26589_marine,93,26,89,8,119,95.6989247311828,8.60215053763441
26590_marine,91,28,87,8,119,95.6043956043956,8.791208791208792
26591_marine,92,28,88,8,120,95.65217391304348,8.695652173913043
26592_marine,92,28,88,8,120,95.65217391304348,8.695652173913043
26593_marine,92,30,88,7,122,95.65217391304348,7.608695652173914
26594_marine,92,30,88,7,122,95.65217391304348,7.608695652173914
26595_marine,91,28,86,8,119,94.5054945054945,8.791208791208792
26596_marine,92,28,87,8,120,94.56521739130434,8.695652173913043
26597_marine,92,28,87,8,120,94.56521739130434,8.695652173913043
26598_marine,93,28,88,8,121,94.6236559139785,8.60215053763441
26599_marine,93,28,88,8,121,94.6236559139785,8.60215053763441
26600_marine,95,28,90,8,123,94.73684210526315,8.421052631578947
26601_marine,95,28,90,8,123,94.73684210526315,8.421052631578947
26602_marine,94,29,89,8,123,94.68085106382979,8.51063829787234
26603_marine,95,29,90,9,124,94.73684210526315,9.473684210526317
26604_marine,99,32,94,11,131,94.94949494949495,11.11111111111111
26605_marine,520,140,338,327,660,65,62.88461538461539
26606_marine,568,179,375,347,747,66.02112676056338,61.09154929577465
26607_marine,558,175,367,345,733,65.77060931899642,61.82795698924731
26608_marine,100,36,95,13,136,95,13
26609_marine,95,33,90,8,128,94.73684210526315,8.421052631578947
26610_marine,94,32,89,8,126,94.68085106382979,8.51063829787234
26611_marine,94,33,89,8,127,94.68085106382979,8.51063829787234
26612_marine,94,33,89,8,127,94.68085106382979,8.51063829787234
26613_marine,94,33,89,8,127,94.68085106382979,8.51063829787234
26614_marine,94,33,89,8,127,94.68085106382979,8.51063829787234
26615_marine,94,33,89,8,127,94.68085106382979,8.51063829787234
26616_marine,94,34,89,8,128,94.68085106382979,8.51063829787234
26617_marine,94,34,89,8,128,94.68085106382979,8.51063829787234
26618_marine,94,34,89,8,128,94.68085106382979,8.51063829787234
26619_marine,96,35,91,8,131,94.79166666666666,8.333333333333332
26620_marine,97,35,92,10,132,94.84536082474226,10.309278350515463
26621_marine,97,38,92,10,135,94.84536082474226,10.309278350515463
26622_marine,100,38,95,10,138,95,10
26623_marine,101,37,96,10,138,95.04950495049505,9.900990099009901
26624_marine,102,37,97,11,139,95.09803921568627,10.784313725490197
26625_marine,101,37,96,10,138,95.04950495049505,9.900990099009901
26626_marine,101,37,96,10,138,95.04950495049505,9.900990099009901
26627_marine,99,38,94,8,137,94.94949494949495,8.080808080808081
26628_marine,99,38,94,8,137,94.94949494949495,8.080808080808081
26629_marine,98,38,93,8,136,94.89795918367348,8.16326530612245
26630_marine,97,38,92,8,135,94.84536082474226,8.24742268041237
26631_marine,98,38,93,9,136,94.89795918367348,9.183673469387756
26632_marine,98,38,93,9,136,94.89795918367348,9.183673469387756
26633_marine,97,38,92,8,135,94.84536082474226,8.24742268041237
26634_marine,98,38,93,7,136,94.89795918367348,7.142857142857142
26635_marine,98,38,93,7,136,94.89795918367348,7.142857142857142
26636_marine,98,38,93,7,136,94.89795918367348,7.142857142857142
26637_marine,98,39,93,7,137,94.89795918367348,7.142857142857142
26638_marine,98,39,93,7,137,94.89795918367348,7.142857142857142
26639_marine,98,39,93,7,137,94.89795918367348,7.142857142857142
26640_marine,98,39,93,7,137,94.89795918367348,7.142857142857142
26641_marine,98,38,93,7,136,94.89795918367348,7.142857142857142
26642_marine,98,39,93,7,137,94.89795918367348,7.142857142857142
26643_marine,98,40,93,7,138,94.89795918367348,7.142857142857142
26644_marine,98,40,93,7,138,94.89795918367348,7.142857142857142
26645_marine,98,40,93,7,138,94.89795918367348,7.142857142857142
26646_marine,98,40,93,7,138,94.89795918367348,7.142857142857142
26647_marine,98,40,93,7,138,94.89795918367348,7.142857142857142
26648_marine,98,40,93,7,138,94.89795918367348,7.142857142857142
26649_marine,97,40,92,7,137,94.84536082474226,7.216494845360824
26650_marine,285,67,194,165,352,68.0701754385965,57.89473684210527
26651_marine,285,67,194,165,352,68.0701754385965,57.89473684210527
26652_marine,267,62,180,152,329,67.41573033707866,56.92883895131086
26653_marine,97,40,92,7,137,94.84536082474226,7.216494845360824
26654_marine,97,41,92,7,138,94.84536082474226,7.216494845360824
26655_marine,97,41,92,7,138,94.84536082474226,7.216494845360824
26656_marine,97,42,92,7,139,94.84536082474226,7.216494845360824
26657_marine,97,43,92,7,140,94.84536082474226,7.216494845360824
26658_marine,96,44,91,7,140,94.79166666666666,7.291666666666667
26659_marine,96,44,91,7,140,94.79166666666666,7.291666666666667
26660_marine,98,43,93,7,141,94.89795918367348,7.142857142857142
26661_marine,102,43,97,7,145,95.09803921568627,6.862745098039216
26662_marine,102,43,97,7,145,95.09803921568627,6.862745098039216
26663_marine,102,43,97,7,145,95.09803921568627,6.862745098039216
26664_marine,104,44,99,7,148,95.1923076923077,6.730769230769231
26665_marine,103,44,98,7,147,95.14563106796116,6.796116504854369
26666_marine,101,44,96,7,145,95.04950495049505,6.9306930693069315
26667_marine,101,44,96,7,145,95.04950495049505,6.9306930693069315
26668_marine,101,44,96,7,145,95.04950495049505,6.9306930693069315
26669_marine,101,44,96,7,145,95.04950495049505,6.9306930693069315
26670_marine,95,44,90,7,139,94.73684210526315,7.368421052631578
26671_marine,94,43,90,6,137,95.74468085106383,6.382978723404255
26672_marine,93,43,89,6,136,95.6989247311828,6.451612903225806
26673_marine,89,42,85,5,131,95.50561797752809,5.617977528089887
26674_marine,88,41,84,5,129,95.45454545454545,5.681818181818182
26675_marine,87,41,83,5,128,95.40229885057471,5.747126436781609
26676_marine,86,40,82,5,126,95.34883720930233,5.813953488372093
26677_marine,86,40,82,5,126,95.34883720930233,5.813953488372093
26678_marine,86,40,82,5,126,95.34883720930233,5.813953488372093
26679_marine,86,40,82,5,126,95.34883720930233,5.813953488372093
26680_marine,86,40,82,5,126,95.34883720930233,5.813953488372093
26681_marine,85,39,81,4,124,95.29411764705881,4.705882352941177
26682_marine,84,39,80,3,123,95.23809523809523,3.571428571428571
26683_marine,84,41,80,3,125,95.23809523809523,3.571428571428571
26684_marine,84,41,80,3,125,95.23809523809523,3.571428571428571
26685_marine,84,40,80,3,124,95.23809523809523,3.571428571428571
26686_marine,84,39,80,3,123,95.23809523809523,3.571428571428571
26687_marine,83,38,79,3,121,95.18072289156626,3.614457831325301
26688_marine,83,38,79,3,121,95.18072289156626,3.614457831325301
26689_marine,85,38,81,3,123,95.29411764705881,3.5294117647058822
26690_marine,84,38,80,3,122,95.23809523809523,3.571428571428571
26691_marine,83,38,79,3,121,95.18072289156626,3.614457831325301
26692_marine,83,40,79,3,123,95.18072289156626,3.614457831325301
26693_marine,84,40,80,3,124,95.23809523809523,3.571428571428571
26694_marine,84,40,80,3,124,95.23809523809523,3.571428571428571
26695_marine,84,40,80,3,124,95.23809523809523,3.571428571428571
26696_marine,84,39,80,3,123,95.23809523809523,3.571428571428571
26697_marine,84,37,80,3,121,95.23809523809523,3.571428571428571
26698_marine,84,37,80,3,121,95.23809523809523,3.571428571428571
26699_marine,84,38,80,3,122,95.23809523809523,3.571428571428571
26700_marine,83,39,79,3,122,95.18072289156626,3.614457831325301
26701_marine,86,39,82,5,125,95.34883720930233,5.813953488372093
26702_marine,89,40,85,6,129,95.50561797752809,6.741573033707865
26703_marine,90,40,85,6,130,94.44444444444444,6.666666666666667
26704_marine,92,42,87,6,134,94.56521739130434,6.521739130434782
26705_marine,89,43,84,4,132,94.3820224719101,4.49438202247191
26706_marine,90,43,85,6,133,94.44444444444444,6.666666666666667
26707_marine,90,42,85,7,132,94.44444444444444,7.777777777777778
26708_marine,88,42,83,7,130,94.31818181818183,7.954545454545454
26709_marine,89,42,84,7,131,94.3820224719101,7.865168539325842
26710_marine,87,42,82,5,129,94.25287356321839,5.747126436781609
26711_marine,89,43,83,6,132,93.25842696629213,6.741573033707865
26712_marine,89,43,82,7,132,92.13483146067416,7.865168539325842
26713_marine,90,43,83,7,133,92.22222222222223,7.777777777777778
26714_marine,93,44,86,7,137,92.47311827956989,7.526881720430108
26715_marine,94,44,87,7,138,92.5531914893617,7.446808510638298
26716_marine,94,44,87,7,138,92.5531914893617,7.446808510638298
26717_marine,100,43,93,11,143,93,11
26718_marine,102,42,95,11,144,93.13725490196079,10.784313725490197
26719_marine,104,44,95,13,148,91.34615384615384,12.5
26720_marine,274,220,215,67,494,78.46715328467153,24.45255474452555
26721_marine,274,224,215,67,498,78.46715328467153,24.45255474452555
26722_marine,278,228,216,70,506,77.6978417266187,25.179856115107913
26726_marine,233,193,211,33,426,90.55793991416309,14.163090128755366
26738_marine,352,240,269,121,592,76.42045454545455,34.375
26739_marine,324,222,246,113,546,75.92592592592592,34.876543209876544
26740_marine,315,205,237,109,520,75.23809523809524,34.6031746031746
26741_marine,113,69,102,15,182,90.2654867256637,13.274336283185843
26742_marine,113,65,104,15,178,92.03539823008849,13.274336283185843
26743_marine,104,37,95,10,141,91.34615384615384,9.615384615384617
26744_marine,98,33,89,10,131,90.81632653061224,10.204081632653061
26745_marine,98,33,89,10,131,90.81632653061224,10.204081632653061
26746_marine,98,33,89,10,131,90.81632653061224,10.204081632653061
26747_marine,100,33,91,12,133,91,12
26748_marine,100,33,91,12,133,91,12
26749_marine,102,33,93,12,135,91.17647058823529,11.76470588235294
26750_marine,102,33,93,12,135,91.17647058823529,11.76470588235294
26751_marine,103,33,94,12,136,91.2621359223301,11.650485436893204
26752_marine,105,33,96,12,138,91.42857142857143,11.428571428571429
26753_marine,103,33,94,10,136,91.2621359223301,9.70873786407767
26754_marine,103,33,94,10,136,91.2621359223301,9.70873786407767
26755_marine,104,35,95,12,139,91.34615384615384,11.538461538461538
26756_marine,120,41,110,19,161,91.66666666666666,15.833333333333332
26757_marine,132,58,120,26,190,90.9090909090909,19.696969696969695
26758_marine,328,204,241,124,532,73.47560975609755,37.80487804878049
26760_marine,339,235,250,128,574,73.74631268436578,37.75811209439528
26761_marine,113,37,104,13,150,92.03539823008849,11.504424778761061
26762_marine,100,35,91,11,135,91,11
26763_marine,91,35,82,8,126,90.10989010989012,8.791208791208792
26764_marine,88,35,81,6,123,92.04545454545455,6.8181818181818175
26765_marine,86,35,79,6,121,91.86046511627907,6.976744186046512
26766_marine,86,35,79,6,121,91.86046511627907,6.976744186046512
26767_marine,86,35,78,6,121,90.69767441860465,6.976744186046512
26768_marine,85,34,77,6,119,90.58823529411765,7.0588235294117645
26769_marine,85,34,77,6,119,90.58823529411765,7.0588235294117645
26770_marine,84,34,76,5,118,90.47619047619048,5.952380952380952
26771_marine,82,34,75,3,116,91.46341463414635,3.6585365853658534
26772_marine,82,34,75,3,116,91.46341463414635,3.6585365853658534
26773_marine,85,34,78,3,119,91.76470588235294,3.5294117647058822
26774_marine,86,34,79,3,120,91.86046511627907,3.488372093023256
26775_marine,83,34,78,1,117,93.97590361445783,1.2048192771084338
26776_marine,84,34,79,1,118,94.04761904761905,1.1904761904761905
26777_marine,84,33,79,1,117,94.04761904761905,1.1904761904761905
26778_marine,84,33,79,1,117,94.04761904761905,1.1904761904761905
26779_marine,84,32,79,1,116,94.04761904761905,1.1904761904761905
26780_marine,85,32,80,1,117,94.11764705882352,1.1764705882352942
26781_marine,85,32,80,1,117,94.11764705882352,1.1764705882352942
26782_marine,85,32,80,1,117,94.11764705882352,1.1764705882352942
26783_marine,85,31,80,1,116,94.11764705882352,1.1764705882352942
26784_marine,86,31,81,1,117,94.18604651162791,1.1627906976744187
26785_marine,87,31,82,2,118,94.25287356321839,2.2988505747126435
26786_marine,88,31,83,2,119,94.31818181818183,2.272727272727273
26787_marine,89,31,84,3,120,94.3820224719101,3.3707865168539324
26788_marine,88,31,83,2,119,94.31818181818183,2.272727272727273
26789_marine,90,31,85,2,121,94.44444444444444,2.2222222222222223
26790_marine,90,31,85,2,121,94.44444444444444,2.2222222222222223
26791_marine,90,31,85,2,121,94.44444444444444,2.2222222222222223
26792_marine,93,31,88,3,124,94.6236559139785,3.225806451612903
26793_marine,98,31,93,5,129,94.89795918367348,5.1020408163265305
26794_marine,105,33,99,8,138,94.28571428571428,7.6190476190476195
26795_marine,213,83,190,31,296,89.2018779342723,14.553990610328638
26799_marine,222,89,199,32,311,89.63963963963964,14.414414414414415
26800_marine,112,33,106,6,145,94.64285714285714,5.357142857142857
26801_marine,121,37,115,9,158,95.0413223140496,7.43801652892562
26802_marine,312,136,285,43,448,91.34615384615384,13.782051282051283
26803_marine,348,168,319,50,516,91.66666666666666,14.367816091954023
26804_marine,348,161,313,55,509,89.9425287356322,15.804597701149426
26860_marine,865,384,513,506,1249,59.30635838150289,58.4971098265896
26861_marine,798,356,499,447,1154,62.531328320802004,56.015037593984964
26862_marine,574,235,384,290,809,66.89895470383276,50.522648083623686
26863_marine,699,327,451,378,1026,64.52074391988555,54.077253218884124
26871_marine,608,266,426,296,874,70.06578947368422,48.68421052631579
26872_marine,612,272,425,294,884,69.44444444444444,48.03921568627451
26873_marine,597,267,417,281,864,69.84924623115577,47.06867671691792
26874_marine,466,175,338,196,641,72.53218884120172,42.06008583690987
26875_marine,458,176,337,191,634,73.58078602620087,41.70305676855895
26876_marine,103,40,95,14,143,92.23300970873787,13.592233009708737
26877_marine,101,39,96,13,140,95.04950495049505,12.871287128712872
26878_marine,101,39,96,13,140,95.04950495049505,12.871287128712872
26879_marine,97,38,92,11,135,94.84536082474226,11.34020618556701
26880_marine,84,36,79,6,120,94.04761904761905,7.142857142857142
26881_marine,80,31,75,6,111,93.75,7.5
26882_marine,74,31,69,4,105,93.24324324324324,5.405405405405405
26883_marine,73,31,69,3,104,94.52054794520548,4.10958904109589
26884_marine,73,31,69,3,104,94.52054794520548,4.10958904109589
26885_marine,73,31,69,3,104,94.52054794520548,4.10958904109589
26886_marine,74,30,70,4,104,94.5945945945946,5.405405405405405
26887_marine,74,30,70,4,104,94.5945945945946,5.405405405405405
26888_marine,74,30,70,3,104,94.5945945945946,4.054054054054054
26889_marine,75,29,71,3,104,94.66666666666667,4
26890_marine,80,29,76,5,109,95,6.25
26891_marine,90,30,86,5,120,95.55555555555556,5.555555555555555
26892_marine,115,40,110,10,155,95.65217391304348,8.695652173913043
26893_marine,375,176,305,98,551,81.33333333333333,26.13333333333333
26895_marine,407,178,327,127,585,80.34398034398035,31.203931203931205
26903_marine,370,178,283,111,548,76.48648648648648,30
26904_marine,340,151,264,104,491,77.64705882352942,30.58823529411765
26905_marine,93,30,90,5,123,96.7741935483871,5.376344086021505
26912_marine,80,29,77,3,109,96.25,3.75
26913_marine,288,94,187,149,382,64.93055555555556,51.736111111111114
26914_marine,413,184,293,161,597,70.94430992736078,38.983050847457626
26917_marine,378,171,294,127,549,77.77777777777779,33.5978835978836
26930_marine,702,244,508,360,946,72.36467236467237,51.28205128205128
26931_marine,575,166,401,285,741,69.73913043478261,49.56521739130435
26932_marine,459,139,323,238,598,70.37037037037037,51.85185185185185
26933_marine,433,128,298,228,561,68.82217090069284,52.65588914549654
26934_marine,426,120,295,228,546,69.24882629107981,53.52112676056338
26935_marine,125,51,109,24,176,87.2,19.2
26936_marine,106,33,98,12,139,92.45283018867924,11.320754716981133
26937_marine,625,162,408,375,787,65.28,60
26938_marine,665,187,437,394,852,65.71428571428571,59.248120300751886
26939_marine,980,345,603,567,1325,61.530612244897966,57.85714285714286
26941_marine,1027,383,632,594,1410,61.53846153846154,57.8383641674781
26944_marine,1027,374,617,609,1401,60.07789678675755,59.29892891918208
26945_marine,832,291,481,531,1123,57.8125,63.82211538461539
26946_marine,134,37,129,17,171,96.26865671641791,12.686567164179104
26947_marine,99,30,95,8,129,95.95959595959596,8.080808080808081
26948_marine,93,28,89,8,121,95.6989247311828,8.60215053763441
26949_marine,91,26,87,8,117,95.6043956043956,8.791208791208792
26950_marine,90,27,86,8,117,95.55555555555556,8.88888888888889
26951_marine,91,28,87,8,119,95.6043956043956,8.791208791208792
26952_marine,91,28,87,8,119,95.6043956043956,8.791208791208792
26953_marine,93,28,89,8,121,95.6989247311828,8.60215053763441
26954_marine,92,28,88,7,120,95.65217391304348,7.608695652173914
26955_marine,93,28,88,8,121,94.6236559139785,8.60215053763441
26956_marine,91,28,86,8,119,94.5054945054945,8.791208791208792
26957_marine,92,28,87,8,120,94.56521739130434,8.695652173913043
26958_marine,93,28,88,8,121,94.6236559139785,8.60215053763441
26959_marine,94,28,89,8,122,94.68085106382979,8.51063829787234
26960_marine,94,28,89,8,122,94.68085106382979,8.51063829787234
26961_marine,95,29,90,8,124,94.73684210526315,8.421052631578947
26962_marine,95,29,90,8,124,94.73684210526315,8.421052631578947
26963_marine,97,31,92,9,128,94.84536082474226,9.278350515463918
26964_marine,102,32,97,12,134,95.09803921568627,11.76470588235294
26965_marine,578,171,366,368,749,63.32179930795848,63.667820069204154
26966_marine,663,213,435,418,876,65.61085972850678,63.04675716440422
26967_marine,568,166,360,358,734,63.38028169014085,63.02816901408451
26968_marine,97,36,92,11,133,94.84536082474226,11.34020618556701
26969_marine,95,33,90,8,128,94.73684210526315,8.421052631578947
26970_marine,93,32,88,8,125,94.6236559139785,8.60215053763441
26971_marine,93,32,88,8,125,94.6236559139785,8.60215053763441
26972_marine,93,33,88,8,126,94.6236559139785,8.60215053763441
26973_marine,93,33,88,8,126,94.6236559139785,8.60215053763441
26974_marine,93,33,88,8,126,94.6236559139785,8.60215053763441
26975_marine,93,33,88,8,126,94.6236559139785,8.60215053763441
26976_marine,94,33,89,8,127,94.68085106382979,8.51063829787234
26977_marine,94,34,89,8,128,94.68085106382979,8.51063829787234
26978_marine,96,33,91,8,129,94.79166666666666,8.333333333333332
26979_marine,96,33,91,8,129,94.79166666666666,8.333333333333332
26980_marine,97,34,92,10,131,94.84536082474226,10.309278350515463
26981_marine,97,36,92,10,133,94.84536082474226,10.309278350515463
26982_marine,99,36,94,10,135,94.94949494949495,10.1010101010101
26983_marine,102,36,97,11,138,95.09803921568627,10.784313725490197
26984_marine,102,36,97,11,138,95.09803921568627,10.784313725490197
26985_marine,101,36,96,10,137,95.04950495049505,9.900990099009901
26986_marine,101,36,96,10,137,95.04950495049505,9.900990099009901
26987_marine,99,37,94,8,136,94.94949494949495,8.080808080808081
26988_marine,99,38,94,8,137,94.94949494949495,8.080808080808081
26989_marine,346,94,250,191,440,72.25433526011561,55.202312138728324
26990_marine,345,95,249,191,440,72.17391304347827,55.362318840579704
26991_marine,98,39,93,8,137,94.89795918367348,8.16326530612245
26992_marine,100,38,95,9,138,95,9
26993_marine,99,38,94,8,137,94.94949494949495,8.080808080808081
26994_marine,98,38,93,7,136,94.89795918367348,7.142857142857142
26995_marine,98,38,93,7,136,94.89795918367348,7.142857142857142
26996_marine,98,38,93,7,136,94.89795918367348,7.142857142857142
26997_marine,98,39,93,7,137,94.89795918367348,7.142857142857142
26998_marine,98,39,93,7,137,94.89795918367348,7.142857142857142
26999_marine,98,39,93,7,137,94.89795918367348,7.142857142857142
27000_marine,98,39,93,7,137,94.89795918367348,7.142857142857142
27001_marine,98,39,93,7,137,94.89795918367348,7.142857142857142
27002_marine,98,40,93,7,138,94.89795918367348,7.142857142857142
27003_marine,98,40,93,7,138,94.89795918367348,7.142857142857142
27004_marine,98,40,93,7,138,94.89795918367348,7.142857142857142
27005_marine,98,40,93,7,138,94.89795918367348,7.142857142857142
27006_marine,98,40,93,7,138,94.89795918367348,7.142857142857142
27007_marine,98,40,93,7,138,94.89795918367348,7.142857142857142
27008_marine,98,40,93,7,138,94.89795918367348,7.142857142857142
27009_marine,97,40,92,7,137,94.84536082474226,7.216494845360824
27010_marine,97,40,92,7,137,94.84536082474226,7.216494845360824
27011_marine,97,40,92,7,137,94.84536082474226,7.216494845360824
27012_marine,97,40,92,7,137,94.84536082474226,7.216494845360824
27013_marine,97,40,92,7,137,94.84536082474226,7.216494845360824
27014_marine,97,41,92,7,138,94.84536082474226,7.216494845360824
27015_marine,97,41,92,7,138,94.84536082474226,7.216494845360824
27016_marine,97,42,92,7,139,94.84536082474226,7.216494845360824
27017_marine,97,42,92,7,139,94.84536082474226,7.216494845360824
27018_marine,96,43,91,7,139,94.79166666666666,7.291666666666667
27019_marine,96,43,91,7,139,94.79166666666666,7.291666666666667
27020_marine,97,43,92,7,140,94.84536082474226,7.216494845360824
27021_marine,97,43,92,7,140,94.84536082474226,7.216494845360824
27022_marine,95,43,90,7,138,94.73684210526315,7.368421052631578
27023_marine,95,43,90,7,138,94.73684210526315,7.368421052631578
27024_marine,96,43,91,7,139,94.79166666666666,7.291666666666667
27025_marine,98,43,93,7,141,94.89795918367348,7.142857142857142
27026_marine,96,44,91,7,140,94.79166666666666,7.291666666666667
27027_marine,94,44,89,7,138,94.68085106382979,7.446808510638298
27028_marine,93,44,88,7,137,94.6236559139785,7.526881720430108
27029_marine,93,44,88,7,137,94.6236559139785,7.526881720430108
27030_marine,93,44,88,7,137,94.6236559139785,7.526881720430108
27031_marine,91,43,87,6,134,95.6043956043956,6.593406593406594
27032_marine,91,43,87,6,134,95.6043956043956,6.593406593406594
27033_marine,88,42,84,5,130,95.45454545454545,5.681818181818182
27034_marine,89,41,85,5,130,95.50561797752809,5.617977528089887
27035_marine,87,40,83,5,127,95.40229885057471,5.747126436781609
27036_marine,87,40,83,5,127,95.40229885057471,5.747126436781609
27037_marine,86,40,82,5,126,95.34883720930233,5.813953488372093
27038_marine,86,40,82,5,126,95.34883720930233,5.813953488372093
27039_marine,86,40,82,5,126,95.34883720930233,5.813953488372093
27040_marine,86,40,82,5,126,95.34883720930233,5.813953488372093
27041_marine,85,40,81,4,125,95.29411764705881,4.705882352941177
27042_marine,85,39,81,4,124,95.29411764705881,4.705882352941177
27043_marine,84,39,80,3,123,95.23809523809523,3.571428571428571
27044_marine,84,41,80,3,125,95.23809523809523,3.571428571428571
27045_marine,84,41,80,3,125,95.23809523809523,3.571428571428571
27046_marine,83,41,79,3,124,95.18072289156626,3.614457831325301
27047_marine,82,41,78,3,123,95.1219512195122,3.6585365853658534
27048_marine,82,39,78,3,121,95.1219512195122,3.6585365853658534
27049_marine,83,39,79,3,122,95.18072289156626,3.614457831325301
27050_marine,82,39,78,3,121,95.1219512195122,3.6585365853658534
27051_marine,82,40,78,3,122,95.1219512195122,3.6585365853658534
27052_marine,82,42,78,3,124,95.1219512195122,3.6585365853658534
27053_marine,83,41,79,3,124,95.18072289156626,3.614457831325301
27054_marine,82,41,78,3,123,95.1219512195122,3.6585365853658534
27055_marine,82,41,78,3,123,95.1219512195122,3.6585365853658534
27056_marine,82,41,78,3,123,95.1219512195122,3.6585365853658534
27057_marine,83,40,79,3,123,95.18072289156626,3.614457831325301
27058_marine,83,39,79,3,122,95.18072289156626,3.614457831325301
27059_marine,83,38,79,3,121,95.18072289156626,3.614457831325301
27060_marine,82,39,78,3,121,95.1219512195122,3.6585365853658534
27061_marine,82,39,78,3,121,95.1219512195122,3.6585365853658534
27062_marine,85,39,81,4,124,95.29411764705881,4.705882352941177
27063_marine,86,39,82,4,125,95.34883720930233,4.651162790697675
27064_marine,87,39,82,4,126,94.25287356321839,4.597701149425287
27065_marine,85,41,80,4,126,94.11764705882352,4.705882352941177
27066_marine,85,42,80,4,127,94.11764705882352,4.705882352941177
27067_marine,84,42,79,4,126,94.04761904761905,4.761904761904762
27068_marine,83,42,78,4,125,93.97590361445783,4.819277108433735
27069_marine,84,42,79,4,126,94.04761904761905,4.761904761904762
27070_marine,84,42,79,4,126,94.04761904761905,4.761904761904762
27071_marine,85,43,80,4,128,94.11764705882352,4.705882352941177
27072_marine,88,43,82,5,131,93.18181818181817,5.681818181818182
27073_marine,90,43,83,6,133,92.22222222222223,6.666666666666667
27074_marine,90,43,83,7,133,92.22222222222223,7.777777777777778
27075_marine,94,43,87,7,137,92.5531914893617,7.446808510638298
27076_marine,94,44,87,7,138,92.5531914893617,7.446808510638298
27077_marine,92,44,85,6,136,92.3913043478261,6.521739130434782
27078_marine,92,44,85,6,136,92.3913043478261,6.521739130434782
27079_marine,97,43,90,8,140,92.78350515463917,8.24742268041237
27080_marine,100,41,92,11,141,92,11
27081_marine,103,42,95,11,145,92.23300970873787,10.679611650485436
27082_marine,102,41,95,10,143,93.13725490196079,9.803921568627452
27083_marine,273,207,215,66,480,78.75457875457876,24.175824175824175
27084_marine,274,206,216,66,480,78.83211678832117,24.087591240875913
27085_marine,253,182,211,49,435,83.399209486166,19.367588932806324
27086_marine,219,159,199,29,378,90.8675799086758,13.24200913242009
27087_marine,229,190,207,33,419,90.39301310043668,14.41048034934498
27098_marine,360,255,272,124,615,75.55555555555556,34.44444444444444
27099_marine,331,268,254,111,599,76.73716012084593,33.53474320241692
27100_marine,316,221,241,106,537,76.26582278481013,33.54430379746836
27101_marine,108,41,98,13,149,90.74074074074075,12.037037037037036
27102_marine,104,45,95,10,149,91.34615384615384,9.615384615384617
27103_marine,102,45,93,10,147,91.17647058823529,9.803921568627452
27104_marine,96,33,87,10,129,90.625,10.416666666666668
27105_marine,96,33,87,10,129,90.625,10.416666666666668
27106_marine,96,33,87,10,129,90.625,10.416666666666668
27107_marine,96,33,87,10,129,90.625,10.416666666666668
27108_marine,98,33,89,10,131,90.81632653061224,10.204081632653061
27109_marine,100,33,91,12,133,91,12
27110_marine,100,33,91,12,133,91,12
27111_marine,101,33,92,12,134,91.0891089108911,11.881188118811881
27112_marine,99,33,90,10,132,90.9090909090909,10.1010101010101
27113_marine,99,33,90,10,132,90.9090909090909,10.1010101010101
27114_marine,100,33,91,10,133,91,10
27115_marine,100,35,91,10,135,91,10
27116_marine,104,39,95,12,143,91.34615384615384,11.538461538461538
27117_marine,113,49,104,14,162,92.03539823008849,12.389380530973451
27118_marine,331,208,244,123,539,73.71601208459214,37.160120845921455
27119_marine,437,311,289,219,748,66.13272311212815,50.11441647597255
27120_marine,443,329,291,223,772,65.68848758465012,50.338600451467265
27121_marine,332,214,247,122,546,74.3975903614458,36.74698795180723
27122_marine,108,39,100,10,147,92.5925925925926,9.25925925925926
27123_marine,90,35,82,7,125,91.11111111111111,7.777777777777778
27124_marine,90,33,82,7,123,91.11111111111111,7.777777777777778
27125_marine,87,35,79,7,122,90.80459770114942,8.045977011494253
27126_marine,86,35,79,6,121,91.86046511627907,6.976744186046512
27127_marine,87,35,80,6,122,91.95402298850574,6.896551724137931
27128_marine,85,35,77,6,120,90.58823529411765,7.0588235294117645
27129_marine,85,35,77,6,120,90.58823529411765,7.0588235294117645
27130_marine,84,34,76,5,118,90.47619047619048,5.952380952380952
27131_marine,83,34,76,4,117,91.56626506024097,4.819277108433735
27132_marine,82,34,75,3,116,91.46341463414635,3.6585365853658534
27133_marine,86,34,79,3,120,91.86046511627907,3.488372093023256
27134_marine,86,34,79,3,120,91.86046511627907,3.488372093023256
27135_marine,86,34,79,3,120,91.86046511627907,3.488372093023256
27136_marine,84,34,79,1,118,94.04761904761905,1.1904761904761905
27137_marine,84,33,79,1,117,94.04761904761905,1.1904761904761905
27138_marine,84,33,79,1,117,94.04761904761905,1.1904761904761905
27139_marine,84,33,79,1,117,94.04761904761905,1.1904761904761905
27140_marine,84,33,79,1,117,94.04761904761905,1.1904761904761905
27141_marine,85,32,80,1,117,94.11764705882352,1.1764705882352942
27142_marine,85,32,80,1,117,94.11764705882352,1.1764705882352942
27143_marine,85,32,80,1,117,94.11764705882352,1.1764705882352942
27144_marine,87,32,82,2,119,94.25287356321839,2.2988505747126435
27145_marine,87,31,82,2,118,94.25287356321839,2.2988505747126435
27146_marine,88,31,83,2,119,94.31818181818183,2.272727272727273
27147_marine,89,31,84,3,120,94.3820224719101,3.3707865168539324
27148_marine,89,31,84,3,120,94.3820224719101,3.3707865168539324
27149_marine,89,31,84,3,120,94.3820224719101,3.3707865168539324
27150_marine,89,31,84,3,120,94.3820224719101,3.3707865168539324
27151_marine,89,31,84,3,120,94.3820224719101,3.3707865168539324
27152_marine,94,31,89,4,125,94.68085106382979,4.25531914893617
27153_marine,100,31,95,6,131,95,6
27154_marine,107,33,102,9,140,95.32710280373831,8.411214953271028
27155_marine,215,83,192,33,298,89.30232558139535,15.348837209302326
27158_marine,218,85,194,34,303,88.9908256880734,15.59633027522936
27159_marine,112,35,106,9,147,94.64285714285714,8.035714285714286
27160_marine,111,33,105,7,144,94.5945945945946,6.306306306306306
27161_marine,119,37,113,9,156,94.9579831932773,7.563025210084033
27162_marine,316,147,289,42,463,91.45569620253164,13.291139240506327
27221_marine,763,328,488,419,1091,63.95806028833552,54.914809960681524
27222_marine,741,324,479,400,1065,64.64237516869096,53.98110661268556
27223_marine,696,329,451,374,1025,64.79885057471265,53.735632183908045
27224_marine,678,315,441,360,993,65.04424778761062,53.09734513274337
27228_marine,632,252,431,324,884,68.19620253164557,51.26582278481012
27229_marine,675,271,464,340,946,68.74074074074073,50.37037037037037
27230_marine,667,270,460,329,937,68.96551724137932,49.32533733133433
27231_marine,634,266,440,312,900,69.4006309148265,49.21135646687697
27232_marine,486,182,351,219,668,72.22222222222221,45.06172839506173
27233_marine,467,175,338,208,642,72.37687366167023,44.53961456102783
27234_marine,112,40,104,17,152,92.85714285714286,15.178571428571427
27235_marine,103,39,96,15,142,93.20388349514563,14.563106796116504
27236_marine,98,39,93,12,137,94.89795918367348,12.244897959183673
27237_marine,99,37,94,13,136,94.94949494949495,13.131313131313133
27238_marine,97,38,92,12,135,94.84536082474226,12.371134020618557
27239_marine,89,36,84,7,125,94.3820224719101,7.865168539325842
27240_marine,81,31,76,7,112,93.82716049382715,8.641975308641975
27241_marine,75,31,70,5,106,93.33333333333333,6.666666666666667
27242_marine,75,31,70,5,106,93.33333333333333,6.666666666666667
27243_marine,75,31,70,5,106,93.33333333333333,6.666666666666667
27244_marine,74,31,69,4,105,93.24324324324324,5.405405405405405
27245_marine,75,31,70,5,106,93.33333333333333,6.666666666666667
27246_marine,74,30,70,4,104,94.5945945945946,5.405405405405405
27247_marine,74,30,70,4,104,94.5945945945946,5.405405405405405
27248_marine,75,30,71,3,105,94.66666666666667,4
27249_marine,76,30,72,4,106,94.73684210526315,5.263157894736842
27250_marine,84,29,79,7,113,94.04761904761905,8.333333333333332
27251_marine,90,29,83,7,119,92.22222222222223,7.777777777777778
27252_marine,104,31,97,9,135,93.26923076923077,8.653846153846153
27253_marine,339,148,275,93,487,81.12094395280236,27.43362831858407
27254_marine,446,194,359,138,640,80.49327354260089,30.94170403587444
27262_marine,395,159,303,130,554,76.70886075949367,32.91139240506329
27263_marine,97,33,94,7,130,96.90721649484536,7.216494845360824
27264_marine,93,30,90,5,123,96.7741935483871,5.376344086021505
27265_marine,83,28,80,3,111,96.3855421686747,3.614457831325301
27266_marine,69,28,66,3,97,95.65217391304348,4.3478260869565215
27271_marine,75,29,72,2,104,96,2.666666666666667
27272_marine,87,31,84,6,118,96.55172413793103,6.896551724137931
27273_marine,536,188,346,296,724,64.55223880597015,55.223880597014926
27274_marine,708,280,494,346,988,69.77401129943502,48.87005649717514
27275_marine,629,251,430,300,880,68.362480127186,47.69475357710652
27276_marine,594,224,408,285,818,68.68686868686868,47.97979797979798
27277_marine,569,168,383,273,737,67.31107205623901,47.97891036906854
27289_marine,575,180,412,285,755,71.65217391304348,49.56521739130435
27291_marine,588,164,404,306,752,68.70748299319727,52.04081632653062
27292_marine,417,108,292,218,525,70.02398081534771,52.27817745803357
27293_marine,100,29,94,10,129,94,10
27294_marine,99,31,93,9,130,93.93939393939394,9.090909090909092
27295_marine,102,31,96,10,133,94.11764705882352,9.803921568627452
27296_marine,106,33,100,10,139,94.33962264150944,9.433962264150944
27297_marine,624,160,409,373,784,65.5448717948718,59.77564102564102
27298_marine,633,176,414,375,809,65.40284360189574,59.241706161137444
27299_marine,649,178,430,383,827,66.2557781201849,59.01386748844376
27300_marine,1031,387,628,602,1418,60.911736178467514,58.38991270611057
27306_marine,1008,348,608,600,1356,60.317460317460316,59.523809523809526
27307_marine,115,33,111,14,148,96.52173913043478,12.173913043478262
27308_marine,95,28,91,8,123,95.78947368421052,8.421052631578947
27309_marine,91,26,87,8,117,95.6043956043956,8.791208791208792
27310_marine,89,27,85,8,116,95.50561797752809,8.98876404494382
27311_marine,90,27,86,8,117,95.55555555555556,8.88888888888889
27312_marine,90,28,86,8,118,95.55555555555556,8.88888888888889
27313_marine,92,28,88,8,120,95.65217391304348,8.695652173913043
27314_marine,93,28,88,9,121,94.6236559139785,9.67741935483871
27315_marine,92,28,87,8,120,94.56521739130434,8.695652173913043
27316_marine,92,28,87,8,120,94.56521739130434,8.695652173913043
27317_marine,91,28,86,8,119,94.5054945054945,8.791208791208792
27318_marine,92,28,87,8,120,94.56521739130434,8.695652173913043
27319_marine,93,29,88,8,122,94.6236559139785,8.60215053763441
27320_marine,94,30,89,8,124,94.68085106382979,8.51063829787234
27321_marine,95,30,90,8,125,94.73684210526315,8.421052631578947
27322_marine,96,30,91,8,126,94.79166666666666,8.333333333333332
27323_marine,97,31,92,9,128,94.84536082474226,9.278350515463918
27324_marine,604,181,394,373,785,65.23178807947019,61.75496688741722
27325_marine,629,194,399,394,823,63.43402225755167,62.63910969793323
27326_marine,714,230,474,444,944,66.38655462184873,62.18487394957983
27327_marine,584,178,368,372,762,63.013698630136986,63.6986301369863
27328_marine,95,33,90,9,128,94.73684210526315,9.473684210526317
27329_marine,95,33,90,8,128,94.73684210526315,8.421052631578947
27330_marine,93,34,88,8,127,94.6236559139785,8.60215053763441
27331_marine,93,33,88,8,126,94.6236559139785,8.60215053763441
27332_marine,93,34,88,8,127,94.6236559139785,8.60215053763441
27333_marine,93,34,88,8,127,94.6236559139785,8.60215053763441
27334_marine,93,33,88,8,126,94.6236559139785,8.60215053763441
27335_marine,93,33,88,8,126,94.6236559139785,8.60215053763441
27336_marine,93,33,88,8,126,94.6236559139785,8.60215053763441
27337_marine,93,33,88,8,126,94.6236559139785,8.60215053763441
27338_marine,95,35,90,8,130,94.73684210526315,8.421052631578947
27339_marine,95,35,90,8,130,94.73684210526315,8.421052631578947
27340_marine,95,36,90,8,131,94.73684210526315,8.421052631578947
27341_marine,97,37,92,10,134,94.84536082474226,10.309278350515463
27342_marine,100,37,95,11,137,95,11
27343_marine,102,37,97,11,139,95.09803921568627,10.784313725490197
27344_marine,101,37,96,10,138,95.04950495049505,9.900990099009901
27345_marine,101,37,96,10,138,95.04950495049505,9.900990099009901
27346_marine,99,37,94,8,136,94.94949494949495,8.080808080808081
27347_marine,99,37,94,8,136,94.94949494949495,8.080808080808081
27348_marine,101,39,96,8,140,95.04950495049505,7.920792079207921
27349_marine,386,120,284,210,506,73.57512953367875,54.40414507772021
27350_marine,386,120,284,210,506,73.57512953367875,54.40414507772021
27351_marine,101,40,96,8,141,95.04950495049505,7.920792079207921
27352_marine,101,38,96,9,139,95.04950495049505,8.91089108910891
27353_marine,99,39,94,8,138,94.94949494949495,8.080808080808081
27354_marine,99,38,94,8,137,94.94949494949495,8.080808080808081
27355_marine,98,38,93,7,136,94.89795918367348,7.142857142857142
27356_marine,98,38,93,7,136,94.89795918367348,7.142857142857142
27357_marine,100,39,95,9,139,95,9
27358_marine,100,39,95,9,139,95,9
27359_marine,100,39,95,9,139,95,9
27360_marine,98,39,93,7,137,94.89795918367348,7.142857142857142
27361_marine,98,40,93,7,138,94.89795918367348,7.142857142857142
27362_marine,98,40,93,7,138,94.89795918367348,7.142857142857142
27363_marine,98,40,93,7,138,94.89795918367348,7.142857142857142
27364_marine,98,40,93,7,138,94.89795918367348,7.142857142857142
27365_marine,98,40,93,7,138,94.89795918367348,7.142857142857142
27366_marine,98,40,93,7,138,94.89795918367348,7.142857142857142
27367_marine,98,40,93,7,138,94.89795918367348,7.142857142857142
27368_marine,98,40,93,7,138,94.89795918367348,7.142857142857142
27369_marine,98,40,93,7,138,94.89795918367348,7.142857142857142
27370_marine,97,40,92,7,137,94.84536082474226,7.216494845360824
27371_marine,97,40,92,7,137,94.84536082474226,7.216494845360824
27372_marine,97,40,92,7,137,94.84536082474226,7.216494845360824
27373_marine,97,40,92,7,137,94.84536082474226,7.216494845360824
27374_marine,97,41,92,7,138,94.84536082474226,7.216494845360824
27375_marine,97,41,92,7,138,94.84536082474226,7.216494845360824
27376_marine,99,42,94,9,141,94.94949494949495,9.090909090909092
27377_marine,99,42,94,9,141,94.94949494949495,9.090909090909092
27378_marine,98,42,93,9,140,94.89795918367348,9.183673469387756
27379_marine,97,43,92,9,140,94.84536082474226,9.278350515463918
27380_marine,95,43,90,7,138,94.73684210526315,7.368421052631578
27381_marine,95,42,90,7,137,94.73684210526315,7.368421052631578
27382_marine,95,42,90,7,137,94.73684210526315,7.368421052631578
27383_marine,93,42,88,7,135,94.6236559139785,7.526881720430108
27384_marine,93,43,88,7,136,94.6236559139785,7.526881720430108
27385_marine,93,43,88,7,136,94.6236559139785,7.526881720430108
27386_marine,93,43,88,7,136,94.6236559139785,7.526881720430108
27387_marine,94,43,89,7,137,94.68085106382979,7.446808510638298
27388_marine,94,43,89,7,137,94.68085106382979,7.446808510638298
27389_marine,94,43,89,7,137,94.68085106382979,7.446808510638298
27390_marine,93,43,88,7,136,94.6236559139785,7.526881720430108
27391_marine,92,43,87,7,135,94.56521739130434,7.608695652173914
27392_marine,89,43,85,6,132,95.50561797752809,6.741573033707865
27393_marine,87,43,83,5,130,95.40229885057471,5.747126436781609
27394_marine,88,41,84,5,129,95.45454545454545,5.681818181818182
27395_marine,86,40,82,5,126,95.34883720930233,5.813953488372093
27396_marine,86,40,82,5,126,95.34883720930233,5.813953488372093
27397_marine,84,40,80,5,124,95.23809523809523,5.952380952380952
27398_marine,85,40,81,5,125,95.29411764705881,5.88235294117647
27399_marine,85,40,81,5,125,95.29411764705881,5.88235294117647
27400_marine,84,40,80,5,124,95.23809523809523,5.952380952380952
27401_marine,83,40,79,4,123,95.18072289156626,4.819277108433735
27402_marine,83,39,79,4,122,95.18072289156626,4.819277108433735
27403_marine,82,39,78,3,121,95.1219512195122,3.6585365853658534
27404_marine,82,39,78,3,121,95.1219512195122,3.6585365853658534
27405_marine,81,41,77,3,122,95.06172839506173,3.7037037037037033
27406_marine,81,41,77,3,122,95.06172839506173,3.7037037037037033
27407_marine,81,41,77,3,122,95.06172839506173,3.7037037037037033
27408_marine,82,41,78,3,123,95.1219512195122,3.6585365853658534
27409_marine,82,41,78,3,123,95.1219512195122,3.6585365853658534
27410_marine,82,41,78,3,123,95.1219512195122,3.6585365853658534
27411_marine,82,40,78,3,122,95.1219512195122,3.6585365853658534
27412_marine,82,42,78,3,124,95.1219512195122,3.6585365853658534
27413_marine,82,42,78,3,124,95.1219512195122,3.6585365853658534
27414_marine,82,42,78,3,124,95.1219512195122,3.6585365853658534
27415_marine,82,42,78,3,124,95.1219512195122,3.6585365853658534
27416_marine,82,42,78,3,124,95.1219512195122,3.6585365853658534
27417_marine,82,40,78,3,122,95.1219512195122,3.6585365853658534
27418_marine,83,39,79,3,122,95.18072289156626,3.614457831325301
27419_marine,82,40,78,3,122,95.1219512195122,3.6585365853658534
27420_marine,82,39,78,3,121,95.1219512195122,3.6585365853658534
27421_marine,82,39,78,3,121,95.1219512195122,3.6585365853658534
27422_marine,83,39,79,4,122,95.18072289156626,4.819277108433735
27423_marine,85,39,81,4,124,95.29411764705881,4.705882352941177
27424_marine,85,39,81,4,124,95.29411764705881,4.705882352941177
27425_marine,84,40,80,4,124,95.23809523809523,4.761904761904762
27426_marine,85,40,80,4,125,94.11764705882352,4.705882352941177
27427_marine,85,42,80,4,127,94.11764705882352,4.705882352941177
27428_marine,84,41,79,4,125,94.04761904761905,4.761904761904762
27429_marine,84,41,79,4,125,94.04761904761905,4.761904761904762
27430_marine,86,42,81,4,128,94.18604651162791,4.651162790697675
27431_marine,86,43,81,4,129,94.18604651162791,4.651162790697675
27432_marine,89,43,83,5,132,93.25842696629213,5.617977528089887
27433_marine,88,44,82,5,132,93.18181818181817,5.681818181818182
27434_marine,88,44,82,5,132,93.18181818181817,5.681818181818182
27435_marine,89,44,82,6,133,92.13483146067416,6.741573033707865
27436_marine,93,45,86,6,138,92.47311827956989,6.451612903225806
27437_marine,92,44,85,6,136,92.3913043478261,6.521739130434782
27438_marine,92,42,85,6,134,92.3913043478261,6.521739130434782
27439_marine,92,42,85,6,134,92.3913043478261,6.521739130434782
27440_marine,94,41,87,7,135,92.5531914893617,7.446808510638298
27441_marine,95,39,87,8,134,91.57894736842105,8.421052631578947
27442_marine,97,41,89,8,138,91.75257731958763,8.24742268041237
27443_marine,99,40,92,8,139,92.92929292929293,8.080808080808081
27444_marine,99,41,92,8,140,92.92929292929293,8.080808080808081
27445_marine,102,41,95,10,143,93.13725490196079,9.803921568627452
27446_marine,102,54,95,10,156,93.13725490196079,9.803921568627452
27447_marine,190,139,177,20,329,93.15789473684211,10.526315789473683
27448_marine,225,177,205,31,402,91.11111111111111,13.777777777777779
27458_marine,348,289,268,113,637,77.01149425287356,32.4712643678161
27460_marine,314,212,240,104,526,76.43312101910828,33.12101910828025
27461_marine,110,61,101,13,171,91.81818181818183,11.818181818181818
27462_marine,96,45,89,7,141,92.70833333333334,7.291666666666667
27463_marine,94,35,85,10,129,90.42553191489363,10.638297872340425
27464_marine,94,33,85,10,127,90.42553191489363,10.638297872340425
27465_marine,94,33,85,10,127,90.42553191489363,10.638297872340425
27466_marine,99,33,90,10,132,90.9090909090909,10.1010101010101
27467_marine,113,41,104,12,154,92.03539823008849,10.619469026548673
27468_marine,360,194,277,119,554,76.94444444444444,33.05555555555556
27469_marine,365,197,280,121,562,76.71232876712328,33.15068493150685
27470_marine,376,234,288,126,610,76.59574468085107,33.51063829787234
27471_marine,362,210,272,130,572,75.13812154696133,35.91160220994475
27472_marine,360,200,270,129,560,75,35.833333333333336
27473_marine,358,194,268,129,552,74.86033519553072,36.03351955307262
27474_marine,115,35,106,12,150,92.17391304347827,10.434782608695652
27475_marine,107,37,98,12,144,91.58878504672897,11.214953271028037
27476_marine,109,41,100,12,150,91.74311926605505,11.009174311926607
27477_marine,111,54,102,12,165,91.8918918918919,10.81081081081081
27478_marine,326,206,243,120,532,74.5398773006135,36.809815950920246
27479_marine,419,327,279,209,746,66.5871121718377,49.88066825775656
27480_marine,414,296,275,203,710,66.42512077294685,49.033816425120776
27481_marine,434,268,291,219,702,67.05069124423963,50.46082949308756
27482_marine,322,180,237,117,502,73.6024844720497,36.33540372670808
27483_marine,94,34,86,9,128,91.48936170212765,9.574468085106384
27484_marine,90,33,82,7,123,91.11111111111111,7.777777777777778
27485_marine,87,34,79,7,121,90.80459770114942,8.045977011494253
27486_marine,87,35,79,7,122,90.80459770114942,8.045977011494253
27487_marine,87,35,80,6,122,91.95402298850574,6.896551724137931
27488_marine,86,35,79,6,121,91.86046511627907,6.976744186046512
27489_marine,87,35,79,6,122,90.80459770114942,6.896551724137931
27490_marine,85,35,77,6,120,90.58823529411765,7.0588235294117645
27491_marine,83,35,76,4,118,91.56626506024097,4.819277108433735
27492_marine,83,34,76,4,117,91.56626506024097,4.819277108433735
27493_marine,85,34,78,3,119,91.76470588235294,3.5294117647058822
27494_marine,86,34,79,3,120,91.86046511627907,3.488372093023256
27495_marine,86,34,79,3,120,91.86046511627907,3.488372093023256
27496_marine,84,34,79,1,118,94.04761904761905,1.1904761904761905
27497_marine,84,34,79,1,118,94.04761904761905,1.1904761904761905
27498_marine,84,33,79,1,117,94.04761904761905,1.1904761904761905
27499_marine,84,33,79,1,117,94.04761904761905,1.1904761904761905
27500_marine,84,33,79,1,117,94.04761904761905,1.1904761904761905
27501_marine,84,33,79,1,117,94.04761904761905,1.1904761904761905
27502_marine,85,33,80,1,118,94.11764705882352,1.1764705882352942
27503_marine,85,32,80,1,117,94.11764705882352,1.1764705882352942
27504_marine,87,32,82,2,119,94.25287356321839,2.2988505747126435
27505_marine,87,32,82,2,119,94.25287356321839,2.2988505747126435
27506_marine,88,32,83,2,120,94.31818181818183,2.272727272727273
27507_marine,88,31,83,2,119,94.31818181818183,2.272727272727273
27508_marine,89,31,84,3,120,94.3820224719101,3.3707865168539324
27509_marine,89,31,84,3,120,94.3820224719101,3.3707865168539324
27510_marine,89,31,84,3,120,94.3820224719101,3.3707865168539324
27511_marine,89,31,84,3,120,94.3820224719101,3.3707865168539324
27512_marine,92,31,87,3,123,94.56521739130434,3.260869565217391
27513_marine,95,31,90,4,126,94.73684210526315,4.2105263157894735
27514_marine,99,33,94,5,132,94.94949494949495,5.05050505050505
27515_marine,211,81,189,32,292,89.57345971563981,15.165876777251185
27516_marine,213,81,190,32,294,89.2018779342723,15.023474178403756
27517_marine,213,81,191,31,294,89.67136150234741,14.553990610328638
27518_marine,104,35,98,9,139,94.23076923076923,8.653846153846153
27519_marine,110,33,104,7,143,94.54545454545455,6.363636363636363
27520_marine,114,33,108,7,147,94.73684210526315,6.140350877192982
27521_marine,117,35,111,7,152,94.87179487179486,5.982905982905983
27522_marine,302,135,276,41,437,91.3907284768212,13.57615894039735
27523_marine,338,166,306,50,504,90.53254437869822,14.792899408284024
27582_marine,735,322,470,402,1057,63.94557823129252,54.69387755102041
27583_marine,774,336,494,427,1110,63.82428940568475,55.167958656330754
27584_marine,693,329,454,364,1022,65.51226551226551,52.52525252525253
27586_marine,696,298,480,362,994,68.96551724137932,52.01149425287356
27587_marine,683,285,465,354,968,68.08199121522695,51.83016105417276
27588_marine,677,277,464,346,954,68.53766617429838,51.10782865583457
27589_marine,678,274,464,342,952,68.43657817109144,50.442477876106196
27590_marine,535,171,379,257,706,70.8411214953271,48.03738317757009
27591_marine,488,169,348,233,657,71.31147540983606,47.74590163934426
27592_marine,497,153,348,268,650,70.02012072434609,53.923541247484906
27593_marine,519,153,366,275,672,70.52023121387283,52.98651252408478
27594_marine,508,150,360,266,658,70.86614173228347,52.362204724409445
27595_marine,499,150,353,263,649,70.74148296593187,52.705410821643284
27596_marine,493,145,349,261,638,70.79107505070994,52.94117647058824
27597_marine,96,36,91,10,132,94.79166666666666,10.416666666666668
27598_marine,90,34,85,8,124,94.44444444444444,8.88888888888889
27599_marine,80,34,76,7,114,95,8.75
27600_marine,76,31,72,5,107,94.73684210526315,6.578947368421052
27601_marine,74,31,70,5,105,94.5945945945946,6.756756756756757
27602_marine,75,31,70,5,106,93.33333333333333,6.666666666666667
27603_marine,75,31,70,5,106,93.33333333333333,6.666666666666667
27604_marine,74,31,69,4,105,93.24324324324324,5.405405405405405
27605_marine,75,31,70,5,106,93.33333333333333,6.666666666666667
27606_marine,75,30,70,5,105,93.33333333333333,6.666666666666667
27607_marine,77,30,72,6,107,93.5064935064935,7.792207792207792
27608_marine,76,30,72,4,106,94.73684210526315,5.263157894736842
27609_marine,76,30,71,5,106,93.42105263157895,6.578947368421052
27610_marine,80,29,75,5,109,93.75,6.25
27611_marine,90,29,83,7,119,92.22222222222223,7.777777777777778
27612_marine,453,97,326,233,550,71.96467991169978,51.434878587196465
27613_marine,458,100,331,235,558,72.27074235807859,51.310043668122276
27614_marine,451,196,363,140,647,80.48780487804879,31.042128603104214
27622_marine,421,165,315,156,586,74.82185273159145,37.05463182897862
27623_marine,95,30,92,5,125,96.84210526315789,5.263157894736842
27624_marine,85,30,82,3,115,96.47058823529412,3.5294117647058822
27625_marine,71,28,68,3,99,95.77464788732394,4.225352112676056
27626_marine,69,28,66,3,97,95.65217391304348,4.3478260869565215
27627_marine,71,28,68,3,99,95.77464788732394,4.225352112676056
27630_marine,69,29,66,0,98,95.65217391304348,0
27631_marine,77,30,74,4,107,96.1038961038961,5.194805194805195
27632_marine,498,158,314,292,656,63.05220883534136,58.63453815261044
27635_marine,602,231,401,329,833,66.61129568106313,54.65116279069767
27636_marine,516,165,332,291,681,64.34108527131784,56.395348837209305
27637_marine,669,200,436,348,869,65.17189835575485,52.01793721973094
27638_marine,832,287,559,442,1119,67.1875,53.125
27640_marine,535,234,397,235,769,74.20560747663552,43.925233644859816
27651_marine,596,171,410,309,767,68.79194630872483,51.84563758389261
27652_marine,109,27,103,11,136,94.4954128440367,10.091743119266056
27653_marine,99,32,93,9,131,93.93939393939394,9.090909090909092
27654_marine,99,30,93,9,129,93.93939393939394,9.090909090909092
27655_marine,103,30,97,10,133,94.1747572815534,9.70873786407767
27656_marine,111,32,105,10,143,94.5945945945946,9.00900900900901
27657_marine,110,29,104,10,139,94.54545454545455,9.090909090909092
27658_marine,111,29,105,12,140,94.5945945945946,10.81081081081081
27659_marine,119,31,113,16,150,94.9579831932773,13.445378151260504
27660_marine,1033,387,630,607,1420,60.98741529525653,58.76089060987415
27666_marine,1043,376,628,618,1419,60.21093000958773,59.25215723873441
27667_marine,1002,342,600,602,1344,59.88023952095808,60.079840319361274
27668_marine,103,30,99,10,133,96.11650485436894,9.70873786407767
27669_marine,95,27,91,8,122,95.78947368421052,8.421052631578947
27670_marine,89,27,85,8,116,95.50561797752809,8.98876404494382
27671_marine,90,27,86,8,117,95.55555555555556,8.88888888888889
27672_marine,90,27,86,8,117,95.55555555555556,8.88888888888889
27673_marine,91,27,86,9,118,94.5054945054945,9.89010989010989
27674_marine,92,28,87,9,120,94.56521739130434,9.782608695652174
27675_marine,92,28,87,9,120,94.56521739130434,9.782608695652174
27676_marine,92,29,87,8,121,94.56521739130434,8.695652173913043
27677_marine,93,29,88,8,122,94.6236559139785,8.60215053763441
27678_marine,91,29,86,8,120,94.5054945054945,8.791208791208792
27679_marine,92,29,87,8,121,94.56521739130434,8.695652173913043
27680_marine,92,30,87,8,122,94.56521739130434,8.695652173913043
27681_marine,93,31,88,8,124,94.6236559139785,8.60215053763441
27682_marine,95,31,90,8,126,94.73684210526315,8.421052631578947
27683_marine,96,31,91,9,127,94.79166666666666,9.375
27684_marine,602,181,392,373,783,65.11627906976744,61.96013289036545
27686_marine,618,190,398,383,808,64.40129449838187,61.97411003236246
27687_marine,569,168,365,360,737,64.14762741652021,63.2688927943761
27688_marine,98,33,93,9,131,94.89795918367348,9.183673469387756
27689_marine,95,33,90,8,128,94.73684210526315,8.421052631578947
27690_marine,95,33,90,8,128,94.73684210526315,8.421052631578947
27691_marine,93,32,88,8,125,94.6236559139785,8.60215053763441
27692_marine,93,33,88,8,126,94.6236559139785,8.60215053763441
27693_marine,93,33,88,8,126,94.6236559139785,8.60215053763441
27694_marine,93,33,88,8,126,94.6236559139785,8.60215053763441
27695_marine,93,33,88,8,126,94.6236559139785,8.60215053763441
27696_marine,93,34,88,8,127,94.6236559139785,8.60215053763441
27697_marine,93,34,88,8,127,94.6236559139785,8.60215053763441
27698_marine,93,34,88,8,127,94.6236559139785,8.60215053763441
27699_marine,93,35,88,8,128,94.6236559139785,8.60215053763441
27700_marine,95,36,90,8,131,94.73684210526315,8.421052631578947
27701_marine,95,36,90,9,131,94.73684210526315,9.473684210526317
27702_marine,96,37,91,9,133,94.79166666666666,9.375
27703_marine,100,38,95,8,138,95,8
27704_marine,98,38,93,8,136,94.89795918367348,8.16326530612245
27705_marine,100,38,95,8,138,95,8
27706_marine,102,39,97,8,141,95.09803921568627,7.8431372549019605
27707_marine,103,39,98,8,142,95.14563106796116,7.766990291262135
27708_marine,103,38,98,8,141,95.14563106796116,7.766990291262135
27709_marine,352,97,256,193,449,72.72727272727273,54.82954545454546
27710_marine,435,117,289,261,552,66.4367816091954,60
27711_marine,417,116,283,245,533,67.86570743405275,58.752997601918466
27712_marine,104,38,99,9,142,95.1923076923077,8.653846153846153
27713_marine,103,38,98,9,141,95.14563106796116,8.737864077669903
27714_marine,99,39,94,8,138,94.94949494949495,8.080808080808081
27715_marine,98,39,93,7,137,94.89795918367348,7.142857142857142
27716_marine,98,38,93,7,136,94.89795918367348,7.142857142857142
27717_marine,100,38,95,9,138,95,9
27718_marine,100,39,95,9,139,95,9
27719_marine,100,39,95,9,139,95,9
27720_marine,100,40,95,9,140,95,9
27721_marine,100,40,95,9,140,95,9
27722_marine,98,40,93,7,138,94.89795918367348,7.142857142857142
27723_marine,97,40,92,7,137,94.84536082474226,7.216494845360824
27724_marine,97,40,92,7,137,94.84536082474226,7.216494845360824
27725_marine,97,40,92,7,137,94.84536082474226,7.216494845360824
27726_marine,98,40,93,7,138,94.89795918367348,7.142857142857142
27727_marine,98,40,93,7,138,94.89795918367348,7.142857142857142
27728_marine,98,40,93,7,138,94.89795918367348,7.142857142857142
27729_marine,98,40,93,7,138,94.89795918367348,7.142857142857142
27730_marine,98,40,93,7,138,94.89795918367348,7.142857142857142
27731_marine,97,40,92,7,137,94.84536082474226,7.216494845360824
27732_marine,97,40,92,7,137,94.84536082474226,7.216494845360824
27733_marine,97,40,92,7,137,94.84536082474226,7.216494845360824
27734_marine,96,41,91,7,137,94.79166666666666,7.291666666666667
27735_marine,96,41,91,7,137,94.79166666666666,7.291666666666667
27736_marine,98,42,93,9,140,94.89795918367348,9.183673469387756
27737_marine,96,42,91,9,138,94.79166666666666,9.375
27738_marine,96,42,91,9,138,94.79166666666666,9.375
27739_marine,96,43,91,9,139,94.79166666666666,9.375
27740_marine,94,43,89,7,137,94.68085106382979,7.446808510638298
27741_marine,94,43,89,7,137,94.68085106382979,7.446808510638298
27742_marine,92,42,87,7,134,94.56521739130434,7.608695652173914
27743_marine,91,42,86,7,133,94.5054945054945,7.6923076923076925
27744_marine,91,42,86,7,133,94.5054945054945,7.6923076923076925
27745_marine,91,42,86,7,133,94.5054945054945,7.6923076923076925
27746_marine,91,43,86,7,134,94.5054945054945,7.6923076923076925
27747_marine,91,43,86,7,134,94.5054945054945,7.6923076923076925
27748_marine,91,43,86,7,134,94.5054945054945,7.6923076923076925
27749_marine,92,43,87,7,135,94.56521739130434,7.608695652173914
27750_marine,91,43,86,7,134,94.5054945054945,7.6923076923076925
27751_marine,90,43,85,7,133,94.44444444444444,7.777777777777778
27752_marine,89,43,85,6,132,95.50561797752809,6.741573033707865
27753_marine,88,43,84,5,131,95.45454545454545,5.681818181818182
27754_marine,87,42,83,5,129,95.40229885057471,5.747126436781609
27755_marine,85,40,81,5,125,95.29411764705881,5.88235294117647
27756_marine,85,40,81,5,125,95.29411764705881,5.88235294117647
27757_marine,83,40,79,5,123,95.18072289156626,6.024096385542169
27758_marine,83,40,79,5,123,95.18072289156626,6.024096385542169
27759_marine,84,40,80,5,124,95.23809523809523,5.952380952380952
27760_marine,84,40,80,5,124,95.23809523809523,5.952380952380952
27761_marine,83,40,79,4,123,95.18072289156626,4.819277108433735
27762_marine,83,40,79,4,123,95.18072289156626,4.819277108433735
27763_marine,83,39,79,4,122,95.18072289156626,4.819277108433735
27764_marine,81,39,77,3,120,95.06172839506173,3.7037037037037033
27765_marine,81,39,77,3,120,95.06172839506173,3.7037037037037033
27766_marine,81,41,77,3,122,95.06172839506173,3.7037037037037033
27767_marine,82,41,78,3,123,95.1219512195122,3.6585365853658534
27768_marine,82,41,78,3,123,95.1219512195122,3.6585365853658534
27769_marine,82,41,78,3,123,95.1219512195122,3.6585365853658534
27770_marine,82,41,78,3,123,95.1219512195122,3.6585365853658534
27771_marine,83,41,79,3,124,95.18072289156626,3.614457831325301
27772_marine,83,43,79,3,126,95.18072289156626,3.614457831325301
27773_marine,83,42,79,3,125,95.18072289156626,3.614457831325301
27774_marine,84,42,80,3,126,95.23809523809523,3.571428571428571
27775_marine,84,42,80,3,126,95.23809523809523,3.571428571428571
27776_marine,83,42,79,3,125,95.18072289156626,3.614457831325301
27777_marine,83,41,79,3,124,95.18072289156626,3.614457831325301
27778_marine,83,41,79,3,124,95.18072289156626,3.614457831325301
27779_marine,82,41,78,3,123,95.1219512195122,3.6585365853658534
27780_marine,82,40,78,3,122,95.1219512195122,3.6585365853658534
27781_marine,82,40,78,3,122,95.1219512195122,3.6585365853658534
27782_marine,83,40,79,4,123,95.18072289156626,4.819277108433735
27783_marine,83,39,79,4,122,95.18072289156626,4.819277108433735
27784_marine,85,39,81,4,124,95.29411764705881,4.705882352941177
27785_marine,84,39,80,4,123,95.23809523809523,4.761904761904762
27786_marine,84,40,80,4,124,95.23809523809523,4.761904761904762
27787_marine,83,41,79,4,124,95.18072289156626,4.819277108433735
27788_marine,86,41,81,4,127,94.18604651162791,4.651162790697675
27789_marine,88,40,83,4,128,94.31818181818183,4.545454545454546
27790_marine,86,40,81,4,126,94.18604651162791,4.651162790697675
27791_marine,88,42,83,6,130,94.31818181818183,6.8181818181818175
27792_marine,87,43,82,6,130,94.25287356321839,6.896551724137931
27793_marine,88,43,82,5,131,93.18181818181817,5.681818181818182
27794_marine,88,44,82,5,132,93.18181818181817,5.681818181818182
27795_marine,88,44,82,5,132,93.18181818181817,5.681818181818182
27796_marine,88,44,82,5,132,93.18181818181817,5.681818181818182
27797_marine,89,45,83,5,134,93.25842696629213,5.617977528089887
27798_marine,89,45,83,5,134,93.25842696629213,5.617977528089887
27799_marine,92,42,85,6,134,92.3913043478261,6.521739130434782
27800_marine,92,42,85,6,134,92.3913043478261,6.521739130434782
27801_marine,94,41,87,7,135,92.5531914893617,7.446808510638298
27802_marine,95,40,87,8,135,91.57894736842105,8.421052631578947
27803_marine,95,39,87,8,134,91.57894736842105,8.421052631578947
27804_marine,95,38,87,8,133,91.57894736842105,8.421052631578947
27805_marine,96,38,88,9,134,91.66666666666666,9.375
27806_marine,95,40,88,8,135,92.63157894736842,8.421052631578947
27807_marine,97,44,89,9,141,91.75257731958763,9.278350515463918
27808_marine,102,54,94,11,156,92.15686274509804,10.784313725490197
27809_marine,189,141,175,21,330,92.5925925925926,11.11111111111111
27810_marine,273,205,218,65,478,79.85347985347985,23.809523809523807
27811_marine,295,232,239,67,527,81.01694915254237,22.71186440677966
27812_marine,308,264,249,70,572,80.84415584415584,22.727272727272727
27818_marine,358,302,271,118,660,75.69832402234637,32.960893854748605
27820_marine,306,190,233,100,496,76.1437908496732,32.6797385620915
27821_marine,102,33,93,7,135,91.17647058823529,6.862745098039216
27822_marine,92,35,85,7,127,92.3913043478261,7.608695652173914
27823_marine,92,35,84,8,127,91.30434782608695,8.695652173913043
27824_marine,93,37,84,9,130,90.32258064516128,9.67741935483871
27825_marine,338,202,262,106,540,77.51479289940828,31.360946745562128
27826_marine,357,204,274,116,561,76.75070028011206,32.49299719887955
27827_marine,360,217,277,120,577,76.94444444444444,33.33333333333333
27833_marine,384,285,291,137,669,75.78125,35.67708333333333
27834_marine,387,277,294,136,664,75.96899224806202,35.14211886304909
27835_marine,384,251,294,131,635,76.5625,34.11458333333333
27836_marine,386,250,296,131,636,76.68393782383419,33.93782383419689
27837_marine,385,258,295,130,643,76.62337662337663,33.76623376623377
27838_marine,380,241,287,131,621,75.52631578947368,34.473684210526315
27839_marine,468,381,321,217,849,68.58974358974359,46.36752136752137
27840_marine,364,240,271,125,604,74.45054945054946,34.34065934065934
27841_marine,354,224,262,125,578,74.01129943502825,35.31073446327684
27842_marine,320,180,235,117,500,73.4375,36.5625
27843_marine,95,34,87,9,129,91.57894736842105,9.473684210526317
27844_marine,92,35,84,7,127,91.30434782608695,7.608695652173914
27845_marine,88,33,80,7,121,90.9090909090909,7.954545454545454
27846_marine,87,35,79,7,122,90.80459770114942,8.045977011494253
27847_marine,88,35,80,7,123,90.9090909090909,7.954545454545454
27848_marine,87,35,80,6,122,91.95402298850574,6.896551724137931
27849_marine,86,35,79,6,121,91.86046511627907,6.976744186046512
27850_marine,87,35,79,6,122,90.80459770114942,6.896551724137931
27851_marine,83,35,76,4,118,91.56626506024097,4.819277108433735
27852_marine,84,35,77,4,119,91.66666666666666,4.761904761904762
27853_marine,85,34,78,4,119,91.76470588235294,4.705882352941177
27854_marine,87,34,80,4,121,91.95402298850574,4.597701149425287
27855_marine,86,34,79,3,120,91.86046511627907,3.488372093023256
27856_marine,86,34,79,3,120,91.86046511627907,3.488372093023256
27857_marine,84,34,79,1,118,94.04761904761905,1.1904761904761905
27858_marine,84,34,79,1,118,94.04761904761905,1.1904761904761905
27859_marine,84,33,79,1,117,94.04761904761905,1.1904761904761905
27860_marine,84,33,79,1,117,94.04761904761905,1.1904761904761905
27861_marine,84,33,79,1,117,94.04761904761905,1.1904761904761905
27862_marine,84,33,79,1,117,94.04761904761905,1.1904761904761905
27863_marine,86,33,81,2,119,94.18604651162791,2.3255813953488373
27864_marine,86,33,82,2,119,95.34883720930233,2.3255813953488373
27865_marine,86,32,82,2,118,95.34883720930233,2.3255813953488373
27866_marine,88,32,83,2,120,94.31818181818183,2.272727272727273
27867_marine,88,32,83,2,120,94.31818181818183,2.272727272727273
27868_marine,89,31,84,3,120,94.3820224719101,3.3707865168539324
27869_marine,89,31,84,3,120,94.3820224719101,3.3707865168539324
27870_marine,89,31,84,3,120,94.3820224719101,3.3707865168539324
27871_marine,90,31,85,3,121,94.44444444444444,3.3333333333333335
27872_marine,90,31,85,3,121,94.44444444444444,3.3333333333333335
27873_marine,92,31,87,3,123,94.56521739130434,3.260869565217391
27874_marine,95,31,90,4,126,94.73684210526315,4.2105263157894735
27875_marine,100,31,95,5,131,95,5
27876_marine,102,31,97,6,133,95.09803921568627,5.88235294117647
27877_marine,100,31,95,6,131,95,6
27878_marine,101,33,95,7,134,94.05940594059405,6.9306930693069315
27879_marine,107,33,101,7,140,94.39252336448598,6.5420560747663545
27880_marine,110,33,104,6,143,94.54545454545455,5.454545454545454
27881_marine,115,33,109,6,148,94.78260869565217,5.217391304347826
27882_marine,122,51,115,10,173,94.26229508196722,8.19672131147541
27883_marine,332,159,303,48,491,91.26506024096386,14.457831325301203
27943_marine,745,328,477,405,1073,64.02684563758389,54.36241610738255
27944_marine,925,455,607,493,1380,65.62162162162161,53.2972972972973
27945_marine,746,329,506,386,1075,67.828418230563,51.742627345844504
27946_marine,697,307,479,361,1004,68.72309899569584,51.79340028694405
27947_marine,556,188,379,288,744,68.16546762589928,51.798561151079134
27948_marine,576,188,399,287,764,69.27083333333334,49.82638888888889
27949_marine,573,189,399,282,762,69.63350785340315,49.21465968586388
27950_marine,541,179,380,265,720,70.24029574861368,48.98336414048059
27951_marine,586,208,419,285,794,71.50170648464163,48.634812286689424
27952_marine,615,224,436,309,839,70.89430894308944,50.24390243902439
27953_marine,586,200,420,305,786,71.67235494880546,52.04778156996587
27954_marine,581,220,417,304,801,71.77280550774526,52.323580034423415
27955_marine,569,215,409,302,784,71.8804920913884,53.075571177504386
27956_marine,489,146,347,258,635,70.96114519427404,52.760736196319016
27957_marine,89,34,85,7,123,95.50561797752809,7.865168539325842
27958_marine,82,34,78,7,116,95.1219512195122,8.536585365853659
27959_marine,80,34,76,7,114,95,8.75
27960_marine,74,31,70,5,105,94.5945945945946,6.756756756756757
27961_marine,74,31,70,5,105,94.5945945945946,6.756756756756757
27962_marine,74,31,70,5,105,94.5945945945946,6.756756756756757
27963_marine,73,31,69,4,104,94.52054794520548,5.47945205479452
27964_marine,75,31,70,5,106,93.33333333333333,6.666666666666667
27965_marine,75,30,70,5,105,93.33333333333333,6.666666666666667
27966_marine,78,30,72,7,108,92.3076923076923,8.974358974358974
27967_marine,78,30,72,7,108,92.3076923076923,8.974358974358974
27968_marine,77,30,71,6,107,92.20779220779221,7.792207792207792
27969_marine,77,30,71,6,107,92.20779220779221,7.792207792207792
27970_marine,81,30,75,6,111,92.5925925925926,7.4074074074074066
27971_marine,434,88,307,229,522,70.73732718894009,52.764976958525345
27972_marine,493,105,359,259,598,72.81947261663286,52.53549695740365
27973_marine,476,100,349,241,576,73.31932773109243,50.63025210084034
27974_marine,620,189,461,277,809,74.35483870967742,44.67741935483871
27982_marine,420,163,312,157,583,74.28571428571429,37.38095238095238
27983_marine,95,30,91,7,125,95.78947368421052,7.368421052631578
27984_marine,83,30,80,3,113,96.3855421686747,3.614457831325301
27985_marine,71,29,68,3,100,95.77464788732394,4.225352112676056
27986_marine,71,29,68,3,100,95.77464788732394,4.225352112676056
27987_marine,69,29,66,1,98,95.65217391304348,1.4492753623188406
27988_marine,69,29,66,0,98,95.65217391304348,0
27989_marine,69,30,66,0,99,95.65217391304348,0
27990_marine,69,30,66,0,99,95.65217391304348,0
27991_marine,73,31,70,4,104,95.8904109589041,5.47945205479452
27992_marine,518,171,328,296,689,63.32046332046332,57.14285714285714
27995_marine,525,183,335,295,708,63.8095238095238,56.19047619047619
27996_marine,506,159,323,288,665,63.83399209486166,56.916996047430835
27997_marine,709,218,458,366,927,64.59802538787024,51.62200282087447
28011_marine,610,174,417,317,784,68.36065573770492,51.967213114754095
28012_marine,109,28,103,11,137,94.4954128440367,10.091743119266056
28013_marine,100,30,94,9,130,94,9
28014_marine,104,30,98,9,134,94.23076923076923,8.653846153846153
28015_marine,655,161,426,393,816,65.0381679389313,60
28016_marine,660,161,431,393,821,65.30303030303031,59.54545454545455
28017_marine,113,31,107,10,144,94.69026548672566,8.849557522123893
28018_marine,142,53,126,26,195,88.73239436619718,18.30985915492958
28019_marine,954,298,587,566,1252,61.530398322851156,59.329140461215935
28027_marine,1030,356,622,611,1386,60.38834951456311,59.320388349514566
28028_marine,111,31,107,12,142,96.3963963963964,10.81081081081081
28029_marine,97,27,93,8,124,95.87628865979381,8.24742268041237
28030_marine,89,28,85,8,117,95.50561797752809,8.98876404494382
28031_marine,90,27,86,8,117,95.55555555555556,8.88888888888889
28032_marine,91,27,86,9,118,94.5054945054945,9.89010989010989
28033_marine,91,27,86,9,118,94.5054945054945,9.89010989010989
28034_marine,92,28,87,9,120,94.56521739130434,9.782608695652174
28035_marine,92,28,87,9,120,94.56521739130434,9.782608695652174
28036_marine,92,28,87,9,120,94.56521739130434,9.782608695652174
28037_marine,93,29,88,9,122,94.6236559139785,9.67741935483871
28038_marine,92,30,87,8,122,94.56521739130434,8.695652173913043
28039_marine,90,31,85,8,121,94.44444444444444,8.88888888888889
28040_marine,92,31,87,8,123,94.56521739130434,8.695652173913043
28041_marine,94,31,89,9,125,94.68085106382979,9.574468085106384
28042_marine,95,32,90,9,127,94.73684210526315,9.473684210526317
28043_marine,97,32,92,10,129,94.84536082474226,10.309278350515463
28044_marine,603,179,393,375,782,65.17412935323384,62.189054726368155
28045_marine,608,183,396,376,791,65.13157894736842,61.8421052631579
28046_marine,605,184,393,377,789,64.95867768595042,62.314049586776854
28047_marine,98,33,93,12,131,94.89795918367348,12.244897959183673
28048_marine,94,33,89,8,127,94.68085106382979,8.51063829787234
28049_marine,94,33,89,8,127,94.68085106382979,8.51063829787234
28050_marine,95,32,90,8,127,94.73684210526315,8.421052631578947
28051_marine,96,31,91,8,127,94.79166666666666,8.333333333333332
28052_marine,95,32,90,8,127,94.73684210526315,8.421052631578947
28053_marine,95,32,90,8,127,94.73684210526315,8.421052631578947
28054_marine,95,32,90,8,127,94.73684210526315,8.421052631578947
28055_marine,95,34,90,8,129,94.73684210526315,8.421052631578947
28056_marine,95,34,90,8,129,94.73684210526315,8.421052631578947
28057_marine,95,34,90,8,129,94.73684210526315,8.421052631578947
28058_marine,96,34,91,9,130,94.79166666666666,9.375
28059_marine,96,35,91,9,131,94.79166666666666,9.375
28060_marine,96,36,91,9,132,94.79166666666666,9.375
28061_marine,96,37,91,10,133,94.79166666666666,10.416666666666668
28062_marine,518,136,326,330,654,62.93436293436293,63.7065637065637
28063_marine,520,136,328,330,656,63.07692307692307,63.46153846153846
28064_marine,521,133,331,328,654,63.53166986564299,62.95585412667947
28065_marine,527,151,331,334,678,62.808349146110054,63.37760910815939
28066_marine,531,152,335,336,683,63.088512241054616,63.2768361581921
28067_marine,539,153,339,340,692,62.89424860853432,63.07977736549165
28068_marine,541,153,341,340,694,63.03142329020333,62.84658040665434
28069_marine,547,156,347,341,703,63.43692870201097,62.3400365630713
28070_marine,463,136,303,276,599,65.44276457883369,59.611231101511876
28071_marine,482,152,326,282,634,67.63485477178423,58.50622406639005
28072_marine,414,115,280,245,529,67.6328502415459,59.17874396135265
28073_marine,103,38,98,9,141,95.14563106796116,8.737864077669903
28074_marine,101,39,96,8,140,95.04950495049505,7.920792079207921
28075_marine,100,39,95,8,139,95,8
28076_marine,97,39,92,7,136,94.84536082474226,7.216494845360824
28077_marine,99,39,94,9,138,94.94949494949495,9.090909090909092
28078_marine,99,38,94,9,137,94.94949494949495,9.090909090909092
28079_marine,99,39,94,9,138,94.94949494949495,9.090909090909092
28080_marine,99,40,94,9,139,94.94949494949495,9.090909090909092
28081_marine,98,40,93,9,138,94.89795918367348,9.183673469387756
28082_marine,96,40,91,7,136,94.79166666666666,7.291666666666667
28083_marine,96,40,91,7,136,94.79166666666666,7.291666666666667
28084_marine,96,40,91,7,136,94.79166666666666,7.291666666666667
28085_marine,96,40,91,7,136,94.79166666666666,7.291666666666667
28086_marine,96,40,91,7,136,94.79166666666666,7.291666666666667
28087_marine,96,40,91,7,136,94.79166666666666,7.291666666666667
28088_marine,96,40,91,7,136,94.79166666666666,7.291666666666667
28089_marine,96,40,91,7,136,94.79166666666666,7.291666666666667
28090_marine,96,40,91,7,136,94.79166666666666,7.291666666666667
28091_marine,96,40,91,7,136,94.79166666666666,7.291666666666667
28092_marine,95,40,90,7,135,94.73684210526315,7.368421052631578
28093_marine,95,40,90,7,135,94.73684210526315,7.368421052631578
28094_marine,95,41,90,7,136,94.73684210526315,7.368421052631578
28095_marine,93,41,88,7,134,94.6236559139785,7.526881720430108
28096_marine,96,42,91,9,138,94.79166666666666,9.375
28097_marine,95,42,90,9,137,94.73684210526315,9.473684210526317
28098_marine,95,42,90,9,137,94.73684210526315,9.473684210526317
28099_marine,95,43,90,9,138,94.73684210526315,9.473684210526317
28100_marine,93,43,88,7,136,94.6236559139785,7.526881720430108
28101_marine,93,43,88,7,136,94.6236559139785,7.526881720430108
28102_marine,91,42,86,7,133,94.5054945054945,7.6923076923076925
28103_marine,91,42,86,7,133,94.5054945054945,7.6923076923076925
28104_marine,91,42,86,7,133,94.5054945054945,7.6923076923076925
28105_marine,91,42,86,7,133,94.5054945054945,7.6923076923076925
28106_marine,91,42,86,7,133,94.5054945054945,7.6923076923076925
28107_marine,91,42,86,7,133,94.5054945054945,7.6923076923076925
28108_marine,91,42,86,7,133,94.5054945054945,7.6923076923076925
28109_marine,91,42,86,7,133,94.5054945054945,7.6923076923076925
28110_marine,90,42,85,7,132,94.44444444444444,7.777777777777778
28111_marine,89,42,84,7,131,94.3820224719101,7.865168539325842
28112_marine,89,42,84,7,131,94.3820224719101,7.865168539325842
28113_marine,89,42,85,6,131,95.50561797752809,6.741573033707865
28114_marine,87,42,83,5,129,95.40229885057471,5.747126436781609
28115_marine,86,40,82,5,126,95.34883720930233,5.813953488372093
28116_marine,88,40,84,7,128,95.45454545454545,7.954545454545454
28117_marine,85,40,81,7,125,95.29411764705881,8.235294117647058
28118_marine,85,40,81,7,125,95.29411764705881,8.235294117647058
28119_marine,85,40,81,7,125,95.29411764705881,8.235294117647058
28120_marine,84,40,80,5,124,95.23809523809523,5.952380952380952
28121_marine,84,40,80,5,124,95.23809523809523,5.952380952380952
28122_marine,83,40,79,4,123,95.18072289156626,4.819277108433735
28123_marine,82,39,78,4,121,95.1219512195122,4.878048780487805
28124_marine,82,39,78,4,121,95.1219512195122,4.878048780487805
28125_marine,81,39,77,3,120,95.06172839506173,3.7037037037037033
28126_marine,82,39,78,3,121,95.1219512195122,3.6585365853658534
28127_marine,82,41,78,3,123,95.1219512195122,3.6585365853658534
28128_marine,83,41,79,3,124,95.18072289156626,3.614457831325301
28129_marine,83,41,79,3,124,95.18072289156626,3.614457831325301
28130_marine,83,41,79,3,124,95.18072289156626,3.614457831325301
28131_marine,84,41,80,3,125,95.23809523809523,3.571428571428571
28132_marine,84,43,80,3,127,95.23809523809523,3.571428571428571
28133_marine,84,43,80,3,127,95.23809523809523,3.571428571428571
28134_marine,84,43,80,3,127,95.23809523809523,3.571428571428571
28135_marine,83,43,79,3,126,95.18072289156626,3.614457831325301
28136_marine,83,42,79,3,125,95.18072289156626,3.614457831325301
28137_marine,83,41,79,3,124,95.18072289156626,3.614457831325301
28138_marine,82,41,78,3,123,95.1219512195122,3.6585365853658534
28139_marine,82,41,78,3,123,95.1219512195122,3.6585365853658534
28140_marine,82,41,78,3,123,95.1219512195122,3.6585365853658534
28141_marine,82,42,78,3,124,95.1219512195122,3.6585365853658534
28142_marine,82,42,78,3,124,95.1219512195122,3.6585365853658534
28143_marine,83,40,79,4,123,95.18072289156626,4.819277108433735
28144_marine,83,40,79,4,123,95.18072289156626,4.819277108433735
28145_marine,85,39,81,4,124,95.29411764705881,4.705882352941177
28146_marine,86,41,82,4,127,95.34883720930233,4.651162790697675
28147_marine,85,41,81,4,126,95.29411764705881,4.705882352941177
28148_marine,85,42,81,4,127,95.29411764705881,4.705882352941177
28149_marine,87,42,82,6,129,94.25287356321839,6.896551724137931
28150_marine,88,42,83,6,130,94.31818181818183,6.8181818181818175
28151_marine,147,69,112,51,216,76.19047619047619,34.69387755102041
28152_marine,146,71,111,51,217,76.02739726027397,34.93150684931507
28153_marine,88,45,82,7,133,93.18181818181817,7.954545454545454
28154_marine,88,44,82,5,132,93.18181818181817,5.681818181818182
28155_marine,88,43,82,5,131,93.18181818181817,5.681818181818182
28156_marine,88,43,82,5,131,93.18181818181817,5.681818181818182
28157_marine,87,45,81,5,132,93.10344827586206,5.747126436781609
28158_marine,87,45,81,5,132,93.10344827586206,5.747126436781609
28159_marine,89,44,83,5,133,93.25842696629213,5.617977528089887
28160_marine,89,42,83,5,131,93.25842696629213,5.617977528089887
28161_marine,90,42,84,5,132,93.33333333333333,5.555555555555555
28162_marine,92,42,84,7,134,91.30434782608695,7.608695652173914
28163_marine,93,41,85,8,134,91.39784946236558,8.60215053763441
28164_marine,93,40,85,8,133,91.39784946236558,8.60215053763441
28165_marine,95,39,87,8,134,91.57894736842105,8.421052631578947
28166_marine,95,37,87,8,132,91.57894736842105,8.421052631578947
28167_marine,93,39,85,8,132,91.39784946236558,8.60215053763441
28168_marine,93,42,85,9,135,91.39784946236558,9.67741935483871
28169_marine,98,44,91,10,142,92.85714285714286,10.204081632653061
28170_marine,98,47,91,10,145,92.85714285714286,10.204081632653061
28171_marine,102,54,95,11,156,93.13725490196079,10.784313725490197
28172_marine,285,210,230,65,495,80.7017543859649,22.807017543859647
28173_marine,301,244,244,70,545,81.06312292358804,23.25581395348837
28178_marine,337,278,259,110,615,76.8545994065282,32.640949554896146
28179_marine,305,206,232,102,511,76.0655737704918,33.442622950819676
28180_marine,302,184,229,102,486,75.82781456953643,33.77483443708609
28181_marine,94,35,87,9,129,92.5531914893617,9.574468085106384
28182_marine,97,35,90,9,132,92.78350515463917,9.278350515463918
28183_marine,95,33,88,7,128,92.63157894736842,7.368421052631578
28184_marine,338,201,259,109,539,76.62721893491124,32.24852071005917
28185_marine,355,282,269,119,637,75.77464788732394,33.52112676056338
28193_marine,439,320,314,179,759,71.5261958997722,40.77448747152619
28194_marine,469,336,335,203,805,71.42857142857143,43.28358208955223
28195_marine,401,319,305,135,720,76.05985037406484,33.66583541147132
28198_marine,408,322,310,136,730,75.98039215686273,33.33333333333333
28199_marine,486,382,336,210,868,69.1358024691358,43.20987654320987
28201_marine,347,196,262,122,543,75.50432276657061,35.158501440922194
28202_marine,101,39,93,11,140,92.07920792079209,10.891089108910892
28203_marine,94,34,86,8,128,91.48936170212765,8.51063829787234
28204_marine,90,34,82,7,124,91.11111111111111,7.777777777777778
28205_marine,92,33,84,7,125,91.30434782608695,7.608695652173914
28206_marine,91,34,83,7,125,91.20879120879121,7.6923076923076925
28207_marine,87,35,79,7,122,90.80459770114942,8.045977011494253
28208_marine,87,35,80,6,122,91.95402298850574,6.896551724137931
28209_marine,86,35,79,6,121,91.86046511627907,6.976744186046512
28210_marine,86,35,79,6,121,91.86046511627907,6.976744186046512
28211_marine,87,35,79,5,122,90.80459770114942,5.747126436781609
28212_marine,83,35,77,4,118,92.7710843373494,4.819277108433735
28213_marine,84,35,78,4,119,92.85714285714286,4.761904761904762
28214_marine,86,34,80,4,120,93.02325581395348,4.651162790697675
28215_marine,86,34,80,4,120,93.02325581395348,4.651162790697675
28216_marine,85,34,79,3,119,92.94117647058823,3.5294117647058822
28217_marine,85,34,79,3,119,92.94117647058823,3.5294117647058822
28218_marine,83,34,79,1,117,95.18072289156626,1.2048192771084338
28219_marine,83,33,79,1,116,95.18072289156626,1.2048192771084338
28220_marine,83,33,79,1,116,95.18072289156626,1.2048192771084338
28221_marine,83,33,79,1,116,95.18072289156626,1.2048192771084338
28222_marine,84,33,80,2,117,95.23809523809523,2.380952380952381
28223_marine,85,33,81,2,118,95.29411764705881,2.3529411764705883
28224_marine,85,33,81,2,118,95.29411764705881,2.3529411764705883
28225_marine,86,33,82,2,119,95.34883720930233,2.3255813953488373
28226_marine,87,35,83,2,122,95.40229885057471,2.2988505747126435
28227_marine,87,34,83,2,121,95.40229885057471,2.2988505747126435
28228_marine,88,34,84,3,122,95.45454545454545,3.4090909090909087
28229_marine,89,34,84,3,123,94.3820224719101,3.3707865168539324
28230_marine,90,33,85,3,123,94.44444444444444,3.3333333333333335
28231_marine,90,33,85,3,123,94.44444444444444,3.3333333333333335
28232_marine,90,33,85,3,123,94.44444444444444,3.3333333333333335
28233_marine,92,31,87,3,123,94.56521739130434,3.260869565217391
28234_marine,94,31,89,3,125,94.68085106382979,3.1914893617021276
28235_marine,92,31,87,3,123,94.56521739130434,3.260869565217391
28236_marine,95,31,90,4,126,94.73684210526315,4.2105263157894735
28237_marine,98,31,93,5,129,94.89795918367348,5.1020408163265305
28238_marine,99,31,93,6,130,93.93939393939394,6.0606060606060606
28239_marine,103,33,97,6,136,94.1747572815534,5.825242718446602
28240_marine,105,33,99,6,138,94.28571428571428,5.714285714285714
28241_marine,111,33,105,6,144,94.5945945945946,5.405405405405405
28242_marine,120,49,113,9,169,94.16666666666667,7.5
28243_marine,306,140,279,41,446,91.17647058823529,13.398692810457517
28303_marine,800,325,525,429,1125,65.625,53.625
28304_marine,846,367,546,464,1213,64.53900709219859,54.84633569739953
28305_marine,569,202,401,284,771,70.47451669595782,49.91212653778559
28306_marine,563,190,399,280,753,70.87033747779752,49.733570159857905
28307_marine,526,186,376,252,712,71.48288973384031,47.90874524714829
28308_marine,722,295,485,367,1017,67.17451523545706,50.83102493074792
28309_marine,707,291,480,352,998,67.89250353606789,49.78783592644979
28310_marine,703,289,484,347,992,68.84779516358464,49.359886201991465
28311_marine,721,284,498,362,1005,69.07073509015257,50.20804438280167
28312_marine,747,296,522,385,1043,69.87951807228916,51.53949129852744
28313_marine,589,210,414,303,799,70.28862478777589,51.44312393887945
28314_marine,518,161,372,262,679,71.81467181467181,50.57915057915058
28315_marine,497,150,353,258,647,71.0261569416499,51.91146881287726
28316_marine,481,142,340,251,623,70.68607068607069,52.18295218295218
28317_marine,84,34,80,7,118,95.23809523809523,8.333333333333332
28318_marine,82,34,78,7,116,95.1219512195122,8.536585365853659
28319_marine,74,31,70,5,105,94.5945945945946,6.756756756756757
28320_marine,74,31,70,5,105,94.5945945945946,6.756756756756757
28321_marine,74,31,70,5,105,94.5945945945946,6.756756756756757
28322_marine,73,31,69,4,104,94.52054794520548,5.47945205479452
28323_marine,73,31,69,4,104,94.52054794520548,5.47945205479452
28324_marine,76,31,71,6,107,93.42105263157895,7.894736842105263
28325_marine,78,30,72,7,108,92.3076923076923,8.974358974358974
28326_marine,78,30,72,7,108,92.3076923076923,8.974358974358974
28327_marine,77,30,71,7,107,92.20779220779221,9.090909090909092
28328_marine,77,30,71,6,107,92.20779220779221,7.792207792207792
28329_marine,77,30,71,6,107,92.20779220779221,7.792207792207792
28330_marine,81,30,75,6,111,92.5925925925926,7.4074074074074066
28331_marine,100,32,92,9,132,92,9
28332_marine,476,100,349,240,576,73.31932773109243,50.42016806722689
28333_marine,558,111,410,301,669,73.47670250896059,53.94265232974911
28334_marine,541,114,395,294,655,73.01293900184844,54.34380776340111
28335_marine,680,245,506,290,925,74.41176470588235,42.64705882352941
28341_marine,517,242,378,196,759,73.11411992263056,37.9110251450677
28342_marine,114,35,109,11,149,95.6140350877193,9.649122807017543
28343_marine,95,30,91,6,125,95.78947368421052,6.315789473684211
28344_marine,83,31,80,4,114,96.3855421686747,4.819277108433735
28345_marine,73,29,70,4,102,95.8904109589041,5.47945205479452
28346_marine,70,29,67,1,99,95.71428571428572,1.4285714285714286
28347_marine,70,29,67,1,99,95.71428571428572,1.4285714285714286
28348_marine,69,29,66,0,98,95.65217391304348,0
28349_marine,69,30,66,0,99,95.65217391304348,0
28350_marine,69,30,66,0,99,95.65217391304348,0
28351_marine,75,31,72,6,106,96,8
28352_marine,520,173,330,296,693,63.46153846153846,56.92307692307692
28355_marine,523,177,333,295,700,63.67112810707457,56.40535372848948
28356_marine,95,29,92,8,124,96.84210526315789,8.421052631578947
28357_marine,712,208,460,367,920,64.60674157303372,51.54494382022472
28358_marine,834,285,560,438,1119,67.14628297362111,52.51798561151079
28361_marine,577,257,436,244,834,75.5632582322357,42.287694974003465
28362_marine,563,249,418,239,812,74.24511545293073,42.45115452930728
28371_marine,614,176,419,320,790,68.24104234527687,52.11726384364821
28372_marine,106,28,100,9,134,94.33962264150944,8.49056603773585
28373_marine,102,30,96,9,132,94.11764705882352,8.823529411764707
28374_marine,656,173,427,388,829,65.09146341463415,59.14634146341463
28375_marine,710,192,460,421,902,64.7887323943662,59.29577464788732
28377_marine,698,188,449,415,886,64.32664756446992,59.45558739255014
28378_marine,702,180,461,415,882,65.66951566951566,59.11680911680912
28379_marine,980,320,610,573,1300,62.244897959183675,58.46938775510204
28387_marine,1042,371,631,617,1413,60.55662188099809,59.21305182341651
28388_marine,122,31,117,17,153,95.90163934426229,13.934426229508196
28389_marine,101,31,97,8,132,96.03960396039604,7.920792079207921
28390_marine,91,28,87,8,119,95.6043956043956,8.791208791208792
28391_marine,91,28,86,9,119,94.5054945054945,9.89010989010989
28392_marine,91,27,86,9,118,94.5054945054945,9.89010989010989
28393_marine,91,28,86,9,119,94.5054945054945,9.89010989010989
28394_marine,92,28,87,9,120,94.56521739130434,9.782608695652174
28395_marine,92,28,87,9,120,94.56521739130434,9.782608695652174
28396_marine,92,28,87,9,120,94.56521739130434,9.782608695652174
28397_marine,93,30,88,9,123,94.6236559139785,9.67741935483871
28398_marine,96,30,91,12,126,94.79166666666666,12.5
28399_marine,95,30,90,11,125,94.73684210526315,11.578947368421053
28400_marine,93,32,88,11,125,94.6236559139785,11.827956989247312
28401_marine,92,32,87,9,124,94.56521739130434,9.782608695652174
28402_marine,93,32,88,9,125,94.6236559139785,9.67741935483871
28403_marine,95,32,90,9,127,94.73684210526315,9.473684210526317
28404_marine,102,34,97,14,136,95.09803921568627,13.725490196078432
28405_marine,101,34,96,14,135,95.04950495049505,13.861386138613863
28406_marine,100,32,95,14,132,95,14.000000000000002
28407_marine,97,32,92,11,129,94.84536082474226,11.34020618556701
28408_marine,97,32,92,11,129,94.84536082474226,11.34020618556701
28409_marine,97,32,92,11,129,94.84536082474226,11.34020618556701
28410_marine,98,32,93,11,130,94.89795918367348,11.224489795918368
28411_marine,96,31,91,9,127,94.79166666666666,9.375
28412_marine,96,32,91,9,128,94.79166666666666,9.375
28413_marine,96,32,91,9,128,94.79166666666666,9.375
28414_marine,95,32,90,9,127,94.73684210526315,9.473684210526317
28415_marine,95,33,90,9,128,94.73684210526315,9.473684210526317
28416_marine,97,33,92,9,130,94.84536082474226,9.278350515463918
28417_marine,97,34,92,9,131,94.84536082474226,9.278350515463918
28418_marine,98,34,93,10,132,94.89795918367348,10.204081632653061
28419_marine,98,35,93,9,133,94.89795918367348,9.183673469387756
28420_marine,98,37,93,9,135,94.89795918367348,9.183673469387756
28421_marine,97,37,92,9,134,94.84536082474226,9.278350515463918
28422_marine,520,135,328,330,655,63.07692307692307,63.46153846153846
28423_marine,560,159,361,350,719,64.46428571428572,62.5
28424_marine,523,133,331,330,656,63.28871892925431,63.09751434034416
28425_marine,527,152,331,334,679,62.808349146110054,63.37760910815939
28426_marine,586,180,370,371,766,63.13993174061433,63.310580204778155
28427_marine,589,180,373,372,769,63.3276740237691,63.1578947368421
28428_marine,579,177,371,362,756,64.07599309153713,62.52158894645942
28429_marine,539,154,339,340,693,62.89424860853432,63.07977736549165
28430_marine,530,167,358,318,697,67.54716981132076,60
28431_marine,491,143,327,298,634,66.59877800407332,60.692464358452135
28432_marine,491,139,327,298,630,66.59877800407332,60.692464358452135
28433_marine,104,39,99,10,143,95.1923076923077,9.615384615384617
28434_marine,103,40,98,9,143,95.14563106796116,8.737864077669903
28435_marine,101,39,96,8,140,95.04950495049505,7.920792079207921
28436_marine,97,39,92,7,136,94.84536082474226,7.216494845360824
28437_marine,99,39,94,9,138,94.94949494949495,9.090909090909092
28438_marine,99,39,94,9,138,94.94949494949495,9.090909090909092
28439_marine,99,40,94,9,139,94.94949494949495,9.090909090909092
28440_marine,98,39,93,9,137,94.89795918367348,9.183673469387756
28441_marine,98,40,93,9,138,94.89795918367348,9.183673469387756
28442_marine,96,41,91,7,137,94.79166666666666,7.291666666666667
28443_marine,96,40,91,7,136,94.79166666666666,7.291666666666667
28444_marine,96,40,91,7,136,94.79166666666666,7.291666666666667
28445_marine,96,40,91,7,136,94.79166666666666,7.291666666666667
28446_marine,96,40,91,7,136,94.79166666666666,7.291666666666667
28447_marine,96,40,91,7,136,94.79166666666666,7.291666666666667
28448_marine,96,40,91,7,136,94.79166666666666,7.291666666666667
28449_marine,96,40,91,7,136,94.79166666666666,7.291666666666667
28450_marine,96,40,91,7,136,94.79166666666666,7.291666666666667
28451_marine,96,40,91,7,136,94.79166666666666,7.291666666666667
28452_marine,97,40,92,7,137,94.84536082474226,7.216494845360824
28453_marine,94,40,89,7,134,94.68085106382979,7.446808510638298
28454_marine,94,41,89,7,135,94.68085106382979,7.446808510638298
28455_marine,95,41,90,7,136,94.73684210526315,7.368421052631578
28456_marine,95,42,90,7,137,94.73684210526315,7.368421052631578
28457_marine,96,42,91,9,138,94.79166666666666,9.375
28458_marine,96,42,91,9,138,94.79166666666666,9.375
28459_marine,96,42,91,9,138,94.79166666666666,9.375
28460_marine,96,43,91,9,139,94.79166666666666,9.375
28461_marine,95,43,90,9,138,94.73684210526315,9.473684210526317
28462_marine,93,43,88,9,136,94.6236559139785,9.67741935483871
28463_marine,91,42,86,7,133,94.5054945054945,7.6923076923076925
28464_marine,91,42,86,7,133,94.5054945054945,7.6923076923076925
28465_marine,91,42,86,7,133,94.5054945054945,7.6923076923076925
28466_marine,91,42,86,7,133,94.5054945054945,7.6923076923076925
28467_marine,91,42,86,7,133,94.5054945054945,7.6923076923076925
28468_marine,91,42,86,7,133,94.5054945054945,7.6923076923076925
28469_marine,90,42,85,7,132,94.44444444444444,7.777777777777778
28470_marine,89,42,84,7,131,94.3820224719101,7.865168539325842
28471_marine,89,42,84,7,131,94.3820224719101,7.865168539325842
28472_marine,89,42,84,7,131,94.3820224719101,7.865168539325842
28473_marine,87,42,82,7,129,94.25287356321839,8.045977011494253
28474_marine,84,42,80,5,126,95.23809523809523,5.952380952380952
28475_marine,86,42,82,7,128,95.34883720930233,8.13953488372093
28476_marine,88,40,84,7,128,95.45454545454545,7.954545454545454
28477_marine,88,40,84,7,128,95.45454545454545,7.954545454545454
28478_marine,86,40,82,7,126,95.34883720930233,8.13953488372093
28479_marine,85,40,81,7,125,95.29411764705881,8.235294117647058
28480_marine,86,40,82,7,126,95.34883720930233,8.13953488372093
28481_marine,86,40,82,7,126,95.34883720930233,8.13953488372093
28482_marine,82,40,78,4,122,95.1219512195122,4.878048780487805
28483_marine,82,40,78,4,122,95.1219512195122,4.878048780487805
28484_marine,82,39,78,4,121,95.1219512195122,4.878048780487805
28485_marine,83,39,79,4,122,95.18072289156626,4.819277108433735
28486_marine,82,39,78,3,121,95.1219512195122,3.6585365853658534
28487_marine,82,39,78,3,121,95.1219512195122,3.6585365853658534
28488_marine,82,41,78,3,123,95.1219512195122,3.6585365853658534
28489_marine,82,41,78,3,123,95.1219512195122,3.6585365853658534
28490_marine,83,41,79,3,124,95.18072289156626,3.614457831325301
28491_marine,83,41,79,3,124,95.18072289156626,3.614457831325301
28492_marine,83,43,79,3,126,95.18072289156626,3.614457831325301
28493_marine,83,43,79,3,126,95.18072289156626,3.614457831325301
28494_marine,83,43,79,3,126,95.18072289156626,3.614457831325301
28495_marine,83,43,79,3,126,95.18072289156626,3.614457831325301
28496_marine,83,43,79,3,126,95.18072289156626,3.614457831325301
28497_marine,82,42,78,3,124,95.1219512195122,3.6585365853658534
28498_marine,82,42,78,3,124,95.1219512195122,3.6585365853658534
28499_marine,82,41,78,3,123,95.1219512195122,3.6585365853658534
28500_marine,82,42,78,3,124,95.1219512195122,3.6585365853658534
28501_marine,82,42,78,3,124,95.1219512195122,3.6585365853658534
28502_marine,82,42,78,3,124,95.1219512195122,3.6585365853658534
28503_marine,84,42,80,4,126,95.23809523809523,4.761904761904762
28504_marine,84,42,80,4,126,95.23809523809523,4.761904761904762
28505_marine,83,42,79,4,125,95.18072289156626,4.819277108433735
28506_marine,85,42,81,4,127,95.29411764705881,4.705882352941177
28507_marine,84,41,80,4,125,95.23809523809523,4.761904761904762
28508_marine,84,42,80,4,126,95.23809523809523,4.761904761904762
28509_marine,86,43,82,6,129,95.34883720930233,6.976744186046512
28510_marine,146,70,112,51,216,76.71232876712328,34.93150684931507
28511_marine,152,73,115,55,225,75.6578947368421,36.18421052631579
28512_marine,148,72,112,52,220,75.67567567567568,35.13513513513514
28513_marine,87,44,82,6,131,94.25287356321839,6.896551724137931
28514_marine,86,45,80,5,131,93.02325581395348,5.813953488372093
28515_marine,88,45,82,5,133,93.18181818181817,5.681818181818182
28516_marine,87,44,81,5,131,93.10344827586206,5.747126436781609
28517_marine,87,45,81,5,132,93.10344827586206,5.747126436781609
28518_marine,87,45,81,5,132,93.10344827586206,5.747126436781609
28519_marine,87,45,81,5,132,93.10344827586206,5.747126436781609
28520_marine,87,44,81,5,131,93.10344827586206,5.747126436781609
28521_marine,87,43,81,5,130,93.10344827586206,5.747126436781609
28522_marine,90,42,84,5,132,93.33333333333333,5.555555555555555
28523_marine,91,42,84,6,133,92.3076923076923,6.593406593406594
28524_marine,92,41,85,7,133,92.3913043478261,7.608695652173914
28525_marine,93,41,85,8,134,91.39784946236558,8.60215053763441
28526_marine,93,39,85,8,132,91.39784946236558,8.60215053763441
28527_marine,92,38,84,8,130,91.30434782608695,8.695652173913043
28528_marine,91,37,84,7,128,92.3076923076923,7.6923076923076925
28529_marine,92,37,85,7,129,92.3913043478261,7.608695652173914
28530_marine,92,44,85,8,136,92.3913043478261,8.695652173913043
28531_marine,99,44,92,11,143,92.92929292929293,11.11111111111111
28532_marine,99,45,92,11,144,92.92929292929293,11.11111111111111
28533_marine,266,202,215,61,468,80.82706766917293,22.932330827067666
28534_marine,316,307,252,80,623,79.74683544303798,25.31645569620253
28538_marine,342,255,263,114,597,76.90058479532163,33.33333333333333
28539_marine,333,209,256,108,542,76.87687687687688,32.432432432432435
28540_marine,332,230,253,110,562,76.20481927710844,33.13253012048193
28541_marine,330,236,251,110,566,76.06060606060606,33.33333333333333
28542_marine,333,235,256,108,568,76.87687687687688,32.432432432432435
28543_marine,327,207,252,108,534,77.06422018348624,33.02752293577982
28544_marine,339,262,259,112,601,76.40117994100295,33.03834808259587
28561_marine,380,247,290,124,627,76.31578947368422,32.631578947368425
28562_marine,107,44,97,8,151,90.65420560747664,7.476635514018691
28563_marine,96,37,88,8,133,91.66666666666666,8.333333333333332
28564_marine,95,34,87,8,129,91.57894736842105,8.421052631578947
28565_marine,90,34,82,7,124,91.11111111111111,7.777777777777778
28566_marine,92,35,84,7,127,91.30434782608695,7.608695652173914
28567_marine,91,34,83,7,125,91.20879120879121,7.6923076923076925
28568_marine,89,35,82,6,124,92.13483146067416,6.741573033707865
28569_marine,87,35,80,6,122,91.95402298850574,6.896551724137931
28570_marine,85,35,79,6,120,92.94117647058823,7.0588235294117645
28571_marine,85,35,79,5,120,92.94117647058823,5.88235294117647
28572_marine,85,35,79,4,120,92.94117647058823,4.705882352941177
28573_marine,86,35,80,4,121,93.02325581395348,4.651162790697675
28574_marine,84,35,78,4,119,92.85714285714286,4.761904761904762
28575_marine,86,34,80,4,120,93.02325581395348,4.651162790697675
28576_marine,86,34,80,4,120,93.02325581395348,4.651162790697675
28577_marine,85,34,79,3,119,92.94117647058823,3.5294117647058822
28578_marine,85,34,79,3,119,92.94117647058823,3.5294117647058822
28579_marine,83,34,79,1,117,95.18072289156626,1.2048192771084338
28580_marine,83,33,79,1,116,95.18072289156626,1.2048192771084338
28581_marine,84,33,80,2,117,95.23809523809523,2.380952380952381
28582_marine,84,33,80,2,117,95.23809523809523,2.380952380952381
28583_marine,84,33,80,2,117,95.23809523809523,2.380952380952381
28584_marine,85,33,81,2,118,95.29411764705881,2.3529411764705883
28585_marine,86,35,82,2,121,95.34883720930233,2.3255813953488373
28586_marine,86,35,82,2,121,95.34883720930233,2.3255813953488373
28587_marine,87,35,83,2,122,95.40229885057471,2.2988505747126435
28588_marine,87,35,83,2,122,95.40229885057471,2.2988505747126435
28589_marine,90,34,85,3,124,94.44444444444444,3.3333333333333335
28590_marine,90,34,85,3,124,94.44444444444444,3.3333333333333335
28591_marine,90,34,85,3,124,94.44444444444444,3.3333333333333335
28592_marine,92,33,87,3,125,94.56521739130434,3.260869565217391
28593_marine,92,33,87,3,125,94.56521739130434,3.260869565217391
28594_marine,94,33,89,3,127,94.68085106382979,3.1914893617021276
28595_marine,92,31,87,3,123,94.56521739130434,3.260869565217391
28596_marine,94,31,89,3,125,94.68085106382979,3.1914893617021276
28597_marine,96,31,91,5,127,94.79166666666666,5.208333333333334
28598_marine,96,31,91,5,127,94.79166666666666,5.208333333333334
28599_marine,97,33,91,6,130,93.81443298969072,6.185567010309279
28600_marine,105,33,99,6,138,94.28571428571428,5.714285714285714
28601_marine,104,33,98,6,137,94.23076923076923,5.769230769230769
28602_marine,115,45,109,6,160,94.78260869565217,5.217391304347826
28603_marine,286,136,259,36,422,90.55944055944056,12.587412587412588
28604_marine,316,144,287,42,460,90.82278481012658,13.291139240506327
28664_marine,543,199,392,257,742,72.19152854511971,47.32965009208103
28665_marine,550,202,393,263,752,71.45454545454545,47.81818181818182
28666_marine,766,310,496,412,1076,64.75195822454309,53.78590078328982
28667_marine,712,293,478,364,1005,67.13483146067416,51.12359550561798
28668_marine,709,281,478,363,990,67.41889985895627,51.198871650211565
28671_marine,666,254,474,339,920,71.17117117117117,50.9009009009009
28672_marine,670,261,475,340,931,70.8955223880597,50.74626865671642
28673_marine,524,168,377,269,692,71.94656488549617,51.335877862595424
28674_marine,103,36,98,10,139,95.14563106796116,9.70873786407767
28675_marine,93,34,89,7,127,95.6989247311828,7.526881720430108
28676_marine,85,34,81,5,119,95.29411764705881,5.88235294117647
28677_marine,80,34,76,5,114,95,6.25
28678_marine,74,34,70,5,108,94.5945945945946,6.756756756756757
28679_marine,74,31,70,5,105,94.5945945945946,6.756756756756757
28680_marine,74,31,70,5,105,94.5945945945946,6.756756756756757
28681_marine,73,31,69,4,104,94.52054794520548,5.47945205479452
28682_marine,75,31,70,5,106,93.33333333333333,6.666666666666667
28683_marine,75,31,70,5,106,93.33333333333333,6.666666666666667
28684_marine,77,31,72,7,108,93.5064935064935,9.090909090909092
28685_marine,77,30,71,7,107,92.20779220779221,9.090909090909092
28686_marine,77,30,71,7,107,92.20779220779221,9.090909090909092
28687_marine,78,30,72,7,108,92.3076923076923,8.974358974358974
28688_marine,77,30,71,6,107,92.20779220779221,7.792207792207792
28689_marine,77,30,71,6,107,92.20779220779221,7.792207792207792
28690_marine,81,30,75,6,111,92.5925925925926,7.4074074074074066
28691_marine,91,31,85,11,122,93.4065934065934,12.087912087912088
28692_marine,463,98,336,242,561,72.57019438444925,52.26781857451404
28693_marine,539,111,397,289,650,73.65491651205936,53.61781076066791
28694_marine,568,114,415,310,682,73.06338028169014,54.5774647887324
28695_marine,637,183,470,282,820,73.78335949764521,44.27001569858713
28701_marine,778,329,536,365,1107,68.89460154241645,46.91516709511568
28702_marine,679,218,458,341,897,67.45213549337261,50.220913107511045
28703_marine,105,32,101,10,137,96.19047619047619,9.523809523809524
28704_marine,83,32,80,4,115,96.3855421686747,4.819277108433735
28705_marine,73,30,70,2,103,95.8904109589041,2.73972602739726
28706_marine,71,29,68,2,100,95.77464788732394,2.8169014084507045
28707_marine,71,29,68,2,100,95.77464788732394,2.8169014084507045
28708_marine,70,29,67,1,99,95.71428571428572,1.4285714285714286
28709_marine,70,30,67,1,100,95.71428571428572,1.4285714285714286
28710_marine,69,30,66,0,99,95.65217391304348,0
28711_marine,75,31,72,6,106,96,8
28712_marine,518,172,328,296,690,63.32046332046332,57.14285714285714
28714_marine,530,172,336,302,702,63.39622641509434,56.9811320754717
28715_marine,98,32,94,9,130,95.91836734693877,9.183673469387756
28716_marine,97,28,94,8,125,96.90721649484536,8.24742268041237
28717_marine,691,186,447,364,877,64.6888567293777,52.67727930535456
28718_marine,841,286,563,443,1127,66.94411414982164,52.675386444708685
28721_marine,596,255,447,258,851,75,43.288590604026844
28722_marine,549,210,409,242,759,74.4990892531876,44.080145719489984
28723_marine,705,293,535,331,998,75.88652482269504,46.95035460992908
28730_marine,656,240,446,330,896,67.98780487804879,50.30487804878049
28731_marine,122,36,116,11,158,95.08196721311475,9.01639344262295
28732_marine,104,28,98,9,132,94.23076923076923,8.653846153846153
28733_marine,104,28,98,9,132,94.23076923076923,8.653846153846153
28734_marine,665,177,434,390,842,65.26315789473685,58.64661654135338
28735_marine,717,194,465,423,911,64.85355648535564,58.995815899581594
28736_marine,792,204,504,493,996,63.63636363636363,62.247474747474755
28737_marine,711,186,460,421,897,64.69760900140648,59.21237693389592
28738_marine,981,296,623,569,1277,63.50662589194699,58.00203873598369
28748_marine,1008,332,610,601,1340,60.51587301587301,59.62301587301587
28749_marine,109,31,103,14,140,94.4954128440367,12.844036697247708
28750_marine,97,29,91,10,126,93.81443298969072,10.309278350515463
28751_marine,91,29,86,9,120,94.5054945054945,9.89010989010989
28752_marine,91,28,86,9,119,94.5054945054945,9.89010989010989
28753_marine,92,28,87,10,120,94.56521739130434,10.869565217391305
28754_marine,95,28,90,10,123,94.73684210526315,10.526315789473683
28755_marine,95,28,90,10,123,94.73684210526315,10.526315789473683
28756_marine,97,30,92,12,127,94.84536082474226,12.371134020618557
28757_marine,98,31,93,12,129,94.89795918367348,12.244897959183673
28758_marine,607,158,385,385,765,63.426688632619445,63.426688632619445
28759_marine,615,158,389,391,773,63.25203252032521,63.577235772357724
28760_marine,646,222,435,400,868,67.3374613003096,61.91950464396285
28761_marine,562,155,368,354,717,65.48042704626334,62.989323843416365
28762_marine,561,152,367,352,713,65.41889483065954,62.745098039215684
28763_marine,92,31,87,9,123,94.56521739130434,9.782608695652174
28764_marine,96,31,91,11,127,94.79166666666666,11.458333333333332
28765_marine,96,31,91,11,127,94.79166666666666,11.458333333333332
28766_marine,96,31,91,11,127,94.79166666666666,11.458333333333332
28767_marine,97,32,92,12,129,94.84536082474226,12.371134020618557
28768_marine,97,32,92,12,129,94.84536082474226,12.371134020618557
28769_marine,97,32,92,12,129,94.84536082474226,12.371134020618557
28770_marine,97,32,92,12,129,94.84536082474226,12.371134020618557
28771_marine,101,31,96,12,132,95.04950495049505,11.881188118811881
28772_marine,101,32,96,12,133,95.04950495049505,11.881188118811881
28773_marine,100,32,95,11,132,95,11
28774_marine,100,32,95,11,132,95,11
28775_marine,98,33,93,9,131,94.89795918367348,9.183673469387756
28776_marine,98,33,93,9,131,94.89795918367348,9.183673469387756
28777_marine,98,33,93,10,131,94.89795918367348,10.204081632653061
28778_marine,98,33,93,10,131,94.89795918367348,10.204081632653061
28779_marine,97,34,92,9,131,94.84536082474226,9.278350515463918
28780_marine,97,37,92,9,134,94.84536082474226,9.278350515463918
28781_marine,528,121,346,330,649,65.53030303030303,62.5
28782_marine,548,138,352,344,686,64.23357664233576,62.77372262773723
28783_marine,523,135,331,330,658,63.28871892925431,63.09751434034416
28784_marine,521,133,331,328,654,63.53166986564299,62.95585412667947
28785_marine,526,152,330,334,678,62.737642585551335,63.49809885931559
28786_marine,609,190,387,387,799,63.54679802955665,63.54679802955665
28787_marine,615,192,391,389,807,63.577235772357724,63.25203252032521
28788_marine,574,166,356,368,740,62.02090592334495,64.11149825783971
28789_marine,607,189,383,387,796,63.097199341021415,63.75617792421746
28790_marine,583,182,373,362,765,63.979416809605496,62.0926243567753
28791_marine,572,181,370,354,753,64.6853146853147,61.88811188811189
28792_marine,502,149,332,304,651,66.13545816733067,60.55776892430279
28793_marine,104,39,99,11,143,95.1923076923077,10.576923076923077
28794_marine,103,40,98,10,143,95.14563106796116,9.70873786407767
28795_marine,102,40,97,9,142,95.09803921568627,8.823529411764707
28796_marine,99,40,94,7,139,94.94949494949495,7.07070707070707
28797_marine,96,39,91,7,135,94.79166666666666,7.291666666666667
28798_marine,98,39,93,9,137,94.89795918367348,9.183673469387756
28799_marine,98,40,93,9,138,94.89795918367348,9.183673469387756
28800_marine,98,40,93,9,138,94.89795918367348,9.183673469387756
28801_marine,96,40,91,7,136,94.79166666666666,7.291666666666667
28802_marine,96,40,91,7,136,94.79166666666666,7.291666666666667
28803_marine,96,40,91,7,136,94.79166666666666,7.291666666666667
28804_marine,96,41,91,7,137,94.79166666666666,7.291666666666667
28805_marine,97,41,92,7,138,94.84536082474226,7.216494845360824
28806_marine,97,41,92,7,138,94.84536082474226,7.216494845360824
28807_marine,97,40,92,7,137,94.84536082474226,7.216494845360824
28808_marine,97,40,92,7,137,94.84536082474226,7.216494845360824
28809_marine,97,40,92,7,137,94.84536082474226,7.216494845360824
28810_marine,97,40,92,7,137,94.84536082474226,7.216494845360824
28811_marine,97,40,92,7,137,94.84536082474226,7.216494845360824
28812_marine,95,40,90,7,135,94.73684210526315,7.368421052631578
28813_marine,94,40,89,7,134,94.68085106382979,7.446808510638298
28814_marine,95,41,90,7,136,94.73684210526315,7.368421052631578
28815_marine,95,41,90,7,136,94.73684210526315,7.368421052631578
28816_marine,95,42,90,7,137,94.73684210526315,7.368421052631578
28817_marine,94,42,89,7,136,94.68085106382979,7.446808510638298
28818_marine,94,42,89,7,136,94.68085106382979,7.446808510638298
28819_marine,96,42,91,9,138,94.79166666666666,9.375
28820_marine,96,43,91,9,139,94.79166666666666,9.375
28821_marine,96,43,91,9,139,94.79166666666666,9.375
28822_marine,94,43,89,9,137,94.68085106382979,9.574468085106384
28823_marine,91,43,86,9,134,94.5054945054945,9.89010989010989
28824_marine,89,42,84,7,131,94.3820224719101,7.865168539325842
28825_marine,89,42,84,7,131,94.3820224719101,7.865168539325842
28826_marine,89,42,84,7,131,94.3820224719101,7.865168539325842
28827_marine,89,42,84,7,131,94.3820224719101,7.865168539325842
28828_marine,88,42,83,7,130,94.31818181818183,7.954545454545454
28829_marine,88,42,83,7,130,94.31818181818183,7.954545454545454
28830_marine,87,42,82,7,129,94.25287356321839,8.045977011494253
28831_marine,87,42,82,7,129,94.25287356321839,8.045977011494253
28832_marine,87,42,82,7,129,94.25287356321839,8.045977011494253
28833_marine,87,42,82,7,129,94.25287356321839,8.045977011494253
28834_marine,85,42,80,6,127,94.11764705882352,7.0588235294117645
28835_marine,86,42,82,7,128,95.34883720930233,8.13953488372093
28836_marine,86,41,82,7,127,95.34883720930233,8.13953488372093
28837_marine,86,40,82,7,126,95.34883720930233,8.13953488372093
28838_marine,84,40,80,7,124,95.23809523809523,8.333333333333332
28839_marine,84,40,80,7,124,95.23809523809523,8.333333333333332
28840_marine,84,40,80,7,124,95.23809523809523,8.333333333333332
28841_marine,84,40,80,7,124,95.23809523809523,8.333333333333332
28842_marine,83,40,79,6,123,95.18072289156626,7.228915662650602
28843_marine,81,40,77,4,121,95.06172839506173,4.938271604938271
28844_marine,82,39,78,4,121,95.1219512195122,4.878048780487805
28845_marine,82,39,78,4,121,95.1219512195122,4.878048780487805
28846_marine,81,39,77,3,120,95.06172839506173,3.7037037037037033
28847_marine,81,39,77,3,120,95.06172839506173,3.7037037037037033
28848_marine,81,39,77,3,120,95.06172839506173,3.7037037037037033
28849_marine,81,41,77,3,122,95.06172839506173,3.7037037037037033
28850_marine,82,41,78,3,123,95.1219512195122,3.6585365853658534
28851_marine,82,41,78,3,123,95.1219512195122,3.6585365853658534
28852_marine,82,43,78,3,125,95.1219512195122,3.6585365853658534
28853_marine,82,43,78,3,125,95.1219512195122,3.6585365853658534
28854_marine,82,43,78,3,125,95.1219512195122,3.6585365853658534
28855_marine,82,43,78,3,125,95.1219512195122,3.6585365853658534
28856_marine,81,42,77,3,123,95.06172839506173,3.7037037037037033
28857_marine,81,42,77,3,123,95.06172839506173,3.7037037037037033
28858_marine,81,42,77,3,123,95.06172839506173,3.7037037037037033
28859_marine,81,42,77,3,123,95.06172839506173,3.7037037037037033
28860_marine,81,43,77,3,124,95.06172839506173,3.7037037037037033
28861_marine,82,44,78,3,126,95.1219512195122,3.6585365853658534
28862_marine,82,42,78,3,124,95.1219512195122,3.6585365853658534
28863_marine,83,42,79,3,125,95.18072289156626,3.614457831325301
28864_marine,84,42,80,4,126,95.23809523809523,4.761904761904762
28865_marine,83,42,79,4,125,95.18072289156626,4.819277108433735
28866_marine,83,42,79,4,125,95.18072289156626,4.819277108433735
28867_marine,84,43,80,4,127,95.23809523809523,4.761904761904762
28868_marine,84,43,80,4,127,95.23809523809523,4.761904761904762
28869_marine,86,44,82,6,130,95.34883720930233,6.976744186046512
28870_marine,147,70,113,51,217,76.87074829931973,34.69387755102041
28871_marine,146,70,112,51,216,76.71232876712328,34.93150684931507
28872_marine,146,71,112,51,217,76.71232876712328,34.93150684931507
28873_marine,88,44,83,6,132,94.31818181818183,6.8181818181818175
28874_marine,86,44,81,4,130,94.18604651162791,4.651162790697675
28875_marine,86,45,81,4,131,94.18604651162791,4.651162790697675
28876_marine,87,45,81,5,132,93.10344827586206,5.747126436781609
28877_marine,87,46,81,5,133,93.10344827586206,5.747126436781609
28878_marine,87,45,81,5,132,93.10344827586206,5.747126436781609
28879_marine,87,44,81,5,131,93.10344827586206,5.747126436781609
28880_marine,87,44,81,5,131,93.10344827586206,5.747126436781609
28881_marine,88,45,82,5,133,93.18181818181817,5.681818181818182
28882_marine,88,44,82,5,132,93.18181818181817,5.681818181818182
28883_marine,88,43,82,5,131,93.18181818181817,5.681818181818182
28884_marine,88,43,82,5,131,93.18181818181817,5.681818181818182
28885_marine,91,41,85,6,132,93.4065934065934,6.593406593406594
28886_marine,91,39,85,6,130,93.4065934065934,6.593406593406594
28887_marine,92,39,85,7,131,92.3913043478261,7.608695652173914
28888_marine,91,39,84,7,130,92.3076923076923,7.6923076923076925
28889_marine,91,39,84,7,130,92.3076923076923,7.6923076923076925
28890_marine,90,37,83,7,127,92.22222222222223,7.777777777777778
28891_marine,94,39,87,8,133,92.5531914893617,8.51063829787234
28892_marine,99,42,92,11,141,92.92929292929293,11.11111111111111
28893_marine,99,43,92,11,142,92.92929292929293,11.11111111111111
28894_marine,300,260,239,78,560,79.66666666666666,26
28921_marine,317,215,253,94,532,79.81072555205047,29.652996845425868
28922_marine,114,79,103,12,193,90.35087719298247,10.526315789473683
28923_marine,106,48,96,10,154,90.56603773584906,9.433962264150944
28924_marine,98,34,90,8,132,91.83673469387756,8.16326530612245
28925_marine,97,34,89,8,131,91.75257731958763,8.24742268041237
28926_marine,93,36,85,8,129,91.39784946236558,8.60215053763441
28927_marine,92,39,84,7,131,91.30434782608695,7.608695652173914
28928_marine,90,34,84,6,124,93.33333333333333,6.666666666666667
28929_marine,90,35,84,6,125,93.33333333333333,6.666666666666667
28930_marine,85,35,79,6,120,92.94117647058823,7.0588235294117645
28931_marine,85,35,79,5,120,92.94117647058823,5.88235294117647
28932_marine,85,35,80,4,120,94.11764705882352,4.705882352941177
28933_marine,86,35,80,4,121,93.02325581395348,4.651162790697675
28934_marine,83,35,77,4,118,92.7710843373494,4.819277108433735
28935_marine,86,35,80,4,121,93.02325581395348,4.651162790697675
28936_marine,86,34,80,4,120,93.02325581395348,4.651162790697675
28937_marine,86,34,80,4,120,93.02325581395348,4.651162790697675
28938_marine,85,34,79,3,119,92.94117647058823,3.5294117647058822
28939_marine,85,34,79,3,119,92.94117647058823,3.5294117647058822
28940_marine,83,34,79,1,117,95.18072289156626,1.2048192771084338
28941_marine,84,33,80,2,117,95.23809523809523,2.380952380952381
28942_marine,84,33,80,2,117,95.23809523809523,2.380952380952381
28943_marine,84,33,80,2,117,95.23809523809523,2.380952380952381
28944_marine,85,35,81,2,120,95.29411764705881,2.3529411764705883
28945_marine,86,35,82,2,121,95.34883720930233,2.3255813953488373
28946_marine,86,35,82,2,121,95.34883720930233,2.3255813953488373
28947_marine,87,35,83,2,122,95.40229885057471,2.2988505747126435
28948_marine,88,35,84,2,123,95.45454545454545,2.272727272727273
28949_marine,89,35,85,3,124,95.50561797752809,3.3707865168539324
28950_marine,90,35,85,3,125,94.44444444444444,3.3333333333333335
28951_marine,92,35,87,3,127,94.56521739130434,3.260869565217391
28952_marine,92,34,87,3,126,94.56521739130434,3.260869565217391
28953_marine,92,33,87,3,125,94.56521739130434,3.260869565217391
28954_marine,90,33,85,3,123,94.44444444444444,3.3333333333333335
28955_marine,92,33,87,3,125,94.56521739130434,3.260869565217391
28956_marine,92,31,87,3,123,94.56521739130434,3.260869565217391
28957_marine,94,31,89,3,125,94.68085106382979,3.1914893617021276
28958_marine,96,31,91,5,127,94.79166666666666,5.208333333333334
28959_marine,97,31,91,6,128,93.81443298969072,6.185567010309279
28960_marine,96,33,90,6,129,93.75,6.25
28961_marine,102,33,96,6,135,94.11764705882352,5.88235294117647
28962_marine,107,37,101,5,144,94.39252336448598,4.672897196261682
28963_marine,119,55,112,8,174,94.11764705882352,6.722689075630252
28964_marine,280,134,257,34,414,91.78571428571428,12.142857142857142
28965_marine,292,135,263,42,427,90.06849315068493,14.383561643835616
29031_marine,679,264,478,346,943,70.39764359351989,50.95729013254786
29032_marine,555,188,399,284,743,71.89189189189189,51.17117117117117
29033_marine,518,168,372,268,686,71.81467181467181,51.737451737451735
29034_marine,99,36,95,10,135,95.95959595959596,10.1010101010101
29035_marine,91,34,87,5,125,95.6043956043956,5.4945054945054945
29036_marine,81,34,77,4,115,95.06172839506173,4.938271604938271
29037_marine,81,34,77,4,115,95.06172839506173,4.938271604938271
29038_marine,76,31,72,5,107,94.73684210526315,6.578947368421052
29039_marine,77,31,72,6,108,93.5064935064935,7.792207792207792
29040_marine,77,31,72,5,108,93.5064935064935,6.493506493506493
29041_marine,77,31,72,5,108,93.5064935064935,6.493506493506493
29042_marine,78,31,73,6,109,93.58974358974359,7.6923076923076925
29043_marine,75,30,70,6,105,93.33333333333333,8
29044_marine,76,30,71,7,106,93.42105263157895,9.210526315789473
29045_marine,76,30,71,7,106,93.42105263157895,9.210526315789473
29046_marine,77,30,71,7,107,92.20779220779221,9.090909090909092
29047_marine,77,30,71,6,107,92.20779220779221,7.792207792207792
29048_marine,77,30,71,6,107,92.20779220779221,7.792207792207792
29049_marine,77,30,71,6,107,92.20779220779221,7.792207792207792
29050_marine,81,31,75,6,112,92.5925925925926,7.4074074074074066
29051_marine,88,34,82,10,122,93.18181818181817,11.363636363636363
29052_marine,457,95,330,240,552,72.21006564551422,52.516411378555794
29053_marine,640,172,411,368,812,64.21875,57.49999999999999
29054_marine,651,171,422,368,822,64.82334869431644,56.528417818740394
29055_marine,478,105,348,245,583,72.80334728033473,51.25523012552301
29056_marine,626,237,468,248,863,74.76038338658148,39.61661341853035
29062_marine,749,281,515,360,1030,68.75834445927904,48.06408544726302
29063_marine,682,210,459,346,892,67.30205278592375,50.733137829912025
29064_marine,87,32,83,4,119,95.40229885057471,4.597701149425287
29065_marine,76,30,72,3,106,94.73684210526315,3.9473684210526314
29066_marine,72,30,68,3,102,94.44444444444444,4.166666666666666
29067_marine,72,29,68,3,101,94.44444444444444,4.166666666666666
29068_marine,71,29,67,2,100,94.36619718309859,2.8169014084507045
29069_marine,73,29,69,2,102,94.52054794520548,2.73972602739726
29070_marine,72,30,69,1,102,95.83333333333334,1.3888888888888888
29071_marine,72,31,69,5,103,95.83333333333334,6.944444444444445
29072_marine,502,154,316,296,656,62.94820717131474,58.964143426294825
29074_marine,533,168,339,301,701,63.60225140712945,56.47279549718574
29075_marine,490,136,306,288,626,62.44897959183674,58.77551020408164
29076_marine,101,28,97,10,129,96.03960396039604,9.900990099009901
29077_marine,726,196,477,375,922,65.70247933884298,51.652892561983464
29078_marine,890,318,602,461,1208,67.64044943820224,51.79775280898876
29082_marine,571,208,429,256,779,75.13134851138354,44.833625218914186
29083_marine,692,274,516,333,966,74.56647398843931,48.12138728323699
29084_marine,702,296,522,336,998,74.35897435897436,47.863247863247864
29088_marine,639,262,443,310,901,69.32707355242567,48.5133020344288
29089_marine,642,244,442,317,886,68.84735202492212,49.37694704049844
29090_marine,708,256,492,368,964,69.49152542372882,51.9774011299435
29091_marine,113,30,107,11,143,94.69026548672566,9.734513274336283
29092_marine,106,30,100,9,136,94.33962264150944,8.49056603773585
29093_marine,129,50,113,25,179,87.59689922480621,19.379844961240313
29094_marine,668,175,437,392,843,65.41916167664671,58.68263473053892
29095_marine,688,182,452,406,870,65.69767441860465,59.01162790697675
29096_marine,695,170,452,417,865,65.03597122302158,60
29097_marine,957,288,604,560,1245,63.11389759665622,58.516196447230925
29101_marine,1074,405,676,630,1479,62.94227188081937,58.659217877094974
29102_marine,1128,438,701,655,1566,62.14539007092199,58.06737588652482
29108_marine,1014,332,613,606,1346,60.45364891518737,59.76331360946746
29109_marine,114,31,108,15,145,94.73684210526315,13.157894736842104
29110_marine,97,29,91,10,126,93.81443298969072,10.309278350515463
29111_marine,92,29,86,10,121,93.47826086956522,10.869565217391305
29112_marine,93,28,87,11,121,93.54838709677419,11.827956989247312
29113_marine,93,28,87,11,121,93.54838709677419,11.827956989247312
29114_marine,98,29,92,10,127,93.87755102040816,10.204081632653061
29115_marine,645,186,361,449,831,55.96899224806201,69.61240310077518
29116_marine,103,31,97,14,134,94.1747572815534,13.592233009708737
29117_marine,99,31,93,13,130,93.93939393939394,13.131313131313133
29118_marine,609,159,387,385,768,63.54679802955665,63.2183908045977
29119_marine,698,229,455,438,927,65.18624641833811,62.75071633237822
29120_marine,694,228,451,436,922,64.98559077809799,62.824207492795395
29121_marine,639,220,428,399,859,66.97965571205008,62.441314553990615
29122_marine,560,154,366,352,714,65.35714285714286,62.857142857142854
29123_marine,92,31,87,9,123,94.56521739130434,9.782608695652174
29124_marine,94,31,89,11,125,94.68085106382979,11.702127659574469
29125_marine,96,31,91,11,127,94.79166666666666,11.458333333333332
29126_marine,131,88,114,28,219,87.02290076335878,21.374045801526716
29127_marine,97,31,92,12,128,94.84536082474226,12.371134020618557
29128_marine,472,108,313,296,580,66.3135593220339,62.71186440677966
29129_marine,561,126,375,337,687,66.84491978609626,60.071301247771835
29130_marine,553,128,367,336,681,66.36528028933093,60.75949367088608
29131_marine,562,131,374,339,693,66.54804270462633,60.320284697508896
29132_marine,564,126,374,341,690,66.31205673758865,60.46099290780141
29133_marine,564,126,374,341,690,66.31205673758865,60.46099290780141
29134_marine,562,125,372,341,687,66.19217081850533,60.67615658362989
29135_marine,133,88,118,26,221,88.7218045112782,19.548872180451127
29136_marine,101,33,96,12,134,95.04950495049505,11.881188118811881
29137_marine,99,33,94,10,132,94.94949494949495,10.1010101010101
29138_marine,98,33,93,9,131,94.89795918367348,9.183673469387756
29139_marine,97,34,92,9,131,94.84536082474226,9.278350515463918
29140_marine,97,36,92,9,133,94.84536082474226,9.278350515463918
29141_marine,554,139,368,341,693,66.4259927797834,61.55234657039711
29142_marine,536,123,354,331,659,66.04477611940298,61.75373134328358
29143_marine,100,37,95,9,137,95,9
29144_marine,101,37,96,9,138,95.04950495049505,8.91089108910891
29145_marine,572,160,358,362,732,62.58741258741259,63.286713286713294
29146_marine,615,188,393,387,803,63.90243902439025,62.926829268292686
29147_marine,636,192,402,404,828,63.20754716981132,63.52201257861635
29148_marine,641,192,403,409,833,62.870514820592824,63.80655226209049
29149_marine,601,168,370,387,769,61.56405990016639,64.39267886855241
29150_marine,597,182,379,375,779,63.484087102177554,62.8140703517588
29151_marine,597,182,377,376,779,63.14907872696818,62.981574539363486
29152_marine,552,157,342,350,709,61.95652173913043,63.40579710144928
29153_marine,544,155,342,342,699,62.86764705882353,62.86764705882353
29154_marine,103,40,98,10,143,95.14563106796116,9.70873786407767
29155_marine,102,40,97,9,142,95.09803921568627,8.823529411764707
29156_marine,101,40,96,8,141,95.04950495049505,7.920792079207921
29157_marine,98,40,93,8,138,94.89795918367348,8.16326530612245
29158_marine,97,40,92,8,137,94.84536082474226,8.24742268041237
29159_marine,96,41,91,7,137,94.79166666666666,7.291666666666667
29160_marine,96,40,91,7,136,94.79166666666666,7.291666666666667
29161_marine,98,41,93,8,139,94.89795918367348,8.16326530612245
29162_marine,97,41,92,7,138,94.84536082474226,7.216494845360824
29163_marine,97,41,92,7,138,94.84536082474226,7.216494845360824
29164_marine,97,41,92,7,138,94.84536082474226,7.216494845360824
29165_marine,97,40,92,7,137,94.84536082474226,7.216494845360824
29166_marine,97,41,92,7,138,94.84536082474226,7.216494845360824
29167_marine,97,41,92,7,138,94.84536082474226,7.216494845360824
29168_marine,97,41,92,7,138,94.84536082474226,7.216494845360824
29169_marine,97,41,92,7,138,94.84536082474226,7.216494845360824
29170_marine,97,40,92,7,137,94.84536082474226,7.216494845360824
29171_marine,95,40,90,7,135,94.73684210526315,7.368421052631578
29172_marine,96,40,91,7,136,94.79166666666666,7.291666666666667
29173_marine,96,40,91,7,136,94.79166666666666,7.291666666666667
29174_marine,95,40,90,7,135,94.73684210526315,7.368421052631578
29175_marine,96,41,91,7,137,94.79166666666666,7.291666666666667
29176_marine,96,42,91,7,138,94.79166666666666,7.291666666666667
29177_marine,95,42,90,7,137,94.73684210526315,7.368421052631578
29178_marine,95,42,90,7,137,94.73684210526315,7.368421052631578
29179_marine,94,42,89,9,136,94.68085106382979,9.574468085106384
29180_marine,94,42,89,9,136,94.68085106382979,9.574468085106384
29181_marine,94,43,89,9,137,94.68085106382979,9.574468085106384
29182_marine,94,43,89,9,137,94.68085106382979,9.574468085106384
29183_marine,94,43,89,9,137,94.68085106382979,9.574468085106384
29184_marine,92,43,87,7,135,94.56521739130434,7.608695652173914
29185_marine,92,42,87,7,134,94.56521739130434,7.608695652173914
29186_marine,91,42,86,7,133,94.5054945054945,7.6923076923076925
29187_marine,91,42,86,7,133,94.5054945054945,7.6923076923076925
29188_marine,90,42,85,7,132,94.44444444444444,7.777777777777778
29189_marine,87,42,82,7,129,94.25287356321839,8.045977011494253
29190_marine,87,42,82,7,129,94.25287356321839,8.045977011494253
29191_marine,87,42,82,7,129,94.25287356321839,8.045977011494253
29192_marine,87,42,82,7,129,94.25287356321839,8.045977011494253
29193_marine,87,42,82,7,129,94.25287356321839,8.045977011494253
29194_marine,86,42,81,6,128,94.18604651162791,6.976744186046512
29195_marine,87,42,82,8,129,94.25287356321839,9.195402298850574
29196_marine,86,41,82,7,127,95.34883720930233,8.13953488372093
29197_marine,85,40,81,7,125,95.29411764705881,8.235294117647058
29198_marine,84,40,80,7,124,95.23809523809523,8.333333333333332
29199_marine,84,40,80,7,124,95.23809523809523,8.333333333333332
29200_marine,83,40,79,7,123,95.18072289156626,8.433734939759036
29201_marine,83,40,79,7,123,95.18072289156626,8.433734939759036
29202_marine,84,40,80,7,124,95.23809523809523,8.333333333333332
29203_marine,82,40,78,4,122,95.1219512195122,4.878048780487805
29204_marine,82,39,78,4,121,95.1219512195122,4.878048780487805
29205_marine,82,39,78,4,121,95.1219512195122,4.878048780487805
29206_marine,82,39,78,4,121,95.1219512195122,4.878048780487805
29207_marine,81,39,77,3,120,95.06172839506173,3.7037037037037033
29208_marine,81,39,77,3,120,95.06172839506173,3.7037037037037033
29209_marine,82,39,78,3,121,95.1219512195122,3.6585365853658534
29210_marine,82,41,78,3,123,95.1219512195122,3.6585365853658534
29211_marine,82,41,78,3,123,95.1219512195122,3.6585365853658534
29212_marine,82,43,78,3,125,95.1219512195122,3.6585365853658534
29213_marine,82,43,78,3,125,95.1219512195122,3.6585365853658534
29214_marine,82,42,78,3,124,95.1219512195122,3.6585365853658534
29215_marine,82,42,78,3,124,95.1219512195122,3.6585365853658534
29216_marine,81,42,77,3,123,95.06172839506173,3.7037037037037033
29217_marine,81,42,77,3,123,95.06172839506173,3.7037037037037033
29218_marine,82,42,78,3,124,95.1219512195122,3.6585365853658534
29219_marine,82,42,78,3,124,95.1219512195122,3.6585365853658534
29220_marine,82,43,78,3,125,95.1219512195122,3.6585365853658534
29221_marine,82,43,78,3,125,95.1219512195122,3.6585365853658534
29222_marine,83,44,79,3,127,95.18072289156626,3.614457831325301
29223_marine,83,43,79,3,126,95.18072289156626,3.614457831325301
29224_marine,83,43,79,3,126,95.18072289156626,3.614457831325301
29225_marine,83,42,79,4,125,95.18072289156626,4.819277108433735
29226_marine,82,42,78,4,124,95.1219512195122,4.878048780487805
29227_marine,82,42,78,4,124,95.1219512195122,4.878048780487805
29228_marine,84,43,80,4,127,95.23809523809523,4.761904761904762
29229_marine,86,44,82,6,130,95.34883720930233,6.976744186046512
29230_marine,86,44,82,6,130,95.34883720930233,6.976744186046512
29231_marine,87,43,83,6,130,95.40229885057471,6.896551724137931
29232_marine,87,44,83,6,131,95.40229885057471,6.896551724137931
29233_marine,87,44,83,6,131,95.40229885057471,6.896551724137931
29234_marine,85,44,80,4,129,94.11764705882352,4.705882352941177
29235_marine,85,45,80,4,130,94.11764705882352,4.705882352941177
29236_marine,87,45,82,4,132,94.25287356321839,4.597701149425287
29237_marine,87,45,81,5,132,93.10344827586206,5.747126436781609
29238_marine,87,46,81,5,133,93.10344827586206,5.747126436781609
29239_marine,88,45,82,5,133,93.18181818181817,5.681818181818182
29240_marine,88,45,82,5,133,93.18181818181817,5.681818181818182
29241_marine,88,45,82,5,133,93.18181818181817,5.681818181818182
29242_marine,88,44,82,5,132,93.18181818181817,5.681818181818182
29243_marine,88,44,82,5,132,93.18181818181817,5.681818181818182
29244_marine,88,43,82,5,131,93.18181818181817,5.681818181818182
29245_marine,88,42,82,5,130,93.18181818181817,5.681818181818182
29246_marine,89,41,83,6,130,93.25842696629213,6.741573033707865
29247_marine,89,40,83,6,129,93.25842696629213,6.741573033707865
29248_marine,92,40,85,7,132,92.3913043478261,7.608695652173914
29249_marine,91,39,84,7,130,92.3076923076923,7.6923076923076925
29250_marine,92,39,85,8,131,92.3913043478261,8.695652173913043
29251_marine,92,39,85,8,131,92.3913043478261,8.695652173913043
29252_marine,93,40,86,8,133,92.47311827956989,8.60215053763441
29253_marine,99,43,92,11,142,92.92929292929293,11.11111111111111
29254_marine,101,53,94,11,154,93.06930693069307,10.891089108910892
29255_marine,298,255,239,76,553,80.20134228187919,25.503355704697988
29256_marine,309,280,247,79,589,79.93527508090615,25.5663430420712
29282_marine,305,203,250,77,508,81.9672131147541,25.245901639344265
29283_marine,299,191,247,70,490,82.6086956521739,23.411371237458194
29284_marine,110,63,101,10,173,91.81818181818183,9.090909090909092
29285_marine,102,44,93,8,146,91.17647058823529,7.8431372549019605
29286_marine,104,60,95,8,164,91.34615384615384,7.6923076923076925
29287_marine,99,53,91,7,152,91.91919191919192,7.07070707070707
29288_marine,97,48,89,7,145,91.75257731958763,7.216494845360824
29289_marine,93,36,87,6,129,93.54838709677419,6.451612903225806
29290_marine,91,35,85,6,126,93.4065934065934,6.593406593406594
29291_marine,86,35,80,6,121,93.02325581395348,6.976744186046512
29292_marine,85,35,80,4,120,94.11764705882352,4.705882352941177
29293_marine,84,35,79,4,119,94.04761904761905,4.761904761904762
29294_marine,85,35,79,4,120,92.94117647058823,4.705882352941177
29295_marine,85,35,79,4,120,92.94117647058823,4.705882352941177
29296_marine,86,35,80,4,121,93.02325581395348,4.651162790697675
29297_marine,86,34,80,4,120,93.02325581395348,4.651162790697675
29298_marine,86,34,80,4,120,93.02325581395348,4.651162790697675
29299_marine,85,34,79,3,119,92.94117647058823,3.5294117647058822
29300_marine,86,34,80,4,120,93.02325581395348,4.651162790697675
29301_marine,84,34,80,2,118,95.23809523809523,2.380952380952381
29302_marine,84,33,80,2,117,95.23809523809523,2.380952380952381
29303_marine,84,33,80,2,117,95.23809523809523,2.380952380952381
29304_marine,85,35,81,2,120,95.29411764705881,2.3529411764705883
29305_marine,86,35,82,2,121,95.34883720930233,2.3255813953488373
29306_marine,86,35,82,2,121,95.34883720930233,2.3255813953488373
29307_marine,88,35,84,2,123,95.45454545454545,2.272727272727273
29308_marine,88,35,84,2,123,95.45454545454545,2.272727272727273
29309_marine,88,35,84,2,123,95.45454545454545,2.272727272727273
29310_marine,91,35,87,3,126,95.6043956043956,3.296703296703297
29311_marine,92,35,87,3,127,94.56521739130434,3.260869565217391
29312_marine,92,35,87,3,127,94.56521739130434,3.260869565217391
29313_marine,92,35,87,3,127,94.56521739130434,3.260869565217391
29314_marine,90,34,85,3,124,94.44444444444444,3.3333333333333335
29315_marine,92,33,87,3,125,94.56521739130434,3.260869565217391
29316_marine,92,33,87,3,125,94.56521739130434,3.260869565217391
29317_marine,92,33,87,3,125,94.56521739130434,3.260869565217391
29318_marine,94,31,89,3,125,94.68085106382979,3.1914893617021276
29319_marine,96,31,90,6,127,93.75,6.25
29320_marine,96,33,90,6,129,93.75,6.25
29321_marine,97,33,91,5,130,93.81443298969072,5.154639175257731
29322_marine,103,35,97,5,138,94.1747572815534,4.854368932038835
29323_marine,113,49,107,7,162,94.69026548672566,6.1946902654867255
29324_marine,116,55,109,9,171,93.96551724137932,7.758620689655173
29325_marine,115,57,109,8,172,94.78260869565217,6.956521739130435
29326_marine,299,136,272,40,435,90.96989966555184,13.377926421404682
29390_marine,657,264,462,336,921,70.31963470319634,51.141552511415526
29391_marine,673,275,473,345,948,70.28231797919761,51.2630014858841
29392_marine,539,173,383,280,712,71.05751391465677,51.94805194805194
29393_marine,100,37,96,9,137,96,9
29394_marine,95,34,90,6,129,94.73684210526315,6.315789473684211
29395_marine,92,32,87,5,124,94.56521739130434,5.434782608695652
29396_marine,83,32,78,5,115,93.97590361445783,6.024096385542169
29397_marine,80,31,75,6,111,93.75,7.5
29398_marine,78,31,73,6,109,93.58974358974359,7.6923076923076925
29399_marine,78,31,73,6,109,93.58974358974359,7.6923076923076925
29400_marine,78,31,73,6,109,93.58974358974359,7.6923076923076925
29401_marine,78,30,73,7,108,93.58974358974359,8.974358974358974
29402_marine,78,30,73,7,108,93.58974358974359,8.974358974358974
29403_marine,78,30,73,7,108,93.58974358974359,8.974358974358974
29404_marine,79,30,74,8,109,93.67088607594937,10.126582278481013
29405_marine,77,31,72,8,108,93.5064935064935,10.38961038961039
29406_marine,78,31,73,8,109,93.58974358974359,10.256410256410255
29407_marine,79,31,73,7,110,92.40506329113924,8.860759493670885
29408_marine,79,31,73,7,110,92.40506329113924,8.860759493670885
29409_marine,79,31,73,7,110,92.40506329113924,8.860759493670885
29410_marine,83,31,77,7,114,92.7710843373494,8.433734939759036
29411_marine,90,35,84,11,125,93.33333333333333,12.222222222222221
29412_marine,99,36,93,14,135,93.93939393939394,14.14141414141414
29413_marine,619,158,396,356,777,63.97415185783522,57.51211631663974
29414_marine,682,175,445,391,857,65.24926686217009,57.33137829912024
29415_marine,123,37,114,16,160,92.6829268292683,13.008130081300814
29416_marine,595,218,437,246,813,73.44537815126051,41.344537815126046
29423_marine,712,237,475,361,949,66.71348314606742,50.70224719101124
29424_marine,105,32,101,10,137,96.19047619047619,9.523809523809524
29425_marine,78,30,74,3,108,94.87179487179486,3.8461538461538463
29426_marine,74,30,70,3,104,94.5945945945946,4.054054054054054
29427_marine,73,30,69,3,103,94.52054794520548,4.10958904109589
29428_marine,72,29,68,2,101,94.44444444444444,2.7777777777777777
29429_marine,72,28,68,2,100,94.44444444444444,2.7777777777777777
29430_marine,73,28,69,2,101,94.52054794520548,2.73972602739726
29431_marine,74,31,70,5,105,94.5945945945946,6.756756756756757
29432_marine,476,139,294,286,615,61.76470588235294,60.08403361344538
29433_marine,579,199,378,334,778,65.28497409326425,57.68566493955095
29435_marine,519,148,324,298,667,62.42774566473989,57.41811175337187
29436_marine,105,35,100,11,140,95.23809523809523,10.476190476190476
29437_marine,725,193,475,376,918,65.51724137931035,51.86206896551724
29438_marine,893,322,604,456,1215,67.63717805151175,51.06382978723404
29442_marine,573,216,425,262,789,74.17102966841188,45.724258289703315
29443_marine,558,208,405,263,766,72.58064516129032,47.132616487455195
29444_marine,583,240,415,272,823,71.18353344768438,46.65523156089194
29448_marine,597,238,414,290,835,69.34673366834171,48.57621440536013
29449_marine,557,200,385,283,757,69.12028725314184,50.80789946140036
29450_marine,520,184,359,268,704,69.03846153846153,51.53846153846153
29451_marine,127,55,113,21,182,88.9763779527559,16.535433070866144
29452_marine,137,50,123,22,187,89.78102189781022,16.05839416058394
29453_marine,135,50,121,25,185,89.62962962962962,18.51851851851852
29454_marine,662,163,439,386,825,66.31419939577039,58.30815709969789
29455_marine,671,164,446,393,835,66.46795827123697,58.56929955290611
29456_marine,139,51,125,31,190,89.92805755395683,22.302158273381295
29460_marine,988,332,614,582,1320,62.145748987854255,58.906882591093115
29461_marine,983,349,608,577,1332,61.85147507629705,58.697863682604265
29462_marine,1010,372,612,599,1382,60.59405940594059,59.306930693069305
29468_marine,1010,334,613,603,1344,60.69306930693069,59.7029702970297
29469_marine,123,31,117,18,154,95.1219512195122,14.634146341463413
29470_marine,99,29,93,12,128,93.93939393939394,12.121212121212121
29471_marine,95,29,89,12,124,93.6842105263158,12.631578947368421
29472_marine,94,28,88,12,122,93.61702127659575,12.76595744680851
29473_marine,95,29,89,11,124,93.6842105263158,11.578947368421053
29474_marine,789,233,449,525,1022,56.907477820025356,66.53992395437263
29475_marine,904,322,540,592,1226,59.73451327433629,65.48672566371681
29476_marine,798,239,458,528,1037,57.393483709273184,66.16541353383458
29477_marine,102,31,96,14,133,94.11764705882352,13.725490196078432
29478_marine,649,215,415,402,864,63.944530046224955,61.94144838212635
29479_marine,607,158,385,385,765,63.426688632619445,63.426688632619445
29480_marine,567,148,373,355,715,65.78483245149911,62.61022927689594
29481_marine,606,210,400,373,816,66.006600660066,61.55115511551155
29482_marine,562,150,368,353,712,65.48042704626334,62.811387900355875
29483_marine,94,31,89,10,125,94.68085106382979,10.638297872340425
29484_marine,597,134,391,366,731,65.49413735343383,61.30653266331658
29485_marine,644,193,426,385,837,66.14906832298136,59.78260869565217
29486_marine,127,38,111,29,165,87.4015748031496,22.83464566929134
29487_marine,611,185,407,366,796,66.61211129296237,59.901800327332246
29488_marine,647,200,441,388,847,68.16074188562597,59.969088098918085
29489_marine,585,130,393,349,715,67.17948717948717,59.65811965811966
29490_marine,634,197,430,381,831,67.82334384858044,60.094637223974765
29491_marine,649,200,433,394,849,66.71802773497689,60.708782742681045
29492_marine,668,200,444,401,868,66.46706586826348,60.02994011976048
29493_marine,668,202,444,401,870,66.46706586826348,60.02994011976048
29494_marine,595,181,395,354,776,66.38655462184873,59.49579831932773
29495_marine,156,97,132,42,253,84.61538461538461,26.923076923076923
29496_marine,100,34,95,11,134,95,11
29497_marine,100,34,95,11,134,95,11
29498_marine,496,124,317,314,620,63.91129032258065,63.306451612903224
29499_marine,100,34,95,11,134,95,11
29500_marine,100,33,95,11,133,95,11
29501_marine,530,117,348,332,647,65.66037735849056,62.64150943396226
29502_marine,531,118,349,332,649,65.72504708097928,62.52354048964218
29503_marine,100,35,95,11,135,95,11
29504_marine,101,37,96,9,138,95.04950495049505,8.91089108910891
29505_marine,573,160,359,364,733,62.652705061082024,63.525305410122165
29506_marine,615,190,393,387,805,63.90243902439025,62.926829268292686
29507_marine,645,194,409,407,839,63.410852713178286,63.100775193798455
29508_marine,651,194,411,413,845,63.133640552995395,63.44086021505376
29509_marine,650,196,410,412,846,63.07692307692307,63.38461538461539
29510_marine,600,166,374,380,766,62.33333333333333,63.33333333333333
29511_marine,631,194,405,388,825,64.18383518225039,61.489698890649755
29512_marine,650,192,420,397,842,64.61538461538461,61.07692307692307
29513_marine,607,167,387,372,774,63.75617792421746,61.28500823723228
29514_marine,103,41,98,10,144,95.14563106796116,9.70873786407767
29515_marine,102,40,97,9,142,95.09803921568627,8.823529411764707
29516_marine,100,40,95,9,140,95,9
29517_marine,99,40,94,8,139,94.94949494949495,8.080808080808081
29518_marine,98,41,93,8,139,94.89795918367348,8.16326530612245
29519_marine,98,41,93,8,139,94.89795918367348,8.16326530612245
29520_marine,98,41,93,8,139,94.89795918367348,8.16326530612245
29521_marine,98,41,93,8,139,94.89795918367348,8.16326530612245
29522_marine,98,41,93,8,139,94.89795918367348,8.16326530612245
29523_marine,98,41,93,8,139,94.89795918367348,8.16326530612245
29524_marine,98,41,93,8,139,94.89795918367348,8.16326530612245
29525_marine,97,41,92,7,138,94.84536082474226,7.216494845360824
29526_marine,97,41,92,7,138,94.84536082474226,7.216494845360824
29527_marine,97,40,92,7,137,94.84536082474226,7.216494845360824
29528_marine,97,41,92,7,138,94.84536082474226,7.216494845360824
29529_marine,97,41,92,7,138,94.84536082474226,7.216494845360824
29530_marine,95,41,90,7,136,94.73684210526315,7.368421052631578
29531_marine,97,41,92,7,138,94.84536082474226,7.216494845360824
29532_marine,97,41,92,7,138,94.84536082474226,7.216494845360824
29533_marine,97,40,92,7,137,94.84536082474226,7.216494845360824
29534_marine,97,40,92,7,137,94.84536082474226,7.216494845360824
29535_marine,100,41,94,9,141,94,9
29536_marine,101,42,95,9,143,94.05940594059405,8.91089108910891
29537_marine,417,103,289,249,520,69.30455635491607,59.71223021582733
29538_marine,418,103,290,249,521,69.377990430622,59.569377990430624
29539_marine,416,101,290,247,517,69.71153846153845,59.375
29540_marine,97,42,91,7,139,93.81443298969072,7.216494845360824
29541_marine,96,42,90,9,138,93.75,9.375
29542_marine,96,43,90,9,139,93.75,9.375
29543_marine,96,43,90,9,139,93.75,9.375
29544_marine,93,43,87,7,136,93.54838709677419,7.526881720430108
29545_marine,93,43,87,7,136,93.54838709677419,7.526881720430108
29546_marine,93,42,87,7,135,93.54838709677419,7.526881720430108
29547_marine,91,42,85,7,133,93.4065934065934,7.6923076923076925
29548_marine,90,42,84,7,132,93.33333333333333,7.777777777777778
29549_marine,89,42,84,7,131,94.3820224719101,7.865168539325842
29550_marine,89,42,84,7,131,94.3820224719101,7.865168539325842
29551_marine,89,42,84,7,131,94.3820224719101,7.865168539325842
29552_marine,89,42,84,7,131,94.3820224719101,7.865168539325842
29553_marine,89,42,84,7,131,94.3820224719101,7.865168539325842
29554_marine,88,42,83,6,130,94.31818181818183,6.8181818181818175
29555_marine,87,42,82,6,129,94.25287356321839,6.896551724137931
29556_marine,86,42,81,8,128,94.18604651162791,9.30232558139535
29557_marine,85,41,81,7,126,95.29411764705881,8.235294117647058
29558_marine,83,40,79,7,123,95.18072289156626,8.433734939759036
29559_marine,82,40,78,7,122,95.1219512195122,8.536585365853659
29560_marine,82,40,78,7,122,95.1219512195122,8.536585365853659
29561_marine,84,40,80,7,124,95.23809523809523,8.333333333333332
29562_marine,84,40,80,7,124,95.23809523809523,8.333333333333332
29563_marine,84,40,80,6,124,95.23809523809523,7.142857142857142
29564_marine,82,40,78,4,122,95.1219512195122,4.878048780487805
29565_marine,82,39,78,4,121,95.1219512195122,4.878048780487805
29566_marine,82,39,78,4,121,95.1219512195122,4.878048780487805
29567_marine,82,39,78,4,121,95.1219512195122,4.878048780487805
29568_marine,81,39,77,3,120,95.06172839506173,3.7037037037037033
29569_marine,82,39,78,3,121,95.1219512195122,3.6585365853658534
29570_marine,82,39,78,3,121,95.1219512195122,3.6585365853658534
29571_marine,82,41,78,3,123,95.1219512195122,3.6585365853658534
29572_marine,82,43,78,3,125,95.1219512195122,3.6585365853658534
29573_marine,82,42,78,3,124,95.1219512195122,3.6585365853658534
29574_marine,82,42,78,3,124,95.1219512195122,3.6585365853658534
29575_marine,82,42,78,3,124,95.1219512195122,3.6585365853658534
29576_marine,82,42,78,3,124,95.1219512195122,3.6585365853658534
29577_marine,82,42,78,3,124,95.1219512195122,3.6585365853658534
29578_marine,82,42,78,3,124,95.1219512195122,3.6585365853658534
29579_marine,82,42,78,3,124,95.1219512195122,3.6585365853658534
29580_marine,82,43,78,3,125,95.1219512195122,3.6585365853658534
29581_marine,83,43,79,3,126,95.18072289156626,3.614457831325301
29582_marine,83,44,79,3,127,95.18072289156626,3.614457831325301
29583_marine,83,43,79,3,126,95.18072289156626,3.614457831325301
29584_marine,83,43,79,3,126,95.18072289156626,3.614457831325301
29585_marine,82,43,78,3,125,95.1219512195122,3.6585365853658534
29586_marine,82,43,78,4,125,95.1219512195122,4.878048780487805
29587_marine,82,42,78,4,124,95.1219512195122,4.878048780487805
29588_marine,82,43,78,4,125,95.1219512195122,4.878048780487805
29589_marine,84,43,80,4,127,95.23809523809523,4.761904761904762
29590_marine,86,43,82,6,129,95.34883720930233,6.976744186046512
29591_marine,86,44,82,6,130,95.34883720930233,6.976744186046512
29592_marine,86,44,82,6,130,95.34883720930233,6.976744186046512
29593_marine,86,44,82,4,130,95.34883720930233,4.651162790697675
29594_marine,85,45,81,4,130,95.29411764705881,4.705882352941177
29595_marine,86,45,81,4,131,94.18604651162791,4.651162790697675
29596_marine,88,45,83,4,133,94.31818181818183,4.545454545454546
29597_marine,88,46,83,4,134,94.31818181818183,4.545454545454546
29598_marine,88,47,83,4,135,94.31818181818183,4.545454545454546
29599_marine,87,46,82,4,133,94.25287356321839,4.597701149425287
29600_marine,88,46,82,5,134,93.18181818181817,5.681818181818182
29601_marine,88,46,82,5,134,93.18181818181817,5.681818181818182
29602_marine,88,46,82,5,134,93.18181818181817,5.681818181818182
29603_marine,88,45,82,5,133,93.18181818181817,5.681818181818182
29604_marine,88,44,82,5,132,93.18181818181817,5.681818181818182
29605_marine,88,44,82,5,132,93.18181818181817,5.681818181818182
29606_marine,89,42,83,6,131,93.25842696629213,6.741573033707865
29607_marine,89,42,83,6,131,93.25842696629213,6.741573033707865
29608_marine,89,42,83,6,131,93.25842696629213,6.741573033707865
29609_marine,90,41,83,8,131,92.22222222222223,8.88888888888889
29610_marine,90,41,83,8,131,92.22222222222223,8.88888888888889
29611_marine,90,41,83,8,131,92.22222222222223,8.88888888888889
29612_marine,94,41,87,8,135,92.5531914893617,8.51063829787234
29613_marine,95,41,88,8,136,92.63157894736842,8.421052631578947
29614_marine,99,44,92,10,143,92.92929292929293,10.1010101010101
29615_marine,103,46,95,12,149,92.23300970873787,11.650485436893204
29616_marine,298,250,239,76,548,80.20134228187919,25.503355704697988
29617_marine,306,263,242,80,569,79.08496732026144,26.143790849673206
29618_marine,353,332,275,106,685,77.90368271954674,30.02832861189802
29624_marine,489,402,291,261,891,59.50920245398773,53.37423312883436
29643_marine,294,203,242,74,497,82.31292517006803,25.170068027210885
29644_marine,289,205,239,69,494,82.69896193771626,23.875432525951556
29645_marine,291,193,242,69,484,83.16151202749141,23.711340206185564
29646_marine,285,198,236,69,483,82.80701754385966,24.210526315789473
29647_marine,288,192,239,69,480,82.98611111111111,23.958333333333336
29648_marine,262,154,217,61,416,82.82442748091603,23.282442748091604
29649_marine,100,41,92,7,141,92,7.000000000000001
29650_marine,94,36,88,7,130,93.61702127659575,7.446808510638298
29651_marine,88,37,82,6,125,93.18181818181817,6.8181818181818175
29652_marine,86,35,81,4,121,94.18604651162791,4.651162790697675
29653_marine,84,35,79,4,119,94.04761904761905,4.761904761904762
29654_marine,84,35,79,4,119,94.04761904761905,4.761904761904762
29655_marine,87,35,81,4,122,93.10344827586206,4.597701149425287
29656_marine,86,35,80,4,121,93.02325581395348,4.651162790697675
29657_marine,86,35,80,4,121,93.02325581395348,4.651162790697675
29658_marine,86,34,80,4,120,93.02325581395348,4.651162790697675
29659_marine,87,34,81,5,121,93.10344827586206,5.747126436781609
29660_marine,87,34,81,5,121,93.10344827586206,5.747126436781609
29661_marine,86,34,80,4,120,93.02325581395348,4.651162790697675
29662_marine,86,34,80,4,120,93.02325581395348,4.651162790697675
29663_marine,84,34,80,2,118,95.23809523809523,2.380952380952381
29664_marine,84,35,80,2,119,95.23809523809523,2.380952380952381
29665_marine,86,35,82,2,121,95.34883720930233,2.3255813953488373
29666_marine,87,35,83,2,122,95.40229885057471,2.2988505747126435
29667_marine,88,35,84,2,123,95.45454545454545,2.272727272727273
29668_marine,88,35,84,2,123,95.45454545454545,2.272727272727273
29669_marine,90,35,86,2,125,95.55555555555556,2.2222222222222223
29670_marine,90,35,86,2,125,95.55555555555556,2.2222222222222223
29671_marine,91,35,86,2,126,94.5054945054945,2.197802197802198
29672_marine,91,35,86,2,126,94.5054945054945,2.197802197802198
29673_marine,92,35,87,3,127,94.56521739130434,3.260869565217391
29674_marine,90,35,85,3,125,94.44444444444444,3.3333333333333335
29675_marine,90,35,85,3,125,94.44444444444444,3.3333333333333335
29676_marine,92,34,87,3,126,94.56521739130434,3.260869565217391
29677_marine,91,33,86,3,124,94.5054945054945,3.296703296703297
29678_marine,92,33,87,2,125,94.56521739130434,2.1739130434782608
29679_marine,93,31,87,3,124,93.54838709677419,3.225806451612903
29680_marine,95,31,89,5,126,93.6842105263158,5.263157894736842
29681_marine,95,33,89,5,128,93.6842105263158,5.263157894736842
29682_marine,97,33,91,5,130,93.81443298969072,5.154639175257731
29683_marine,103,35,97,5,138,94.1747572815534,4.854368932038835
29684_marine,109,35,103,7,144,94.4954128440367,6.422018348623854
29685_marine,117,43,110,9,160,94.01709401709401,7.6923076923076925
29686_marine,282,130,257,35,412,91.13475177304964,12.411347517730496
29687_marine,419,189,360,87,608,85.91885441527445,20.763723150357997
29750_marine,663,273,465,339,936,70.13574660633483,51.13122171945701
29751_marine,549,186,393,283,735,71.58469945355192,51.54826958105647
29752_marine,526,169,371,276,695,70.53231939163499,52.47148288973384
29753_marine,97,35,92,9,132,94.84536082474226,9.278350515463918
29754_marine,94,32,89,7,126,94.68085106382979,7.446808510638298
29755_marine,85,32,80,5,117,94.11764705882352,5.88235294117647
29756_marine,81,32,76,5,113,93.82716049382715,6.172839506172839
29757_marine,78,31,73,6,109,93.58974358974359,7.6923076923076925
29758_marine,78,30,73,6,108,93.58974358974359,7.6923076923076925
29759_marine,79,30,74,7,109,93.67088607594937,8.860759493670885
29760_marine,79,30,74,7,109,93.67088607594937,8.860759493670885
29761_marine,78,30,73,7,108,93.58974358974359,8.974358974358974
29762_marine,78,30,73,7,108,93.58974358974359,8.974358974358974
29763_marine,78,31,73,7,109,93.58974358974359,8.974358974358974
29764_marine,79,31,74,8,110,93.67088607594937,10.126582278481013
29765_marine,79,31,74,8,110,93.67088607594937,10.126582278481013
29766_marine,79,31,74,8,110,93.67088607594937,10.126582278481013
29767_marine,79,31,74,7,110,93.67088607594937,8.860759493670885
29768_marine,77,31,72,7,108,93.5064935064935,9.090909090909092
29769_marine,78,31,73,7,109,93.58974358974359,8.974358974358974
29770_marine,83,31,77,7,114,92.7710843373494,8.433734939759036
29771_marine,88,35,82,11,123,93.18181818181817,12.5
29772_marine,606,152,380,359,758,62.70627062706271,59.240924092409244
29773_marine,687,173,444,406,860,64.62882096069869,59.09752547307132
29774_marine,657,170,424,376,827,64.53576864535768,57.22983257229832
29775_marine,633,152,406,362,785,64.13902053712481,57.187993680884674
29776_marine,119,45,112,13,164,94.11764705882352,10.92436974789916
29777_marine,624,251,454,261,875,72.75641025641025,41.82692307692308
29778_marine,654,270,471,277,924,72.01834862385321,42.354740061162076
29779_marine,775,324,529,368,1099,68.25806451612904,47.483870967741936
29783_marine,755,279,511,372,1034,67.68211920529801,49.271523178807946
29784_marine,111,32,107,11,143,96.3963963963964,9.90990990990991
29785_marine,86,30,82,4,116,95.34883720930233,4.651162790697675
29786_marine,74,30,70,4,104,94.5945945945946,5.405405405405405
29787_marine,74,29,70,4,103,94.5945945945946,5.405405405405405
29788_marine,72,29,68,2,101,94.44444444444444,2.7777777777777777
29789_marine,72,29,68,2,101,94.44444444444444,2.7777777777777777
29790_marine,72,28,68,2,100,94.44444444444444,2.7777777777777777
29791_marine,73,29,69,4,102,94.52054794520548,5.47945205479452
29792_marine,82,31,76,12,113,92.6829268292683,14.634146341463413
29793_marine,514,151,317,301,665,61.673151750972764,58.5603112840467
29795_marine,533,157,333,305,690,62.476547842401494,57.223264540337716
29796_marine,111,33,105,14,144,94.5945945945946,12.612612612612612
29797_marine,725,192,474,378,917,65.37931034482759,52.137931034482754
29798_marine,776,267,511,391,1043,65.85051546391753,50.38659793814433
29802_marine,613,260,453,276,873,73.89885807504079,45.02446982055465
29803_marine,620,262,444,285,882,71.61290322580646,45.96774193548387
29804_marine,592,217,424,281,809,71.62162162162163,47.46621621621622
29805_marine,611,237,436,289,848,71.35842880523732,47.299509001636665
29806_marine,603,237,424,291,840,70.3150912106136,48.258706467661696
29807_marine,578,202,393,299,780,67.99307958477509,51.73010380622838
29808_marine,570,187,386,300,757,67.71929824561404,52.63157894736842
29809_marine,545,179,368,287,724,67.52293577981652,52.66055045871559
29810_marine,507,163,333,276,670,65.68047337278107,54.437869822485204
29811_marine,127,49,113,22,176,88.9763779527559,17.322834645669293
29812_marine,130,51,116,22,181,89.23076923076924,16.923076923076923
29813_marine,133,45,119,25,178,89.47368421052632,18.796992481203006
29814_marine,179,51,165,34,230,92.17877094972067,18.994413407821227
29815_marine,179,52,165,35,231,92.17877094972067,19.553072625698324
29816_marine,823,264,538,458,1087,65.37059538274606,55.650060753341435
29819_marine,1071,374,683,612,1445,63.77217553688141,57.14285714285714
29820_marine,972,326,595,578,1298,61.21399176954733,59.465020576131685
29821_marine,960,338,586,576,1298,61.04166666666667,60
29828_marine,1009,347,612,603,1356,60.654112983151634,59.762140733399406
29829_marine,121,30,115,18,151,95.0413223140496,14.87603305785124
29830_marine,109,29,103,14,138,94.4954128440367,12.844036697247708
29831_marine,101,29,95,14,130,94.05940594059405,13.861386138613863
29832_marine,95,29,89,11,124,93.6842105263158,11.578947368421053
29833_marine,95,31,89,11,126,93.6842105263158,11.578947368421053
29834_marine,794,242,454,525,1036,57.17884130982368,66.12090680100756
29835_marine,913,338,545,599,1251,59.69331872946331,65.6078860898138
29836_marine,797,239,457,527,1036,57.340025094102884,66.12296110414053
29837_marine,102,31,96,14,133,94.11764705882352,13.725490196078432
29838_marine,99,31,93,13,130,93.93939393939394,13.131313131313133
29839_marine,96,31,91,10,127,94.79166666666666,10.416666666666668
29840_marine,96,31,91,10,127,94.79166666666666,10.416666666666668
29841_marine,94,31,89,10,125,94.68085106382979,10.638297872340425
29842_marine,98,31,91,12,129,92.85714285714286,12.244897959183673
29843_marine,599,133,393,365,732,65.6093489148581,60.934891485809686
29844_marine,682,206,459,415,888,67.30205278592375,60.85043988269795
29845_marine,644,197,426,386,841,66.14906832298136,59.93788819875776
29846_marine,160,97,132,47,257,82.5,29.375
29847_marine,617,190,413,367,807,66.93679092382496,59.48136142625607
29848_marine,650,200,444,390,850,68.3076923076923,60
29849_marine,589,129,395,351,718,67.06281833616299,59.59252971137521
29850_marine,611,186,406,361,797,66.44844517184943,59.08346972176759
29851_marine,587,130,379,358,717,64.5655877342419,60.98807495741057
29852_marine,672,209,449,404,881,66.81547619047619,60.11904761904761
29853_marine,670,203,447,402,873,66.71641791044776,60
29854_marine,100,35,95,11,135,95,11
29855_marine,100,33,95,11,133,95,11
29856_marine,152,94,128,41,246,84.21052631578947,26.973684210526315
29857_marine,603,147,393,364,750,65.17412935323384,60.3648424543947
29858_marine,679,222,447,409,901,65.8321060382916,60.23564064801178
29859_marine,680,228,447,410,908,65.73529411764706,60.29411764705882
29860_marine,608,149,394,369,757,64.80263157894737,60.69078947368421
29861_marine,565,136,373,340,701,66.01769911504425,60.17699115044248
29862_marine,562,126,370,340,688,65.83629893238434,60.4982206405694
29863_marine,101,35,96,11,136,95.04950495049505,10.891089108910892
29864_marine,101,36,96,11,137,95.04950495049505,10.891089108910892
29865_marine,103,37,98,11,140,95.14563106796116,10.679611650485436
29866_marine,104,38,99,11,142,95.1923076923077,10.576923076923077
29867_marine,602,167,376,384,769,62.45847176079734,63.78737541528239
29868_marine,610,170,378,390,780,61.967213114754095,63.934426229508205
29869_marine,651,192,413,410,843,63.44086021505376,62.98003072196621
29870_marine,608,168,384,381,776,63.1578947368421,62.664473684210535
29871_marine,615,169,393,378,784,63.90243902439025,61.46341463414634
29872_marine,652,192,424,396,844,65.03067484662577,60.73619631901841
29873_marine,609,169,389,372,778,63.8752052545156,61.083743842364534
29874_marine,103,41,98,10,144,95.14563106796116,9.70873786407767
29875_marine,103,40,98,10,143,95.14563106796116,9.70873786407767
29876_marine,100,40,95,9,140,95,9
29877_marine,99,40,94,8,139,94.94949494949495,8.080808080808081
29878_marine,98,41,93,8,139,94.89795918367348,8.16326530612245
29879_marine,98,41,93,8,139,94.89795918367348,8.16326530612245
29880_marine,98,41,93,8,139,94.89795918367348,8.16326530612245
29881_marine,98,41,93,8,139,94.89795918367348,8.16326530612245
29882_marine,98,41,93,8,139,94.89795918367348,8.16326530612245
29883_marine,98,41,93,8,139,94.89795918367348,8.16326530612245
29884_marine,98,41,93,8,139,94.89795918367348,8.16326530612245
29885_marine,98,41,93,8,139,94.89795918367348,8.16326530612245
29886_marine,98,41,93,8,139,94.89795918367348,8.16326530612245
29887_marine,98,41,93,8,139,94.89795918367348,8.16326530612245
29888_marine,99,40,93,8,139,93.93939393939394,8.080808080808081
29889_marine,97,40,91,8,137,93.81443298969072,8.24742268041237
29890_marine,98,41,92,7,139,93.87755102040816,7.142857142857142
29891_marine,98,41,92,7,139,93.87755102040816,7.142857142857142
29892_marine,98,41,92,7,139,93.87755102040816,7.142857142857142
29893_marine,100,41,94,9,141,94,9
29894_marine,100,41,94,9,141,94,9
29895_marine,100,40,94,9,140,94,9
29896_marine,102,42,96,9,144,94.11764705882352,8.823529411764707
29897_marine,420,104,294,249,524,70,59.285714285714285
29898_marine,423,107,297,247,530,70.2127659574468,58.392434988179666
29899_marine,416,104,290,247,520,69.71153846153845,59.375
29900_marine,99,42,93,7,141,93.93939393939394,7.07070707070707
29901_marine,97,42,91,7,139,93.81443298969072,7.216494845360824
29902_marine,96,43,90,7,139,93.75,7.291666666666667
29903_marine,93,43,87,7,136,93.54838709677419,7.526881720430108
29904_marine,93,43,87,7,136,93.54838709677419,7.526881720430108
29905_marine,93,43,87,7,136,93.54838709677419,7.526881720430108
29906_marine,93,43,87,7,136,93.54838709677419,7.526881720430108
29907_marine,92,42,86,7,134,93.47826086956522,7.608695652173914
29908_marine,91,42,85,7,133,93.4065934065934,7.6923076923076925
29909_marine,91,42,85,7,133,93.4065934065934,7.6923076923076925
29910_marine,89,42,83,7,131,93.25842696629213,7.865168539325842
29911_marine,89,42,83,7,131,93.25842696629213,7.865168539325842
29912_marine,89,42,83,7,131,93.25842696629213,7.865168539325842
29913_marine,89,42,83,7,131,93.25842696629213,7.865168539325842
29914_marine,88,42,82,6,130,93.18181818181817,6.8181818181818175
29915_marine,87,42,81,6,129,93.10344827586206,6.896551724137931
29916_marine,87,42,81,6,129,93.10344827586206,6.896551724137931
29917_marine,87,41,81,6,128,93.10344827586206,6.896551724137931
29918_marine,83,40,78,5,123,93.97590361445783,6.024096385542169
29919_marine,85,40,80,7,125,94.11764705882352,8.235294117647058
29920_marine,86,40,81,7,126,94.18604651162791,8.13953488372093
29921_marine,84,40,79,7,124,94.04761904761905,8.333333333333332
29922_marine,84,40,79,7,124,94.04761904761905,8.333333333333332
29923_marine,86,40,81,7,126,94.18604651162791,8.13953488372093
29924_marine,83,40,78,4,123,93.97590361445783,4.819277108433735
29925_marine,82,39,78,4,121,95.1219512195122,4.878048780487805
29926_marine,82,39,78,4,121,95.1219512195122,4.878048780487805
29927_marine,82,39,78,4,121,95.1219512195122,4.878048780487805
29928_marine,81,39,77,3,120,95.06172839506173,3.7037037037037033
29929_marine,82,39,78,3,121,95.1219512195122,3.6585365853658534
29930_marine,82,39,78,3,121,95.1219512195122,3.6585365853658534
29931_marine,82,39,78,3,121,95.1219512195122,3.6585365853658534
29932_marine,83,42,79,3,125,95.18072289156626,3.614457831325301
29933_marine,83,42,79,3,125,95.18072289156626,3.614457831325301
29934_marine,83,42,79,3,125,95.18072289156626,3.614457831325301
29935_marine,82,42,78,3,124,95.1219512195122,3.6585365853658534
29936_marine,82,42,78,3,124,95.1219512195122,3.6585365853658534
29937_marine,82,42,78,3,124,95.1219512195122,3.6585365853658534
29938_marine,82,42,78,3,124,95.1219512195122,3.6585365853658534
29939_marine,82,42,78,3,124,95.1219512195122,3.6585365853658534
29940_marine,82,43,78,3,125,95.1219512195122,3.6585365853658534
29941_marine,83,43,79,3,126,95.18072289156626,3.614457831325301
29942_marine,83,44,79,3,127,95.18072289156626,3.614457831325301
29943_marine,83,44,79,3,127,95.18072289156626,3.614457831325301
29944_marine,82,43,78,3,125,95.1219512195122,3.6585365853658534
29945_marine,81,43,77,3,124,95.06172839506173,3.7037037037037033
29946_marine,82,43,78,3,125,95.1219512195122,3.6585365853658534
29947_marine,82,43,78,3,125,95.1219512195122,3.6585365853658534
29948_marine,82,43,78,3,125,95.1219512195122,3.6585365853658534
29949_marine,83,44,79,4,127,95.18072289156626,4.819277108433735
29950_marine,85,42,81,4,127,95.29411764705881,4.705882352941177
29951_marine,84,44,80,4,128,95.23809523809523,4.761904761904762
29952_marine,84,44,80,4,128,95.23809523809523,4.761904761904762
29953_marine,83,46,79,4,129,95.18072289156626,4.819277108433735
29954_marine,85,45,81,4,130,95.29411764705881,4.705882352941177
29955_marine,85,46,81,4,131,95.29411764705881,4.705882352941177
29956_marine,86,46,81,4,132,94.18604651162791,4.651162790697675
29957_marine,88,47,83,4,135,94.31818181818183,4.545454545454546
29958_marine,88,47,83,4,135,94.31818181818183,4.545454545454546
29959_marine,88,46,83,4,134,94.31818181818183,4.545454545454546
29960_marine,88,46,83,4,134,94.31818181818183,4.545454545454546
29961_marine,88,46,83,4,134,94.31818181818183,4.545454545454546
29962_marine,88,46,82,5,134,93.18181818181817,5.681818181818182
29963_marine,88,45,82,5,133,93.18181818181817,5.681818181818182
29964_marine,88,44,82,5,132,93.18181818181817,5.681818181818182
29965_marine,88,44,82,5,132,93.18181818181817,5.681818181818182
29966_marine,88,44,82,5,132,93.18181818181817,5.681818181818182
29967_marine,89,43,83,6,132,93.25842696629213,6.741573033707865
29968_marine,89,42,83,6,131,93.25842696629213,6.741573033707865
29969_marine,90,42,84,7,132,93.33333333333333,7.777777777777778
29970_marine,88,41,81,8,129,92.04545454545455,9.090909090909092
29971_marine,90,40,83,8,130,92.22222222222223,8.88888888888889
29972_marine,93,40,85,9,133,91.39784946236558,9.67741935483871
29973_marine,206,118,150,66,324,72.81553398058253,32.038834951456316
29974_marine,204,120,148,66,324,72.54901960784314,32.35294117647059
29975_marine,99,44,91,11,143,91.91919191919192,11.11111111111111
29976_marine,102,44,94,12,146,92.15686274509804,11.76470588235294
29977_marine,301,246,241,77,547,80.06644518272425,25.581395348837212
29978_marine,303,256,243,78,559,80.19801980198021,25.742574257425744
29979_marine,309,264,247,82,573,79.93527508090615,26.537216828478964
29980_marine,308,257,247,81,565,80.1948051948052,26.2987012987013
29981_marine,299,249,241,74,548,80.60200668896321,24.74916387959866
29982_marine,305,243,244,78,548,80,25.573770491803277
30006_marine,299,185,246,78,484,82.2742474916388,26.08695652173913
30007_marine,294,175,242,74,469,82.31292517006803,25.170068027210885
30008_marine,274,190,226,65,464,82.48175182481752,23.722627737226276
30009_marine,267,177,220,65,444,82.39700374531836,24.344569288389515
30010_marine,97,42,89,9,139,91.75257731958763,9.278350515463918
30011_marine,89,38,83,7,127,93.25842696629213,7.865168539325842
30012_marine,89,38,84,5,127,94.3820224719101,5.617977528089887
30013_marine,87,37,82,4,124,94.25287356321839,4.597701149425287
30014_marine,86,35,81,4,121,94.18604651162791,4.651162790697675
30015_marine,88,35,83,4,123,94.31818181818183,4.545454545454546
30016_marine,87,35,81,4,122,93.10344827586206,4.597701149425287
30017_marine,86,35,80,4,121,93.02325581395348,4.651162790697675
30018_marine,86,35,80,4,121,93.02325581395348,4.651162790697675
30019_marine,87,35,81,5,122,93.10344827586206,5.747126436781609
30020_marine,87,34,81,5,121,93.10344827586206,5.747126436781609
30021_marine,87,34,81,5,121,93.10344827586206,5.747126436781609
30022_marine,87,34,81,5,121,93.10344827586206,5.747126436781609
30023_marine,87,34,81,5,121,93.10344827586206,5.747126436781609
30024_marine,84,36,80,2,120,95.23809523809523,2.380952380952381
30025_marine,86,36,82,2,122,95.34883720930233,2.3255813953488373
30026_marine,87,35,83,2,122,95.40229885057471,2.2988505747126435
30027_marine,87,35,83,2,122,95.40229885057471,2.2988505747126435
30028_marine,88,35,84,2,123,95.45454545454545,2.272727272727273
30029_marine,90,35,86,2,125,95.55555555555556,2.2222222222222223
30030_marine,90,35,86,2,125,95.55555555555556,2.2222222222222223
30031_marine,90,35,86,2,125,95.55555555555556,2.2222222222222223
30032_marine,91,35,86,2,126,94.5054945054945,2.197802197802198
30033_marine,91,35,86,2,126,94.5054945054945,2.197802197802198
30034_marine,89,35,84,2,124,94.3820224719101,2.247191011235955
30035_marine,89,35,84,2,124,94.3820224719101,2.247191011235955
30036_marine,88,35,83,2,123,94.31818181818183,2.272727272727273
30037_marine,90,35,85,2,125,94.44444444444444,2.2222222222222223
30038_marine,90,35,85,2,125,94.44444444444444,2.2222222222222223
30039_marine,93,33,87,3,126,93.54838709677419,3.225806451612903
30040_marine,93,31,87,3,124,93.54838709677419,3.225806451612903
30041_marine,94,31,88,4,125,93.61702127659575,4.25531914893617
30042_marine,95,33,89,5,128,93.6842105263158,5.263157894736842
30043_marine,97,33,91,5,130,93.81443298969072,5.154639175257731
30044_marine,105,35,99,5,140,94.28571428571428,4.761904761904762
30045_marine,111,35,105,7,146,94.5945945945946,6.306306306306306
30046_marine,119,45,112,9,164,94.11764705882352,7.563025210084033
30047_marine,273,118,246,37,391,90.10989010989012,13.553113553113553
30048_marine,296,134,267,40,430,90.2027027027027,13.513513513513514
30109_marine,650,257,459,328,907,70.61538461538461,50.46153846153846
30110_marine,659,269,465,335,928,70.56145675265554,50.834597875569045
30111_marine,524,166,375,271,690,71.56488549618321,51.717557251908396
30112_marine,99,39,94,9,138,94.94949494949495,9.090909090909092
30113_marine,98,33,93,9,131,94.89795918367348,9.183673469387756
30114_marine,92,32,87,5,124,94.56521739130434,5.434782608695652
30115_marine,83,31,78,5,114,93.97590361445783,6.024096385542169
30116_marine,80,30,75,6,110,93.75,7.5
30117_marine,78,30,73,6,108,93.58974358974359,7.6923076923076925
30118_marine,79,30,74,7,109,93.67088607594937,8.860759493670885
30119_marine,79,30,74,7,109,93.67088607594937,8.860759493670885
30120_marine,79,30,74,7,109,93.67088607594937,8.860759493670885
30121_marine,79,31,74,7,110,93.67088607594937,8.860759493670885
30122_marine,79,31,74,7,110,93.67088607594937,8.860759493670885
30123_marine,79,31,74,7,110,93.67088607594937,8.860759493670885
30124_marine,80,31,75,8,111,93.75,10
30125_marine,80,31,75,8,111,93.75,10
30126_marine,79,31,74,8,110,93.67088607594937,10.126582278481013
30127_marine,79,31,74,7,110,93.67088607594937,8.860759493670885
30128_marine,79,31,74,7,110,93.67088607594937,8.860759493670885
30129_marine,79,31,74,7,110,93.67088607594937,8.860759493670885
30130_marine,85,31,80,7,116,94.11764705882352,8.235294117647058
30131_marine,85,37,80,9,122,94.11764705882352,10.588235294117647
30132_marine,603,155,377,359,758,62.520729684908794,59.53565505804311
30133_marine,682,177,444,405,859,65.10263929618768,59.384164222873906
30134_marine,693,177,452,406,870,65.22366522366522,58.58585858585859
30135_marine,635,156,408,365,791,64.25196850393701,57.48031496062992
30136_marine,109,32,103,11,141,94.4954128440367,10.091743119266056
30137_marine,118,42,112,14,160,94.91525423728814,11.864406779661017
30138_marine,121,48,115,13,169,95.0413223140496,10.743801652892563
30139_marine,683,219,455,350,902,66.61786237188872,51.244509516837475
30143_marine,751,275,506,371,1026,67.37683089214381,49.40079893475366
30144_marine,109,32,104,7,141,95.41284403669725,6.422018348623854
30145_marine,88,30,83,4,118,94.31818181818183,4.545454545454546
30146_marine,76,29,71,4,105,93.42105263157895,5.263157894736842
30147_marine,75,29,70,3,104,93.33333333333333,4
30148_marine,75,29,70,3,104,93.33333333333333,4
30149_marine,76,29,71,4,105,93.42105263157895,5.263157894736842
30150_marine,74,29,69,4,103,93.24324324324324,5.405405405405405
30151_marine,75,30,70,4,105,93.33333333333333,5.333333333333334
30152_marine,82,30,76,11,112,92.6829268292683,13.414634146341465
30153_marine,501,136,308,301,637,61.477045908183634,60.079840319361274
30155_marine,727,209,472,394,936,64.92434662998625,54.19532324621733
30156_marine,753,257,495,410,1010,65.73705179282868,54.448871181938905
30157_marine,690,197,442,385,887,64.05797101449275,55.79710144927537
30158_marine,750,243,487,395,993,64.93333333333334,52.666666666666664
30159_marine,763,282,505,383,1045,66.18610747051113,50.19659239842726
30164_marine,681,252,484,319,933,71.071953010279,46.84287812041116
30165_marine,617,210,434,300,827,70.34035656401944,48.62236628849271
30166_marine,584,201,411,291,785,70.37671232876713,49.82876712328767
30167_marine,580,188,393,305,768,67.75862068965517,52.58620689655172
30168_marine,573,184,387,302,757,67.5392670157068,52.70506108202443
30169_marine,562,176,376,298,738,66.90391459074732,53.02491103202846
30170_marine,549,168,363,296,717,66.12021857923497,53.916211293260474
30171_marine,527,147,350,285,674,66.41366223908919,54.079696394686906
30172_marine,107,29,101,12,136,94.39252336448598,11.214953271028037
30173_marine,114,31,107,15,145,93.85964912280701,13.157894736842104
30174_marine,148,35,141,21,183,95.27027027027027,14.18918918918919
30175_marine,749,208,506,407,957,67.55674232309747,54.33911882510013
30176_marine,979,381,645,543,1360,65.8835546475996,55.464759959141986
30180_marine,997,344,622,577,1341,62.38716148445336,57.87362086258776
30188_marine,1006,345,611,599,1351,60.73558648111332,59.5427435387674
30189_marine,118,30,111,18,148,94.0677966101695,15.254237288135593
30190_marine,108,29,101,16,137,93.51851851851852,14.814814814814813
30191_marine,104,29,98,15,133,94.23076923076923,14.423076923076922
30192_marine,103,29,97,11,132,94.1747572815534,10.679611650485436
30193_marine,101,31,95,11,132,94.05940594059405,10.891089108910892
30194_marine,798,242,458,525,1040,57.393483709273184,65.78947368421053
30195_marine,912,331,545,597,1243,59.75877192982456,65.46052631578947
30196_marine,795,233,456,527,1028,57.35849056603774,66.28930817610062
30197_marine,103,31,97,14,134,94.1747572815534,13.592233009708737
30198_marine,98,31,93,10,129,94.89795918367348,10.204081632653061
30199_marine,98,31,93,10,129,94.89795918367348,10.204081632653061
30200_marine,98,31,93,10,129,94.89795918367348,10.204081632653061
30201_marine,96,31,91,10,127,94.79166666666666,10.416666666666668
30202_marine,98,31,91,12,129,92.85714285714286,12.244897959183673
30203_marine,108,35,101,14,143,93.51851851851852,12.962962962962962
30204_marine,643,194,425,384,837,66.09642301710731,59.72006220839814
30205_marine,599,137,393,367,736,65.6093489148581,61.26878130217028
30206_marine,120,36,104,29,156,86.66666666666667,24.166666666666668
30207_marine,574,131,382,350,705,66.55052264808361,60.97560975609756
30208_marine,575,131,383,350,706,66.6086956521739,60.86956521739131
30209_marine,555,126,369,336,681,66.48648648648648,60.54054054054055
30210_marine,636,199,431,383,835,67.76729559748428,60.22012578616353
30211_marine,587,129,379,358,716,64.5655877342419,60.98807495741057
30212_marine,618,188,400,373,806,64.72491909385113,60.35598705501618
30213_marine,629,192,410,375,821,65.18282988871225,59.61844197138315
30214_marine,551,127,371,330,678,67.33212341197822,59.89110707803993
30215_marine,549,125,369,330,674,67.21311475409836,60.10928961748634
30216_marine,100,33,95,11,133,95,11
30217_marine,603,149,393,364,752,65.17412935323384,60.3648424543947
30218_marine,680,222,447,410,902,65.73529411764706,60.29411764705882
30219_marine,688,234,452,413,922,65.69767441860465,60.029069767441854
30220_marine,666,218,436,405,884,65.46546546546547,60.810810810810814
30221_marine,631,207,420,379,838,66.56101426307448,60.063391442155314
30222_marine,562,130,370,340,692,65.83629893238434,60.4982206405694
30223_marine,584,127,382,355,711,65.41095890410958,60.78767123287672
30224_marine,584,127,382,355,711,65.41095890410958,60.78767123287672
30225_marine,102,37,97,11,139,95.09803921568627,10.784313725490197
30226_marine,102,37,97,11,139,95.09803921568627,10.784313725490197
30227_marine,102,38,97,11,140,95.09803921568627,10.784313725490197
30228_marine,600,163,376,378,763,62.66666666666667,63
30229_marine,602,164,378,378,766,62.7906976744186,62.7906976744186
30230_marine,643,191,411,400,834,63.91912908242613,62.208398133748055
30231_marine,615,169,393,378,784,63.90243902439025,61.46341463414634
30232_marine,648,192,420,394,840,64.81481481481481,60.802469135802475
30233_marine,646,192,418,394,838,64.70588235294117,60.99071207430341
30234_marine,597,165,379,368,762,63.484087102177554,61.64154103852596
30235_marine,101,40,96,10,141,95.04950495049505,9.900990099009901
30236_marine,100,40,95,9,140,95,9
30237_marine,99,40,94,8,139,94.94949494949495,8.080808080808081
30238_marine,99,41,94,8,140,94.94949494949495,8.080808080808081
30239_marine,98,41,93,8,139,94.89795918367348,8.16326530612245
30240_marine,98,41,93,8,139,94.89795918367348,8.16326530612245
30241_marine,98,41,93,8,139,94.89795918367348,8.16326530612245
30242_marine,98,41,93,8,139,94.89795918367348,8.16326530612245
30243_marine,99,41,93,8,140,93.93939393939394,8.080808080808081
30244_marine,99,41,93,8,140,93.93939393939394,8.080808080808081
30245_marine,99,41,93,8,140,93.93939393939394,8.080808080808081
30246_marine,99,41,93,8,140,93.93939393939394,8.080808080808081
30247_marine,99,41,93,8,140,93.93939393939394,8.080808080808081
30248_marine,97,41,91,8,138,93.81443298969072,8.24742268041237
30249_marine,99,40,93,8,139,93.93939393939394,8.080808080808081
30250_marine,99,40,93,8,139,93.93939393939394,8.080808080808081
30251_marine,99,41,93,8,140,93.93939393939394,8.080808080808081
30252_marine,99,41,93,8,140,93.93939393939394,8.080808080808081
30253_marine,101,41,95,10,142,94.05940594059405,9.900990099009901
30254_marine,101,41,95,10,142,94.05940594059405,9.900990099009901
30255_marine,101,41,95,10,142,94.05940594059405,9.900990099009901
30256_marine,101,43,95,10,144,94.05940594059405,9.900990099009901
30257_marine,422,104,296,251,526,70.14218009478674,59.47867298578199
30258_marine,425,109,299,251,534,70.35294117647058,59.05882352941176
30259_marine,422,110,294,250,532,69.66824644549763,59.241706161137444
30260_marine,398,105,278,236,503,69.84924623115577,59.2964824120603
30261_marine,397,103,277,236,500,69.77329974811083,59.44584382871536
30262_marine,100,43,94,10,143,94,10
30263_marine,97,44,91,9,141,93.81443298969072,9.278350515463918
30264_marine,95,44,89,9,139,93.6842105263158,9.473684210526317
30265_marine,93,43,87,7,136,93.54838709677419,7.526881720430108
30266_marine,92,43,86,7,135,93.47826086956522,7.608695652173914
30267_marine,92,43,86,7,135,93.47826086956522,7.608695652173914
30268_marine,91,42,85,7,133,93.4065934065934,7.6923076923076925
30269_marine,91,42,85,7,133,93.4065934065934,7.6923076923076925
30270_marine,91,42,85,7,133,93.4065934065934,7.6923076923076925
30271_marine,90,42,84,7,132,93.33333333333333,7.777777777777778
30272_marine,90,42,84,7,132,93.33333333333333,7.777777777777778
30273_marine,89,42,83,7,131,93.25842696629213,7.865168539325842
30274_marine,89,42,83,7,131,93.25842696629213,7.865168539325842
30275_marine,88,42,82,6,130,93.18181818181817,6.8181818181818175
30276_marine,87,42,81,6,129,93.10344827586206,6.896551724137931
30277_marine,87,42,81,6,129,93.10344827586206,6.896551724137931
30278_marine,86,41,80,6,127,93.02325581395348,6.976744186046512
30279_marine,84,40,79,5,124,94.04761904761905,5.952380952380952
30280_marine,86,40,81,7,126,94.18604651162791,8.13953488372093
30281_marine,86,40,81,7,126,94.18604651162791,8.13953488372093
30282_marine,86,40,81,7,126,94.18604651162791,8.13953488372093
30283_marine,86,40,81,7,126,94.18604651162791,8.13953488372093
30284_marine,84,40,79,4,124,94.04761904761905,4.761904761904762
30285_marine,82,40,77,4,122,93.90243902439023,4.878048780487805
30286_marine,83,39,78,4,122,93.97590361445783,4.819277108433735
30287_marine,83,39,78,4,122,93.97590361445783,4.819277108433735
30288_marine,85,39,80,4,124,94.11764705882352,4.705882352941177
30289_marine,84,39,79,3,123,94.04761904761905,3.571428571428571
30290_marine,84,39,79,3,123,94.04761904761905,3.571428571428571
30291_marine,84,38,79,3,122,94.04761904761905,3.571428571428571
30292_marine,84,39,79,3,123,94.04761904761905,3.571428571428571
30293_marine,84,41,79,3,125,94.04761904761905,3.571428571428571
30294_marine,84,41,79,3,125,94.04761904761905,3.571428571428571
30295_marine,83,41,78,3,124,93.97590361445783,3.614457831325301
30296_marine,82,41,78,3,123,95.1219512195122,3.6585365853658534
30297_marine,82,41,78,3,123,95.1219512195122,3.6585365853658534
30298_marine,82,41,78,3,123,95.1219512195122,3.6585365853658534
30299_marine,82,41,78,3,123,95.1219512195122,3.6585365853658534
30300_marine,83,41,79,3,124,95.18072289156626,3.614457831325301
30301_marine,83,43,79,3,126,95.18072289156626,3.614457831325301
30302_marine,83,43,79,3,126,95.18072289156626,3.614457831325301
30303_marine,83,44,79,3,127,95.18072289156626,3.614457831325301
30304_marine,82,44,78,3,126,95.1219512195122,3.6585365853658534
30305_marine,82,43,78,3,125,95.1219512195122,3.6585365853658534
30306_marine,82,43,78,3,125,95.1219512195122,3.6585365853658534
30307_marine,82,43,78,3,125,95.1219512195122,3.6585365853658534
30308_marine,82,43,78,3,125,95.1219512195122,3.6585365853658534
30309_marine,82,44,78,3,126,95.1219512195122,3.6585365853658534
30310_marine,81,44,77,3,125,95.06172839506173,3.7037037037037033
30311_marine,81,44,77,3,125,95.06172839506173,3.7037037037037033
30312_marine,82,45,78,3,127,95.1219512195122,3.6585365853658534
30313_marine,82,46,78,3,128,95.1219512195122,3.6585365853658534
30314_marine,82,46,78,3,128,95.1219512195122,3.6585365853658534
30315_marine,82,46,78,3,128,95.1219512195122,3.6585365853658534
30316_marine,85,46,81,4,131,95.29411764705881,4.705882352941177
30317_marine,88,46,83,4,134,94.31818181818183,4.545454545454546
30318_marine,88,47,83,4,135,94.31818181818183,4.545454545454546
30319_marine,88,46,83,4,134,94.31818181818183,4.545454545454546
30320_marine,88,45,83,4,133,94.31818181818183,4.545454545454546
30321_marine,88,45,83,4,133,94.31818181818183,4.545454545454546
30322_marine,88,45,83,4,133,94.31818181818183,4.545454545454546
30323_marine,88,45,83,4,133,94.31818181818183,4.545454545454546
30324_marine,89,44,83,5,133,93.25842696629213,5.617977528089887
30325_marine,88,43,82,5,131,93.18181818181817,5.681818181818182
30326_marine,88,43,82,5,131,93.18181818181817,5.681818181818182
30327_marine,89,44,83,6,133,93.25842696629213,6.741573033707865
30328_marine,90,42,84,7,132,93.33333333333333,7.777777777777778
30329_marine,89,42,83,7,131,93.25842696629213,7.865168539325842
30330_marine,90,42,83,8,132,92.22222222222223,8.88888888888889
30331_marine,93,40,86,8,133,92.47311827956989,8.60215053763441
30332_marine,100,46,92,9,146,92,9
30333_marine,224,144,161,78,368,71.875,34.82142857142857
30334_marine,213,126,157,68,339,73.70892018779342,31.92488262910798
30335_marine,99,44,91,11,143,91.91919191919192,11.11111111111111
30336_marine,100,46,92,12,146,92,12
30337_marine,97,45,89,11,142,91.75257731958763,11.34020618556701
30338_marine,103,46,95,11,149,92.23300970873787,10.679611650485436
30339_marine,104,45,96,11,149,92.3076923076923,10.576923076923077
30340_marine,102,45,94,11,147,92.15686274509804,10.784313725490197
30341_marine,99,44,93,11,143,93.93939393939394,11.11111111111111
30342_marine,290,214,234,72,504,80.6896551724138,24.82758620689655
30369_marine,279,198,228,71,477,81.72043010752688,25.448028673835125
30370_marine,268,184,223,65,452,83.2089552238806,24.253731343283583
30371_marine,93,48,85,7,141,91.39784946236558,7.526881720430108
30372_marine,88,38,83,6,126,94.31818181818183,6.8181818181818175
30373_marine,88,38,83,5,126,94.31818181818183,5.681818181818182
30374_marine,89,39,84,4,128,94.3820224719101,4.49438202247191
30375_marine,87,37,82,4,124,94.25287356321839,4.597701149425287
30376_marine,88,37,83,4,125,94.31818181818183,4.545454545454546
30377_marine,90,35,84,4,125,93.33333333333333,4.444444444444445
30378_marine,87,35,81,5,122,93.10344827586206,5.747126436781609
30379_marine,87,35,81,5,122,93.10344827586206,5.747126436781609
30380_marine,87,35,81,5,122,93.10344827586206,5.747126436781609
30381_marine,87,34,81,5,121,93.10344827586206,5.747126436781609
30382_marine,87,34,81,5,121,93.10344827586206,5.747126436781609
30383_marine,87,34,81,5,121,93.10344827586206,5.747126436781609
30384_marine,88,36,82,5,124,93.18181818181817,5.681818181818182
30385_marine,87,36,83,3,123,95.40229885057471,3.4482758620689653
30386_marine,88,36,84,3,124,95.45454545454545,3.4090909090909087
30387_marine,87,36,83,2,123,95.40229885057471,2.2988505747126435
30388_marine,91,35,87,2,126,95.6043956043956,2.197802197802198
30389_marine,91,35,87,2,126,95.6043956043956,2.197802197802198
30390_marine,91,35,87,2,126,95.6043956043956,2.197802197802198
30391_marine,91,35,87,2,126,95.6043956043956,2.197802197802198
30392_marine,91,35,87,2,126,95.6043956043956,2.197802197802198
30393_marine,91,35,86,2,126,94.5054945054945,2.197802197802198
30394_marine,88,35,83,2,123,94.31818181818183,2.272727272727273
30395_marine,88,35,83,2,123,94.31818181818183,2.272727272727273
30396_marine,88,35,83,2,123,94.31818181818183,2.272727272727273
30397_marine,88,35,83,2,123,94.31818181818183,2.272727272727273
30398_marine,90,35,85,2,125,94.44444444444444,2.2222222222222223
30399_marine,90,35,85,2,125,94.44444444444444,2.2222222222222223
30400_marine,93,33,87,3,126,93.54838709677419,3.225806451612903
30401_marine,93,31,87,3,124,93.54838709677419,3.225806451612903
30402_marine,93,31,87,3,124,93.54838709677419,3.225806451612903
30403_marine,94,33,88,4,127,93.61702127659575,4.25531914893617
30404_marine,103,33,97,5,136,94.1747572815534,4.854368932038835
30405_marine,103,35,97,5,138,94.1747572815534,4.854368932038835
30406_marine,107,35,101,5,142,94.39252336448598,4.672897196261682
30407_marine,113,35,106,9,148,93.80530973451327,7.964601769911504
30408_marine,115,46,108,9,161,93.91304347826087,7.82608695652174
30409_marine,278,121,250,40,399,89.92805755395683,14.388489208633093
30422_marine,298,139,254,59,437,85.23489932885906,19.798657718120804
30423_marine,274,121,243,44,395,88.6861313868613,16.05839416058394
30424_marine,273,117,243,43,390,89.01098901098901,15.75091575091575
30469_marine,687,277,479,357,964,69.72343522561863,51.96506550218341
30470_marine,548,183,396,275,731,72.26277372262774,50.18248175182482
30471_marine,108,38,101,10,146,93.51851851851852,9.25925925925926
30472_marine,100,33,95,9,133,95,9
30473_marine,95,32,90,8,127,94.73684210526315,8.421052631578947
30474_marine,88,33,83,6,121,94.31818181818183,6.8181818181818175
30475_marine,80,31,75,6,111,93.75,7.5
30476_marine,79,31,74,7,110,93.67088607594937,8.860759493670885
30477_marine,79,31,74,7,110,93.67088607594937,8.860759493670885
30478_marine,79,32,74,7,111,93.67088607594937,8.860759493670885
30479_marine,79,32,74,7,111,93.67088607594937,8.860759493670885
30480_marine,79,32,74,7,111,93.67088607594937,8.860759493670885
30481_marine,79,32,74,7,111,93.67088607594937,8.860759493670885
30482_marine,79,32,74,7,111,93.67088607594937,8.860759493670885
30483_marine,79,32,74,7,111,93.67088607594937,8.860759493670885
30484_marine,80,32,75,8,112,93.75,10
30485_marine,80,32,75,8,112,93.75,10
30486_marine,80,32,75,8,112,93.75,10
30487_marine,80,32,75,7,112,93.75,8.75
30488_marine,79,32,74,7,111,93.67088607594937,8.860759493670885
30489_marine,79,32,74,7,111,93.67088607594937,8.860759493670885
30490_marine,80,32,75,7,112,93.75,8.75
30491_marine,87,38,82,9,125,94.25287356321839,10.344827586206897
30492_marine,613,154,387,363,767,63.132137030995104,59.216965742251226
30493_marine,679,170,439,406,849,64.65390279823269,59.79381443298969
30494_marine,686,175,446,406,861,65.01457725947522,59.183673469387756
30495_marine,633,158,406,366,791,64.13902053712481,57.81990521327014
30496_marine,101,33,95,9,134,94.05940594059405,8.91089108910891
30497_marine,101,34,95,7,135,94.05940594059405,6.9306930693069315
30498_marine,109,34,103,11,143,94.4954128440367,10.091743119266056
30499_marine,116,34,110,14,150,94.82758620689656,12.068965517241379
30500_marine,736,260,492,369,996,66.84782608695652,50.1358695652174
30502_marine,760,281,515,373,1041,67.76315789473685,49.078947368421055
30503_marine,699,214,464,364,913,66.38054363376253,52.07439198855508
30504_marine,102,32,97,7,134,95.09803921568627,6.862745098039216
30505_marine,86,29,81,5,115,94.18604651162791,5.813953488372093
30506_marine,77,29,72,4,106,93.5064935064935,5.194805194805195
30507_marine,78,29,73,4,107,93.58974358974359,5.128205128205128
30508_marine,78,29,73,4,107,93.58974358974359,5.128205128205128
30509_marine,78,29,73,4,107,93.58974358974359,5.128205128205128
30510_marine,75,29,70,4,104,93.33333333333333,5.333333333333334
30511_marine,75,30,70,4,105,93.33333333333333,5.333333333333334
30512_marine,80,30,75,8,110,93.75,10
30513_marine,96,31,90,14,127,93.75,14.583333333333334
30514_marine,510,138,317,302,648,62.15686274509804,59.21568627450981
30515_marine,803,286,533,432,1089,66.3760896637609,53.79825653798257
30519_marine,768,296,520,398,1064,67.70833333333334,51.822916666666664
30520_marine,714,276,488,352,990,68.34733893557423,49.299719887955185
30525_marine,684,250,477,329,934,69.73684210526315,48.099415204678365
30526_marine,596,196,407,304,792,68.28859060402685,51.006711409395976
30527_marine,598,184,403,308,782,67.3913043478261,51.50501672240802
30528_marine,621,210,405,325,831,65.21739130434783,52.33494363929147
30529_marine,612,206,399,323,818,65.19607843137256,52.77777777777778
30530_marine,589,178,387,317,767,65.70458404074702,53.82003395585738
30531_marine,618,174,421,318,792,68.12297734627832,51.45631067961165
30532_marine,628,171,429,324,799,68.31210191082803,51.59235668789809
30533_marine,649,182,446,330,831,68.7211093990755,50.847457627118644
30534_marine,718,215,481,372,933,66.991643454038993,51.81058495821726
30543_marine,971,343,591,584,1314,60.865087538619974,60.14418125643667
30544_marine,1001,351,604,596,1352,60.33966033966034,59.540459540459544
30547_marine,1085,398,668,639,1483,61.566820276497694,58.89400921658986
30548_marine,948,327,580,568,1275,61.18143459915611,59.91561181434599
30549_marine,900,302,538,555,1202,59.77777777777777,61.66666666666667
30550_marine,108,29,101,16,137,93.51851851851852,14.814814814814813
30551_marine,105,29,98,15,134,93.33333333333333,14.285714285714285
30552_marine,654,170,418,400,824,63.91437308868502,61.16207951070336
30553_marine,685,228,440,412,913,64.23357664233576,60.14598540145985
30554_marine,790,232,457,519,1022,57.848101265822784,65.69620253164557
30555_marine,784,232,451,520,1016,57.525510204081634,66.3265306122449
30556_marine,99,31,93,12,130,93.93939393939394,12.121212121212121
30557_marine,98,31,92,11,129,93.87755102040816,11.224489795918368
30558_marine,96,31,91,10,127,94.79166666666666,10.416666666666668
30559_marine,96,31,91,10,127,94.79166666666666,10.416666666666668
30560_marine,96,31,91,10,127,94.79166666666666,10.416666666666668
30561_marine,96,31,91,10,127,94.79166666666666,10.416666666666668
30562_marine,96,31,91,10,127,94.79166666666666,10.416666666666668
30563_marine,96,31,91,10,127,94.79166666666666,10.416666666666668
30564_marine,96,31,91,10,127,94.79166666666666,10.416666666666668
30565_marine,96,31,91,10,127,94.79166666666666,10.416666666666668
30566_marine,117,37,103,26,154,88.03418803418803,22.22222222222222
30567_marine,95,31,90,10,126,94.73684210526315,10.526315789473683
30568_marine,97,32,92,11,129,94.84536082474226,11.34020618556701
30569_marine,555,124,369,336,679,66.48648648648648,60.54054054054055
30570_marine,554,124,368,335,678,66.4259927797834,60.46931407942239
30571_marine,96,32,91,9,128,94.79166666666666,9.375
30572_marine,96,33,91,9,129,94.79166666666666,9.375
30573_marine,548,126,368,330,674,67.15328467153284,60.21897810218978
30574_marine,629,199,430,378,828,68.362480127186,60.095389507154216
30575_marine,549,129,369,330,678,67.21311475409836,60.10928961748634
30576_marine,98,34,93,9,132,94.89795918367348,9.183673469387756
30577_marine,563,147,371,340,710,65.89698046181172,60.39076376554174
30578_marine,669,221,441,403,890,65.91928251121077,60.239162929745895
30579_marine,605,148,393,366,753,64.95867768595042,60.49586776859505
30580_marine,566,134,374,340,700,66.07773851590106,60.07067137809188
30581_marine,566,136,374,340,702,66.07773851590106,60.07067137809188
30582_marine,562,130,370,340,692,65.83629893238434,60.4982206405694
30583_marine,647,198,429,387,845,66.30602782071098,59.8145285935085
30584_marine,647,200,429,388,847,66.30602782071098,59.969088098918085
30585_marine,102,39,97,11,141,95.09803921568627,10.784313725490197
30586_marine,100,37,95,11,137,95,11
30587_marine,100,39,95,11,139,95,11
30588_marine,595,168,375,374,763,63.02521008403361,62.857142857142854
30589_marine,635,190,407,396,825,64.09448818897637,62.36220472440945
30590_marine,637,192,409,396,829,64.2072213500785,62.166405023547874
30591_marine,609,167,387,378,776,63.54679802955665,62.06896551724138
30592_marine,599,166,381,370,765,63.60601001669449,61.769616026711184
30593_marine,636,191,410,392,827,64.46540880503144,61.63522012578616
30594_marine,599,165,381,370,764,63.60601001669449,61.769616026711184
30595_marine,101,41,96,10,142,95.04950495049505,9.900990099009901
30596_marine,100,40,95,9,140,95,9
30597_marine,99,41,94,8,140,94.94949494949495,8.080808080808081
30598_marine,99,41,94,8,140,94.94949494949495,8.080808080808081
30599_marine,99,41,94,8,140,94.94949494949495,8.080808080808081
30600_marine,98,41,93,8,139,94.89795918367348,8.16326530612245
30601_marine,99,41,93,8,140,93.93939393939394,8.080808080808081
30602_marine,99,41,93,8,140,93.93939393939394,8.080808080808081
30603_marine,99,41,93,8,140,93.93939393939394,8.080808080808081
30604_marine,99,41,93,8,140,93.93939393939394,8.080808080808081
30605_marine,99,41,93,8,140,93.93939393939394,8.080808080808081
30606_marine,99,41,93,8,140,93.93939393939394,8.080808080808081
30607_marine,99,41,93,8,140,93.93939393939394,8.080808080808081
30608_marine,99,41,93,8,140,93.93939393939394,8.080808080808081
30609_marine,99,41,93,8,140,93.93939393939394,8.080808080808081
30610_marine,99,41,93,8,140,93.93939393939394,8.080808080808081
30611_marine,99,40,93,8,139,93.93939393939394,8.080808080808081
30612_marine,99,41,93,8,140,93.93939393939394,8.080808080808081
30613_marine,99,41,93,10,140,93.93939393939394,10.1010101010101
30614_marine,99,41,93,10,140,93.93939393939394,10.1010101010101
30615_marine,99,41,93,10,140,93.93939393939394,10.1010101010101
30616_marine,99,42,93,10,141,93.93939393939394,10.1010101010101
30617_marine,102,44,96,11,146,94.11764705882352,10.784313725490197
30618_marine,419,100,293,250,519,69.92840095465394,59.665871121718375
30619_marine,422,109,294,250,531,69.66824644549763,59.241706161137444
30620_marine,422,114,295,249,536,69.90521327014217,59.0047393364929
30621_marine,400,106,280,236,506,70,59
30622_marine,401,105,283,237,506,70.57356608478803,59.10224438902743
30623_marine,101,43,95,11,144,94.05940594059405,10.891089108910892
30624_marine,96,44,90,10,140,93.75,10.416666666666668
30625_marine,94,44,88,9,138,93.61702127659575,9.574468085106384
30626_marine,94,44,88,9,138,93.61702127659575,9.574468085106384
30627_marine,92,44,86,7,136,93.47826086956522,7.608695652173914
30628_marine,91,43,85,7,134,93.4065934065934,7.6923076923076925
30629_marine,91,42,85,7,133,93.4065934065934,7.6923076923076925
30630_marine,91,42,85,7,133,93.4065934065934,7.6923076923076925
30631_marine,91,42,85,7,133,93.4065934065934,7.6923076923076925
30632_marine,90,42,84,7,132,93.33333333333333,7.777777777777778
30633_marine,90,42,84,7,132,93.33333333333333,7.777777777777778
30634_marine,90,42,84,7,132,93.33333333333333,7.777777777777778
30635_marine,89,42,83,6,131,93.25842696629213,6.741573033707865
30636_marine,87,42,81,6,129,93.10344827586206,6.896551724137931
30637_marine,87,42,81,6,129,93.10344827586206,6.896551724137931
30638_marine,87,41,81,6,128,93.10344827586206,6.896551724137931
30639_marine,85,41,79,6,126,92.94117647058823,7.0588235294117645
30640_marine,84,40,79,5,124,94.04761904761905,5.952380952380952
30641_marine,84,40,79,5,124,94.04761904761905,5.952380952380952
30642_marine,84,40,79,5,124,94.04761904761905,5.952380952380952
30643_marine,85,40,80,5,125,94.11764705882352,5.88235294117647
30644_marine,84,40,79,4,124,94.04761904761905,4.761904761904762
30645_marine,85,40,80,4,125,94.11764705882352,4.705882352941177
30646_marine,85,40,80,4,125,94.11764705882352,4.705882352941177
30647_marine,85,39,80,4,124,94.11764705882352,4.705882352941177
30648_marine,86,39,81,4,125,94.18604651162791,4.651162790697675
30649_marine,84,38,79,4,122,94.04761904761905,4.761904761904762
30650_marine,84,38,79,3,122,94.04761904761905,3.571428571428571
30651_marine,84,38,79,3,122,94.04761904761905,3.571428571428571
30652_marine,84,39,79,3,123,94.04761904761905,3.571428571428571
30653_marine,84,39,79,3,123,94.04761904761905,3.571428571428571
30654_marine,83,41,78,3,124,93.97590361445783,3.614457831325301
30655_marine,83,41,78,3,124,93.97590361445783,3.614457831325301
30656_marine,83,41,78,3,124,93.97590361445783,3.614457831325301
30657_marine,83,41,78,3,124,93.97590361445783,3.614457831325301
30658_marine,83,41,78,3,124,93.97590361445783,3.614457831325301
30659_marine,84,41,79,3,125,94.04761904761905,3.571428571428571
30660_marine,84,41,79,3,125,94.04761904761905,3.571428571428571
30661_marine,84,42,79,3,126,94.04761904761905,3.571428571428571
30662_marine,84,42,79,3,126,94.04761904761905,3.571428571428571
30663_marine,84,43,79,3,127,94.04761904761905,3.571428571428571
30664_marine,83,43,78,3,126,93.97590361445783,3.614457831325301
30665_marine,82,43,78,3,125,95.1219512195122,3.6585365853658534
30666_marine,82,42,78,3,124,95.1219512195122,3.6585365853658534
30667_marine,82,42,78,3,124,95.1219512195122,3.6585365853658534
30668_marine,82,43,78,3,125,95.1219512195122,3.6585365853658534
30669_marine,82,43,78,3,125,95.1219512195122,3.6585365853658534
30670_marine,81,44,77,3,125,95.06172839506173,3.7037037037037033
30671_marine,81,44,77,3,125,95.06172839506173,3.7037037037037033
30672_marine,80,45,76,3,125,95,3.75
30673_marine,82,46,78,3,128,95.1219512195122,3.6585365853658534
30674_marine,82,47,78,3,129,95.1219512195122,3.6585365853658534
30675_marine,82,48,78,3,130,95.1219512195122,3.6585365853658534
30676_marine,82,46,78,3,128,95.1219512195122,3.6585365853658534
30677_marine,84,46,80,3,130,95.23809523809523,3.571428571428571
30678_marine,87,46,82,3,133,94.25287356321839,3.4482758620689653
30679_marine,87,46,82,3,133,94.25287356321839,3.4482758620689653
30680_marine,87,46,82,3,133,94.25287356321839,3.4482758620689653
30681_marine,87,46,82,3,133,94.25287356321839,3.4482758620689653
30682_marine,88,45,83,4,133,94.31818181818183,4.545454545454546
30683_marine,88,45,83,4,133,94.31818181818183,4.545454545454546
30684_marine,89,44,84,4,133,94.3820224719101,4.49438202247191
30685_marine,89,43,84,4,132,94.3820224719101,4.49438202247191
30686_marine,90,42,84,5,132,93.33333333333333,5.555555555555555
30687_marine,90,42,84,5,132,93.33333333333333,5.555555555555555
30688_marine,94,42,88,7,136,93.61702127659575,7.446808510638298
30689_marine,91,43,85,7,134,93.4065934065934,7.6923076923076925
30690_marine,96,42,89,8,138,92.70833333333334,8.333333333333332
30691_marine,94,42,87,8,136,92.5531914893617,8.51063829787234
30692_marine,98,44,90,9,142,91.83673469387756,9.183673469387756
30693_marine,208,123,152,68,331,73.07692307692307,32.69230769230769
30694_marine,208,120,152,68,328,73.07692307692307,32.69230769230769
30695_marine,100,46,92,11,146,92,11
30696_marine,100,45,92,12,145,92,12
30697_marine,100,47,92,12,147,92,12
30698_marine,190,101,140,62,291,73.68421052631578,32.631578947368425
30699_marine,201,112,149,63,313,74.12935323383084,31.343283582089555
30700_marine,195,98,145,62,293,74.35897435897436,31.794871794871792
30701_marine,98,44,92,9,142,93.87755102040816,9.183673469387756
30702_marine,291,211,234,70,502,80.41237113402062,24.054982817869416
30730_marine,279,182,230,68,461,82.43727598566308,24.372759856630825
30731_marine,264,176,223,57,440,84.46969696969697,21.59090909090909
30732_marine,98,66,93,6,164,94.89795918367348,6.122448979591836
30733_marine,100,42,95,5,142,95,5
30734_marine,91,38,86,5,129,94.5054945054945,5.4945054945054945
30735_marine,91,39,86,5,130,94.5054945054945,5.4945054945054945
30736_marine,92,39,87,4,131,94.56521739130434,4.3478260869565215
30737_marine,89,35,84,5,124,94.3820224719101,5.617977528089887
30738_marine,90,35,85,5,125,94.44444444444444,5.555555555555555
30739_marine,91,35,85,5,126,93.4065934065934,5.4945054945054945
30740_marine,87,35,81,5,122,93.10344827586206,5.747126436781609
30741_marine,88,35,82,5,123,93.18181818181817,5.681818181818182
30742_marine,88,35,82,5,123,93.18181818181817,5.681818181818182
30743_marine,89,34,83,5,123,93.25842696629213,5.617977528089887
30744_marine,89,36,83,5,125,93.25842696629213,5.617977528089887
30745_marine,88,36,82,5,124,93.18181818181817,5.681818181818182
30746_marine,87,36,83,3,123,95.40229885057471,3.4482758620689653
30747_marine,87,36,83,3,123,95.40229885057471,3.4482758620689653
30748_marine,90,36,86,3,126,95.55555555555556,3.3333333333333335
30749_marine,90,35,86,3,125,95.55555555555556,3.3333333333333335
30750_marine,91,35,87,4,126,95.6043956043956,4.395604395604396
30751_marine,93,35,89,4,128,95.6989247311828,4.301075268817205
30752_marine,93,37,89,4,130,95.6989247311828,4.301075268817205
30753_marine,92,37,88,2,129,95.65217391304348,2.1739130434782608
30754_marine,91,37,86,2,128,94.5054945054945,2.197802197802198
30755_marine,89,37,84,2,126,94.3820224719101,2.247191011235955
30756_marine,88,35,83,2,123,94.31818181818183,2.272727272727273
30757_marine,88,35,83,2,123,94.31818181818183,2.272727272727273
30758_marine,88,35,83,2,123,94.31818181818183,2.272727272727273
30759_marine,90,35,85,2,125,94.44444444444444,2.2222222222222223
30760_marine,91,35,85,3,126,93.4065934065934,3.296703296703297
30761_marine,93,33,87,3,126,93.54838709677419,3.225806451612903
30762_marine,93,33,87,3,126,93.54838709677419,3.225806451612903
30763_marine,93,33,87,3,126,93.54838709677419,3.225806451612903
30764_marine,97,33,91,3,130,93.81443298969072,3.0927835051546393
30765_marine,97,33,91,3,130,93.81443298969072,3.0927835051546393
30766_marine,103,33,97,5,136,94.1747572815534,4.854368932038835
30767_marine,107,35,101,5,142,94.39252336448598,4.672897196261682
30768_marine,112,35,106,8,147,94.64285714285714,7.142857142857142
30769_marine,109,35,103,8,144,94.4954128440367,7.339449541284404
30770_marine,264,115,238,37,379,90.15151515151516,14.015151515151514
30776_marine,288,128,257,40,416,89.23611111111111,13.88888888888889
30777_marine,295,137,263,43,432,89.15254237288136,14.576271186440678
30780_marine,294,129,261,42,423,88.77551020408163,14.285714285714285
30781_marine,259,113,228,40,372,88.03088803088804,15.444015444015443
30782_marine,254,114,226,37,368,88.9763779527559,14.566929133858267
30783_marine,98,34,92,11,132,93.87755102040816,11.224489795918368
30784_marine,106,47,98,11,153,92.45283018867924,10.377358490566039
30785_marine,271,134,241,41,405,88.92988929889299,15.129151291512915
30828_marine,698,273,477,373,971,68.33810888252148,53.43839541547278
30829_marine,695,281,475,369,976,68.34532374100719,53.093525179856115
30830_marine,532,168,380,275,700,71.42857142857143,51.691729323308266
30831_marine,101,39,95,9,140,94.05940594059405,8.91089108910891
30832_marine,98,33,93,9,131,94.89795918367348,9.183673469387756
30833_marine,93,33,88,8,126,94.6236559139785,8.60215053763441
30834_marine,85,33,80,8,118,94.11764705882352,9.411764705882353
30835_marine,83,32,78,8,115,93.97590361445783,9.63855421686747
30836_marine,80,32,75,7,112,93.75,8.75
30837_marine,81,32,76,7,113,93.82716049382715,8.641975308641975
30838_marine,80,32,75,7,112,93.75,8.75
30839_marine,80,32,75,7,112,93.75,8.75
30840_marine,80,32,75,7,112,93.75,8.75
30841_marine,80,32,75,7,112,93.75,8.75
30842_marine,80,32,75,7,112,93.75,8.75
30843_marine,80,32,75,7,112,93.75,8.75
30844_marine,81,32,76,8,113,93.82716049382715,9.876543209876543
30845_marine,81,32,76,8,113,93.82716049382715,9.876543209876543
30846_marine,81,32,76,8,113,93.82716049382715,9.876543209876543
30847_marine,81,32,76,7,113,93.82716049382715,8.641975308641975
30848_marine,81,32,76,7,113,93.82716049382715,8.641975308641975
30849_marine,81,32,76,7,113,93.82716049382715,8.641975308641975
30850_marine,82,32,77,7,114,93.90243902439023,8.536585365853659
30851_marine,88,39,83,9,127,94.31818181818183,10.227272727272728
30852_marine,614,152,388,363,766,63.19218241042345,59.12052117263844
30853_marine,676,172,436,404,848,64.49704142011834,59.76331360946746
30854_marine,680,178,441,404,858,64.8529411764706,59.411764705882355
30855_marine,625,157,399,366,782,63.839999999999996,58.56
30856_marine,103,35,97,12,138,94.1747572815534,11.650485436893204
30857_marine,96,31,90,7,127,93.75,7.291666666666667
30858_marine,100,33,94,7,133,94,7.000000000000001
30859_marine,102,33,96,9,135,94.11764705882352,8.823529411764707
30860_marine,111,37,105,9,148,94.5945945945946,8.108108108108109
30861_marine,114,37,108,11,151,94.73684210526315,9.649122807017543
30862_marine,114,36,108,11,150,94.73684210526315,9.649122807017543
30863_marine,104,34,98,10,138,94.23076923076923,9.615384615384617
30864_marine,97,29,92,5,126,94.84536082474226,5.154639175257731
30865_marine,79,29,74,5,108,93.67088607594937,6.329113924050633
30866_marine,77,29,72,4,106,93.5064935064935,5.194805194805195
30867_marine,77,29,72,4,106,93.5064935064935,5.194805194805195
30868_marine,78,29,73,4,107,93.58974358974359,5.128205128205128
30869_marine,78,29,73,4,107,93.58974358974359,5.128205128205128
30870_marine,76,29,71,4,105,93.42105263157895,5.263157894736842
30871_marine,76,30,71,4,106,93.42105263157895,5.263157894736842
30872_marine,80,30,75,7,110,93.75,8.75
30873_marine,93,29,87,13,122,93.54838709677419,13.978494623655912
30874_marine,111,31,106,14,142,95.4954954954955,12.612612612612612
30875_marine,691,192,445,388,883,64.39942112879883,56.150506512301014
30880_marine,687,269,469,342,956,68.26783114992722,49.78165938864629
30885_marine,690,250,478,334,940,69.27536231884058,48.40579710144928
30886_marine,659,207,446,337,866,67.6783004552352,51.138088012139605
30887_marine,644,187,432,334,831,67.08074534161491,51.86335403726709
30890_marine,644,187,435,334,831,67.54658385093167,51.86335403726709
30891_marine,650,195,444,331,845,68.3076923076923,50.92307692307693
30892_marine,650,198,447,328,848,68.76923076923077,50.46153846153846
30893_marine,678,216,465,333,894,68.58407079646017,49.11504424778761
30900_marine,1120,465,717,649,1585,64.01785714285714,57.94642857142858
30901_marine,1053,404,669,624,1457,63.53276353276354,59.25925925925925
30902_marine,922,309,561,560,1231,60.84598698481562,60.73752711496746
30903_marine,112,26,105,17,138,93.75,15.178571428571427
30904_marine,116,26,109,17,142,93.96551724137932,14.655172413793101
30905_marine,956,337,576,578,1293,60.25104602510461,60.46025104602511
30906_marine,1042,398,645,615,1440,61.90019193857965,59.02111324376199
30908_marine,1002,392,624,600,1394,62.27544910179641,59.88023952095808
30909_marine,900,301,538,557,1201,59.77777777777777,61.88888888888889
30910_marine,108,29,101,20,137,93.51851851851852,18.51851851851852
30911_marine,108,30,101,18,138,93.51851851851852,16.666666666666664
30912_marine,704,229,455,424,933,64.63068181818183,60.22727272727273
30913_marine,701,232,450,421,933,64.19400855920114,60.05706134094151
30914_marine,645,157,411,396,802,63.72093023255814,61.395348837209305
30915_marine,103,31,97,13,134,94.1747572815534,12.62135922330097
30916_marine,103,31,97,12,134,94.1747572815534,11.650485436893204
30917_marine,97,31,91,12,128,93.81443298969072,12.371134020618557
30918_marine,96,31,91,11,127,94.79166666666666,11.458333333333332
30919_marine,97,31,92,11,128,94.84536082474226,11.34020618556701
30920_marine,96,30,91,10,126,94.79166666666666,10.416666666666668
30921_marine,96,30,91,10,126,94.79166666666666,10.416666666666668
30922_marine,96,30,91,10,126,94.79166666666666,10.416666666666668
30923_marine,96,30,91,10,126,94.79166666666666,10.416666666666668
30924_marine,96,30,91,10,126,94.79166666666666,10.416666666666668
30925_marine,96,30,91,10,126,94.79166666666666,10.416666666666668
30926_marine,96,31,91,10,127,94.79166666666666,10.416666666666668
30927_marine,94,31,89,10,125,94.68085106382979,10.638297872340425
30928_marine,96,31,91,10,127,94.79166666666666,10.416666666666668
30929_marine,97,31,92,11,128,94.84536082474226,11.34020618556701
30930_marine,98,31,93,11,129,94.89795918367348,11.224489795918368
30931_marine,97,30,92,10,127,94.84536082474226,10.309278350515463
30932_marine,97,32,92,10,129,94.84536082474226,10.309278350515463
30933_marine,546,125,366,328,671,67.03296703296702,60.07326007326007
30934_marine,547,127,367,328,674,67.09323583180988,59.96343692870201
30935_marine,547,127,367,328,674,67.09323583180988,59.96343692870201
30936_marine,98,33,93,9,131,94.89795918367348,9.183673469387756
30937_marine,563,141,371,340,704,65.89698046181172,60.39076376554174
30938_marine,563,143,371,340,706,65.89698046181172,60.39076376554174
30939_marine,98,33,93,9,131,94.89795918367348,9.183673469387756
30940_marine,98,34,93,9,132,94.89795918367348,9.183673469387756
30941_marine,98,34,93,9,132,94.89795918367348,9.183673469387756
30942_marine,103,36,98,11,139,95.14563106796116,10.679611650485436
30943_marine,585,127,383,355,712,65.47008547008546,60.68376068376068
30944_marine,585,128,383,355,713,65.47008547008546,60.68376068376068
30945_marine,102,37,97,11,139,95.09803921568627,10.784313725490197
30946_marine,100,38,95,11,138,95,11
30947_marine,100,38,95,11,138,95,11
30948_marine,595,165,375,374,760,63.02521008403361,62.857142857142854
30949_marine,635,190,407,396,825,64.09448818897637,62.36220472440945
30950_marine,597,168,377,374,765,63.14907872696818,62.6465661641541
30951_marine,593,161,373,374,754,62.900505902192236,63.06913996627319
30952_marine,599,161,381,370,760,63.60601001669449,61.769616026711184
30953_marine,610,172,388,378,782,63.60655737704918,61.967213114754095
30954_marine,510,128,346,314,638,67.84313725490196,61.568627450980394
30955_marine,99,40,94,10,139,94.94949494949495,10.1010101010101
30956_marine,98,40,93,9,138,94.89795918367348,9.183673469387756
30957_marine,100,41,95,9,141,95,9
30958_marine,100,41,94,8,141,94,8
30959_marine,100,41,94,8,141,94,8
30960_marine,99,41,93,8,140,93.93939393939394,8.080808080808081
30961_marine,99,41,93,8,140,93.93939393939394,8.080808080808081
30962_marine,99,41,93,8,140,93.93939393939394,8.080808080808081
30963_marine,99,41,93,8,140,93.93939393939394,8.080808080808081
30964_marine,99,41,93,8,140,93.93939393939394,8.080808080808081
30965_marine,101,41,95,8,142,94.05940594059405,7.920792079207921
30966_marine,101,41,95,8,142,94.05940594059405,7.920792079207921
30967_marine,101,41,95,8,142,94.05940594059405,7.920792079207921
30968_marine,101,41,95,8,142,94.05940594059405,7.920792079207921
30969_marine,101,41,95,8,142,94.05940594059405,7.920792079207921
30970_marine,99,41,93,8,140,93.93939393939394,8.080808080808081
30971_marine,97,41,91,8,138,93.81443298969072,8.24742268041237
30972_marine,97,40,91,8,137,93.81443298969072,8.24742268041237
30973_marine,97,41,91,8,138,93.81443298969072,8.24742268041237
30974_marine,97,41,91,8,138,93.81443298969072,8.24742268041237
30975_marine,99,41,93,10,140,93.93939393939394,10.1010101010101
30976_marine,99,43,93,10,142,93.93939393939394,10.1010101010101
30977_marine,100,43,94,11,143,94,11
30978_marine,100,44,94,11,144,94,11
30979_marine,397,104,277,236,501,69.77329974811083,59.44584382871536
30980_marine,398,104,278,236,502,69.84924623115577,59.2964824120603
30981_marine,422,120,298,246,542,70.61611374407583,58.29383886255924
30982_marine,398,107,280,236,505,70.35175879396985,59.2964824120603
30983_marine,101,45,95,11,146,94.05940594059405,10.891089108910892
30984_marine,99,43,93,11,142,93.93939393939394,11.11111111111111
30985_marine,96,44,90,10,140,93.75,10.416666666666668
30986_marine,95,44,89,10,139,93.6842105263158,10.526315789473683
30987_marine,92,44,86,7,136,93.47826086956522,7.608695652173914
30988_marine,91,44,85,7,135,93.4065934065934,7.6923076923076925
30989_marine,91,43,85,7,134,93.4065934065934,7.6923076923076925
30990_marine,91,42,85,7,133,93.4065934065934,7.6923076923076925
30991_marine,91,42,85,7,133,93.4065934065934,7.6923076923076925
30992_marine,91,42,85,7,133,93.4065934065934,7.6923076923076925
30993_marine,90,42,84,7,132,93.33333333333333,7.777777777777778
30994_marine,90,42,84,7,132,93.33333333333333,7.777777777777778
30995_marine,90,42,84,7,132,93.33333333333333,7.777777777777778
30996_marine,89,42,83,6,131,93.25842696629213,6.741573033707865
30997_marine,88,42,82,6,130,93.18181818181817,6.8181818181818175
30998_marine,89,41,83,6,130,93.25842696629213,6.741573033707865
30999_marine,87,41,81,6,128,93.10344827586206,6.896551724137931
31000_marine,85,40,80,5,125,94.11764705882352,5.88235294117647
31001_marine,85,40,80,5,125,94.11764705882352,5.88235294117647
31002_marine,85,40,80,5,125,94.11764705882352,5.88235294117647
31003_marine,85,40,80,5,125,94.11764705882352,5.88235294117647
31004_marine,85,40,80,5,125,94.11764705882352,5.88235294117647
31005_marine,85,40,80,5,125,94.11764705882352,5.88235294117647
31006_marine,85,40,80,4,125,94.11764705882352,4.705882352941177
31007_marine,85,39,80,4,124,94.11764705882352,4.705882352941177
31008_marine,86,38,81,4,124,94.18604651162791,4.651162790697675
31009_marine,86,38,81,4,124,94.18604651162791,4.651162790697675
31010_marine,85,38,80,3,123,94.11764705882352,3.5294117647058822
31011_marine,85,38,80,3,123,94.11764705882352,3.5294117647058822
31012_marine,83,37,78,3,120,93.97590361445783,3.614457831325301
31013_marine,83,39,78,3,122,93.97590361445783,3.614457831325301
31014_marine,83,39,78,3,122,93.97590361445783,3.614457831325301
31015_marine,83,41,78,3,124,93.97590361445783,3.614457831325301
31016_marine,83,41,78,3,124,93.97590361445783,3.614457831325301
31017_marine,85,41,80,5,126,94.11764705882352,5.88235294117647
31018_marine,86,41,81,5,127,94.18604651162791,5.813953488372093
31019_marine,86,41,81,5,127,94.18604651162791,5.813953488372093
31020_marine,86,41,81,5,127,94.18604651162791,5.813953488372093
31021_marine,86,41,81,5,127,94.18604651162791,5.813953488372093
31022_marine,85,42,80,5,127,94.11764705882352,5.88235294117647
31023_marine,86,42,81,5,128,94.18604651162791,5.813953488372093
31024_marine,85,43,80,5,128,94.11764705882352,5.88235294117647
31025_marine,85,44,80,5,129,94.11764705882352,5.88235294117647
31026_marine,85,44,80,5,129,94.11764705882352,5.88235294117647
31027_marine,85,43,80,5,128,94.11764705882352,5.88235294117647
31028_marine,85,43,80,5,128,94.11764705882352,5.88235294117647
31029_marine,84,43,79,5,127,94.04761904761905,5.952380952380952
31030_marine,85,43,80,5,128,94.11764705882352,5.88235294117647
31031_marine,84,45,79,5,129,94.04761904761905,5.952380952380952
31032_marine,83,45,79,5,128,95.18072289156626,6.024096385542169
31033_marine,83,46,79,5,129,95.18072289156626,6.024096385542169
31034_marine,85,46,81,5,131,95.29411764705881,5.88235294117647
31035_marine,85,47,81,5,132,95.29411764705881,5.88235294117647
31036_marine,85,48,81,5,133,95.29411764705881,5.88235294117647
31037_marine,85,46,81,5,131,95.29411764705881,5.88235294117647
31038_marine,91,47,87,5,138,95.6043956043956,5.4945054945054945
31039_marine,92,47,87,5,139,94.56521739130434,5.434782608695652
31040_marine,92,47,87,5,139,94.56521739130434,5.434782608695652
31041_marine,92,47,87,5,139,94.56521739130434,5.434782608695652
31042_marine,92,46,87,5,138,94.56521739130434,5.434782608695652
31043_marine,92,45,87,5,137,94.56521739130434,5.434782608695652
31044_marine,92,43,87,5,135,94.56521739130434,5.434782608695652
31045_marine,93,42,88,6,135,94.6236559139785,6.451612903225806
31046_marine,93,42,88,6,135,94.6236559139785,6.451612903225806
31047_marine,92,42,87,7,134,94.56521739130434,7.608695652173914
31048_marine,103,42,96,10,145,93.20388349514563,9.70873786407767
31049_marine,102,43,94,11,145,92.15686274509804,10.784313725490197
31050_marine,99,44,92,10,143,92.92929292929293,10.1010101010101
31051_marine,94,43,87,8,137,92.5531914893617,8.51063829787234
31052_marine,95,46,88,8,141,92.63157894736842,8.421052631578947
31053_marine,99,46,92,10,145,92.92929292929293,10.1010101010101
31054_marine,100,45,92,11,145,92,11
31055_marine,100,45,92,11,145,92,11
31056_marine,99,45,91,11,144,91.91919191919192,11.11111111111111
31057_marine,99,47,91,12,146,91.91919191919192,12.121212121212121
31058_marine,192,100,142,63,292,73.95833333333334,32.8125
31059_marine,220,121,157,83,341,71.36363636363636,37.72727272727273
31060_marine,196,98,146,62,294,74.48979591836735,31.63265306122449
31061_marine,286,196,230,66,482,80.41958041958041,23.076923076923077
31091_marine,259,172,220,57,431,84.94208494208493,22.00772200772201
31092_marine,255,168,217,54,423,85.09803921568627,21.176470588235293
31093_marine,95,60,90,5,155,94.73684210526315,5.263157894736842
31094_marine,98,42,93,5,140,94.89795918367348,5.1020408163265305
31095_marine,95,38,90,5,133,94.73684210526315,5.263157894736842
31096_marine,98,36,93,5,134,94.89795918367348,5.1020408163265305
31097_marine,94,37,89,5,131,94.68085106382979,5.319148936170213
31098_marine,95,35,90,5,130,94.73684210526315,5.263157894736842
31099_marine,93,35,88,5,128,94.6236559139785,5.376344086021505
31100_marine,94,35,88,5,129,93.61702127659575,5.319148936170213
31101_marine,91,35,85,5,126,93.4065934065934,5.4945054945054945
31102_marine,88,35,82,5,123,93.18181818181817,5.681818181818182
31103_marine,88,35,82,5,123,93.18181818181817,5.681818181818182
31104_marine,88,37,82,5,125,93.18181818181817,5.681818181818182
31105_marine,88,37,82,5,125,93.18181818181817,5.681818181818182
31106_marine,88,36,82,5,124,93.18181818181817,5.681818181818182
31107_marine,89,36,85,3,125,95.50561797752809,3.3707865168539324
31108_marine,89,36,85,3,125,95.50561797752809,3.3707865168539324
31109_marine,90,36,86,3,126,95.55555555555556,3.3333333333333335
31110_marine,92,36,88,5,128,95.65217391304348,5.434782608695652
31111_marine,94,35,90,5,129,95.74468085106383,5.319148936170213
31112_marine,96,37,92,5,133,95.83333333333334,5.208333333333334
31113_marine,91,37,87,2,128,95.6043956043956,2.197802197802198
31114_marine,90,37,85,2,127,94.44444444444444,2.2222222222222223
31115_marine,91,37,86,2,128,94.5054945054945,2.197802197802198
31116_marine,93,35,88,2,128,94.6236559139785,2.1505376344086025
31117_marine,92,35,87,2,127,94.56521739130434,2.1739130434782608
31118_marine,90,35,85,2,125,94.44444444444444,2.2222222222222223
31119_marine,88,35,83,2,123,94.31818181818183,2.272727272727273
31120_marine,91,35,85,3,126,93.4065934065934,3.296703296703297
31121_marine,91,33,85,3,124,93.4065934065934,3.296703296703297
31122_marine,91,33,85,3,124,93.4065934065934,3.296703296703297
31123_marine,92,33,86,3,125,93.47826086956522,3.260869565217391
31124_marine,91,33,85,3,124,93.4065934065934,3.296703296703297
31125_marine,95,35,89,3,130,93.6842105263158,3.1578947368421053
31126_marine,97,35,91,3,132,93.81443298969072,3.0927835051546393
31127_marine,101,33,95,3,134,94.05940594059405,2.9702970297029703
31128_marine,103,35,97,3,138,94.1747572815534,2.912621359223301
31129_marine,108,35,102,6,143,94.44444444444444,5.555555555555555
31130_marine,105,35,100,5,140,95.23809523809523,4.761904761904762
31131_marine,262,115,236,36,377,90.07633587786259,13.740458015267176
31132_marine,281,118,252,38,399,89.6797153024911,13.523131672597867
31133_marine,288,126,257,41,414,89.23611111111111,14.23611111111111
31134_marine,270,114,240,37,384,88.88888888888889,13.703703703703704
31135_marine,118,52,110,11,170,93.22033898305084,9.322033898305085
31136_marine,106,35,100,8,141,94.33962264150944,7.547169811320755
31137_marine,110,50,101,8,160,91.81818181818183,7.2727272727272725
31138_marine,267,115,237,36,382,88.76404494382022,13.48314606741573
31139_marine,268,110,239,37,378,89.17910447761194,13.805970149253731
31140_marine,115,44,105,10,159,91.30434782608695,8.695652173913043
31141_marine,100,35,93,9,135,93,9
31142_marine,101,35,94,10,136,93.06930693069307,9.900990099009901
31143_marine,98,36,91,10,134,92.85714285714286,10.204081632653061
31144_marine,98,36,91,10,134,92.85714285714286,10.204081632653061
31145_marine,253,120,225,37,373,88.93280632411067,14.624505928853754
31146_marine,279,135,248,42,414,88.88888888888889,15.053763440860216
31147_marine,278,139,248,43,417,89.20863309352518,15.467625899280577
31148_marine,276,142,246,43,418,89.13043478260869,15.579710144927535
31187_marine,745,300,488,415,1045,65.50335570469798,55.70469798657718
31188_marine,707,279,480,381,986,67.89250353606789,53.88967468175389
31189_marine,555,166,389,295,721,70.09009009009009,53.153153153153156
31190_marine,105,39,99,10,144,94.28571428571428,9.523809523809524
31191_marine,100,34,94,10,134,94,10
31192_marine,96,34,91,8,130,94.79166666666666,8.333333333333332
31193_marine,92,33,87,9,125,94.56521739130434,9.782608695652174
31194_marine,82,33,77,7,115,93.90243902439023,8.536585365853659
31195_marine,82,33,77,8,115,93.90243902439023,9.75609756097561
31196_marine,82,32,77,8,114,93.90243902439023,9.75609756097561
31197_marine,82,32,77,8,114,93.90243902439023,9.75609756097561
31198_marine,80,32,75,7,112,93.75,8.75
31199_marine,80,32,75,7,112,93.75,8.75
31200_marine,80,32,75,7,112,93.75,8.75
31201_marine,80,32,75,7,112,93.75,8.75
31202_marine,80,32,75,7,112,93.75,8.75
31203_marine,81,32,76,8,113,93.82716049382715,9.876543209876543
31204_marine,81,32,76,8,113,93.82716049382715,9.876543209876543
31205_marine,81,32,76,8,113,93.82716049382715,9.876543209876543
31206_marine,80,32,75,7,112,93.75,8.75
31207_marine,80,32,75,7,112,93.75,8.75
31208_marine,81,32,76,7,113,93.82716049382715,8.641975308641975
31209_marine,81,32,76,7,113,93.82716049382715,8.641975308641975
31210_marine,84,33,79,9,117,94.04761904761905,10.714285714285714
31211_marine,88,38,83,9,126,94.31818181818183,10.227272727272728
31212_marine,613,150,387,362,763,63.132137030995104,59.05383360522023
31213_marine,671,168,432,400,839,64.38152011922503,59.61251862891207
31214_marine,673,170,434,400,843,64.48736998514116,59.43536404160476
31215_marine,621,153,395,365,774,63.60708534621578,58.77616747181964
31216_marine,95,35,90,12,130,94.73684210526315,12.631578947368421
31217_marine,89,33,83,7,122,93.25842696629213,7.865168539325842
31218_marine,93,32,87,7,125,93.54838709677419,7.526881720430108
31219_marine,94,32,88,7,126,93.61702127659575,7.446808510638298
31220_marine,91,32,85,7,123,93.4065934065934,7.6923076923076925
31221_marine,91,31,85,7,122,93.4065934065934,7.6923076923076925
31222_marine,88,30,82,7,118,93.18181818181817,7.954545454545454
31223_marine,84,29,79,5,113,94.04761904761905,5.952380952380952
31224_marine,80,29,75,5,109,93.75,6.25
31225_marine,78,29,73,5,107,93.58974358974359,6.41025641025641
31226_marine,79,29,74,5,108,93.67088607594937,6.329113924050633
31227_marine,78,29,73,4,107,93.58974358974359,5.128205128205128
31228_marine,78,29,73,4,107,93.58974358974359,5.128205128205128
31229_marine,78,29,73,4,107,93.58974358974359,5.128205128205128
31230_marine,76,29,71,4,105,93.42105263157895,5.263157894736842
31231_marine,76,29,71,4,105,93.42105263157895,5.263157894736842
31232_marine,78,30,73,5,108,93.58974358974359,6.41025641025641
31233_marine,84,29,78,9,113,92.85714285714286,10.714285714285714
31234_marine,112,29,106,14,141,94.64285714285714,12.5
31235_marine,699,196,439,404,895,62.80400572246065,57.79685264663805
31236_marine,751,253,484,419,1004,64.4474034620506,55.792276964047936
31245_marine,716,277,498,342,993,69.55307262569832,47.76536312849162
31250_marine,717,242,495,346,959,69.0376569037657,48.25662482566248
31251_marine,692,235,477,334,927,68.9306358381503,48.26589595375722
31252_marine,781,280,550,384,1061,70.4225352112676,49.167733674775924
31259_marine,928,315,577,540,1243,62.17672413793104,58.189655172413794
31260_marine,940,319,579,555,1259,61.59574468085106,59.04255319148937
31261_marine,898,285,554,538,1183,61.69265033407573,59.910913140311806
31262_marine,108,27,101,15,135,93.51851851851852,13.88888888888889
31263_marine,114,26,107,19,140,93.85964912280701,16.666666666666664
31264_marine,116,28,109,21,144,93.96551724137932,18.103448275862068
31265_marine,935,340,561,568,1275,60,60.748663101604286
31266_marine,1103,448,685,662,1551,62.103354487760654,60.018132366273804
31268_marine,951,373,563,588,1324,59.20084121976866,61.82965299684543
31269_marine,938,363,550,578,1301,58.63539445628998,61.62046908315565
31270_marine,922,333,540,576,1255,58.56832971800434,62.47288503253796
31271_marine,665,182,429,409,847,64.51127819548871,61.503759398496236
31272_marine,721,247,467,437,968,64.77115117891817,60.61026352288488
31273_marine,667,183,429,409,850,64.31784107946027,61.31934032983508
31274_marine,647,157,413,399,804,63.83307573415765,61.66924265842349
31275_marine,107,30,100,16,137,93.45794392523365,14.953271028037381
31276_marine,107,30,101,16,137,94.39252336448598,14.953271028037381
31277_marine,101,30,95,12,131,94.05940594059405,11.881188118811881
31278_marine,101,30,95,12,131,94.05940594059405,11.881188118811881
31279_marine,97,30,92,11,127,94.84536082474226,11.34020618556701
31280_marine,97,30,92,11,127,94.84536082474226,11.34020618556701
31281_marine,97,30,92,11,127,94.84536082474226,11.34020618556701
31282_marine,97,30,92,11,127,94.84536082474226,11.34020618556701
31283_marine,97,30,92,11,127,94.84536082474226,11.34020618556701
31284_marine,96,30,91,10,126,94.79166666666666,10.416666666666668
31285_marine,96,30,91,10,126,94.79166666666666,10.416666666666668
31286_marine,96,30,91,10,126,94.79166666666666,10.416666666666668
31287_marine,96,30,91,10,126,94.79166666666666,10.416666666666668
31288_marine,94,30,89,10,124,94.68085106382979,10.638297872340425
31289_marine,96,31,91,10,127,94.79166666666666,10.416666666666668
31290_marine,98,31,93,11,129,94.89795918367348,11.224489795918368
31291_marine,98,30,93,11,128,94.89795918367348,11.224489795918368
31292_marine,98,32,93,11,130,94.89795918367348,11.224489795918368
31293_marine,98,32,93,11,130,94.89795918367348,11.224489795918368
31294_marine,98,33,93,10,131,94.89795918367348,10.204081632653061
31295_marine,157,96,131,43,253,83.43949044585987,27.388535031847134
31296_marine,123,41,107,27,164,86.99186991869918,21.951219512195124
31297_marine,98,33,93,9,131,94.89795918367348,9.183673469387756
31298_marine,98,33,93,9,131,94.89795918367348,9.183673469387756
31299_marine,98,33,93,9,131,94.89795918367348,9.183673469387756
31300_marine,98,33,93,9,131,94.89795918367348,9.183673469387756
31301_marine,98,33,93,9,131,94.89795918367348,9.183673469387756
31302_marine,99,33,94,9,132,94.94949494949495,9.090909090909092
31303_marine,101,34,96,11,135,95.04950495049505,10.891089108910892
31304_marine,101,36,96,11,137,95.04950495049505,10.891089108910892
31305_marine,102,36,97,11,138,95.09803921568627,10.784313725490197
31306_marine,100,38,95,11,138,95,11
31307_marine,100,38,95,11,138,95,11
31308_marine,100,41,95,11,141,95,11
31309_marine,589,165,375,368,754,63.66723259762309,62.478777589134125
31310_marine,591,165,377,368,756,63.7901861252115,62.2673434856176
31311_marine,103,40,98,11,143,95.14563106796116,10.679611650485436
31312_marine,511,128,347,314,639,67.90606653620353,61.44814090019569
31313_marine,547,151,378,330,698,69.10420475319927,60.3290676416819
31314_marine,548,150,378,330,698,68.97810218978103,60.21897810218978
31315_marine,101,41,95,10,142,94.05940594059405,9.900990099009901
31316_marine,101,40,95,10,141,94.05940594059405,9.900990099009901
31317_marine,100,40,94,9,140,94,9
31318_marine,99,40,93,8,139,93.93939393939394,8.080808080808081
31319_marine,98,41,92,8,139,93.87755102040816,8.16326530612245
31320_marine,99,41,93,8,140,93.93939393939394,8.080808080808081
31321_marine,98,43,92,8,141,93.87755102040816,8.16326530612245
31322_marine,98,43,92,8,141,93.87755102040816,8.16326530612245
31323_marine,98,41,92,8,139,93.87755102040816,8.16326530612245
31324_marine,98,41,92,8,139,93.87755102040816,8.16326530612245
31325_marine,100,41,94,8,141,94,8
31326_marine,101,41,95,8,142,94.05940594059405,7.920792079207921
31327_marine,101,41,95,8,142,94.05940594059405,7.920792079207921
31328_marine,99,41,93,8,140,93.93939393939394,8.080808080808081
31329_marine,99,41,93,8,140,93.93939393939394,8.080808080808081
31330_marine,99,41,93,8,140,93.93939393939394,8.080808080808081
31331_marine,99,41,93,8,140,93.93939393939394,8.080808080808081
31332_marine,97,41,91,8,138,93.81443298969072,8.24742268041237
31333_marine,97,41,91,8,138,93.81443298969072,8.24742268041237
31334_marine,97,41,91,8,138,93.81443298969072,8.24742268041237
31335_marine,97,42,91,8,139,93.81443298969072,8.24742268041237
31336_marine,97,43,91,8,140,93.81443298969072,8.24742268041237
31337_marine,97,43,91,8,140,93.81443298969072,8.24742268041237
31338_marine,98,43,92,9,141,93.87755102040816,9.183673469387756
31339_marine,97,43,91,8,140,93.81443298969072,8.24742268041237
31340_marine,99,43,93,8,142,93.93939393939394,8.080808080808081
31341_marine,396,102,278,234,498,70.2020202020202,59.09090909090909
31342_marine,410,109,286,246,519,69.7560975609756,60
31343_marine,424,120,299,248,544,70.51886792452831,58.490566037735846
31344_marine,405,108,283,245,513,69.87654320987654,60.49382716049383
31345_marine,98,42,92,10,140,93.87755102040816,10.204081632653061
31346_marine,94,43,88,8,137,93.61702127659575,8.51063829787234
31347_marine,93,44,87,8,137,93.54838709677419,8.60215053763441
31348_marine,93,44,87,8,137,93.54838709677419,8.60215053763441
31349_marine,91,43,85,7,134,93.4065934065934,7.6923076923076925
31350_marine,92,42,86,7,134,93.47826086956522,7.608695652173914
31351_marine,92,42,86,7,134,93.47826086956522,7.608695652173914
31352_marine,92,41,86,7,133,93.47826086956522,7.608695652173914
31353_marine,91,41,85,7,132,93.4065934065934,7.6923076923076925
31354_marine,91,41,85,7,132,93.4065934065934,7.6923076923076925
31355_marine,92,41,86,7,133,93.47826086956522,7.608695652173914
31356_marine,90,42,84,6,132,93.33333333333333,6.666666666666667
31357_marine,89,42,83,6,131,93.25842696629213,6.741573033707865
31358_marine,89,42,83,6,131,93.25842696629213,6.741573033707865
31359_marine,89,41,83,6,130,93.25842696629213,6.741573033707865
31360_marine,87,41,81,6,128,93.10344827586206,6.896551724137931
31361_marine,86,40,81,5,126,94.18604651162791,5.813953488372093
31362_marine,88,40,83,7,128,94.31818181818183,7.954545454545454
31363_marine,87,40,82,7,127,94.25287356321839,8.045977011494253
31364_marine,87,40,82,7,127,94.25287356321839,8.045977011494253
31365_marine,87,39,82,7,126,94.25287356321839,8.045977011494253
31366_marine,87,39,82,7,126,94.25287356321839,8.045977011494253
31367_marine,88,39,83,7,127,94.31818181818183,7.954545454545454
31368_marine,88,39,83,6,127,94.31818181818183,6.8181818181818175
31369_marine,88,38,83,6,126,94.31818181818183,6.8181818181818175
31370_marine,88,38,83,6,126,94.31818181818183,6.8181818181818175
31371_marine,87,37,82,5,124,94.25287356321839,5.747126436781609
31372_marine,87,37,82,5,124,94.25287356321839,5.747126436781609
31373_marine,87,39,82,5,126,94.25287356321839,5.747126436781609
31374_marine,86,39,81,5,125,94.18604651162791,5.813953488372093
31375_marine,84,39,79,5,123,94.04761904761905,5.952380952380952
31376_marine,84,41,79,5,125,94.04761904761905,5.952380952380952
31377_marine,84,41,79,5,125,94.04761904761905,5.952380952380952
31378_marine,85,41,80,5,126,94.11764705882352,5.88235294117647
31379_marine,85,41,80,5,126,94.11764705882352,5.88235294117647
31380_marine,85,41,80,5,126,94.11764705882352,5.88235294117647
31381_marine,85,41,80,5,126,94.11764705882352,5.88235294117647
31382_marine,86,42,81,5,128,94.18604651162791,5.813953488372093
31383_marine,87,43,82,5,130,94.25287356321839,5.747126436781609
31384_marine,86,44,81,5,130,94.18604651162791,5.813953488372093
31385_marine,86,44,81,5,130,94.18604651162791,5.813953488372093
31386_marine,86,44,81,5,130,94.18604651162791,5.813953488372093
31387_marine,86,44,81,5,130,94.18604651162791,5.813953488372093
31388_marine,85,43,80,5,128,94.11764705882352,5.88235294117647
31389_marine,85,44,80,5,129,94.11764705882352,5.88235294117647
31390_marine,87,44,82,5,131,94.25287356321839,5.747126436781609
31391_marine,86,44,81,5,130,94.18604651162791,5.813953488372093
31392_marine,86,45,81,5,131,94.18604651162791,5.813953488372093
31393_marine,86,45,81,5,131,94.18604651162791,5.813953488372093
31394_marine,86,46,81,5,132,94.18604651162791,5.813953488372093
31395_marine,86,47,81,5,133,94.18604651162791,5.813953488372093
31396_marine,88,46,83,5,134,94.31818181818183,5.681818181818182
31397_marine,87,47,83,5,134,95.40229885057471,5.747126436781609
31398_marine,87,45,83,5,132,95.40229885057471,5.747126436781609
31399_marine,91,46,87,5,137,95.6043956043956,5.4945054945054945
31400_marine,91,46,87,5,137,95.6043956043956,5.4945054945054945
31401_marine,92,46,87,5,138,94.56521739130434,5.434782608695652
31402_marine,92,46,87,5,138,94.56521739130434,5.434782608695652
31403_marine,92,44,87,5,136,94.56521739130434,5.434782608695652
31404_marine,92,44,87,5,136,94.56521739130434,5.434782608695652
31405_marine,94,43,89,5,137,94.68085106382979,5.319148936170213
31406_marine,95,41,90,6,136,94.73684210526315,6.315789473684211
31407_marine,101,42,95,8,143,94.05940594059405,7.920792079207921
31408_marine,165,94,145,31,259,87.87878787878788,18.787878787878785
31409_marine,164,90,143,32,254,87.1951219512195,19.51219512195122
31410_marine,109,42,101,15,151,92.66055045871559,13.761467889908257
31411_marine,107,42,100,13,149,93.45794392523365,12.149532710280374
31412_marine,104,44,97,11,148,93.26923076923077,10.576923076923077
31413_marine,101,45,94,13,146,93.06930693069307,12.871287128712872
31414_marine,103,45,96,13,148,93.20388349514563,12.62135922330097
31415_marine,104,44,96,14,148,92.3076923076923,13.461538461538462
31416_marine,102,46,94,13,148,92.15686274509804,12.745098039215685
31417_marine,100,45,92,13,145,92,13
31418_marine,102,46,94,14,148,92.15686274509804,13.725490196078432
31419_marine,104,45,96,14,149,92.3076923076923,13.461538461538462
31420_marine,110,51,102,15,161,92.72727272727272,13.636363636363635
31421_marine,299,209,240,72,508,80.2675585284281,24.08026755852843
31451_marine,259,158,219,59,417,84.55598455598455,22.779922779922778
31452_marine,257,161,217,58,418,84.43579766536965,22.56809338521401
31453_marine,253,162,213,56,415,84.18972332015811,22.134387351778656
31454_marine,96,46,91,5,142,94.79166666666666,5.208333333333334
31455_marine,98,40,93,5,138,94.89795918367348,5.1020408163265305
31456_marine,99,36,94,6,135,94.94949494949495,6.0606060606060606
31457_marine,100,36,95,6,136,95,6
31458_marine,102,36,97,6,138,95.09803921568627,5.88235294117647
31459_marine,95,35,90,5,130,94.73684210526315,5.263157894736842
31460_marine,93,35,88,5,128,94.6236559139785,5.376344086021505
31461_marine,94,35,88,5,129,93.61702127659575,5.319148936170213
31462_marine,94,35,88,5,129,93.61702127659575,5.319148936170213
31463_marine,90,35,84,5,125,93.33333333333333,5.555555555555555
31464_marine,90,35,84,5,125,93.33333333333333,5.555555555555555
31465_marine,90,39,84,5,129,93.33333333333333,5.555555555555555
31466_marine,90,39,84,5,129,93.33333333333333,5.555555555555555
31467_marine,89,39,85,3,128,95.50561797752809,3.3707865168539324
31468_marine,89,39,85,3,128,95.50561797752809,3.3707865168539324
31469_marine,90,38,86,3,128,95.55555555555556,3.3333333333333335
31470_marine,92,38,88,3,130,95.65217391304348,3.260869565217391
31471_marine,104,42,96,11,146,92.3076923076923,10.576923076923077
31472_marine,104,43,96,11,147,92.3076923076923,10.576923076923077
31473_marine,98,44,90,9,142,91.83673469387756,9.183673469387756
31474_marine,90,38,86,3,128,95.55555555555556,3.3333333333333335
31475_marine,92,38,87,2,130,94.56521739130434,2.1739130434782608
31476_marine,93,36,88,2,129,94.6236559139785,2.1505376344086025
31477_marine,92,36,87,2,128,94.56521739130434,2.1739130434782608
31478_marine,90,36,85,2,126,94.44444444444444,2.2222222222222223
31479_marine,90,36,85,2,126,94.44444444444444,2.2222222222222223
31480_marine,89,35,83,3,124,93.25842696629213,3.3707865168539324
31481_marine,90,35,84,3,125,93.33333333333333,3.3333333333333335
31482_marine,90,33,84,3,123,93.33333333333333,3.3333333333333335
31483_marine,89,33,83,3,122,93.25842696629213,3.3707865168539324
31484_marine,89,33,83,3,122,93.25842696629213,3.3707865168539324
31485_marine,96,33,90,4,129,93.75,4.166666666666666
31486_marine,98,35,92,4,133,93.87755102040816,4.081632653061225
31487_marine,98,35,92,4,133,93.87755102040816,4.081632653061225
31488_marine,100,35,94,4,135,94,4
31489_marine,103,34,97,4,137,94.1747572815534,3.8834951456310676
31490_marine,102,34,96,4,136,94.11764705882352,3.9215686274509802
31491_marine,105,36,99,4,141,94.28571428571428,3.8095238095238098
31492_marine,105,37,99,5,142,94.28571428571428,4.761904761904762
31493_marine,107,37,101,7,144,94.39252336448598,6.5420560747663545
31494_marine,106,37,100,6,143,94.33962264150944,5.660377358490567
31495_marine,105,35,99,6,140,94.28571428571428,5.714285714285714
31496_marine,103,35,97,6,138,94.1747572815534,5.825242718446602
31497_marine,102,35,96,6,137,94.11764705882352,5.88235294117647
31498_marine,102,36,96,6,138,94.11764705882352,5.88235294117647
31499_marine,101,36,94,7,137,93.06930693069307,6.9306930693069315
31500_marine,100,37,93,7,137,93,7.000000000000001
31501_marine,93,36,86,6,129,92.47311827956989,6.451612903225806
31502_marine,93,36,86,6,129,92.47311827956989,6.451612903225806
31503_marine,92,36,85,6,128,92.3913043478261,6.521739130434782
31504_marine,92,34,85,6,126,92.3913043478261,6.521739130434782
31505_marine,89,36,82,6,125,92.13483146067416,6.741573033707865
31506_marine,99,47,92,8,146,92.92929292929293,8.080808080808081
31507_marine,222,101,197,40,323,88.73873873873875,18.01801801801802
31508_marine,262,133,233,47,395,88.93129770992367,17.938931297709924
31509_marine,278,144,246,50,422,88.48920863309353,17.985611510791365
31547_marine,789,347,503,451,1136,63.751584283903675,57.16096324461344
31548_marine,557,169,387,299,726,69.47935368043088,53.680430879712745
31549_marine,108,38,101,13,146,93.51851851851852,12.037037037037036
31550_marine,100,33,94,11,133,94,11
31551_marine,98,34,93,11,132,94.89795918367348,11.224489795918368
31552_marine,93,33,88,9,126,94.6236559139785,9.67741935483871
31553_marine,82,33,77,7,115,93.90243902439023,8.536585365853659
31554_marine,81,33,76,7,114,93.82716049382715,8.641975308641975
31555_marine,81,33,76,7,114,93.82716049382715,8.641975308641975
31556_marine,82,32,77,8,114,93.90243902439023,9.75609756097561
31557_marine,81,32,76,8,113,93.82716049382715,9.876543209876543
31558_marine,81,32,76,8,113,93.82716049382715,9.876543209876543
31559_marine,81,32,76,8,113,93.82716049382715,9.876543209876543
31560_marine,81,32,76,8,113,93.82716049382715,9.876543209876543
31561_marine,81,32,76,8,113,93.82716049382715,9.876543209876543
31562_marine,81,32,76,8,113,93.82716049382715,9.876543209876543
31563_marine,81,32,76,8,113,93.82716049382715,9.876543209876543
31564_marine,81,32,76,8,113,93.82716049382715,9.876543209876543
31565_marine,81,32,76,8,113,93.82716049382715,9.876543209876543
31566_marine,80,32,75,7,112,93.75,8.75
31567_marine,80,33,75,7,113,93.75,8.75
31568_marine,81,33,76,7,114,93.82716049382715,8.641975308641975
31569_marine,81,33,76,7,114,93.82716049382715,8.641975308641975
31570_marine,84,33,79,9,117,94.04761904761905,10.714285714285714
31571_marine,84,38,79,9,122,94.04761904761905,10.714285714285714
31572_marine,608,150,383,361,758,62.99342105263158,59.375
31573_marine,670,168,431,400,838,64.32835820895522,59.70149253731343
31574_marine,672,168,433,400,840,64.43452380952381,59.523809523809526
31575_marine,621,153,395,365,774,63.60708534621578,58.77616747181964
31576_marine,95,36,90,12,131,94.73684210526315,12.631578947368421
31577_marine,88,33,83,7,121,94.31818181818183,7.954545454545454
31578_marine,89,33,84,7,122,94.3820224719101,7.865168539325842
31579_marine,91,33,85,7,124,93.4065934065934,7.6923076923076925
31580_marine,90,32,84,7,122,93.33333333333333,7.777777777777778
31581_marine,89,30,83,7,119,93.25842696629213,7.865168539325842
31582_marine,85,29,79,7,114,92.94117647058823,8.235294117647058
31583_marine,82,29,77,6,111,93.90243902439023,7.317073170731707
31584_marine,81,29,76,5,110,93.82716049382715,6.172839506172839
31585_marine,79,29,74,5,108,93.67088607594937,6.329113924050633
31586_marine,79,29,74,5,108,93.67088607594937,6.329113924050633
31587_marine,78,29,73,4,107,93.58974358974359,5.128205128205128
31588_marine,78,29,73,4,107,93.58974358974359,5.128205128205128
31589_marine,78,29,73,4,107,93.58974358974359,5.128205128205128
31590_marine,78,29,73,4,107,93.58974358974359,5.128205128205128
31591_marine,76,29,71,4,105,93.42105263157895,5.263157894736842
31592_marine,77,30,72,5,107,93.5064935064935,6.493506493506493
31593_marine,81,29,76,6,110,93.82716049382715,7.4074074074074066
31594_marine,101,29,95,14,130,94.05940594059405,13.861386138613863
31595_marine,675,195,428,387,870,63.40740740740741,57.333333333333336
31607_marine,780,287,540,388,1067,69.23076923076923,49.743589743589745
31608_marine,789,284,547,394,1073,69.32826362484157,49.93662864385298
31611_marine,782,279,551,387,1061,70.46035805626599,49.48849104859335
31613_marine,1122,628,728,645,1750,64.88413547237076,57.48663101604278
31620_marine,883,274,541,527,1157,61.268403171007925,59.68289920724802
31621_marine,941,318,567,575,1259,60.255047821466526,61.10520722635494
31622_marine,926,316,550,570,1242,59.395248380129594,61.55507559395248
31623_marine,927,316,557,569,1243,60.08629989212514,61.38079827400216
31624_marine,922,333,554,567,1255,60.08676789587852,61.49674620390455
31625_marine,967,371,573,593,1338,59.25542916235781,61.32368148914168
31626_marine,1094,455,667,657,1549,60.96892138939671,60.054844606946986
31627_marine,960,371,561,598,1331,58.4375,62.291666666666664
31630_marine,942,361,551,581,1303,58.49256900212314,61.67728237791932
31631_marine,667,184,428,412,851,64.16791604197901,61.76911544227887
31632_marine,707,247,458,427,954,64.78076379066479,60.396039603960396
31633_marine,660,170,425,407,830,64.39393939393939,61.66666666666667
31634_marine,115,30,107,18,145,93.04347826086956,15.65217391304348
31635_marine,110,30,103,16,140,93.63636363636364,14.545454545454545
31636_marine,109,30,102,16,139,93.57798165137615,14.678899082568808
31637_marine,109,30,103,16,139,94.4954128440367,14.678899082568808
31638_marine,109,30,103,16,139,94.4954128440367,14.678899082568808
31639_marine,105,30,100,15,135,95.23809523809523,14.285714285714285
31640_marine,103,30,98,15,133,95.14563106796116,14.563106796116504
31641_marine,95,30,90,11,125,94.73684210526315,11.578947368421053
31642_marine,95,30,90,11,125,94.73684210526315,11.578947368421053
31643_marine,95,30,90,11,125,94.73684210526315,11.578947368421053
31644_marine,95,30,90,11,125,94.73684210526315,11.578947368421053
31645_marine,95,30,90,11,125,94.73684210526315,11.578947368421053
31646_marine,94,30,89,10,124,94.68085106382979,10.638297872340425
31647_marine,94,30,89,10,124,94.68085106382979,10.638297872340425
31648_marine,94,30,89,10,124,94.68085106382979,10.638297872340425
31649_marine,92,30,87,10,122,94.56521739130434,10.869565217391305
31650_marine,94,30,89,10,124,94.68085106382979,10.638297872340425
31651_marine,95,30,90,10,125,94.73684210526315,10.526315789473683
31652_marine,95,30,90,10,125,94.73684210526315,10.526315789473683
31653_marine,96,32,91,11,128,94.79166666666666,11.458333333333332
31654_marine,99,33,94,11,132,94.94949494949495,11.11111111111111
31655_marine,156,33,119,53,189,76.28205128205127,33.97435897435898
31656_marine,156,33,119,53,189,76.28205128205127,33.97435897435898
31657_marine,99,33,94,10,132,94.94949494949495,10.1010101010101
31658_marine,98,33,93,9,131,94.89795918367348,9.183673469387756
31659_marine,98,35,93,9,133,94.89795918367348,9.183673469387756
31660_marine,98,35,93,9,133,94.89795918367348,9.183673469387756
31661_marine,99,33,94,10,132,94.94949494949495,10.1010101010101
31662_marine,100,34,95,10,134,95,10
31663_marine,101,34,96,10,135,95.04950495049505,9.900990099009901
31664_marine,100,34,95,10,134,95,10
31665_marine,99,36,94,10,135,94.94949494949495,10.1010101010101
31666_marine,99,37,94,10,136,94.94949494949495,10.1010101010101
31667_marine,101,38,96,10,139,95.04950495049505,9.900990099009901
31668_marine,102,38,97,11,140,95.09803921568627,10.784313725490197
31669_marine,102,38,97,11,140,95.09803921568627,10.784313725490197
31670_marine,103,38,98,11,141,95.14563106796116,10.679611650485436
31671_marine,104,40,98,11,144,94.23076923076923,10.576923076923077
31672_marine,514,129,349,314,643,67.89883268482491,61.08949416342413
31673_marine,521,134,356,315,655,68.33013435700576,60.46065259117083
31674_marine,548,153,378,330,701,68.97810218978103,60.21897810218978
31675_marine,513,131,348,314,644,67.83625730994152,61.20857699805068
31676_marine,101,40,95,10,141,94.05940594059405,9.900990099009901
31677_marine,100,40,94,9,140,94,9
31678_marine,99,42,93,8,141,93.93939393939394,8.080808080808081
31679_marine,99,42,93,8,141,93.93939393939394,8.080808080808081
31680_marine,99,42,93,8,141,93.93939393939394,8.080808080808081
31681_marine,98,42,92,8,140,93.87755102040816,8.16326530612245
31682_marine,98,42,92,8,140,93.87755102040816,8.16326530612245
31683_marine,443,106,301,268,549,67.94582392776523,60.496613995485326
31684_marine,443,105,301,268,548,67.94582392776523,60.496613995485326
31685_marine,446,103,304,268,549,68.16143497757847,60.0896860986547
31686_marine,100,41,94,8,141,94,8
31687_marine,100,41,94,8,141,94,8
31688_marine,100,41,94,8,141,94,8
31689_marine,100,41,94,8,141,94,8
31690_marine,100,41,94,8,141,94,8
31691_marine,100,41,94,8,141,94,8
31692_marine,100,41,94,8,141,94,8
31693_marine,100,41,94,8,141,94,8
31694_marine,100,42,94,10,142,94,10
31695_marine,100,43,94,10,143,94,10
31696_marine,100,43,94,10,143,94,10
31697_marine,100,43,94,10,143,94,10
31698_marine,101,43,95,11,144,94.05940594059405,10.891089108910892
31699_marine,99,43,93,9,142,93.93939393939394,9.090909090909092
31700_marine,99,43,93,9,142,93.93939393939394,9.090909090909092
31701_marine,98,43,92,8,141,93.87755102040816,8.16326530612245
31702_marine,406,107,284,244,513,69.95073891625616,60.09852216748769
31703_marine,425,118,300,248,543,70.58823529411765,58.35294117647059
31704_marine,408,108,286,247,516,70.09803921568627,60.5392156862745
31705_marine,102,42,96,13,144,94.11764705882352,12.745098039215685
31706_marine,99,43,93,10,142,93.93939393939394,10.1010101010101
31707_marine,96,43,90,10,139,93.75,10.416666666666668
31708_marine,96,42,90,10,138,93.75,10.416666666666668
31709_marine,96,42,90,10,138,93.75,10.416666666666668
31710_marine,96,43,90,10,139,93.75,10.416666666666668
31711_marine,95,42,89,9,137,93.6842105263158,9.473684210526317
31712_marine,94,42,88,9,136,93.61702127659575,9.574468085106384
31713_marine,94,41,88,9,135,93.61702127659575,9.574468085106384
31714_marine,94,41,88,9,135,93.61702127659575,9.574468085106384
31715_marine,93,41,87,9,134,93.54838709677419,9.67741935483871
31716_marine,93,41,87,9,134,93.54838709677419,9.67741935483871
31717_marine,91,41,85,8,132,93.4065934065934,8.791208791208792
31718_marine,91,42,85,8,133,93.4065934065934,8.791208791208792
31719_marine,91,41,85,8,132,93.4065934065934,8.791208791208792
31720_marine,89,41,83,8,130,93.25842696629213,8.98876404494382
31721_marine,88,41,83,7,129,94.31818181818183,7.954545454545454
31722_marine,88,40,83,7,128,94.31818181818183,7.954545454545454
31723_marine,88,40,83,7,128,94.31818181818183,7.954545454545454
31724_marine,88,39,83,7,127,94.31818181818183,7.954545454545454
31725_marine,88,39,83,7,127,94.31818181818183,7.954545454545454
31726_marine,88,39,83,7,127,94.31818181818183,7.954545454545454
31727_marine,88,39,83,7,127,94.31818181818183,7.954545454545454
31728_marine,88,39,83,7,127,94.31818181818183,7.954545454545454
31729_marine,88,39,83,6,127,94.31818181818183,6.8181818181818175
31730_marine,88,38,83,6,126,94.31818181818183,6.8181818181818175
31731_marine,88,37,83,6,125,94.31818181818183,6.8181818181818175
31732_marine,87,37,82,5,124,94.25287356321839,5.747126436781609
31733_marine,87,37,82,5,124,94.25287356321839,5.747126436781609
31734_marine,87,39,82,5,126,94.25287356321839,5.747126436781609
31735_marine,87,39,82,5,126,94.25287356321839,5.747126436781609
31736_marine,87,39,82,5,126,94.25287356321839,5.747126436781609
31737_marine,87,41,82,5,128,94.25287356321839,5.747126436781609
31738_marine,85,41,80,5,126,94.11764705882352,5.88235294117647
31739_marine,85,41,80,5,126,94.11764705882352,5.88235294117647
31740_marine,85,41,80,5,126,94.11764705882352,5.88235294117647
31741_marine,85,42,80,5,127,94.11764705882352,5.88235294117647
31742_marine,85,42,80,5,127,94.11764705882352,5.88235294117647
31743_marine,87,43,82,5,130,94.25287356321839,5.747126436781609
31744_marine,86,43,81,5,129,94.18604651162791,5.813953488372093
31745_marine,86,44,81,5,130,94.18604651162791,5.813953488372093
31746_marine,86,44,81,5,130,94.18604651162791,5.813953488372093
31747_marine,85,45,80,5,130,94.11764705882352,5.88235294117647
31748_marine,85,45,80,5,130,94.11764705882352,5.88235294117647
31749_marine,85,44,80,5,129,94.11764705882352,5.88235294117647
31750_marine,84,44,79,5,128,94.04761904761905,5.952380952380952
31751_marine,85,44,80,5,129,94.11764705882352,5.88235294117647
31752_marine,85,44,80,5,129,94.11764705882352,5.88235294117647
31753_marine,85,44,80,5,129,94.11764705882352,5.88235294117647
31754_marine,85,45,80,5,130,94.11764705882352,5.88235294117647
31755_marine,85,45,80,5,130,94.11764705882352,5.88235294117647
31756_marine,85,45,80,5,130,94.11764705882352,5.88235294117647
31757_marine,87,45,82,5,132,94.25287356321839,5.747126436781609
31758_marine,87,46,82,5,133,94.25287356321839,5.747126436781609
31759_marine,89,46,84,5,135,94.3820224719101,5.617977528089887
31760_marine,91,46,86,5,137,94.5054945054945,5.4945054945054945
31761_marine,90,45,86,5,135,95.55555555555556,5.555555555555555
31762_marine,91,44,86,5,135,94.5054945054945,5.4945054945054945
31763_marine,91,44,86,5,135,94.5054945054945,5.4945054945054945
31764_marine,91,43,86,5,134,94.5054945054945,5.4945054945054945
31765_marine,93,42,88,5,135,94.6236559139785,5.376344086021505
31766_marine,98,43,93,6,141,94.89795918367348,6.122448979591836
31767_marine,108,45,102,10,153,94.44444444444444,9.25925925925926
31768_marine,183,119,157,45,302,85.79234972677595,24.59016393442623
31769_marine,188,122,161,46,310,85.63829787234043,24.46808510638298
31770_marine,173,103,152,32,276,87.861271676300575,18.497109826589593
31771_marine,169,98,148,30,267,87.57396449704143,17.75147928994083
31772_marine,112,46,105,14,158,93.75,12.5
31773_marine,109,44,102,13,153,93.57798165137615,11.926605504587156
31774_marine,101,44,94,13,145,93.06930693069307,12.871287128712872
31775_marine,101,44,94,13,145,93.06930693069307,12.871287128712872
31776_marine,100,44,93,13,144,93,13
31777_marine,103,44,95,14,147,92.23300970873787,13.592233009708737
31778_marine,103,43,95,14,146,92.23300970873787,13.592233009708737
31779_marine,109,52,101,14,161,92.66055045871559,12.844036697247708
31780_marine,303,206,244,71,509,80.52805280528052,23.432343234323433
31812_marine,255,155,215,58,410,84.31372549019608,22.745098039215687
31813_marine,251,167,211,56,418,84.06374501992032,22.31075697211155
31814_marine,257,164,217,55,421,84.43579766536965,21.40077821011673
31815_marine,98,50,93,6,148,94.89795918367348,6.122448979591836
31816_marine,96,40,91,6,136,94.79166666666666,6.25
31817_marine,96,36,91,6,132,94.79166666666666,6.25
31818_marine,97,36,92,6,133,94.84536082474226,6.185567010309279
31819_marine,102,36,97,6,138,95.09803921568627,5.88235294117647
31820_marine,100,37,95,6,137,95,6
31821_marine,95,37,90,5,132,94.73684210526315,5.263157894736842
31822_marine,94,41,88,5,135,93.61702127659575,5.319148936170213
31823_marine,94,39,88,5,133,93.61702127659575,5.319148936170213
31824_marine,90,39,84,5,129,93.33333333333333,5.555555555555555
31825_marine,90,39,84,5,129,93.33333333333333,5.555555555555555
31826_marine,90,39,84,5,129,93.33333333333333,5.555555555555555
31827_marine,92,41,86,5,133,93.47826086956522,5.434782608695652
31828_marine,90,41,86,3,131,95.55555555555556,3.3333333333333335
31829_marine,94,41,90,3,135,95.74468085106383,3.1914893617021276
31830_marine,98,41,94,7,139,95.91836734693877,7.142857142857142
31831_marine,108,48,100,13,156,92.5925925925926,12.037037037037036
31832_marine,106,45,98,13,151,92.45283018867924,12.264150943396226
31833_marine,102,45,94,11,147,92.15686274509804,10.784313725490197
31834_marine,90,38,86,3,128,95.55555555555556,3.3333333333333335
31835_marine,91,36,87,3,127,95.6043956043956,3.296703296703297
31836_marine,96,36,91,4,132,94.79166666666666,4.166666666666666
31837_marine,94,36,89,4,130,94.68085106382979,4.25531914893617
31838_marine,90,36,85,3,126,94.44444444444444,3.3333333333333335
31839_marine,90,36,85,3,126,94.44444444444444,3.3333333333333335
31840_marine,88,36,83,3,124,94.31818181818183,3.4090909090909087
31841_marine,89,36,83,4,125,93.25842696629213,4.49438202247191
31842_marine,89,34,83,4,123,93.25842696629213,4.49438202247191
31843_marine,90,34,84,4,124,93.33333333333333,4.444444444444445
31844_marine,90,34,84,4,124,93.33333333333333,4.444444444444445
31845_marine,90,34,84,4,124,93.33333333333333,4.444444444444445
31846_marine,90,34,84,4,124,93.33333333333333,4.444444444444445
31847_marine,96,34,90,4,130,93.75,4.166666666666666
31848_marine,96,36,89,5,132,92.70833333333334,5.208333333333334
31849_marine,100,36,93,5,136,93,5
31850_marine,102,35,95,5,137,93.13725490196079,4.901960784313726
31851_marine,101,35,94,5,136,93.06930693069307,4.9504950495049505
31852_marine,101,37,94,5,138,93.06930693069307,4.9504950495049505
31853_marine,99,39,92,5,138,92.92929292929293,5.05050505050505
31854_marine,99,39,92,5,138,92.92929292929293,5.05050505050505
31855_marine,98,39,91,5,137,92.85714285714286,5.1020408163265305
31856_marine,97,37,90,5,134,92.78350515463917,5.154639175257731
31857_marine,95,37,88,5,132,92.63157894736842,5.263157894736842
31858_marine,95,37,88,5,132,92.63157894736842,5.263157894736842
31859_marine,96,35,88,6,131,91.66666666666666,6.25
31860_marine,93,33,85,6,126,91.39784946236558,6.451612903225806
31861_marine,94,33,86,7,127,91.48936170212765,7.446808510638298
31862_marine,93,32,85,6,125,91.39784946236558,6.451612903225806
31863_marine,92,32,84,6,124,91.30434782608695,6.521739130434782
31864_marine,92,32,84,6,124,91.30434782608695,6.521739130434782
31865_marine,91,34,84,6,125,92.3076923076923,6.593406593406594
31866_marine,216,86,189,41,302,87.5,18.98148148148148
31867_marine,220,96,194,42,316,88.18181818181819,19.090909090909093
31868_marine,278,148,227,77,426,81.65467625899281,27.697841726618705
31869_marine,280,139,247,51,419,88.21428571428571,18.21428571428571
31907_marine,558,163,387,301,721,69.35483870967742,53.94265232974911
31908_marine,107,36,101,14,143,94.39252336448598,13.084112149532709
31909_marine,98,33,92,11,131,93.87755102040816,11.224489795918368
31910_marine,99,33,93,12,132,93.93939393939394,12.121212121212121
31911_marine,96,33,91,10,129,94.79166666666666,10.416666666666668
31912_marine,88,33,83,8,121,94.31818181818183,9.090909090909092
31913_marine,84,33,79,8,117,94.04761904761905,9.523809523809524
31914_marine,82,33,77,8,115,93.90243902439023,9.75609756097561
31915_marine,82,33,77,8,115,93.90243902439023,9.75609756097561
31916_marine,80,33,75,7,113,93.75,8.75
31917_marine,81,32,76,8,113,93.82716049382715,9.876543209876543
31918_marine,81,32,76,8,113,93.82716049382715,9.876543209876543
31919_marine,81,32,76,8,113,93.82716049382715,9.876543209876543
31920_marine,81,32,76,8,113,93.82716049382715,9.876543209876543
31921_marine,81,33,76,8,114,93.82716049382715,9.876543209876543
31922_marine,81,33,76,8,114,93.82716049382715,9.876543209876543
31923_marine,81,33,76,8,114,93.82716049382715,9.876543209876543
31924_marine,81,33,76,8,114,93.82716049382715,9.876543209876543
31925_marine,81,33,76,8,114,93.82716049382715,9.876543209876543
31926_marine,80,33,75,7,113,93.75,8.75
31927_marine,80,33,75,7,113,93.75,8.75
31928_marine,81,33,76,7,114,93.82716049382715,8.641975308641975
31929_marine,81,33,76,7,114,93.82716049382715,8.641975308641975
31930_marine,84,33,79,9,117,94.04761904761905,10.714285714285714
31931_marine,86,36,81,9,122,94.18604651162791,10.465116279069768
31932_marine,97,39,92,13,136,94.84536082474226,13.402061855670103
31933_marine,621,155,394,367,776,63.44605475040258,59.09822866344605
31934_marine,676,166,437,400,842,64.64497041420118,59.171597633136095
31935_marine,623,153,397,364,776,63.7239165329053,58.42696629213483
31936_marine,94,36,89,12,130,94.68085106382979,12.76595744680851
31937_marine,87,33,82,7,120,94.25287356321839,8.045977011494253
31938_marine,88,33,83,7,121,94.31818181818183,7.954545454545454
31939_marine,89,33,84,7,122,94.3820224719101,7.865168539325842
31940_marine,89,32,84,7,121,94.3820224719101,7.865168539325842
31941_marine,88,30,83,6,118,94.31818181818183,6.8181818181818175
31942_marine,82,29,77,6,111,93.90243902439023,7.317073170731707
31943_marine,82,29,77,6,111,93.90243902439023,7.317073170731707
31944_marine,81,29,76,6,110,93.82716049382715,7.4074074074074066
31945_marine,80,29,75,5,109,93.75,6.25
31946_marine,80,29,75,5,109,93.75,6.25
31947_marine,80,29,75,5,109,93.75,6.25
31948_marine,80,29,75,5,109,93.75,6.25
31949_marine,79,29,74,4,108,93.67088607594937,5.063291139240507
31950_marine,79,29,74,4,108,93.67088607594937,5.063291139240507
31951_marine,79,29,74,4,108,93.67088607594937,5.063291139240507
31952_marine,79,30,74,4,109,93.67088607594937,5.063291139240507
31953_marine,80,29,75,5,109,93.75,6.25
31954_marine,92,29,86,10,121,93.47826086956522,10.869565217391305
31955_marine,112,29,106,14,141,94.64285714285714,12.5
31956_marine,683,198,434,389,881,63.543191800878475,56.95461200585652
31957_marine,696,211,441,399,907,63.36206896551724,57.327586206896555
31966_marine,735,290,509,349,1025,69.25170068027211,47.48299319727891
31967_marine,718,256,503,344,974,70.05571030640668,47.910863509749305
31968_marine,771,297,538,379,1068,69.77950713359273,49.15693904020752
31980_marine,1067,412,666,619,1479,62.41799437675727,58.01312089971884
31984_marine,968,383,589,579,1351,60.847107438016536,59.81404958677686
31987_marine,1036,430,616,633,1466,59.45945945945946,61.100386100386096
31990_marine,945,376,556,582,1321,58.83597883597883,61.58730158730159
31991_marine,923,362,546,575,1285,59.154929577464785,62.29685807150596
31992_marine,901,349,548,553,1250,60.82130965593785,61.3762486126526
31993_marine,826,301,493,517,1127,59.68523002421308,62.590799031477
31994_marine,754,274,486,439,1028,64.45623342175067,58.22281167108754
31995_marine,763,284,495,440,1047,64.87549148099608,57.66710353866317
31996_marine,744,260,478,437,1004,64.24731182795699,58.73655913978495
31997_marine,117,30,109,18,147,93.16239316239316,15.384615384615385
31998_marine,116,30,109,18,146,93.96551724137932,15.517241379310345
31999_marine,113,30,107,18,143,94.69026548672566,15.929203539823009
32000_marine,110,30,104,16,140,94.54545454545455,14.545454545454545
32001_marine,110,30,104,16,140,94.54545454545455,14.545454545454545
32002_marine,103,30,98,15,133,95.14563106796116,14.563106796116504
32003_marine,97,30,92,13,127,94.84536082474226,13.402061855670103
32004_marine,97,30,92,13,127,94.84536082474226,13.402061855670103
32005_marine,95,30,90,11,125,94.73684210526315,11.578947368421053
32006_marine,97,30,92,13,127,94.84536082474226,13.402061855670103
32007_marine,97,30,92,13,127,94.84536082474226,13.402061855670103
32008_marine,98,30,93,14,128,94.89795918367348,14.285714285714285
32009_marine,98,30,93,14,128,94.89795918367348,14.285714285714285
32010_marine,97,30,92,14,127,94.84536082474226,14.432989690721648
32011_marine,98,29,93,14,127,94.89795918367348,14.285714285714285
32012_marine,99,30,94,14,129,94.94949494949495,14.14141414141414
32013_marine,99,31,94,14,130,94.94949494949495,14.14141414141414
32014_marine,153,33,116,52,186,75.81699346405229,33.98692810457516
32015_marine,238,96,181,92,334,76.05042016806722,38.655462184873954
32016_marine,172,33,135,59,205,78.48837209302324,34.30232558139535
32017_marine,98,33,93,11,131,94.89795918367348,11.224489795918368
32018_marine,98,35,93,11,133,94.89795918367348,11.224489795918368
32019_marine,98,35,93,11,133,94.89795918367348,11.224489795918368
32020_marine,97,36,92,10,133,94.84536082474226,10.309278350515463
32021_marine,97,36,92,10,133,94.84536082474226,10.309278350515463
32022_marine,97,34,92,9,131,94.84536082474226,9.278350515463918
32023_marine,98,34,93,9,132,94.89795918367348,9.183673469387756
32024_marine,96,34,91,9,130,94.79166666666666,9.375
32025_marine,96,35,91,9,131,94.79166666666666,9.375
32026_marine,98,36,93,9,134,94.89795918367348,9.183673469387756
32027_marine,99,38,94,10,137,94.94949494949495,10.1010101010101
32028_marine,101,38,96,12,139,95.04950495049505,11.881188118811881
32029_marine,102,38,96,12,140,94.11764705882352,11.76470588235294
32030_marine,102,38,96,12,140,94.11764705882352,11.76470588235294
32031_marine,102,40,96,11,142,94.11764705882352,10.784313725490197
32032_marine,512,130,347,314,642,67.7734375,61.328125
32033_marine,550,151,380,330,701,69.0909090909091,60
32034_marine,548,151,378,330,699,68.97810218978103,60.21897810218978
32035_marine,513,131,348,314,644,67.83625730994152,61.20857699805068
32036_marine,100,41,94,10,141,94,10
32037_marine,99,42,93,10,141,93.93939393939394,10.1010101010101
32038_marine,98,42,92,9,140,93.87755102040816,9.183673469387756
32039_marine,97,42,91,8,139,93.81443298969072,8.24742268041237
32040_marine,99,42,93,8,141,93.93939393939394,8.080808080808081
32041_marine,96,44,90,8,140,93.75,8.333333333333332
32042_marine,94,44,88,8,138,93.61702127659575,8.51063829787234
32043_marine,443,108,299,270,551,67.49435665914221,60.94808126410835
32044_marine,449,109,305,272,558,67.92873051224944,60.57906458797328
32045_marine,447,106,303,270,553,67.78523489932886,60.40268456375839
32046_marine,100,43,94,8,143,94,8
32047_marine,100,43,94,8,143,94,8
32048_marine,100,43,94,8,143,94,8
32049_marine,100,43,94,8,143,94,8
32050_marine,102,43,96,10,145,94.11764705882352,9.803921568627452
32051_marine,102,43,96,10,145,94.11764705882352,9.803921568627452
32052_marine,102,44,96,10,146,94.11764705882352,9.803921568627452
32053_marine,102,44,96,10,146,94.11764705882352,9.803921568627452
32054_marine,100,45,94,10,145,94,10
32055_marine,100,45,94,10,145,94,10
32056_marine,100,45,94,10,145,94,10
32057_marine,100,45,94,10,145,94,10
32058_marine,100,45,94,10,145,94,10
32059_marine,100,45,94,10,145,94,10
32060_marine,384,103,276,223,487,71.875,58.072916666666664
32061_marine,383,102,275,223,485,71.80156657963447,58.22454308093995
32062_marine,98,44,92,10,142,93.87755102040816,10.204081632653061
32063_marine,404,107,282,244,511,69.80198019801979,60.396039603960396
32064_marine,404,107,282,244,511,69.80198019801979,60.396039603960396
32065_marine,98,44,92,11,142,93.87755102040816,11.224489795918368
32066_marine,98,44,92,11,142,93.87755102040816,11.224489795918368
32067_marine,96,45,90,10,141,93.75,10.416666666666668
32068_marine,96,45,90,10,141,93.75,10.416666666666668
32069_marine,96,45,90,10,141,93.75,10.416666666666668
32070_marine,96,44,90,10,140,93.75,10.416666666666668
32071_marine,96,44,90,10,140,93.75,10.416666666666668
32072_marine,96,44,90,10,140,93.75,10.416666666666668
32073_marine,96,43,90,9,139,93.75,9.375
32074_marine,94,44,88,9,138,93.61702127659575,9.574468085106384
32075_marine,93,43,87,9,136,93.54838709677419,9.67741935483871
32076_marine,93,43,87,9,136,93.54838709677419,9.67741935483871
32077_marine,93,43,87,9,136,93.54838709677419,9.67741935483871
32078_marine,91,43,85,8,134,93.4065934065934,8.791208791208792
32079_marine,91,42,85,8,133,93.4065934065934,8.791208791208792
32080_marine,91,43,85,8,134,93.4065934065934,8.791208791208792
32081_marine,89,42,83,8,131,93.25842696629213,8.98876404494382
32082_marine,88,42,83,7,130,94.31818181818183,7.954545454545454
32083_marine,88,41,83,7,129,94.31818181818183,7.954545454545454
32084_marine,88,41,83,7,129,94.31818181818183,7.954545454545454
32085_marine,88,41,83,7,129,94.31818181818183,7.954545454545454
32086_marine,88,41,83,7,129,94.31818181818183,7.954545454545454
32087_marine,89,41,84,7,130,94.3820224719101,7.865168539325842
32088_marine,89,40,84,7,129,94.3820224719101,7.865168539325842
32089_marine,90,40,85,7,130,94.44444444444444,7.777777777777778
32090_marine,90,40,85,7,130,94.44444444444444,7.777777777777778
32091_marine,89,39,84,6,128,94.3820224719101,6.741573033707865
32092_marine,88,39,83,5,127,94.31818181818183,5.681818181818182
32093_marine,88,39,83,5,127,94.31818181818183,5.681818181818182
32094_marine,87,41,82,5,128,94.25287356321839,5.747126436781609
32095_marine,87,41,82,5,128,94.25287356321839,5.747126436781609
32096_marine,90,41,85,5,131,94.44444444444444,5.555555555555555
32097_marine,90,41,85,5,131,94.44444444444444,5.555555555555555
32098_marine,90,43,85,5,133,94.44444444444444,5.555555555555555
32099_marine,90,44,85,5,134,94.44444444444444,5.555555555555555
32100_marine,90,44,85,5,134,94.44444444444444,5.555555555555555
32101_marine,90,44,85,5,134,94.44444444444444,5.555555555555555
32102_marine,88,44,83,5,132,94.31818181818183,5.681818181818182
32103_marine,87,45,82,5,132,94.25287356321839,5.747126436781609
32104_marine,87,46,82,5,133,94.25287356321839,5.747126436781609
32105_marine,87,47,82,5,134,94.25287356321839,5.747126436781609
32106_marine,87,47,82,5,134,94.25287356321839,5.747126436781609
32107_marine,85,47,80,5,132,94.11764705882352,5.88235294117647
32108_marine,85,47,80,5,132,94.11764705882352,5.88235294117647
32109_marine,85,47,80,5,132,94.11764705882352,5.88235294117647
32110_marine,84,46,79,5,130,94.04761904761905,5.952380952380952
32111_marine,84,46,79,5,130,94.04761904761905,5.952380952380952
32112_marine,84,45,79,5,129,94.04761904761905,5.952380952380952
32113_marine,84,44,79,5,128,94.04761904761905,5.952380952380952
32114_marine,85,45,80,5,130,94.11764705882352,5.88235294117647
32115_marine,85,47,80,5,132,94.11764705882352,5.88235294117647
32116_marine,85,47,80,5,132,94.11764705882352,5.88235294117647
32117_marine,85,47,80,5,132,94.11764705882352,5.88235294117647
32118_marine,87,46,82,5,133,94.25287356321839,5.747126436781609
32119_marine,87,47,82,5,134,94.25287356321839,5.747126436781609
32120_marine,89,47,84,5,136,94.3820224719101,5.617977528089887
32121_marine,89,46,84,5,135,94.3820224719101,5.617977528089887
32122_marine,91,45,86,5,136,94.5054945054945,5.4945054945054945
32123_marine,90,45,86,5,135,95.55555555555556,5.555555555555555
32124_marine,91,45,86,5,136,94.5054945054945,5.4945054945054945
32125_marine,96,45,91,6,141,94.79166666666666,6.25
32126_marine,100,45,95,6,145,95,6
32127_marine,109,50,104,9,159,95.41284403669725,8.256880733944955
32128_marine,174,104,153,31,278,87.93103448275862,17.81609195402299
32129_marine,227,167,179,76,394,78.8546255506608,33.480176211453745
32130_marine,201,163,167,53,364,83.08457711442786,26.368159203980102
32131_marine,204,142,167,56,346,81.86274509803921,27.450980392156865
32132_marine,171,99,149,31,270,87.13450292397661,18.128654970760234
32133_marine,112,45,105,13,157,93.75,11.607142857142858
32134_marine,101,46,94,11,147,93.06930693069307,10.891089108910892
32135_marine,99,47,92,11,146,92.92929292929293,11.11111111111111
32136_marine,99,47,92,11,146,92.92929292929293,11.11111111111111
32137_marine,102,46,95,11,148,93.13725490196079,10.784313725490197
32138_marine,109,49,102,13,158,93.57798165137615,11.926605504587156
32139_marine,290,182,234,66,472,80.6896551724138,22.758620689655174
32171_marine,496,382,283,269,878,57.056451612903224,54.233870967741936
32172_marine,259,159,215,63,418,83.01158301158301,24.324324324324326
32173_marine,265,159,221,63,424,83.39622641509435,23.77358490566038
32174_marine,270,176,224,64,446,82.96296296296296,23.703703703703706
32175_marine,270,171,226,64,441,83.7037037037037,23.703703703703706
32176_marine,269,167,225,62,436,83.64312267657994,23.04832713754647
32177_marine,102,44,97,6,146,95.09803921568627,5.88235294117647
32178_marine,101,42,96,6,143,95.04950495049505,5.9405940594059405
32179_marine,102,46,97,6,148,95.09803921568627,5.88235294117647
32180_marine,100,44,95,6,144,95,6
32181_marine,102,45,97,6,147,95.09803921568627,5.88235294117647
32182_marine,102,41,97,6,143,95.09803921568627,5.88235294117647
32183_marine,96,41,90,5,137,93.75,5.208333333333334
32184_marine,92,41,86,5,133,93.47826086956522,5.434782608695652
32185_marine,90,39,84,5,129,93.33333333333333,5.555555555555555
32186_marine,92,41,86,5,133,93.47826086956522,5.434782608695652
32187_marine,92,43,86,5,135,93.47826086956522,5.434782608695652
32188_marine,93,44,87,6,137,93.54838709677419,6.451612903225806
32189_marine,94,44,90,4,138,95.74468085106383,4.25531914893617
32190_marine,98,44,94,8,142,95.91836734693877,8.16326530612245
32191_marine,108,52,100,14,160,92.5925925925926,12.962962962962962
32192_marine,104,48,96,14,152,92.3076923076923,13.461538461538462
32193_marine,102,46,94,12,148,92.15686274509804,11.76470588235294
32194_marine,92,40,88,4,132,95.65217391304348,4.3478260869565215
32195_marine,94,42,90,4,136,95.74468085106383,4.25531914893617
32196_marine,94,40,90,4,134,95.74468085106383,4.25531914893617
32197_marine,96,40,91,4,136,94.79166666666666,4.166666666666666
32198_marine,91,40,86,4,131,94.5054945054945,4.395604395604396
32199_marine,91,38,86,4,129,94.5054945054945,4.395604395604396
32200_marine,89,38,84,4,127,94.3820224719101,4.49438202247191
32201_marine,90,38,84,5,128,93.33333333333333,5.555555555555555
32202_marine,88,36,82,4,124,93.18181818181817,4.545454545454546
32203_marine,90,36,84,4,126,93.33333333333333,4.444444444444445
32204_marine,90,36,84,4,126,93.33333333333333,4.444444444444445
32205_marine,91,36,84,5,127,92.3076923076923,5.4945054945054945
32206_marine,91,36,84,5,127,92.3076923076923,5.4945054945054945
32207_marine,90,36,83,5,126,92.22222222222223,5.555555555555555
32208_marine,92,36,85,5,128,92.3913043478261,5.434782608695652
32209_marine,92,36,85,5,128,92.3913043478261,5.434782608695652
32210_marine,96,36,89,5,132,92.70833333333334,5.208333333333334
32211_marine,95,36,88,5,131,92.63157894736842,5.263157894736842
32212_marine,97,38,90,5,135,92.78350515463917,5.154639175257731
32213_marine,97,38,90,5,135,92.78350515463917,5.154639175257731
32214_marine,95,38,88,5,133,92.63157894736842,5.263157894736842
32215_marine,96,38,89,5,134,92.70833333333334,5.208333333333334
32216_marine,97,38,90,5,135,92.78350515463917,5.154639175257731
32217_marine,96,38,89,5,134,92.70833333333334,5.208333333333334
32218_marine,96,38,89,5,134,92.70833333333334,5.208333333333334
32219_marine,91,38,83,6,129,91.20879120879121,6.593406593406594
32220_marine,92,44,84,6,136,91.30434782608695,6.521739130434782
32221_marine,92,44,84,7,136,91.30434782608695,7.608695652173914
32222_marine,93,38,85,6,131,91.39784946236558,6.451612903225806
32223_marine,92,37,84,6,129,91.30434782608695,6.521739130434782
32224_marine,92,37,84,6,129,91.30434782608695,6.521739130434782
32225_marine,91,37,83,6,128,91.20879120879121,6.593406593406594
32226_marine,219,89,191,41,308,87.21461187214612,18.72146118721461
32228_marine,221,104,193,43,325,87.33031674208145,19.457013574660635
32229_marine,288,150,254,50,438,88.19444444444444,17.36111111111111
32265_marine,568,192,393,307,760,69.19014084507043,54.04929577464789
32266_marine,559,161,386,302,720,69.05187835420394,54.02504472271914
32267_marine,101,36,93,16,137,92.07920792079209,15.841584158415841
32268_marine,99,38,92,13,137,92.92929292929293,13.131313131313133
32269_marine,98,35,91,13,133,92.85714285714286,13.26530612244898
32270_marine,99,35,92,13,134,92.92929292929293,13.131313131313133
32271_marine,93,35,87,11,128,93.54838709677419,11.827956989247312
32272_marine,87,35,81,11,122,93.10344827586206,12.643678160919542
32273_marine,89,35,83,13,124,93.25842696629213,14.606741573033707
32274_marine,89,35,83,13,124,93.25842696629213,14.606741573033707
32275_marine,87,36,81,13,123,93.10344827586206,14.942528735632186
32276_marine,84,36,78,11,120,92.85714285714286,13.095238095238097
32277_marine,84,35,78,11,119,92.85714285714286,13.095238095238097
32278_marine,82,35,77,9,117,93.90243902439023,10.975609756097562
32279_marine,81,35,76,8,116,93.82716049382715,9.876543209876543
32280_marine,81,35,76,8,116,93.82716049382715,9.876543209876543
32281_marine,81,35,76,8,116,93.82716049382715,9.876543209876543
32282_marine,81,35,76,8,116,93.82716049382715,9.876543209876543
32283_marine,81,35,76,8,116,93.82716049382715,9.876543209876543
32284_marine,81,35,76,8,116,93.82716049382715,9.876543209876543
32285_marine,80,35,75,7,115,93.75,8.75
32286_marine,80,35,75,7,115,93.75,8.75
32287_marine,80,35,75,7,115,93.75,8.75
32288_marine,80,35,75,7,115,93.75,8.75
32289_marine,81,35,76,7,116,93.82716049382715,8.641975308641975
32290_marine,84,36,79,9,120,94.04761904761905,10.714285714285714
32291_marine,84,38,79,9,122,94.04761904761905,10.714285714285714
32292_marine,94,41,89,13,135,94.68085106382979,13.829787234042554
32293_marine,656,165,422,393,821,64.32926829268293,59.90853658536586
32294_marine,661,168,426,393,829,64.44780635400907,59.4553706505295
32295_marine,612,153,389,361,765,63.56209150326797,58.98692810457516
32296_marine,97,38,92,11,135,94.84536082474226,11.34020618556701
32297_marine,87,35,82,7,122,94.25287356321839,8.045977011494253
32298_marine,88,34,83,7,122,94.31818181818183,7.954545454545454
32299_marine,88,33,83,7,121,94.31818181818183,7.954545454545454
32300_marine,88,32,84,6,120,95.45454545454545,6.8181818181818175
32301_marine,84,32,80,6,116,95.23809523809523,7.142857142857142
32302_marine,83,32,79,6,115,95.18072289156626,7.228915662650602
32303_marine,83,31,78,6,114,93.97590361445783,7.228915662650602
32304_marine,81,31,76,6,112,93.82716049382715,7.4074074074074066
32305_marine,81,31,76,6,112,93.82716049382715,7.4074074074074066
32306_marine,81,31,76,6,112,93.82716049382715,7.4074074074074066
32307_marine,80,31,75,5,111,93.75,6.25
32308_marine,80,31,75,5,111,93.75,6.25
32309_marine,80,31,75,5,111,93.75,6.25
32310_marine,79,31,74,4,110,93.67088607594937,5.063291139240507
32311_marine,79,31,74,4,110,93.67088607594937,5.063291139240507
32312_marine,79,32,74,4,111,93.67088607594937,5.063291139240507
32313_marine,80,31,75,5,111,93.75,6.25
32314_marine,86,31,81,6,117,94.18604651162791,6.976744186046512
32315_marine,104,31,98,14,135,94.23076923076923,13.461538461538462
32316_marine,118,34,111,18,152,94.0677966101695,15.254237288135593
32317_marine,698,212,441,398,910,63.180515759312314,57.02005730659025
32326_marine,721,291,502,338,1012,69.62552011095701,46.87933425797504
32327_marine,768,296,536,382,1064,69.79166666666666,49.73958333333333
32328_marine,783,298,542,390,1081,69.22094508301406,49.808429118773944
32346_marine,983,400,592,594,1383,60.223804679552394,60.42726347914547
32347_marine,1018,414,603,626,1432,59.23379174852652,61.493123772102166
32351_marine,1091,542,640,683,1633,58.661778185151235,62.60311640696609
32352_marine,992,448,590,608,1440,59.4758064516129,61.29032258064516
32353_marine,899,372,532,561,1271,59.17686318131257,62.40266963292548
32354_marine,899,370,536,552,1269,59.62180200222469,61.40155728587319
32355_marine,928,387,562,561,1315,60.560344827586206,60.452586206896555
32356_marine,888,355,529,545,1243,59.57207207207207,61.373873873873876
32357_marine,872,325,517,540,1197,59.28899082568807,61.92660550458715
32358_marine,121,30,113,21,151,93.38842975206612,17.355371900826448
32359_marine,120,30,113,20,150,94.16666666666667,16.666666666666664
32360_marine,119,30,112,20,149,94.11764705882352,16.80672268907563
32361_marine,115,30,108,18,145,93.91304347826087,15.65217391304348
32362_marine,115,30,108,18,145,93.91304347826087,15.65217391304348
32363_marine,114,30,106,16,144,92.98245614035088,14.035087719298245
32364_marine,103,30,96,13,133,93.20388349514563,12.62135922330097
32365_marine,103,30,96,15,133,93.20388349514563,14.563106796116504
32366_marine,786,270,470,496,1056,59.796437659033074,63.104325699745544
32367_marine,99,30,94,15,129,94.94949494949495,15.151515151515152
32368_marine,99,30,94,15,129,94.94949494949495,15.151515151515152
32369_marine,99,30,94,15,129,94.94949494949495,15.151515151515152
32370_marine,99,30,94,14,129,94.94949494949495,14.14141414141414
32371_marine,99,29,94,14,128,94.94949494949495,14.14141414141414
32372_marine,99,30,94,14,129,94.94949494949495,14.14141414141414
32373_marine,99,30,94,14,129,94.94949494949495,14.14141414141414
32374_marine,157,31,120,56,188,76.43312101910828,35.6687898089172
32375_marine,172,33,135,60,205,78.48837209302324,34.883720930232556
32376_marine,170,33,133,58,203,78.23529411764706,34.11764705882353
32377_marine,97,33,92,10,130,94.84536082474226,10.309278350515463
32378_marine,97,36,92,10,133,94.84536082474226,10.309278350515463
32379_marine,97,36,92,10,133,94.84536082474226,10.309278350515463
32380_marine,97,36,92,10,133,94.84536082474226,10.309278350515463
32381_marine,95,36,90,10,131,94.73684210526315,10.526315789473683
32382_marine,95,34,90,9,129,94.73684210526315,9.473684210526317
32383_marine,95,34,90,9,129,94.73684210526315,9.473684210526317
32384_marine,96,34,91,9,130,94.79166666666666,9.375
32385_marine,96,35,91,9,131,94.79166666666666,9.375
32386_marine,98,35,93,9,133,94.89795918367348,9.183673469387756
32387_marine,513,124,348,312,637,67.83625730994152,60.81871345029239
32388_marine,513,125,348,312,638,67.83625730994152,60.81871345029239
32389_marine,101,38,95,11,139,94.05940594059405,10.891089108910892
32390_marine,516,122,351,319,638,68.02325581395348,61.82170542635659
32391_marine,101,39,95,11,140,94.05940594059405,10.891089108910892
32392_marine,102,42,96,11,144,94.11764705882352,10.784313725490197
32393_marine,550,152,380,330,702,69.0909090909091,60
32394_marine,553,153,383,330,706,69.25858951175407,59.6745027124774
32395_marine,513,137,350,313,650,68.2261208576998,61.01364522417154
32396_marine,509,133,346,310,642,67.97642436149313,60.90373280943025
32397_marine,100,42,94,10,142,94,10
32398_marine,98,42,92,9,140,93.87755102040816,9.183673469387756
32399_marine,97,42,91,8,139,93.81443298969072,8.24742268041237
32400_marine,97,42,91,8,139,93.81443298969072,8.24742268041237
32401_marine,98,42,92,10,140,93.87755102040816,10.204081632653061
32402_marine,94,42,88,8,136,93.61702127659575,8.51063829787234
32403_marine,444,104,300,270,548,67.56756756756756,60.810810810810814
32404_marine,444,104,300,270,548,67.56756756756756,60.810810810810814
32405_marine,447,102,303,270,549,67.78523489932886,60.40268456375839
32406_marine,100,40,94,8,140,94,8
32407_marine,100,40,94,8,140,94,8
32408_marine,102,40,96,10,142,94.11764705882352,9.803921568627452
32409_marine,102,42,96,10,144,94.11764705882352,9.803921568627452
32410_marine,102,42,96,10,144,94.11764705882352,9.803921568627452
32411_marine,102,42,96,10,144,94.11764705882352,9.803921568627452
32412_marine,102,42,96,10,144,94.11764705882352,9.803921568627452
32413_marine,102,42,96,10,144,94.11764705882352,9.803921568627452
32414_marine,103,42,97,10,145,94.1747572815534,9.70873786407767
32415_marine,101,42,95,10,143,94.05940594059405,9.900990099009901
32416_marine,101,43,95,10,144,94.05940594059405,9.900990099009901
32417_marine,101,43,95,10,144,94.05940594059405,9.900990099009901
32418_marine,101,43,95,10,144,94.05940594059405,9.900990099009901
32419_marine,101,42,95,10,143,94.05940594059405,9.900990099009901
32420_marine,387,104,279,224,491,72.09302325581395,57.88113695090439
32421_marine,384,100,276,223,484,71.875,58.072916666666664
32422_marine,99,42,93,10,141,93.93939393939394,10.1010101010101
32423_marine,98,42,92,10,140,93.87755102040816,10.204081632653061
32424_marine,98,42,92,10,140,93.87755102040816,10.204081632653061
32425_marine,97,42,91,10,139,93.81443298969072,10.309278350515463
32426_marine,98,42,92,11,140,93.87755102040816,11.224489795918368
32427_marine,96,42,90,10,138,93.75,10.416666666666668
32428_marine,96,43,90,10,139,93.75,10.416666666666668
32429_marine,96,43,90,10,139,93.75,10.416666666666668
32430_marine,96,43,90,10,139,93.75,10.416666666666668
32431_marine,96,43,90,10,139,93.75,10.416666666666668
32432_marine,97,43,91,10,140,93.81443298969072,10.309278350515463
32433_marine,97,42,91,10,139,93.81443298969072,10.309278350515463
32434_marine,94,41,88,9,135,93.61702127659575,9.574468085106384
32435_marine,94,41,88,9,135,93.61702127659575,9.574468085106384
32436_marine,94,41,88,9,135,93.61702127659575,9.574468085106384
32437_marine,94,41,88,9,135,93.61702127659575,9.574468085106384
32438_marine,93,40,87,9,133,93.54838709677419,9.67741935483871
32439_marine,91,40,85,8,131,93.4065934065934,8.791208791208792
32440_marine,91,39,85,8,130,93.4065934065934,8.791208791208792
32441_marine,89,39,83,8,128,93.25842696629213,8.98876404494382
32442_marine,89,39,83,8,128,93.25842696629213,8.98876404494382
32443_marine,88,38,83,7,126,94.31818181818183,7.954545454545454
32444_marine,88,38,83,7,126,94.31818181818183,7.954545454545454
32445_marine,89,38,84,7,127,94.3820224719101,7.865168539325842
32446_marine,89,38,84,7,127,94.3820224719101,7.865168539325842
32447_marine,90,38,85,7,128,94.44444444444444,7.777777777777778
32448_marine,90,38,85,7,128,94.44444444444444,7.777777777777778
32449_marine,90,38,85,7,128,94.44444444444444,7.777777777777778
32450_marine,92,38,87,7,130,94.56521739130434,7.608695652173914
32451_marine,92,38,87,7,130,94.56521739130434,7.608695652173914
32452_marine,92,37,87,7,129,94.56521739130434,7.608695652173914
32453_marine,90,37,85,5,127,94.44444444444444,5.555555555555555
32454_marine,89,37,84,5,126,94.3820224719101,5.617977528089887
32455_marine,89,39,84,5,128,94.3820224719101,5.617977528089887
32456_marine,90,39,85,5,129,94.44444444444444,5.555555555555555
32457_marine,91,40,86,5,131,94.5054945054945,5.4945054945054945
32458_marine,91,40,86,5,131,94.5054945054945,5.4945054945054945
32459_marine,91,42,86,5,133,94.5054945054945,5.4945054945054945
32460_marine,91,43,86,5,134,94.5054945054945,5.4945054945054945
32461_marine,91,43,86,5,134,94.5054945054945,5.4945054945054945
32462_marine,91,43,86,5,134,94.5054945054945,5.4945054945054945
32463_marine,90,44,85,5,134,94.44444444444444,5.555555555555555
32464_marine,90,44,85,5,134,94.44444444444444,5.555555555555555
32465_marine,88,44,83,5,132,94.31818181818183,5.681818181818182
32466_marine,87,45,82,5,132,94.25287356321839,5.747126436781609
32467_marine,87,45,82,5,132,94.25287356321839,5.747126436781609
32468_marine,87,45,82,5,132,94.25287356321839,5.747126436781609
32469_marine,88,45,83,5,133,94.31818181818183,5.681818181818182
32470_marine,85,45,80,5,130,94.11764705882352,5.88235294117647
32471_marine,85,42,80,5,127,94.11764705882352,5.88235294117647
32472_marine,85,42,80,5,127,94.11764705882352,5.88235294117647
32473_marine,85,42,80,5,127,94.11764705882352,5.88235294117647
32474_marine,85,42,80,5,127,94.11764705882352,5.88235294117647
32475_marine,85,43,80,5,128,94.11764705882352,5.88235294117647
32476_marine,85,43,80,5,128,94.11764705882352,5.88235294117647
32477_marine,85,43,80,5,128,94.11764705882352,5.88235294117647
32478_marine,85,43,80,5,128,94.11764705882352,5.88235294117647
32479_marine,85,44,80,5,129,94.11764705882352,5.88235294117647
32480_marine,87,44,82,5,131,94.25287356321839,5.747126436781609
32481_marine,89,44,84,5,133,94.3820224719101,5.617977528089887
32482_marine,89,44,84,5,133,94.3820224719101,5.617977528089887
32483_marine,91,43,86,5,134,94.5054945054945,5.4945054945054945
32484_marine,91,43,86,5,134,94.5054945054945,5.4945054945054945
32485_marine,97,43,93,6,140,95.87628865979381,6.185567010309279
32486_marine,100,44,95,6,144,95,6
32487_marine,109,48,104,9,157,95.41284403669725,8.256880733944955
32488_marine,172,103,151,29,275,87.79069767441861,16.86046511627907
32489_marine,340,228,240,141,568,70.58823529411765,41.47058823529412
32490_marine,351,235,247,152,586,70.37037037037037,43.3048433048433
32491_marine,327,213,235,131,540,71.86544342507645,40.0611620795107
32492_marine,174,113,153,29,287,87.93103448275862,16.666666666666664
32493_marine,113,44,106,14,157,93.80530973451327,12.389380530973451
32494_marine,103,44,96,12,147,93.20388349514563,11.650485436893204
32495_marine,100,45,93,11,145,93,11
32496_marine,104,48,97,11,152,93.26923076923077,10.576923076923077
32497_marine,105,48,98,13,153,93.33333333333333,12.380952380952381
32498_marine,114,51,107,13,165,93.85964912280701,11.403508771929824
32499_marine,309,204,248,69,513,80.2588996763754,22.330097087378643
32535_marine,294,163,245,82,457,83.33333333333334,27.89115646258503
32536_marine,290,172,241,78,462,83.10344827586206,26.89655172413793
32537_marine,291,167,243,77,458,83.50515463917526,26.46048109965636
32538_marine,105,48,100,9,153,95.23809523809523,8.571428571428571
32539_marine,104,42,99,9,146,95.1923076923077,8.653846153846153
32540_marine,109,40,104,9,149,95.41284403669725,8.256880733944955
32541_marine,108,40,103,8,148,95.37037037037037,7.4074074074074066
32542_marine,107,41,102,7,148,95.32710280373831,6.5420560747663545
32543_marine,108,39,102,7,147,94.44444444444444,6.481481481481481
32544_marine,103,37,97,6,140,94.1747572815534,5.825242718446602
32545_marine,95,37,89,6,132,93.6842105263158,6.315789473684211
32546_marine,94,38,87,7,132,92.5531914893617,7.446808510638298
32547_marine,92,42,85,7,134,92.3913043478261,7.608695652173914
32548_marine,92,42,85,7,134,92.3913043478261,7.608695652173914
32549_marine,95,42,88,7,137,92.63157894736842,7.368421052631578
32550_marine,97,42,92,7,139,94.84536082474226,7.216494845360824
32551_marine,95,42,90,7,137,94.73684210526315,7.368421052631578
32552_marine,95,38,90,7,133,94.73684210526315,7.368421052631578
32553_marine,95,38,90,7,133,94.73684210526315,7.368421052631578
32554_marine,93,38,88,5,131,94.6236559139785,5.376344086021505
32555_marine,95,40,90,5,135,94.73684210526315,5.263157894736842
32556_marine,93,40,88,5,133,94.6236559139785,5.376344086021505
32557_marine,94,40,89,5,134,94.68085106382979,5.319148936170213
32558_marine,94,40,88,5,134,93.61702127659575,5.319148936170213
32559_marine,94,39,88,5,133,93.61702127659575,5.319148936170213
32560_marine,91,37,85,5,128,93.4065934065934,5.4945054945054945
32561_marine,92,37,85,6,129,92.3913043478261,6.521739130434782
32562_marine,92,34,85,6,126,92.3913043478261,6.521739130434782
32563_marine,90,34,83,6,124,92.22222222222223,6.666666666666667
32564_marine,90,34,83,6,124,92.22222222222223,6.666666666666667
32565_marine,89,34,82,5,123,92.13483146067416,5.617977528089887
32566_marine,89,34,82,5,123,92.13483146067416,5.617977528089887
32567_marine,88,34,81,5,122,92.04545454545455,5.681818181818182
32568_marine,90,34,83,5,124,92.22222222222223,5.555555555555555
32569_marine,89,34,82,5,123,92.13483146067416,5.617977528089887
32570_marine,88,34,81,5,122,92.04545454545455,5.681818181818182
32571_marine,87,34,80,5,121,91.95402298850574,5.747126436781609
32572_marine,89,34,82,5,123,92.13483146067416,5.617977528089887
32573_marine,89,34,82,5,123,92.13483146067416,5.617977528089887
32574_marine,86,34,79,5,120,91.86046511627907,5.813953488372093
32575_marine,87,34,80,5,121,91.95402298850574,5.747126436781609
32576_marine,89,34,82,5,123,92.13483146067416,5.617977528089887
32577_marine,88,34,81,5,122,92.04545454545455,5.681818181818182
32578_marine,88,34,81,5,122,92.04545454545455,5.681818181818182
32579_marine,88,34,81,5,122,92.04545454545455,5.681818181818182
32580_marine,91,40,83,6,131,91.20879120879121,6.593406593406594
32581_marine,92,42,84,7,134,91.30434782608695,7.608695652173914
32582_marine,92,36,84,7,128,91.30434782608695,7.608695652173914
32583_marine,90,36,82,6,126,91.11111111111111,6.666666666666667
32584_marine,91,36,83,6,127,91.20879120879121,6.593406593406594
32585_marine,216,84,188,39,300,87.03703703703704,18.055555555555554
32586_marine,221,88,193,41,309,87.33031674208145,18.552036199095024
32588_marine,269,130,237,48,399,88.10408921933085,17.843866171003718
32624_marine,584,201,406,316,785,69.52054794520548,54.109589041095894
32625_marine,553,170,379,301,723,68.53526220614829,54.43037974683544
32626_marine,100,38,92,16,138,92,16
32627_marine,101,38,93,16,139,92.07920792079209,15.841584158415841
32628_marine,99,32,92,13,131,92.92929292929293,13.131313131313133
32629_marine,96,33,89,11,129,92.70833333333334,11.458333333333332
32630_marine,91,33,85,11,124,93.4065934065934,12.087912087912088
32631_marine,87,33,81,13,120,93.10344827586206,14.942528735632186
32632_marine,89,33,83,13,122,93.25842696629213,14.606741573033707
32633_marine,89,33,83,13,122,93.25842696629213,14.606741573033707
32634_marine,89,34,83,13,123,93.25842696629213,14.606741573033707
32635_marine,86,35,80,13,121,93.02325581395348,15.11627906976744
32636_marine,86,35,80,13,121,93.02325581395348,15.11627906976744
32637_marine,84,34,78,11,118,92.85714285714286,13.095238095238097
32638_marine,82,34,76,9,116,92.6829268292683,10.975609756097562
32639_marine,83,33,77,10,116,92.7710843373494,12.048192771084338
32640_marine,82,33,76,9,115,92.6829268292683,10.975609756097562
32641_marine,82,33,76,9,115,92.6829268292683,10.975609756097562
32642_marine,81,33,76,8,114,93.82716049382715,9.876543209876543
32643_marine,81,33,76,8,114,93.82716049382715,9.876543209876543
32644_marine,80,33,75,7,113,93.75,8.75
32645_marine,80,33,75,7,113,93.75,8.75
32646_marine,80,33,75,7,113,93.75,8.75
32647_marine,80,33,75,7,113,93.75,8.75
32648_marine,80,33,75,7,113,93.75,8.75
32649_marine,81,34,76,7,115,93.82716049382715,8.641975308641975
32650_marine,82,34,77,7,116,93.90243902439023,8.536585365853659
32651_marine,84,37,79,9,121,94.04761904761905,10.714285714285714
32652_marine,94,38,89,13,132,94.68085106382979,13.829787234042554
32653_marine,607,157,383,363,764,63.097199341021415,59.80230642504119
32654_marine,661,166,426,393,827,64.44780635400907,59.4553706505295
32655_marine,610,148,387,361,758,63.44262295081967,59.18032786885246
32656_marine,95,34,90,9,129,94.73684210526315,9.473684210526317
32657_marine,87,32,82,7,119,94.25287356321839,8.045977011494253
32658_marine,88,31,83,7,119,94.31818181818183,7.954545454545454
32659_marine,87,31,83,6,118,95.40229885057471,6.896551724137931
32660_marine,87,30,83,6,117,95.40229885057471,6.896551724137931
32661_marine,85,30,81,6,115,95.29411764705881,7.0588235294117645
32662_marine,80,30,76,6,110,95,7.5
32663_marine,82,30,78,6,112,95.1219512195122,7.317073170731707
32664_marine,82,30,78,6,112,95.1219512195122,7.317073170731707
32665_marine,82,29,78,6,111,95.1219512195122,7.317073170731707
32666_marine,82,30,78,6,112,95.1219512195122,7.317073170731707
32667_marine,83,30,78,6,113,93.97590361445783,7.228915662650602
32668_marine,82,30,77,5,112,93.90243902439023,6.097560975609756
32669_marine,82,30,77,5,112,93.90243902439023,6.097560975609756
32670_marine,82,30,77,5,112,93.90243902439023,6.097560975609756
32671_marine,82,30,77,5,112,93.90243902439023,6.097560975609756
32672_marine,81,29,76,4,110,93.82716049382715,4.938271604938271
32673_marine,81,29,76,4,110,93.82716049382715,4.938271604938271
32674_marine,84,29,79,5,113,94.04761904761905,5.952380952380952
32675_marine,94,29,89,10,123,94.68085106382979,10.638297872340425
32676_marine,111,29,105,14,140,94.5945945945946,12.612612612612612
32677_marine,682,196,429,394,878,62.903225806451616,57.77126099706745
32678_marine,769,261,498,436,1030,64.7594278283485,56.697009102730824
32686_marine,761,303,539,359,1064,70.82785808147175,47.174770039421816
32687_marine,710,249,497,341,959,70,48.02816901408451
32688_marine,715,228,490,351,943,68.53146853146853,49.09090909090909
32689_marine,719,250,498,344,969,69.26286509040334,47.8442280945758
32699_marine,979,331,599,580,1310,61.18488253319714,59.244126659857
32705_marine,967,363,574,593,1330,59.358841778697006,61.32368148914168
32706_marine,944,347,564,584,1291,59.7457627118644,61.86440677966102
32707_marine,952,372,562,583,1324,59.03361344537815,61.23949579831933
32718_marine,892,350,529,548,1242,59.30493273542601,61.43497757847533
32719_marine,877,338,524,539,1215,59.74914481185861,61.45952109464082
32720_marine,862,323,516,533,1185,59.86078886310905,61.832946635730856
32721_marine,122,32,113,20,154,92.62295081967213,16.39344262295082
32722_marine,123,32,113,20,155,91.869918699187,16.260162601626014
32723_marine,820,290,491,511,1110,59.8780487804878,62.31707317073171
32724_marine,831,293,498,512,1124,59.92779783393502,61.612515042117934
32725_marine,828,291,500,507,1119,60.38647342995169,61.23188405797102
32726_marine,864,327,530,525,1191,61.342592592592595,60.763888888888886
32727_marine,802,282,480,500,1084,59.85037406483791,62.34413965087282
32728_marine,110,34,102,16,144,92.72727272727272,14.545454545454545
32729_marine,818,274,481,522,1092,58.801955990220044,63.81418092909536
32730_marine,830,281,490,525,1111,59.036144578313255,63.25301204819277
32731_marine,823,273,485,521,1096,58.93074119076549,63.30498177399757
32732_marine,105,33,98,15,138,93.33333333333333,14.285714285714285
32733_marine,104,32,98,15,136,94.23076923076923,14.423076923076922
32734_marine,100,33,94,15,133,94,15
32735_marine,100,34,94,15,134,94,15
32736_marine,96,35,91,12,131,94.79166666666666,12.5
32737_marine,94,36,89,10,130,94.68085106382979,10.638297872340425
32738_marine,95,36,90,10,131,94.73684210526315,10.526315789473683
32739_marine,95,36,90,10,131,94.73684210526315,10.526315789473683
32740_marine,95,36,90,10,131,94.73684210526315,10.526315789473683
32741_marine,96,36,91,10,132,94.79166666666666,10.416666666666668
32742_marine,96,36,91,10,132,94.79166666666666,10.416666666666668
32743_marine,96,36,91,10,132,94.79166666666666,10.416666666666668
32744_marine,97,36,91,9,133,93.81443298969072,9.278350515463918
32745_marine,98,37,92,9,135,93.87755102040816,9.183673469387756
32746_marine,118,42,101,24,160,85.59322033898306,20.33898305084746
32747_marine,541,146,373,321,687,68.94639556377079,59.33456561922365
32748_marine,521,131,356,313,652,68.33013435700576,60.076775431861805
32749_marine,513,124,348,316,637,67.83625730994152,61.59844054580896
32750_marine,537,147,368,327,684,68.52886405959032,60.893854748603346
32751_marine,514,128,349,317,642,67.89883268482491,61.673151750972764
32752_marine,101,42,95,11,143,94.05940594059405,10.891089108910892
32753_marine,511,135,348,312,646,68.10176125244618,61.05675146771037
32754_marine,513,137,350,312,650,68.2261208576998,60.81871345029239
32755_marine,547,155,379,328,702,69.28702010968921,59.96343692870201
32756_marine,511,137,348,312,648,68.10176125244618,61.05675146771037
32757_marine,508,139,345,311,647,67.91338582677166,61.22047244094488
32758_marine,507,133,344,311,640,67.85009861932939,61.34122287968442
32759_marine,100,44,94,11,144,94,11
32760_marine,99,44,93,10,143,93.93939393939394,10.1010101010101
32761_marine,99,42,93,10,141,93.93939393939394,10.1010101010101
32762_marine,98,42,92,8,140,93.87755102040816,8.16326530612245
32763_marine,98,42,92,8,140,93.87755102040816,8.16326530612245
32764_marine,99,40,93,8,139,93.93939393939394,8.080808080808081
32765_marine,99,41,93,8,140,93.93939393939394,8.080808080808081
32766_marine,101,41,95,8,142,94.05940594059405,7.920792079207921
32767_marine,101,41,95,8,142,94.05940594059405,7.920792079207921
32768_marine,494,113,332,298,607,67.20647773279353,60.32388663967612
32769_marine,494,115,332,298,609,67.20647773279353,60.32388663967612
32770_marine,103,41,97,10,144,94.1747572815534,9.70873786407767
32771_marine,103,42,97,10,145,94.1747572815534,9.70873786407767
32772_marine,103,42,97,10,145,94.1747572815534,9.70873786407767
32773_marine,103,42,97,10,145,94.1747572815534,9.70873786407767
32774_marine,103,42,97,10,145,94.1747572815534,9.70873786407767
32775_marine,100,43,94,10,143,94,10
32776_marine,100,42,94,10,142,94,10
32777_marine,100,42,94,10,142,94,10
32778_marine,100,42,94,10,142,94,10
32779_marine,100,42,94,10,142,94,10
32780_marine,382,98,274,222,480,71.72774869109948,58.1151832460733
32781_marine,382,98,274,223,480,71.72774869109948,58.37696335078534
32782_marine,98,42,92,10,140,93.87755102040816,10.204081632653061
32783_marine,97,42,91,10,139,93.81443298969072,10.309278350515463
32784_marine,98,42,92,10,140,93.87755102040816,10.204081632653061
32785_marine,98,42,92,10,140,93.87755102040816,10.204081632653061
32786_marine,99,42,93,11,141,93.93939393939394,11.11111111111111
32787_marine,98,42,92,11,140,93.87755102040816,11.224489795918368
32788_marine,97,42,91,10,139,93.81443298969072,10.309278350515463
32789_marine,99,43,93,12,142,93.93939393939394,12.121212121212121
32790_marine,100,43,94,12,143,94,12
32791_marine,98,43,92,10,141,93.87755102040816,10.204081632653061
32792_marine,98,43,92,10,141,93.87755102040816,10.204081632653061
32793_marine,99,43,93,12,142,93.93939393939394,12.121212121212121
32794_marine,99,43,93,12,142,93.93939393939394,12.121212121212121
32795_marine,96,41,90,11,137,93.75,11.458333333333332
32796_marine,96,41,90,11,137,93.75,11.458333333333332
32797_marine,96,41,90,11,137,93.75,11.458333333333332
32798_marine,96,41,90,11,137,93.75,11.458333333333332
32799_marine,96,41,90,11,137,93.75,11.458333333333332
32800_marine,95,40,89,10,135,93.6842105263158,10.526315789473683
32801_marine,95,39,89,10,134,93.6842105263158,10.526315789473683
32802_marine,90,39,84,8,129,93.33333333333333,8.88888888888889
32803_marine,90,39,84,8,129,93.33333333333333,8.88888888888889
32804_marine,91,38,86,7,129,94.5054945054945,7.6923076923076925
32805_marine,91,38,86,7,129,94.5054945054945,7.6923076923076925
32806_marine,91,38,86,7,129,94.5054945054945,7.6923076923076925
32807_marine,92,38,87,7,130,94.56521739130434,7.608695652173914
32808_marine,92,38,87,7,130,94.56521739130434,7.608695652173914
32809_marine,92,38,87,7,130,94.56521739130434,7.608695652173914
32810_marine,92,38,87,7,130,94.56521739130434,7.608695652173914
32811_marine,92,38,87,7,130,94.56521739130434,7.608695652173914
32812_marine,93,38,88,7,131,94.6236559139785,7.526881720430108
32813_marine,92,37,87,7,129,94.56521739130434,7.608695652173914
32814_marine,91,37,86,6,128,94.5054945054945,6.593406593406594
32815_marine,91,39,86,5,130,94.5054945054945,5.4945054945054945
32816_marine,91,41,86,5,132,94.5054945054945,5.4945054945054945
32817_marine,91,41,86,5,132,94.5054945054945,5.4945054945054945
32818_marine,91,41,86,5,132,94.5054945054945,5.4945054945054945
32819_marine,91,41,86,5,132,94.5054945054945,5.4945054945054945
32820_marine,91,43,86,5,134,94.5054945054945,5.4945054945054945
32821_marine,91,43,86,5,134,94.5054945054945,5.4945054945054945
32822_marine,91,43,86,5,134,94.5054945054945,5.4945054945054945
32823_marine,90,44,85,5,134,94.44444444444444,5.555555555555555
32824_marine,91,44,86,5,135,94.5054945054945,5.4945054945054945
32825_marine,90,44,85,5,134,94.44444444444444,5.555555555555555
32826_marine,90,44,85,5,134,94.44444444444444,5.555555555555555
32827_marine,90,45,85,5,135,94.44444444444444,5.555555555555555
32828_marine,90,45,85,5,135,94.44444444444444,5.555555555555555
32829_marine,87,45,82,5,132,94.25287356321839,5.747126436781609
32830_marine,87,44,82,5,131,94.25287356321839,5.747126436781609
32831_marine,86,43,81,5,129,94.18604651162791,5.813953488372093
32832_marine,86,43,81,5,129,94.18604651162791,5.813953488372093
32833_marine,85,42,80,5,127,94.11764705882352,5.88235294117647
32834_marine,85,41,80,5,126,94.11764705882352,5.88235294117647
32835_marine,85,42,80,5,127,94.11764705882352,5.88235294117647
32836_marine,85,43,80,5,128,94.11764705882352,5.88235294117647
32837_marine,85,43,80,5,128,94.11764705882352,5.88235294117647
32838_marine,85,43,80,5,128,94.11764705882352,5.88235294117647
32839_marine,85,42,80,5,127,94.11764705882352,5.88235294117647
32840_marine,85,43,80,5,128,94.11764705882352,5.88235294117647
32841_marine,85,43,80,5,128,94.11764705882352,5.88235294117647
32842_marine,89,43,84,5,132,94.3820224719101,5.617977528089887
32843_marine,89,44,84,5,133,94.3820224719101,5.617977528089887
32844_marine,91,43,86,5,134,94.5054945054945,5.4945054945054945
32845_marine,97,43,93,6,140,95.87628865979381,6.185567010309279
32846_marine,99,43,95,6,142,95.95959595959596,6.0606060606060606
32847_marine,108,48,103,8,156,95.37037037037037,7.4074074074074066
32848_marine,170,99,151,27,269,88.8235294117647,15.88235294117647
32849_marine,335,214,238,136,549,71.04477611940298,40.59701492537313
32850_marine,327,222,235,130,549,71.86544342507645,39.75535168195719
32851_marine,323,207,234,127,530,72.44582043343654,39.318885448916404
32852_marine,173,109,152,30,282,87.861271676300575,17.341040462427745
32853_marine,110,43,104,12,153,94.54545454545455,10.909090909090908
32854_marine,101,44,95,10,145,94.05940594059405,9.900990099009901
32855_marine,100,44,94,10,144,94,10
32856_marine,102,49,96,9,151,94.11764705882352,8.823529411764707
32857_marine,109,48,102,12,157,93.57798165137615,11.009174311926607
32858_marine,115,57,109,12,172,94.78260869565217,10.434782608695652
32859_marine,412,289,300,146,701,72.81553398058253,35.43689320388349
32897_marine,291,173,240,80,464,82.4742268041237,27.491408934707906
32898_marine,302,176,245,89,478,81.12582781456953,29.47019867549669
32899_marine,289,136,233,88,425,80.62283737024222,30.44982698961938
32900_marine,299,145,243,96,444,81.27090301003345,32.10702341137124
32901_marine,300,131,244,96,431,81.33333333333333,32
32902_marine,123,70,117,15,193,95.1219512195122,12.195121951219512
32903_marine,111,55,105,11,166,94.5945945945946,9.90990990990991
32904_marine,116,40,107,11,156,92.24137931034483,9.482758620689655
32905_marine,114,40,105,11,154,92.10526315789474,9.649122807017543
32906_marine,106,40,99,9,146,93.39622641509435,8.49056603773585
32907_marine,100,42,93,9,142,93,9
32908_marine,96,44,89,9,140,92.70833333333334,9.375
32909_marine,94,42,87,8,136,92.5531914893617,8.51063829787234
32910_marine,97,42,90,9,139,92.78350515463917,9.278350515463918
32911_marine,97,40,90,9,137,92.78350515463917,9.278350515463918
32912_marine,95,38,90,7,133,94.73684210526315,7.368421052631578
32913_marine,95,38,90,7,133,94.73684210526315,7.368421052631578
32914_marine,91,38,86,5,129,94.5054945054945,5.4945054945054945
32915_marine,91,40,86,5,131,94.5054945054945,5.4945054945054945
32916_marine,93,40,88,5,133,94.6236559139785,5.376344086021505
32917_marine,94,40,89,5,134,94.68085106382979,5.319148936170213
32918_marine,94,40,89,5,134,94.68085106382979,5.319148936170213
32919_marine,90,40,85,5,130,94.44444444444444,5.555555555555555
32920_marine,91,38,85,5,129,93.4065934065934,5.4945054945054945
32921_marine,91,37,85,5,128,93.4065934065934,5.4945054945054945
32922_marine,92,35,85,6,127,92.3913043478261,6.521739130434782
32923_marine,93,35,85,7,128,91.39784946236558,7.526881720430108
32924_marine,93,35,85,7,128,91.39784946236558,7.526881720430108
32925_marine,92,35,84,7,127,91.30434782608695,7.608695652173914
32926_marine,91,34,83,7,125,91.20879120879121,7.6923076923076925
32927_marine,88,34,80,6,122,90.9090909090909,6.8181818181818175
32928_marine,87,34,79,6,121,90.80459770114942,6.896551724137931
32929_marine,86,34,78,6,120,90.69767441860465,6.976744186046512
32930_marine,86,34,78,6,120,90.69767441860465,6.976744186046512
32931_marine,86,34,78,6,120,90.69767441860465,6.976744186046512
32932_marine,85,34,77,6,119,90.58823529411765,7.0588235294117645
32933_marine,88,34,80,6,122,90.9090909090909,6.8181818181818175
32934_marine,85,34,78,5,119,91.76470588235294,5.88235294117647
32935_marine,87,34,80,5,121,91.95402298850574,5.747126436781609
32936_marine,87,34,80,5,121,91.95402298850574,5.747126436781609
32937_marine,87,34,80,5,121,91.95402298850574,5.747126436781609
32938_marine,86,34,79,5,120,91.86046511627907,5.813953488372093
32939_marine,86,34,79,5,120,91.86046511627907,5.813953488372093
32940_marine,86,34,79,5,120,91.86046511627907,5.813953488372093
32941_marine,87,34,79,6,121,90.80459770114942,6.896551724137931
32942_marine,89,36,81,7,125,91.01123595505618,7.865168539325842
32943_marine,87,36,79,7,123,90.80459770114942,8.045977011494253
32944_marine,88,36,80,7,124,90.9090909090909,7.954545454545454
32945_marine,214,85,185,41,299,86.44859813084112,19.158878504672895
32946_marine,238,104,201,54,342,84.45378151260505,22.689075630252102
32947_marine,218,87,191,40,305,87.61467889908256,18.34862385321101
32948_marine,250,116,224,38,366,89.60000000000001,15.2
32983_marine,688,252,463,370,940,67.29651162790698,53.779069767441854
32984_marine,569,174,393,310,743,69.06854130052724,54.48154657293497
32985_marine,101,36,93,16,137,92.07920792079209,15.841584158415841
32986_marine,101,34,93,16,135,92.07920792079209,15.841584158415841
32987_marine,100,32,92,15,132,92,15
32988_marine,96,32,89,13,128,92.70833333333334,13.541666666666666
32989_marine,90,34,83,9,124,92.22222222222223,10
32990_marine,93,34,87,13,127,93.54838709677419,13.978494623655912
32991_marine,89,34,83,13,123,93.25842696629213,14.606741573033707
32992_marine,90,34,84,13,124,93.33333333333333,14.444444444444443
32993_marine,93,34,87,15,127,93.54838709677419,16.129032258064516
32994_marine,95,36,89,15,131,93.6842105263158,15.789473684210526
32995_marine,92,36,86,15,128,93.47826086956522,16.304347826086957
32996_marine,94,36,88,15,130,93.61702127659575,15.957446808510639
32997_marine,90,36,84,13,126,93.33333333333333,14.444444444444443
32998_marine,88,33,82,11,121,93.18181818181817,12.5
32999_marine,86,33,80,9,119,93.02325581395348,10.465116279069768
33000_marine,85,32,79,10,117,92.94117647058823,11.76470588235294
33001_marine,84,32,78,9,116,92.85714285714286,10.714285714285714
33002_marine,84,32,78,9,116,92.85714285714286,10.714285714285714
33003_marine,83,32,77,8,115,92.7710843373494,9.63855421686747
33004_marine,83,32,77,8,115,92.7710843373494,9.63855421686747
33005_marine,82,32,77,7,114,93.90243902439023,8.536585365853659
33006_marine,82,32,77,7,114,93.90243902439023,8.536585365853659
33007_marine,82,34,77,7,116,93.90243902439023,8.536585365853659
33008_marine,82,34,77,7,116,93.90243902439023,8.536585365853659
33009_marine,83,34,78,7,117,93.97590361445783,8.433734939759036
33010_marine,83,34,78,7,117,93.97590361445783,8.433734939759036
33011_marine,88,37,83,9,125,94.31818181818183,10.227272727272728
33012_marine,95,36,90,12,131,94.73684210526315,12.631578947368421
33013_marine,604,153,381,361,757,63.079470198675494,59.7682119205298
33014_marine,606,153,383,361,759,63.20132013201321,59.570957095709574
33015_marine,603,147,380,359,750,63.018242122719734,59.53565505804311
33016_marine,93,32,88,9,125,94.6236559139785,9.67741935483871
33017_marine,87,32,82,7,119,94.25287356321839,8.045977011494253
33018_marine,88,32,83,7,120,94.31818181818183,7.954545454545454
33019_marine,87,30,83,6,117,95.40229885057471,6.896551724137931
33020_marine,86,30,82,6,116,95.34883720930233,6.976744186046512
33021_marine,86,30,82,6,116,95.34883720930233,6.976744186046512
33022_marine,82,30,78,6,112,95.1219512195122,7.317073170731707
33023_marine,82,30,78,6,112,95.1219512195122,7.317073170731707
33024_marine,82,31,78,6,113,95.1219512195122,7.317073170731707
33025_marine,82,31,78,6,113,95.1219512195122,7.317073170731707
33026_marine,82,31,78,6,113,95.1219512195122,7.317073170731707
33027_marine,82,31,78,6,113,95.1219512195122,7.317073170731707
33028_marine,82,30,78,6,112,95.1219512195122,7.317073170731707
33029_marine,81,30,77,5,111,95.06172839506173,6.172839506172839
33030_marine,81,30,77,5,111,95.06172839506173,6.172839506172839
33031_marine,81,30,77,5,111,95.06172839506173,6.172839506172839
33032_marine,81,30,77,5,111,95.06172839506173,6.172839506172839
33033_marine,80,30,76,4,110,95,5
33034_marine,81,30,77,5,111,95.06172839506173,6.172839506172839
33035_marine,86,29,82,5,115,95.34883720930233,5.813953488372093
33036_marine,102,29,97,12,131,95.09803921568627,11.76470588235294
33037_marine,113,31,107,17,144,94.69026548672566,15.04424778761062
33038_marine,694,198,440,400,892,63.40057636887608,57.636887608069166
33044_marine,761,303,550,369,1064,72.27332457293035,48.48883048620237
33048_marine,718,248,499,349,966,69.49860724233984,48.607242339832865
33051_marine,1123,601,731,638,1724,65.09349955476402,56.81211041852182
33059_marine,958,335,583,564,1293,60.855949895615865,58.872651356993735
33065_marine,1146,507,685,714,1653,59.77312390924956,62.30366492146597
33066_marine,1154,522,697,699,1676,60.39861351819758,60.57192374350087
33067_marine,1124,499,666,696,1623,59.252669039145914,61.92170818505338
33081_marine,877,348,523,541,1225,59.635119726339795,61.68757126567846
33082_marine,879,332,522,545,1211,59.38566552901023,62.00227531285552
33083_marine,913,362,557,556,1275,61.00766703176341,60.89813800657174
33084_marine,900,343,546,547,1243,60.66666666666667,60.77777777777777
33085_marine,905,333,553,550,1238,61.1049723756906,60.773480662983424
33086_marine,932,340,562,570,1272,60.30042918454935,61.1587982832618
33089_marine,895,343,533,552,1238,59.55307262569832,61.675977653631286
33090_marine,970,399,589,591,1369,60.72164948453608,60.92783505154639
33091_marine,941,367,568,581,1308,60.36131774707758,61.742826780021254
33092_marine,850,297,504,533,1147,59.29411764705882,62.70588235294118
33093_marine,840,293,496,530,1133,59.04761904761905,63.095238095238095
33094_marine,843,295,508,522,1138,60.26097271648872,61.92170818505338
33095_marine,101,35,94,15,136,93.06930693069307,14.85148514851485
33096_marine,101,35,94,15,136,93.06930693069307,14.85148514851485
33097_marine,98,34,91,13,132,92.85714285714286,13.26530612244898
33098_marine,96,34,89,11,130,92.70833333333334,11.458333333333332
33099_marine,96,34,90,10,130,93.75,10.416666666666668
33100_marine,95,34,90,10,129,94.73684210526315,10.526315789473683
33101_marine,96,34,91,10,130,94.79166666666666,10.416666666666668
33102_marine,97,34,91,10,131,93.81443298969072,10.309278350515463
33103_marine,97,34,91,10,131,93.81443298969072,10.309278350515463
33104_marine,98,34,92,10,132,93.87755102040816,10.204081632653061
33105_marine,98,34,92,9,132,93.87755102040816,9.183673469387756
33106_marine,98,35,92,9,133,93.87755102040816,9.183673469387756
33107_marine,511,124,346,312,635,67.71037181996086,61.05675146771037
33108_marine,513,126,348,312,639,67.83625730994152,60.81871345029239
33109_marine,513,122,348,316,635,67.83625730994152,61.59844054580896
33110_marine,513,125,348,316,638,67.83625730994152,61.59844054580896
33111_marine,514,124,349,317,638,67.89883268482491,61.673151750972764
33112_marine,102,39,96,12,141,94.11764705882352,11.76470588235294
33113_marine,101,40,95,11,141,94.05940594059405,10.891089108910892
33114_marine,511,135,348,312,646,68.10176125244618,61.05675146771037
33115_marine,547,155,379,328,702,69.28702010968921,59.96343692870201
33116_marine,547,154,379,328,701,69.28702010968921,59.96343692870201
33117_marine,542,157,374,326,699,69.00369003690037,60.147601476014756
33118_marine,510,133,347,313,643,68.03921568627452,61.372549019607845
33119_marine,101,42,95,12,143,94.05940594059405,11.881188118811881
33120_marine,99,42,93,10,141,93.93939393939394,10.1010101010101
33121_marine,99,42,93,10,141,93.93939393939394,10.1010101010101
33122_marine,97,42,91,8,139,93.81443298969072,8.24742268041237
33123_marine,98,41,92,8,139,93.87755102040816,8.16326530612245
33124_marine,98,41,92,8,139,93.87755102040816,8.16326530612245
33125_marine,98,41,92,8,139,93.87755102040816,8.16326530612245
33126_marine,463,115,313,284,578,67.60259179265658,61.33909287257019
33127_marine,465,115,315,284,580,67.74193548387096,61.0752688172043
33128_marine,493,117,331,298,610,67.13995943204868,60.446247464503045
33129_marine,519,133,351,309,652,67.63005780346822,59.53757225433526
33130_marine,495,118,331,300,613,66.86868686868686,60.60606060606061
33131_marine,102,41,96,10,143,94.11764705882352,9.803921568627452
33132_marine,102,41,96,10,143,94.11764705882352,9.803921568627452
33133_marine,102,41,96,10,143,94.11764705882352,9.803921568627452
33134_marine,102,42,96,10,144,94.11764705882352,9.803921568627452
33135_marine,100,43,94,10,143,94,10
33136_marine,100,42,94,10,142,94,10
33137_marine,102,42,96,12,144,94.11764705882352,11.76470588235294
33138_marine,102,42,96,12,144,94.11764705882352,11.76470588235294
33139_marine,102,42,96,12,144,94.11764705882352,11.76470588235294
33140_marine,99,42,93,10,141,93.93939393939394,10.1010101010101
33141_marine,100,42,94,11,142,94,11
33142_marine,98,42,92,10,140,93.87755102040816,10.204081632653061
33143_marine,97,42,91,10,139,93.81443298969072,10.309278350515463
33144_marine,97,42,91,10,139,93.81443298969072,10.309278350515463
33145_marine,97,42,91,10,139,93.81443298969072,10.309278350515463
33146_marine,96,42,90,10,138,93.75,10.416666666666668
33147_marine,97,42,91,11,139,93.81443298969072,11.34020618556701
33148_marine,98,42,92,12,140,93.87755102040816,12.244897959183673
33149_marine,99,42,93,12,141,93.93939393939394,12.121212121212121
33150_marine,99,43,93,12,142,93.93939393939394,12.121212121212121
33151_marine,99,43,93,12,142,93.93939393939394,12.121212121212121
33152_marine,98,43,92,12,141,93.87755102040816,12.244897959183673
33153_marine,98,43,92,12,141,93.87755102040816,12.244897959183673
33154_marine,99,43,93,12,142,93.93939393939394,12.121212121212121
33155_marine,99,43,93,12,142,93.93939393939394,12.121212121212121
33156_marine,99,43,93,11,142,93.93939393939394,11.11111111111111
33157_marine,99,42,93,11,141,93.93939393939394,11.11111111111111
33158_marine,99,41,93,11,140,93.93939393939394,11.11111111111111
33159_marine,101,41,95,11,142,94.05940594059405,10.891089108910892
33160_marine,101,40,95,11,141,94.05940594059405,10.891089108910892
33161_marine,98,40,92,10,138,93.87755102040816,10.204081632653061
33162_marine,98,40,92,10,138,93.87755102040816,10.204081632653061
33163_marine,95,40,89,10,135,93.6842105263158,10.526315789473683
33164_marine,95,40,89,10,135,93.6842105263158,10.526315789473683
33165_marine,92,39,87,7,131,94.56521739130434,7.608695652173914
33166_marine,92,39,87,7,131,94.56521739130434,7.608695652173914
33167_marine,93,39,88,7,132,94.6236559139785,7.526881720430108
33168_marine,93,39,88,7,132,94.6236559139785,7.526881720430108
33169_marine,93,39,88,7,132,94.6236559139785,7.526881720430108
33170_marine,93,39,88,7,132,94.6236559139785,7.526881720430108
33171_marine,93,39,88,7,132,94.6236559139785,7.526881720430108
33172_marine,93,39,88,7,132,94.6236559139785,7.526881720430108
33173_marine,92,40,87,7,132,94.56521739130434,7.608695652173914
33174_marine,91,39,86,6,130,94.5054945054945,6.593406593406594
33175_marine,92,39,87,6,131,94.56521739130434,6.521739130434782
33176_marine,91,39,86,5,130,94.5054945054945,5.4945054945054945
33177_marine,91,41,86,5,132,94.5054945054945,5.4945054945054945
33178_marine,91,41,86,5,132,94.5054945054945,5.4945054945054945
33179_marine,91,41,86,5,132,94.5054945054945,5.4945054945054945
33180_marine,91,41,86,5,132,94.5054945054945,5.4945054945054945
33181_marine,92,43,87,5,135,94.56521739130434,5.434782608695652
33182_marine,91,43,86,5,134,94.5054945054945,5.4945054945054945
33183_marine,91,44,86,5,135,94.5054945054945,5.4945054945054945
33184_marine,91,44,86,5,135,94.5054945054945,5.4945054945054945
33185_marine,90,44,85,5,134,94.44444444444444,5.555555555555555
33186_marine,90,44,85,5,134,94.44444444444444,5.555555555555555
33187_marine,90,44,85,5,134,94.44444444444444,5.555555555555555
33188_marine,90,44,85,5,134,94.44444444444444,5.555555555555555
33189_marine,89,44,84,5,133,94.3820224719101,5.617977528089887
33190_marine,89,44,84,5,133,94.3820224719101,5.617977528089887
33191_marine,89,43,84,5,132,94.3820224719101,5.617977528089887
33192_marine,86,42,81,5,128,94.18604651162791,5.813953488372093
33193_marine,86,42,81,5,128,94.18604651162791,5.813953488372093
33194_marine,86,41,81,5,127,94.18604651162791,5.813953488372093
33195_marine,85,42,80,5,127,94.11764705882352,5.88235294117647
33196_marine,85,43,80,5,128,94.11764705882352,5.88235294117647
33197_marine,85,42,80,5,127,94.11764705882352,5.88235294117647
33198_marine,85,42,80,5,127,94.11764705882352,5.88235294117647
33199_marine,85,42,80,5,127,94.11764705882352,5.88235294117647
33200_marine,85,43,80,5,128,94.11764705882352,5.88235294117647
33201_marine,85,43,80,5,128,94.11764705882352,5.88235294117647
33202_marine,85,43,80,5,128,94.11764705882352,5.88235294117647
33203_marine,87,44,82,5,131,94.25287356321839,5.747126436781609
33204_marine,89,44,84,5,133,94.3820224719101,5.617977528089887
33205_marine,96,44,91,6,140,94.79166666666666,6.25
33206_marine,96,43,92,6,139,95.83333333333334,6.25
33207_marine,105,43,100,8,148,95.23809523809523,7.6190476190476195
33208_marine,108,48,103,8,156,95.37037037037037,7.4074074074074066
33209_marine,172,97,151,31,269,87.79069767441861,18.023255813953487
33210_marine,279,142,208,92,421,74.55197132616487,32.97491039426524
33211_marine,206,105,171,59,311,83.00970873786407,28.640776699029125
33212_marine,168,93,147,29,261,87.5,17.261904761904763
33213_marine,108,44,102,12,152,94.44444444444444,11.11111111111111
33214_marine,99,44,93,9,143,93.93939393939394,9.090909090909092
33215_marine,99,45,93,9,144,93.93939393939394,9.090909090909092
33216_marine,104,49,98,8,153,94.23076923076923,7.6923076923076925
33217_marine,110,48,105,9,158,95.45454545454545,8.181818181818182
33218_marine,111,56,106,10,167,95.4954954954955,9.00900900900901
33262_marine,319,172,259,104,491,81.19122257053291,32.60188087774294
33263_marine,311,142,250,103,453,80.38585209003215,33.11897106109325
33264_marine,118,46,109,13,164,92.37288135593221,11.016949152542372
33265_marine,116,44,107,11,160,92.24137931034483,9.482758620689655
33266_marine,177,73,152,56,250,85.87570621468926,31.63841807909605
33267_marine,171,73,148,54,244,86.54970760233918,31.57894736842105
33268_marine,161,73,138,54,234,85.71428571428571,33.54037267080746
33269_marine,163,73,140,55,236,85.88957055214725,33.74233128834356
33270_marine,97,41,90,11,138,92.78350515463917,11.34020618556701
33271_marine,95,39,88,9,134,92.63157894736842,9.473684210526317
33272_marine,95,39,88,9,134,92.63157894736842,9.473684210526317
33273_marine,93,39,88,7,132,94.6236559139785,7.526881720430108
33274_marine,91,39,86,5,130,94.5054945054945,5.4945054945054945
33275_marine,91,41,86,5,132,94.5054945054945,5.4945054945054945
33276_marine,91,41,86,5,132,94.5054945054945,5.4945054945054945
33277_marine,91,41,86,5,132,94.5054945054945,5.4945054945054945
33278_marine,91,41,86,5,132,94.5054945054945,5.4945054945054945
33279_marine,90,39,85,5,129,94.44444444444444,5.555555555555555
33280_marine,90,39,85,5,129,94.44444444444444,5.555555555555555
33281_marine,91,39,85,5,130,93.4065934065934,5.4945054945054945
33282_marine,91,36,84,6,127,92.3076923076923,6.593406593406594
33283_marine,92,35,84,7,127,91.30434782608695,7.608695652173914
33284_marine,92,35,84,7,127,91.30434782608695,7.608695652173914
33285_marine,91,35,83,7,126,91.20879120879121,7.6923076923076925
33286_marine,91,35,83,7,126,91.20879120879121,7.6923076923076925
33287_marine,90,35,82,7,125,91.11111111111111,7.777777777777778
33288_marine,90,35,82,7,125,91.11111111111111,7.777777777777778
33289_marine,88,34,80,6,122,90.9090909090909,6.8181818181818175
33290_marine,88,34,80,6,122,90.9090909090909,6.8181818181818175
33291_marine,88,34,80,6,122,90.9090909090909,6.8181818181818175
33292_marine,86,34,78,6,120,90.69767441860465,6.976744186046512
33293_marine,86,34,78,6,120,90.69767441860465,6.976744186046512
33294_marine,83,34,75,6,117,90.36144578313254,7.228915662650602
33295_marine,83,34,75,6,117,90.36144578313254,7.228915662650602
33296_marine,82,34,75,5,116,91.46341463414635,6.097560975609756
33297_marine,82,34,75,5,116,91.46341463414635,6.097560975609756
33298_marine,83,34,76,5,117,91.56626506024097,6.024096385542169
33299_marine,84,34,77,5,118,91.66666666666666,5.952380952380952
33300_marine,86,34,79,5,120,91.86046511627907,5.813953488372093
33301_marine,88,36,81,5,124,92.04545454545455,5.681818181818182
33302_marine,88,34,81,5,122,92.04545454545455,5.681818181818182
33303_marine,85,36,78,5,121,91.76470588235294,5.88235294117647
33304_marine,85,36,78,5,121,91.76470588235294,5.88235294117647
33305_marine,206,87,180,35,293,87.37864077669903,16.990291262135923
33306_marine,209,85,182,38,294,87.08133971291866,18.181818181818183
33307_marine,217,93,192,37,310,88.47926267281106,17.050691244239633
33308_marine,97,51,92,7,148,94.84536082474226,7.216494845360824
33309_marine,279,132,252,40,411,90.32258064516128,14.336917562724013
33343_marine,616,188,423,335,804,68.66883116883116,54.38311688311688
33344_marine,102,36,94,18,138,92.15686274509804,17.647058823529413
33345_marine,101,36,93,17,137,92.07920792079209,16.831683168316832
33346_marine,98,33,90,15,131,91.83673469387756,15.306122448979592
33347_marine,95,33,87,14,128,91.57894736842105,14.736842105263156
33348_marine,91,33,84,9,124,92.3076923076923,9.89010989010989
33349_marine,95,34,89,13,129,93.6842105263158,13.684210526315791
33350_marine,90,34,84,13,124,93.33333333333333,14.444444444444443
33351_marine,90,34,84,13,124,93.33333333333333,14.444444444444443
33352_marine,94,36,88,15,130,93.61702127659575,15.957446808510639
33353_marine,98,36,92,17,134,93.87755102040816,17.346938775510203
33354_marine,98,36,92,17,134,93.87755102040816,17.346938775510203
33355_marine,562,183,371,331,745,66.01423487544484,58.89679715302491
33356_marine,560,186,369,331,746,65.89285714285714,59.10714285714286
33357_marine,558,183,367,329,741,65.77060931899642,58.96057347670251
33358_marine,92,36,86,12,128,93.47826086956522,13.043478260869565
33359_marine,88,34,82,9,122,93.18181818181817,10.227272727272728
33360_marine,84,33,78,9,117,92.85714285714286,10.714285714285714
33361_marine,83,33,77,8,116,92.7710843373494,9.63855421686747
33362_marine,83,33,77,8,116,92.7710843373494,9.63855421686747
33363_marine,83,33,77,8,116,92.7710843373494,9.63855421686747
33364_marine,83,33,77,8,116,92.7710843373494,9.63855421686747
33365_marine,83,33,77,8,116,92.7710843373494,9.63855421686747
33366_marine,83,33,77,8,116,92.7710843373494,9.63855421686747
33367_marine,82,33,77,7,115,93.90243902439023,8.536585365853659
33368_marine,82,33,77,7,115,93.90243902439023,8.536585365853659
33369_marine,82,33,77,7,115,93.90243902439023,8.536585365853659
33370_marine,83,33,78,7,116,93.97590361445783,8.433734939759036
33371_marine,87,34,82,9,121,94.25287356321839,10.344827586206897
33372_marine,89,34,84,12,123,94.3820224719101,13.48314606741573
33373_marine,93,36,88,12,129,94.6236559139785,12.903225806451612
33374_marine,95,37,90,12,132,94.73684210526315,12.631578947368421
33375_marine,96,37,91,11,133,94.79166666666666,11.458333333333332
33376_marine,91,32,86,7,123,94.5054945054945,7.6923076923076925
33377_marine,89,32,84,7,121,94.3820224719101,7.865168539325842
33378_marine,87,31,83,6,118,95.40229885057471,6.896551724137931
33379_marine,87,31,83,6,118,95.40229885057471,6.896551724137931
33380_marine,85,31,81,6,116,95.29411764705881,7.0588235294117645
33381_marine,86,30,82,6,116,95.34883720930233,6.976744186046512
33382_marine,83,30,79,6,113,95.18072289156626,7.228915662650602
33383_marine,82,31,78,6,113,95.1219512195122,7.317073170731707
33384_marine,82,31,78,6,113,95.1219512195122,7.317073170731707
33385_marine,82,31,78,6,113,95.1219512195122,7.317073170731707
33386_marine,82,31,78,6,113,95.1219512195122,7.317073170731707
33387_marine,82,31,78,6,113,95.1219512195122,7.317073170731707
33388_marine,82,31,78,6,113,95.1219512195122,7.317073170731707
33389_marine,82,31,78,6,113,95.1219512195122,7.317073170731707
33390_marine,82,30,78,6,112,95.1219512195122,7.317073170731707
33391_marine,81,30,77,5,111,95.06172839506173,6.172839506172839
33392_marine,81,30,77,5,111,95.06172839506173,6.172839506172839
33393_marine,81,30,77,5,111,95.06172839506173,6.172839506172839
33394_marine,81,30,77,5,111,95.06172839506173,6.172839506172839
33395_marine,86,30,82,5,116,95.34883720930233,5.813953488372093
33396_marine,89,30,85,8,119,95.50561797752809,8.98876404494382
33397_marine,107,29,102,14,136,95.32710280373831,13.084112149532709
33398_marine,673,196,423,395,869,62.852897473997025,58.6924219910847
33399_marine,712,210,454,404,922,63.76404494382022,56.74157303370787
33410_marine,747,266,512,366,1013,68.54082998661312,48.99598393574297
33411_marine,1150,619,747,653,1769,64.95652173913044,56.78260869565217
33417_marine,1172,596,752,682,1768,64.16382252559727,58.19112627986348
33418_marine,987,362,619,559,1349,62.71529888551165,56.636271529888546
33424_marine,1060,434,650,639,1494,61.32075471698113,60.28301886792453
33425_marine,1135,493,676,708,1628,59.55947136563877,62.37885462555066
33426_marine,1127,492,675,689,1619,59.893522626441886,61.1357586512866
33427_marine,1119,494,672,685,1613,60.05361930294906,61.2153708668454
33428_marine,1055,469,630,643,1524,59.71563981042654,60.947867298578196
33444_marine,892,357,528,550,1249,59.19282511210763,61.65919282511211
33445_marine,896,355,531,551,1251,59.26339285714286,61.49553571428571
33446_marine,922,368,551,560,1290,59.76138828633406,60.73752711496746
33449_marine,933,369,558,578,1302,59.80707395498393,61.95069667738478
33450_marine,983,423,584,616,1406,59.409969481180056,62.66531027466938
33453_marine,982,398,589,608,1380,59.979633401221996,61.91446028513238
33454_marine,871,310,523,535,1181,60.0459242250287,61.42365097588978
33455_marine,809,272,478,515,1081,59.08529048207664,63.658838071693445
33456_marine,745,236,454,467,981,60.939597315436245,62.68456375838927
33457_marine,102,35,93,15,137,91.17647058823529,14.705882352941178
33458_marine,98,35,89,13,133,90.81632653061224,13.26530612244898
33459_marine,97,34,88,11,131,90.72164948453609,11.34020618556701
33460_marine,98,34,89,11,132,90.81632653061224,11.224489795918368
33461_marine,98,34,91,10,132,92.85714285714286,10.204081632653061
33462_marine,97,34,91,10,131,93.81443298969072,10.309278350515463
33463_marine,97,34,91,10,131,93.81443298969072,10.309278350515463
33464_marine,98,34,92,10,132,93.87755102040816,10.204081632653061
33465_marine,99,34,93,10,133,93.93939393939394,10.1010101010101
33466_marine,99,35,93,10,134,93.93939393939394,10.1010101010101
33467_marine,97,35,91,9,132,93.81443298969072,9.278350515463918
33468_marine,97,36,91,9,133,93.81443298969072,9.278350515463918
33469_marine,99,37,93,9,136,93.93939393939394,9.090909090909092
33470_marine,99,38,93,9,137,93.93939393939394,9.090909090909092
33471_marine,99,38,93,9,137,93.93939393939394,9.090909090909092
33472_marine,102,39,96,12,141,94.11764705882352,11.76470588235294
33473_marine,100,39,94,12,139,94,12
33474_marine,99,40,93,11,139,93.93939393939394,11.11111111111111
33475_marine,511,134,348,312,645,68.10176125244618,61.05675146771037
33476_marine,539,153,371,328,692,68.83116883116884,60.85343228200371
33477_marine,539,154,371,326,693,68.83116883116884,60.48237476808905
33478_marine,510,134,347,312,644,68.03921568627452,61.1764705882353
33479_marine,102,43,96,12,145,94.11764705882352,11.76470588235294
33480_marine,101,42,95,11,143,94.05940594059405,10.891089108910892
33481_marine,100,41,94,10,141,94,10
33482_marine,98,39,92,8,137,93.87755102040816,8.16326530612245
33483_marine,98,40,92,8,138,93.87755102040816,8.16326530612245
33484_marine,98,40,92,8,138,93.87755102040816,8.16326530612245
33485_marine,465,114,313,286,579,67.31182795698925,61.505376344086024
33486_marine,483,132,328,296,615,67.90890269151139,61.28364389233955
33487_marine,467,117,315,288,584,67.45182012847965,61.67023554603854
33488_marine,497,116,331,302,613,66.59959758551308,60.7645875251509
33489_marine,517,130,347,312,647,67.11798839458413,60.34816247582205
33490_marine,514,133,345,311,647,67.12062256809338,60.505836575875485
33491_marine,493,115,329,300,608,66.73427991886409,60.85192697768763
33492_marine,102,41,96,10,143,94.11764705882352,9.803921568627452
33493_marine,102,41,96,10,143,94.11764705882352,9.803921568627452
33494_marine,102,41,96,10,143,94.11764705882352,9.803921568627452
33495_marine,100,42,94,10,142,94,10
33496_marine,102,42,96,12,144,94.11764705882352,11.76470588235294
33497_marine,102,42,96,12,144,94.11764705882352,11.76470588235294
33498_marine,102,42,96,12,144,94.11764705882352,11.76470588235294
33499_marine,101,42,95,12,143,94.05940594059405,11.881188118811881
33500_marine,101,42,95,12,143,94.05940594059405,11.881188118811881
33501_marine,100,42,94,11,142,94,11
33502_marine,98,42,92,10,140,93.87755102040816,10.204081632653061
33503_marine,97,42,91,10,139,93.81443298969072,10.309278350515463
33504_marine,99,43,93,12,142,93.93939393939394,12.121212121212121
33505_marine,348,89,250,200,437,71.83908045977012,57.47126436781609
33506_marine,367,100,265,209,467,72.20708446866485,56.94822888283378
33507_marine,346,87,248,199,433,71.67630057803468,57.51445086705203
33508_marine,99,42,93,12,141,93.93939393939394,12.121212121212121
33509_marine,99,42,93,12,141,93.93939393939394,12.121212121212121
33510_marine,99,42,93,12,141,93.93939393939394,12.121212121212121
33511_marine,99,43,93,12,142,93.93939393939394,12.121212121212121
33512_marine,99,43,93,12,142,93.93939393939394,12.121212121212121
33513_marine,99,43,93,12,142,93.93939393939394,12.121212121212121
33514_marine,99,43,93,12,142,93.93939393939394,12.121212121212121
33515_marine,99,43,93,12,142,93.93939393939394,12.121212121212121
33516_marine,99,43,93,12,142,93.93939393939394,12.121212121212121
33517_marine,98,43,92,11,141,93.87755102040816,11.224489795918368
33518_marine,98,43,92,11,141,93.87755102040816,11.224489795918368
33519_marine,100,42,94,11,142,94,11
33520_marine,100,41,94,11,141,94,11
33521_marine,100,40,94,11,140,94,11
33522_marine,99,40,93,10,139,93.93939393939394,10.1010101010101
33523_marine,99,40,93,10,139,93.93939393939394,10.1010101010101
33524_marine,97,40,91,10,137,93.81443298969072,10.309278350515463
33525_marine,95,39,89,8,134,93.6842105263158,8.421052631578947
33526_marine,94,39,89,7,133,94.68085106382979,7.446808510638298
33527_marine,95,39,90,7,134,94.73684210526315,7.368421052631578
33528_marine,94,39,89,7,133,94.68085106382979,7.446808510638298
33529_marine,94,39,89,7,133,94.68085106382979,7.446808510638298
33530_marine,94,39,89,7,133,94.68085106382979,7.446808510638298
33531_marine,93,40,88,7,133,94.6236559139785,7.526881720430108
33532_marine,93,40,88,7,133,94.6236559139785,7.526881720430108
33533_marine,92,40,87,7,132,94.56521739130434,7.608695652173914
33534_marine,92,40,87,7,132,94.56521739130434,7.608695652173914
33535_marine,92,37,87,6,129,94.56521739130434,6.521739130434782
33536_marine,92,37,87,6,129,94.56521739130434,6.521739130434782
33537_marine,92,37,87,6,129,94.56521739130434,6.521739130434782
33538_marine,91,39,86,5,130,94.5054945054945,5.4945054945054945
33539_marine,91,39,86,5,130,94.5054945054945,5.4945054945054945
33540_marine,91,39,86,5,130,94.5054945054945,5.4945054945054945
33541_marine,92,39,87,5,131,94.56521739130434,5.434782608695652
33542_marine,91,41,86,5,132,94.5054945054945,5.4945054945054945
33543_marine,91,42,86,5,133,94.5054945054945,5.4945054945054945
33544_marine,90,42,85,5,132,94.44444444444444,5.555555555555555
33545_marine,90,42,85,5,132,94.44444444444444,5.555555555555555
33546_marine,90,41,85,5,131,94.44444444444444,5.555555555555555
33547_marine,90,41,85,5,131,94.44444444444444,5.555555555555555
33548_marine,90,41,85,5,131,94.44444444444444,5.555555555555555
33549_marine,89,42,84,5,131,94.3820224719101,5.617977528089887
33550_marine,89,41,84,5,130,94.3820224719101,5.617977528089887
33551_marine,89,40,84,5,129,94.3820224719101,5.617977528089887
33552_marine,89,40,84,5,129,94.3820224719101,5.617977528089887
33553_marine,88,40,83,5,128,94.31818181818183,5.681818181818182
33554_marine,88,40,83,5,128,94.31818181818183,5.681818181818182
33555_marine,86,38,81,5,124,94.18604651162791,5.813953488372093
33556_marine,86,40,81,5,126,94.18604651162791,5.813953488372093
33557_marine,85,40,80,5,125,94.11764705882352,5.88235294117647
33558_marine,85,40,80,5,125,94.11764705882352,5.88235294117647
33559_marine,85,40,80,5,125,94.11764705882352,5.88235294117647
33560_marine,85,41,80,5,126,94.11764705882352,5.88235294117647
33561_marine,85,41,80,5,126,94.11764705882352,5.88235294117647
33562_marine,85,41,80,5,126,94.11764705882352,5.88235294117647
33563_marine,85,41,80,5,126,94.11764705882352,5.88235294117647
33564_marine,87,42,82,5,129,94.25287356321839,5.747126436781609
33565_marine,90,42,85,5,132,94.44444444444444,5.555555555555555
33566_marine,93,42,89,7,135,95.6989247311828,7.526881720430108
33567_marine,97,42,93,7,139,95.87628865979381,7.216494845360824
33568_marine,102,41,97,9,143,95.09803921568627,8.823529411764707
33569_marine,105,41,100,9,146,95.23809523809523,8.571428571428571
33570_marine,107,44,101,11,151,94.39252336448598,10.2803738317757
33571_marine,105,42,99,11,147,94.28571428571428,10.476190476190476
33572_marine,104,42,98,10,146,94.23076923076923,9.615384615384617
33573_marine,99,42,93,9,141,93.93939393939394,9.090909090909092
33574_marine,97,43,91,9,140,93.81443298969072,9.278350515463918
33575_marine,100,45,94,9,145,94,9
33576_marine,102,47,96,8,149,94.11764705882352,7.8431372549019605
33577_marine,105,48,100,9,153,95.23809523809523,8.571428571428571
33578_marine,235,121,196,45,356,83.40425531914893,19.148936170212767
33579_marine,350,242,254,115,592,72.57142857142857,32.857142857142854
33580_marine,466,341,302,210,807,64.8068669527897,45.06437768240343
33581_marine,367,247,257,138,614,70.02724795640327,37.60217983651226
33623_marine,322,176,260,104,498,80.74534161490683,32.298136645962735
33624_marine,317,145,255,103,462,80.4416403785489,32.49211356466877
33625_marine,134,80,125,17,214,93.28358208955224,12.686567164179104
33626_marine,182,93,157,56,275,86.26373626373626,30.76923076923077
33627_marine,186,97,161,57,283,86.55913978494624,30.64516129032258
33628_marine,190,95,163,65,285,85.78947368421052,34.21052631578947
33629_marine,162,73,139,54,235,85.80246913580247,33.33333333333333
33630_marine,101,41,94,11,142,93.06930693069307,10.891089108910892
33631_marine,94,39,87,8,133,92.5531914893617,8.51063829787234
33632_marine,93,39,86,7,132,92.47311827956989,7.526881720430108
33633_marine,91,39,86,5,130,94.5054945054945,5.4945054945054945
33634_marine,91,39,86,5,130,94.5054945054945,5.4945054945054945
33635_marine,91,39,86,5,130,94.5054945054945,5.4945054945054945
33636_marine,90,41,85,5,131,94.44444444444444,5.555555555555555
33637_marine,90,41,85,5,131,94.44444444444444,5.555555555555555
33638_marine,91,39,86,5,130,94.5054945054945,5.4945054945054945
33639_marine,91,39,86,5,130,94.5054945054945,5.4945054945054945
33640_marine,90,39,85,5,129,94.44444444444444,5.555555555555555
33641_marine,90,39,84,6,129,93.33333333333333,6.666666666666667
33642_marine,90,37,84,6,127,93.33333333333333,6.666666666666667
33643_marine,91,36,84,6,127,92.3076923076923,6.593406593406594
33644_marine,90,36,83,6,126,92.22222222222223,6.666666666666667
33645_marine,91,36,83,7,127,91.20879120879121,7.6923076923076925
33646_marine,91,35,83,7,126,91.20879120879121,7.6923076923076925
33647_marine,90,35,82,7,125,91.11111111111111,7.777777777777778
33648_marine,89,35,81,7,124,91.01123595505618,7.865168539325842
33649_marine,89,35,81,7,124,91.01123595505618,7.865168539325842
33650_marine,89,34,81,7,123,91.01123595505618,7.865168539325842
33651_marine,88,34,80,6,122,90.9090909090909,6.8181818181818175
33652_marine,89,34,81,6,123,91.01123595505618,6.741573033707865
33653_marine,86,34,78,6,120,90.69767441860465,6.976744186046512
33654_marine,85,34,77,6,119,90.58823529411765,7.0588235294117645
33655_marine,85,34,77,6,119,90.58823529411765,7.0588235294117645
33656_marine,84,34,77,5,118,91.66666666666666,5.952380952380952
33657_marine,82,34,75,5,116,91.46341463414635,6.097560975609756
33658_marine,81,34,75,4,115,92.5925925925926,4.938271604938271
33659_marine,80,34,74,4,114,92.5,5
33660_marine,80,34,74,4,114,92.5,5
33661_marine,83,36,77,4,119,92.7710843373494,4.819277108433735
33662_marine,84,36,78,4,120,92.85714285714286,4.761904761904762
33663_marine,82,36,76,4,118,92.6829268292683,4.878048780487805
33664_marine,84,38,78,4,122,92.85714285714286,4.761904761904762
33665_marine,82,36,76,4,118,92.6829268292683,4.878048780487805
33666_marine,86,38,80,6,124,93.02325581395348,6.976744186046512
33667_marine,90,40,84,6,130,93.33333333333333,6.666666666666667
33668_marine,94,40,89,7,134,94.68085106382979,7.446808510638298
33669_marine,253,117,228,36,370,90.11857707509881,14.229249011857709
33670_marine,285,134,257,40,419,90.17543859649123,14.035087719298245
33702_marine,646,220,441,350,866,68.26625386996903,54.179566563467496
33703_marine,109,36,101,19,145,92.66055045871559,17.431192660550458
33704_marine,104,37,96,19,141,92.3076923076923,18.269230769230766
33705_marine,100,33,92,15,133,92,15
33706_marine,99,33,91,15,132,91.91919191919192,15.151515151515152
33707_marine,92,33,84,10,125,91.30434782608695,10.869565217391305
33708_marine,94,33,86,12,127,91.48936170212765,12.76595744680851
33709_marine,92,34,86,13,126,93.47826086956522,14.130434782608695
33710_marine,92,34,86,15,126,93.47826086956522,16.304347826086957
33711_marine,95,34,89,15,129,93.6842105263158,15.789473684210526
33712_marine,100,36,94,16,136,94,16
33713_marine,101,37,95,17,138,94.05940594059405,16.831683168316832
33714_marine,105,37,99,16,142,94.28571428571428,15.238095238095239
33715_marine,584,204,391,334,788,66.95205479452055,57.1917808219178
33716_marine,625,220,425,360,845,68,57.599999999999994
33717_marine,582,201,388,334,783,66.66666666666666,57.388316151202744
33718_marine,103,36,97,15,139,94.1747572815534,14.563106796116504
33719_marine,90,34,84,10,124,93.33333333333333,11.11111111111111
33720_marine,84,34,78,9,118,92.85714285714286,10.714285714285714
33721_marine,84,33,78,9,117,92.85714285714286,10.714285714285714
33722_marine,83,33,77,8,116,92.7710843373494,9.63855421686747
33723_marine,83,33,77,8,116,92.7710843373494,9.63855421686747
33724_marine,83,33,77,8,116,92.7710843373494,9.63855421686747
33725_marine,83,33,77,8,116,92.7710843373494,9.63855421686747
33726_marine,83,33,77,8,116,92.7710843373494,9.63855421686747
33727_marine,83,33,77,8,116,92.7710843373494,9.63855421686747
33728_marine,83,33,77,8,116,92.7710843373494,9.63855421686747
33729_marine,83,33,77,8,116,92.7710843373494,9.63855421686747
33730_marine,84,33,78,8,117,92.85714285714286,9.523809523809524
33731_marine,88,33,82,8,121,93.18181818181817,9.090909090909092
33732_marine,91,34,85,13,125,93.4065934065934,14.285714285714285
33733_marine,94,34,88,13,128,93.61702127659575,13.829787234042554
33734_marine,96,34,90,13,130,93.75,13.541666666666666
33735_marine,92,34,87,9,126,94.56521739130434,9.782608695652174
33736_marine,89,30,84,7,119,94.3820224719101,7.865168539325842
33737_marine,90,30,85,7,120,94.44444444444444,7.777777777777778
33738_marine,87,30,83,6,117,95.40229885057471,6.896551724137931
33739_marine,87,30,83,6,117,95.40229885057471,6.896551724137931
33740_marine,85,30,81,6,115,95.29411764705881,7.0588235294117645
33741_marine,83,30,79,6,113,95.18072289156626,7.228915662650602
33742_marine,83,30,79,6,113,95.18072289156626,7.228915662650602
33743_marine,83,32,79,6,115,95.18072289156626,7.228915662650602
33744_marine,82,31,78,6,113,95.1219512195122,7.317073170731707
33745_marine,82,31,78,6,113,95.1219512195122,7.317073170731707
33746_marine,82,31,78,6,113,95.1219512195122,7.317073170731707
33747_marine,82,31,78,6,113,95.1219512195122,7.317073170731707
33748_marine,82,31,78,6,113,95.1219512195122,7.317073170731707
33749_marine,82,31,78,6,113,95.1219512195122,7.317073170731707
33750_marine,82,31,78,6,113,95.1219512195122,7.317073170731707
33751_marine,82,31,78,6,113,95.1219512195122,7.317073170731707
33752_marine,82,31,78,6,113,95.1219512195122,7.317073170731707
33753_marine,81,31,77,5,112,95.06172839506173,6.172839506172839
33754_marine,81,30,77,5,111,95.06172839506173,6.172839506172839
33755_marine,82,30,78,6,112,95.1219512195122,7.317073170731707
33756_marine,87,30,83,8,117,95.40229885057471,9.195402298850574
33757_marine,93,30,88,9,123,94.6236559139785,9.67741935483871
33758_marine,104,31,99,12,135,95.1923076923077,11.538461538461538
33759_marine,116,32,110,18,148,94.82758620689656,15.517241379310345
33760_marine,711,210,453,406,921,63.71308016877637,57.102672292545705
33770_marine,785,277,530,391,1062,67.51592356687898,49.80891719745223
33771_marine,1198,631,764,691,1829,63.77295492487479,57.679465776293824
33773_marine,1193,622,774,689,1815,64.87845766974016,57.75356244761106
33776_marine,1181,597,761,689,1778,64.43691786621507,58.34038950042337
33777_marine,1188,616,763,689,1804,64.22558922558923,57.996632996633004
33778_marine,974,348,612,558,1322,62.83367556468173,57.28952772073922
33785_marine,939,326,560,580,1265,59.63791267305645,61.7678381256656
33792_marine,1053,489,637,635,1542,60.49382716049383,60.30389363722697
33806_marine,916,368,547,560,1284,59.71615720524017,61.135371179039296
33807_marine,901,341,530,559,1242,58.82352941176471,62.04217536071032
33808_marine,864,318,509,539,1182,58.91203703703704,62.38425925925925
33809_marine,889,320,532,543,1209,59.84251968503938,61.079865016872894
33810_marine,875,313,518,543,1188,59.199999999999996,62.05714285714286
33811_marine,971,400,576,605,1371,59.320288362512876,62.3069001029866
33814_marine,964,393,576,599,1357,59.75103734439834,62.136929460580916
33815_marine,891,344,542,546,1235,60.83052749719416,61.27946127946128
33816_marine,815,278,482,513,1093,59.14110429447853,62.944785276073624
33817_marine,709,234,444,435,943,62.62341325811002,61.3540197461213
33818_marine,705,235,440,435,940,62.4113475177305,61.702127659574465
33819_marine,615,171,407,366,786,66.17886178861788,59.512195121951216
33820_marine,612,171,404,364,783,66.01307189542483,59.47712418300654
33821_marine,611,171,405,364,782,66.2847790507365,59.57446808510638
33822_marine,97,34,89,11,131,91.75257731958763,11.34020618556701
33823_marine,97,34,90,10,131,92.78350515463917,10.309278350515463
33824_marine,98,34,91,10,132,92.85714285714286,10.204081632653061
33825_marine,99,34,92,10,133,92.92929292929293,10.1010101010101
33826_marine,99,35,92,10,134,92.92929292929293,10.1010101010101
33827_marine,99,35,92,10,134,92.92929292929293,10.1010101010101
33828_marine,96,37,90,9,133,93.75,9.375
33829_marine,96,37,90,9,133,93.75,9.375
33830_marine,98,38,92,9,136,93.87755102040816,9.183673469387756
33831_marine,98,38,92,9,136,93.87755102040816,9.183673469387756
33832_marine,100,39,94,11,139,94,11
33833_marine,101,39,95,12,140,94.05940594059405,11.881188118811881
33834_marine,101,39,95,12,140,94.05940594059405,11.881188118811881
33835_marine,101,40,95,12,141,94.05940594059405,11.881188118811881
33836_marine,508,133,345,312,641,67.91338582677166,61.417322834645674
33837_marine,509,133,346,312,642,67.97642436149313,61.29666011787819
33838_marine,506,131,343,310,637,67.78656126482213,61.26482213438735
33839_marine,101,42,95,12,143,94.05940594059405,11.881188118811881
33840_marine,100,41,94,11,141,94,11
33841_marine,100,39,94,8,139,94,8
33842_marine,100,40,94,8,140,94,8
33843_marine,100,40,94,8,140,94,8
33844_marine,100,40,94,8,140,94,8
33845_marine,465,114,313,286,579,67.31182795698925,61.505376344086024
33846_marine,489,130,334,296,619,68.30265848670757,60.53169734151329
33847_marine,491,116,325,302,607,66.19144602851324,61.5071283095723
33848_marine,515,130,345,311,645,66.99029126213593,60.38834951456311
33849_marine,521,130,351,313,651,67.37044145873321,60.076775431861805
33850_marine,495,117,329,302,612,66.46464646464646,61.01010101010102
33851_marine,495,114,331,302,609,66.86868686868686,61.01010101010102
33852_marine,104,40,98,12,144,94.23076923076923,11.538461538461538
33853_marine,104,40,98,12,144,94.23076923076923,11.538461538461538
33854_marine,100,41,94,10,141,94,10
33855_marine,100,41,94,10,141,94,10
33856_marine,100,41,94,12,141,94,12
33857_marine,100,39,94,12,139,94,12
33858_marine,99,40,93,12,139,93.93939393939394,12.121212121212121
33859_marine,99,41,93,12,140,93.93939393939394,12.121212121212121
33860_marine,99,41,93,12,140,93.93939393939394,12.121212121212121
33861_marine,98,41,92,11,139,93.87755102040816,11.224489795918368
33862_marine,96,41,90,10,137,93.75,10.416666666666668
33863_marine,97,41,91,12,138,93.81443298969072,12.371134020618557
33864_marine,348,88,250,202,436,71.83908045977012,58.04597701149425
33865_marine,349,90,250,202,439,71.63323782234957,57.879656160458445
33866_marine,367,99,264,211,466,71.93460490463215,57.49318801089919
33867_marine,348,86,250,199,434,71.83908045977012,57.18390804597702
33868_marine,98,41,92,10,139,93.87755102040816,10.204081632653061
33869_marine,100,41,94,12,141,94,12
33870_marine,100,41,94,12,141,94,12
33871_marine,99,41,93,12,140,93.93939393939394,12.121212121212121
33872_marine,99,42,93,12,141,93.93939393939394,12.121212121212121
33873_marine,99,42,93,12,141,93.93939393939394,12.121212121212121
33874_marine,99,42,93,12,141,93.93939393939394,12.121212121212121
33875_marine,99,42,93,12,141,93.93939393939394,12.121212121212121
33876_marine,99,42,93,12,141,93.93939393939394,12.121212121212121
33877_marine,98,42,92,11,140,93.87755102040816,11.224489795918368
33878_marine,98,42,92,11,140,93.87755102040816,11.224489795918368
33879_marine,98,42,92,11,140,93.87755102040816,11.224489795918368
33880_marine,98,41,92,11,139,93.87755102040816,11.224489795918368
33881_marine,98,40,92,11,138,93.87755102040816,11.224489795918368
33882_marine,98,39,92,11,137,93.87755102040816,11.224489795918368
33883_marine,99,39,93,11,138,93.93939393939394,11.11111111111111
33884_marine,98,39,92,10,137,93.87755102040816,10.204081632653061
33885_marine,94,40,88,8,134,93.61702127659575,8.51063829787234
33886_marine,94,39,88,8,133,93.61702127659575,8.51063829787234
33887_marine,94,39,89,7,133,94.68085106382979,7.446808510638298
33888_marine,94,40,89,7,134,94.68085106382979,7.446808510638298
33889_marine,93,38,88,7,131,94.6236559139785,7.526881720430108
33890_marine,94,38,89,7,132,94.68085106382979,7.446808510638298
33891_marine,94,38,89,7,132,94.68085106382979,7.446808510638298
33892_marine,94,38,89,7,132,94.68085106382979,7.446808510638298
33893_marine,93,38,88,7,131,94.6236559139785,7.526881720430108
33894_marine,93,38,88,7,131,94.6236559139785,7.526881720430108
33895_marine,94,38,89,7,132,94.68085106382979,7.446808510638298
33896_marine,93,38,88,6,131,94.6236559139785,6.451612903225806
33897_marine,93,38,88,6,131,94.6236559139785,6.451612903225806
33898_marine,93,38,88,6,131,94.6236559139785,6.451612903225806
33899_marine,92,40,87,5,132,94.56521739130434,5.434782608695652
33900_marine,93,39,88,5,132,94.6236559139785,5.376344086021505
33901_marine,93,39,88,5,132,94.6236559139785,5.376344086021505
33902_marine,92,39,87,5,131,94.56521739130434,5.434782608695652
33903_marine,92,40,87,5,132,94.56521739130434,5.434782608695652
33904_marine,91,41,86,5,132,94.5054945054945,5.4945054945054945
33905_marine,91,41,86,5,132,94.5054945054945,5.4945054945054945
33906_marine,89,41,84,5,130,94.3820224719101,5.617977528089887
33907_marine,89,41,84,5,130,94.3820224719101,5.617977528089887
33908_marine,88,41,83,5,129,94.31818181818183,5.681818181818182
33909_marine,87,40,82,5,127,94.25287356321839,5.747126436781609
33910_marine,87,41,82,5,128,94.25287356321839,5.747126436781609
33911_marine,89,41,84,5,130,94.3820224719101,5.617977528089887
33912_marine,89,39,84,5,128,94.3820224719101,5.617977528089887
33913_marine,89,39,84,5,128,94.3820224719101,5.617977528089887
33914_marine,88,39,83,5,127,94.31818181818183,5.681818181818182
33915_marine,88,39,83,5,127,94.31818181818183,5.681818181818182
33916_marine,88,40,83,5,128,94.31818181818183,5.681818181818182
33917_marine,88,40,83,5,128,94.31818181818183,5.681818181818182
33918_marine,86,40,81,5,126,94.18604651162791,5.813953488372093
33919_marine,85,40,80,5,125,94.11764705882352,5.88235294117647
33920_marine,85,41,80,5,126,94.11764705882352,5.88235294117647
33921_marine,85,41,80,5,126,94.11764705882352,5.88235294117647
33922_marine,85,41,80,5,126,94.11764705882352,5.88235294117647
33923_marine,85,41,80,5,126,94.11764705882352,5.88235294117647
33924_marine,84,40,79,6,124,94.04761904761905,7.142857142857142
33925_marine,89,41,84,6,130,94.3820224719101,6.741573033707865
33926_marine,88,42,84,6,130,95.45454545454545,6.8181818181818175
33927_marine,89,42,85,7,131,95.50561797752809,7.865168539325842
33928_marine,92,42,87,7,134,94.56521739130434,7.608695652173914
33929_marine,95,41,90,7,136,94.73684210526315,7.368421052631578
33930_marine,94,41,89,6,135,94.68085106382979,6.382978723404255
33931_marine,95,41,89,7,136,93.6842105263158,7.368421052631578
33932_marine,94,42,88,8,136,93.61702127659575,8.51063829787234
33933_marine,94,42,88,8,136,93.61702127659575,8.51063829787234
33934_marine,94,44,88,8,138,93.61702127659575,8.51063829787234
33935_marine,98,44,92,9,142,93.87755102040816,9.183673469387756
33936_marine,98,47,93,7,145,94.89795918367348,7.142857142857142
33937_marine,106,49,101,9,155,95.28301886792453,8.49056603773585
33938_marine,234,122,195,45,356,83.33333333333334,19.230769230769234
33939_marine,339,250,243,116,589,71.68141592920354,34.21828908554572
33985_marine,329,178,266,104,507,80.85106382978722,31.61094224924012
33986_marine,327,153,266,105,480,81.34556574923548,32.11009174311927
33987_marine,180,87,157,56,267,87.22222222222223,31.11111111111111
33988_marine,176,74,153,56,250,86.93181818181817,31.818181818181817
33989_marine,168,71,145,54,239,86.30952380952381,32.142857142857146
33990_marine,101,37,94,11,138,93.06930693069307,10.891089108910892
33991_marine,96,39,89,8,135,92.70833333333334,8.333333333333332
33992_marine,93,39,86,7,132,92.47311827956989,7.526881720430108
33993_marine,91,39,86,5,130,94.5054945054945,5.4945054945054945
33994_marine,90,39,85,5,129,94.44444444444444,5.555555555555555
33995_marine,90,39,85,5,129,94.44444444444444,5.555555555555555
33996_marine,90,39,85,5,129,94.44444444444444,5.555555555555555
33997_marine,90,39,85,5,129,94.44444444444444,5.555555555555555
33998_marine,90,39,85,5,129,94.44444444444444,5.555555555555555
33999_marine,90,39,85,5,129,94.44444444444444,5.555555555555555
34000_marine,90,39,84,6,129,93.33333333333333,6.666666666666667
34001_marine,90,37,84,6,127,93.33333333333333,6.666666666666667
34002_marine,90,37,84,6,127,93.33333333333333,6.666666666666667
34003_marine,90,36,84,6,126,93.33333333333333,6.666666666666667
34004_marine,89,36,83,6,125,93.25842696629213,6.741573033707865
34005_marine,90,36,83,6,126,92.22222222222223,6.666666666666667
34006_marine,89,36,82,6,125,92.13483146067416,6.741573033707865
34007_marine,88,36,81,6,124,92.04545454545455,6.8181818181818175
34008_marine,88,35,81,6,123,92.04545454545455,6.8181818181818175
34009_marine,88,35,81,6,123,92.04545454545455,6.8181818181818175
34010_marine,88,35,81,6,123,92.04545454545455,6.8181818181818175
34011_marine,88,34,81,6,122,92.04545454545455,6.8181818181818175
34012_marine,89,34,82,6,123,92.13483146067416,6.741573033707865
34013_marine,86,34,79,5,120,91.86046511627907,5.813953488372093
34014_marine,84,34,77,5,118,91.66666666666666,5.952380952380952
34015_marine,84,34,77,5,118,91.66666666666666,5.952380952380952
34016_marine,84,34,77,5,118,91.66666666666666,5.952380952380952
34017_marine,84,34,77,5,118,91.66666666666666,5.952380952380952
34018_marine,84,34,77,5,118,91.66666666666666,5.952380952380952
34019_marine,82,34,76,4,116,92.6829268292683,4.878048780487805
34020_marine,82,34,76,4,116,92.6829268292683,4.878048780487805
34021_marine,79,34,73,4,113,92.40506329113924,5.063291139240507
34022_marine,79,34,73,4,113,92.40506329113924,5.063291139240507
34023_marine,79,36,73,4,115,92.40506329113924,5.063291139240507
34024_marine,84,39,78,4,123,92.85714285714286,4.761904761904762
34025_marine,82,37,76,4,119,92.6829268292683,4.878048780487805
34026_marine,82,39,76,4,121,92.6829268292683,4.878048780487805
34027_marine,88,41,82,6,129,93.18181818181817,6.8181818181818175
34028_marine,89,41,84,6,130,94.3820224719101,6.741573033707865
34029_marine,98,38,92,7,136,93.87755102040816,7.142857142857142
34030_marine,251,111,226,35,362,90.0398406374502,13.94422310756972
34031_marine,287,123,258,41,410,89.89547038327527,14.285714285714285
34061_marine,687,248,467,372,935,67.97671033478893,54.14847161572053
34062_marine,108,38,100,20,146,92.5925925925926,18.51851851851852
34063_marine,107,38,99,17,145,92.5233644859813,15.887850467289718
34064_marine,102,34,94,13,136,92.15686274509804,12.745098039215685
34065_marine,98,34,90,13,132,91.83673469387756,13.26530612244898
34066_marine,94,34,86,11,128,91.48936170212765,11.702127659574469
34067_marine,93,34,85,10,127,91.39784946236558,10.75268817204301
34068_marine,90,33,83,12,123,92.22222222222223,13.333333333333334
34069_marine,91,34,85,13,125,93.4065934065934,14.285714285714285
34070_marine,94,34,88,15,128,93.61702127659575,15.957446808510639
34071_marine,94,36,88,15,130,93.61702127659575,15.957446808510639
34072_marine,98,37,92,16,135,93.87755102040816,16.3265306122449
34073_marine,531,167,354,316,698,66.66666666666666,59.51035781544256
34074_marine,565,183,385,324,748,68.14159292035397,57.34513274336284
34075_marine,590,210,396,336,800,67.11864406779661,56.949152542372886
34077_marine,586,206,392,337,792,66.89419795221842,57.508532423208194
34078_marine,104,36,98,14,140,94.23076923076923,13.461538461538462
34079_marine,94,34,88,10,128,93.61702127659575,10.638297872340425
34080_marine,86,34,80,9,120,93.02325581395348,10.465116279069768
34081_marine,84,34,78,9,118,92.85714285714286,10.714285714285714
34082_marine,83,33,77,8,116,92.7710843373494,9.63855421686747
34083_marine,83,33,77,8,116,92.7710843373494,9.63855421686747
34084_marine,83,33,77,8,116,92.7710843373494,9.63855421686747
34085_marine,83,33,77,8,116,92.7710843373494,9.63855421686747
34086_marine,83,33,77,8,116,92.7710843373494,9.63855421686747
34087_marine,83,33,77,8,116,92.7710843373494,9.63855421686747
34088_marine,83,33,77,8,116,92.7710843373494,9.63855421686747
34089_marine,83,33,77,8,116,92.7710843373494,9.63855421686747
34090_marine,87,32,81,9,119,93.10344827586206,10.344827586206897
34091_marine,512,112,344,294,624,67.1875,57.421875
34092_marine,512,119,343,296,631,66.9921875,57.8125
34093_marine,514,119,345,298,633,67.12062256809338,57.97665369649806
34094_marine,517,113,349,297,630,67.50483558994198,57.446808510638306
34095_marine,94,32,88,10,126,93.61702127659575,10.638297872340425
34096_marine,90,30,84,8,120,93.33333333333333,8.88888888888889
34097_marine,91,30,85,8,121,93.4065934065934,8.791208791208792
34098_marine,88,30,83,7,118,94.31818181818183,7.954545454545454
34099_marine,88,30,83,7,118,94.31818181818183,7.954545454545454
34100_marine,86,30,81,7,116,94.18604651162791,8.13953488372093
34101_marine,84,30,79,7,114,94.04761904761905,8.333333333333332
34102_marine,83,31,78,7,114,93.97590361445783,8.433734939759036
34103_marine,84,31,79,7,115,94.04761904761905,8.333333333333332
34104_marine,84,31,79,7,115,94.04761904761905,8.333333333333332
34105_marine,84,31,79,7,115,94.04761904761905,8.333333333333332
34106_marine,83,31,79,6,114,95.18072289156626,7.228915662650602
34107_marine,83,32,79,6,115,95.18072289156626,7.228915662650602
34108_marine,82,31,78,6,113,95.1219512195122,7.317073170731707
34109_marine,82,31,78,6,113,95.1219512195122,7.317073170731707
34110_marine,82,31,78,6,113,95.1219512195122,7.317073170731707
34111_marine,82,31,78,6,113,95.1219512195122,7.317073170731707
34112_marine,82,31,78,6,113,95.1219512195122,7.317073170731707
34113_marine,82,31,78,6,113,95.1219512195122,7.317073170731707
34114_marine,81,31,77,6,112,95.06172839506173,7.4074074074074066
34115_marine,80,32,76,5,112,95,6.25
34116_marine,83,31,79,6,114,95.18072289156626,7.228915662650602
34117_marine,87,31,83,8,118,95.40229885057471,9.195402298850574
34118_marine,96,33,91,10,129,94.79166666666666,10.416666666666668
34119_marine,104,32,99,12,136,95.1923076923077,11.538461538461538
34120_marine,693,194,441,401,887,63.63636363636363,57.864357864357864
34121_marine,696,200,444,402,896,63.793103448275865,57.758620689655174
34122_marine,754,242,485,425,996,64.3236074270557,56.366047745358095
34127_marine,861,320,567,448,1181,65.85365853658537,52.03252032520326
34128_marine,811,272,540,428,1083,66.58446362515413,52.77435265104808
34129_marine,788,260,521,423,1048,66.11675126903553,53.68020304568528
34130_marine,796,244,520,431,1040,65.32663316582915,54.14572864321608
34131_marine,795,248,520,425,1043,65.40880503144653,53.459119496855344
34132_marine,814,269,535,427,1083,65.72481572481573,52.45700245700245
34133_marine,809,276,532,426,1085,65.7601977750309,52.65760197775031
34134_marine,798,249,527,424,1047,66.04010025062657,53.1328320802005
34136_marine,916,364,610,497,1280,66.5938864628821,54.25764192139738
34137_marine,1065,425,673,637,1490,63.19248826291079,59.81220657276995
34138_marine,957,345,601,547,1302,62.80041797283177,57.157784743991634
34139_marine,996,366,615,589,1362,61.74698795180723,59.13654618473896
34145_marine,956,350,575,581,1306,60.14644351464435,60.77405857740585
34146_marine,956,375,563,586,1331,58.89121338912135,61.29707112970711
34147_marine,936,373,556,573,1309,59.401709401709404,61.21794871794872
34148_marine,938,375,556,573,1313,59.27505330490405,61.08742004264393
34149_marine,939,377,556,571,1316,59.21192758253461,60.809371671991485
34150_marine,1020,436,613,612,1456,60.09803921568627,60
34151_marine,1003,432,603,605,1435,60.11964107676969,60.31904287138584
34152_marine,1039,450,624,629,1489,60.05774783445621,60.53897978825794
34165_marine,1005,478,586,633,1483,58.308457711442784,62.98507462686567
34167_marine,1036,473,618,629,1509,59.65250965250966,60.71428571428571
34168_marine,909,351,542,555,1260,59.625962596259626,61.05610561056105
34169_marine,905,346,542,551,1251,59.889502762430936,60.88397790055249
34170_marine,961,383,575,595,1344,59.833506763787724,61.914672216441204
34175_marine,958,410,570,599,1368,59.49895615866389,62.52609603340292
34176_marine,898,342,542,557,1240,60.35634743875279,62.02672605790646
34177_marine,821,287,490,509,1108,59.68331303288672,61.99756394640682
34178_marine,765,272,488,461,1037,63.79084967320261,60.26143790849673
34179_marine,633,187,417,378,820,65.87677725118483,59.71563981042654
34180_marine,683,223,456,399,906,66.76427525622255,58.41874084919473
34181_marine,627,183,413,372,810,65.86921850079744,59.33014354066985
34182_marine,100,34,89,11,134,89,11
34183_marine,97,34,89,11,131,91.75257731958763,11.34020618556701
34184_marine,98,34,91,10,132,92.85714285714286,10.204081632653061
34185_marine,100,34,93,10,134,93,10
34186_marine,100,37,93,10,137,93,10
34187_marine,100,37,93,10,137,93,10
34188_marine,99,37,92,10,136,92.92929292929293,10.1010101010101
34189_marine,98,38,91,9,136,92.85714285714286,9.183673469387756
34190_marine,98,39,91,9,137,92.85714285714286,9.183673469387756
34191_marine,97,39,90,9,136,92.78350515463917,9.278350515463918
34192_marine,99,40,92,11,139,92.92929292929293,11.11111111111111
34193_marine,98,40,92,11,138,93.87755102040816,11.224489795918368
34194_marine,98,39,92,11,137,93.87755102040816,11.224489795918368
34195_marine,99,40,93,12,139,93.93939393939394,12.121212121212121
34196_marine,530,142,368,320,672,69.43396226415094,60.37735849056604
34197_marine,530,142,368,320,672,69.43396226415094,60.37735849056604
34198_marine,97,40,91,10,137,93.81443298969072,10.309278350515463
34199_marine,98,39,92,10,137,93.87755102040816,10.204081632653061
34200_marine,97,39,91,9,136,93.81443298969072,9.278350515463918
34201_marine,100,39,94,8,139,94,8
34202_marine,99,39,93,8,138,93.93939393939394,8.080808080808081
34203_marine,99,40,93,8,139,93.93939393939394,8.080808080808081
34204_marine,99,40,93,8,139,93.93939393939394,8.080808080808081
34205_marine,466,112,314,286,578,67.38197424892704,61.37339055793991
34206_marine,464,114,312,286,578,67.24137931034483,61.63793103448276
34207_marine,466,112,314,288,578,67.38197424892704,61.80257510729614
34208_marine,490,116,324,302,606,66.12244897959184,61.63265306122449
34209_marine,490,116,324,302,606,66.12244897959184,61.63265306122449
34210_marine,490,114,324,302,604,66.12244897959184,61.63265306122449
34211_marine,99,40,93,12,139,93.93939393939394,12.121212121212121
34212_marine,99,39,93,12,138,93.93939393939394,12.121212121212121
34213_marine,99,39,93,12,138,93.93939393939394,12.121212121212121
34214_marine,100,40,94,12,140,94,12
34215_marine,98,40,92,10,138,93.87755102040816,10.204081632653061
34216_marine,100,40,94,12,140,94,12
34217_marine,99,40,93,12,139,93.93939393939394,12.121212121212121
34218_marine,99,39,93,12,138,93.93939393939394,12.121212121212121
34219_marine,99,39,93,12,138,93.93939393939394,12.121212121212121
34220_marine,99,39,93,12,138,93.93939393939394,12.121212121212121
34221_marine,98,39,92,11,137,93.87755102040816,11.224489795918368
34222_marine,96,40,90,10,136,93.75,10.416666666666668
34223_marine,98,40,92,12,138,93.87755102040816,12.244897959183673
34224_marine,349,90,251,202,439,71.91977077363897,57.879656160458445
34225_marine,373,102,270,213,475,72.38605898123325,57.10455764075068
34226_marine,349,88,251,202,437,71.91977077363897,57.879656160458445
34227_marine,99,41,93,13,140,93.93939393939394,13.131313131313133
34228_marine,98,41,92,12,139,93.87755102040816,12.244897959183673
34229_marine,98,41,92,12,139,93.87755102040816,12.244897959183673
34230_marine,97,41,91,12,138,93.81443298969072,12.371134020618557
34231_marine,97,41,91,12,138,93.81443298969072,12.371134020618557
34232_marine,97,41,91,12,138,93.81443298969072,12.371134020618557
34233_marine,99,42,93,12,141,93.93939393939394,12.121212121212121
34234_marine,99,42,93,12,141,93.93939393939394,12.121212121212121
34235_marine,99,42,93,12,141,93.93939393939394,12.121212121212121
34236_marine,100,42,94,13,142,94,13
34237_marine,100,42,94,13,142,94,13
34238_marine,99,42,93,12,141,93.93939393939394,12.121212121212121
34239_marine,101,42,95,14,143,94.05940594059405,13.861386138613863
34240_marine,100,42,94,13,142,94,13
34241_marine,100,42,94,13,142,94,13
34242_marine,98,40,92,11,138,93.87755102040816,11.224489795918368
34243_marine,98,40,92,11,138,93.87755102040816,11.224489795918368
34244_marine,98,37,92,9,135,93.87755102040816,9.183673469387756
34245_marine,96,37,90,8,133,93.75,8.333333333333332
34246_marine,94,38,88,8,132,93.61702127659575,8.51063829787234
34247_marine,95,37,89,8,132,93.6842105263158,8.421052631578947
34248_marine,94,37,89,7,131,94.68085106382979,7.446808510638298
34249_marine,94,37,89,7,131,94.68085106382979,7.446808510638298
34250_marine,93,37,88,7,130,94.6236559139785,7.526881720430108
34251_marine,93,37,88,7,130,94.6236559139785,7.526881720430108
34252_marine,93,37,88,7,130,94.6236559139785,7.526881720430108
34253_marine,92,37,87,7,129,94.56521739130434,7.608695652173914
34254_marine,92,37,87,7,129,94.56521739130434,7.608695652173914
34255_marine,93,37,88,7,130,94.6236559139785,7.526881720430108
34256_marine,93,38,88,7,131,94.6236559139785,7.526881720430108
34257_marine,92,38,87,6,130,94.56521739130434,6.521739130434782
34258_marine,92,38,87,6,130,94.56521739130434,6.521739130434782
34259_marine,92,38,87,6,130,94.56521739130434,6.521739130434782
34260_marine,93,40,88,6,133,94.6236559139785,6.451612903225806
34261_marine,91,40,86,5,131,94.5054945054945,5.4945054945054945
34262_marine,91,39,86,5,130,94.5054945054945,5.4945054945054945
34263_marine,91,39,86,5,130,94.5054945054945,5.4945054945054945
34264_marine,90,39,85,5,129,94.44444444444444,5.555555555555555
34265_marine,88,39,83,5,127,94.31818181818183,5.681818181818182
34266_marine,88,41,83,5,129,94.31818181818183,5.681818181818182
34267_marine,88,40,83,5,128,94.31818181818183,5.681818181818182
34268_marine,88,40,83,5,128,94.31818181818183,5.681818181818182
34269_marine,88,40,83,5,128,94.31818181818183,5.681818181818182
34270_marine,88,39,83,5,127,94.31818181818183,5.681818181818182
34271_marine,88,39,83,5,127,94.31818181818183,5.681818181818182
34272_marine,88,40,83,5,128,94.31818181818183,5.681818181818182
34273_marine,88,39,83,5,127,94.31818181818183,5.681818181818182
34274_marine,90,39,85,5,129,94.44444444444444,5.555555555555555
34275_marine,89,39,84,5,128,94.3820224719101,5.617977528089887
34276_marine,89,39,84,5,128,94.3820224719101,5.617977528089887
34277_marine,87,40,82,5,127,94.25287356321839,5.747126436781609
34278_marine,87,40,82,5,127,94.25287356321839,5.747126436781609
34279_marine,87,40,82,5,127,94.25287356321839,5.747126436781609
34280_marine,85,40,80,5,125,94.11764705882352,5.88235294117647
34281_marine,84,41,79,5,125,94.04761904761905,5.952380952380952
34282_marine,84,40,79,5,124,94.04761904761905,5.952380952380952
34283_marine,84,40,79,5,124,94.04761904761905,5.952380952380952
34284_marine,86,40,81,6,126,94.18604651162791,6.976744186046512
34285_marine,88,40,83,6,128,94.31818181818183,6.8181818181818175
34286_marine,87,42,83,6,129,95.40229885057471,6.896551724137931
34287_marine,87,42,83,6,129,95.40229885057471,6.896551724137931
34288_marine,87,42,82,5,129,94.25287356321839,5.747126436781609
34289_marine,87,42,82,5,129,94.25287356321839,5.747126436781609
34290_marine,89,41,84,5,130,94.3820224719101,5.617977528089887
34291_marine,91,41,85,6,132,93.4065934065934,6.593406593406594
34292_marine,90,41,84,6,131,93.33333333333333,6.666666666666667
34293_marine,90,41,84,6,131,93.33333333333333,6.666666666666667
34294_marine,92,44,86,7,136,93.47826086956522,7.608695652173914
34295_marine,96,44,90,7,140,93.75,7.291666666666667
34296_marine,96,47,91,6,143,94.79166666666666,6.25
34297_marine,102,47,97,6,149,95.09803921568627,5.88235294117647
34298_marine,227,116,190,42,343,83.70044052863436,18.502202643171806
34299_marine,391,328,262,156,719,67.0076726342711,39.89769820971867
34300_marine,298,265,227,76,563,76.1744966442953,25.503355704697988
34346_marine,330,171,268,104,501,81.21212121212122,31.515151515151512
34347_marine,126,47,119,11,173,94.44444444444444,8.73015873015873
34348_marine,119,39,112,11,158,94.11764705882352,9.243697478991598
34349_marine,111,37,104,11,148,93.69369369369369,9.90990990990991
34350_marine,99,37,92,9,136,92.92929292929293,9.090909090909092
34351_marine,95,37,88,8,132,92.63157894736842,8.421052631578947
34352_marine,94,37,87,7,131,92.5531914893617,7.446808510638298
34353_marine,90,37,85,5,127,94.44444444444444,5.555555555555555
34354_marine,90,39,85,5,129,94.44444444444444,5.555555555555555
34355_marine,90,39,85,5,129,94.44444444444444,5.555555555555555
34356_marine,90,39,85,5,129,94.44444444444444,5.555555555555555
34357_marine,90,39,85,5,129,94.44444444444444,5.555555555555555
34358_marine,89,39,84,5,128,94.3820224719101,5.617977528089887
34359_marine,91,39,85,6,130,93.4065934065934,6.593406593406594
34360_marine,90,37,84,6,127,93.33333333333333,6.666666666666667
34361_marine,90,37,84,6,127,93.33333333333333,6.666666666666667
34362_marine,90,37,84,6,127,93.33333333333333,6.666666666666667
34363_marine,89,37,83,6,126,93.25842696629213,6.741573033707865
34364_marine,89,36,83,6,125,93.25842696629213,6.741573033707865
34365_marine,92,36,86,7,128,93.47826086956522,7.608695652173914
34366_marine,93,36,87,9,129,93.54838709677419,9.67741935483871
34367_marine,92,36,86,9,128,93.47826086956522,9.782608695652174
34368_marine,88,36,81,6,124,92.04545454545455,6.8181818181818175
34369_marine,88,36,81,6,124,92.04545454545455,6.8181818181818175
34370_marine,88,35,81,6,123,92.04545454545455,6.8181818181818175
34371_marine,89,35,82,6,124,92.13483146067416,6.741573033707865
34372_marine,87,34,80,6,121,91.95402298850574,6.896551724137931
34373_marine,87,34,80,6,121,91.95402298850574,6.896551724137931
34374_marine,84,34,77,5,118,91.66666666666666,5.952380952380952
34375_marine,84,34,77,5,118,91.66666666666666,5.952380952380952
34376_marine,84,34,77,5,118,91.66666666666666,5.952380952380952
34377_marine,84,34,77,5,118,91.66666666666666,5.952380952380952
34378_marine,84,34,77,5,118,91.66666666666666,5.952380952380952
34379_marine,82,34,76,4,116,92.6829268292683,4.878048780487805
34380_marine,83,36,77,4,119,92.7710843373494,4.819277108433735
34381_marine,83,36,77,4,119,92.7710843373494,4.819277108433735
34382_marine,99,45,93,4,144,93.93939393939394,4.040404040404041
34383_marine,82,37,76,4,119,92.6829268292683,4.878048780487805
34384_marine,85,39,79,4,124,92.94117647058823,4.705882352941177
34385_marine,82,37,76,4,119,92.6829268292683,4.878048780487805
34386_marine,82,37,76,4,119,92.6829268292683,4.878048780487805
34387_marine,82,41,76,4,123,92.6829268292683,4.878048780487805
34388_marine,88,41,83,3,129,94.31818181818183,3.4090909090909087
34389_marine,91,39,86,6,130,94.5054945054945,6.593406593406594
34390_marine,97,37,92,6,134,94.84536082474226,6.185567010309279
34391_marine,240,102,217,32,342,90.41666666666667,13.333333333333334
34421_marine,684,237,467,369,921,68.27485380116958,53.94736842105263
34422_marine,105,36,98,17,141,93.33333333333333,16.19047619047619
34423_marine,103,34,95,13,137,92.23300970873787,12.62135922330097
34424_marine,102,34,94,13,136,92.15686274509804,12.745098039215685
34425_marine,98,34,90,13,132,91.83673469387756,13.26530612244898
34426_marine,94,34,86,11,128,91.48936170212765,11.702127659574469
34427_marine,93,34,85,10,127,91.39784946236558,10.75268817204301
34428_marine,90,34,83,12,124,92.22222222222223,13.333333333333334
34429_marine,95,34,89,15,129,93.6842105263158,15.789473684210526
34430_marine,96,34,90,15,130,93.75,15.625
34431_marine,96,37,90,15,133,93.75,15.625
34432_marine,104,38,98,16,142,94.23076923076923,15.384615384615385
34433_marine,547,180,368,321,727,67.27605118829982,58.68372943327239
34434_marine,582,195,396,337,777,68.04123711340206,57.90378006872853
34435_marine,583,198,389,336,781,66.7238421955403,57.63293310463122
34436_marine,617,214,417,352,831,67.58508914100486,57.05024311183144
34437_marine,588,204,395,333,792,67.17687074829932,56.63265306122449
34438_marine,536,183,357,313,719,66.6044776119403,58.3955223880597
34439_marine,95,34,89,10,129,93.6842105263158,10.526315789473683
34440_marine,90,34,84,9,124,93.33333333333333,10
34441_marine,84,34,78,9,118,92.85714285714286,10.714285714285714
34442_marine,84,33,78,9,117,92.85714285714286,10.714285714285714
34443_marine,83,33,77,8,116,92.7710843373494,9.63855421686747
34444_marine,83,33,77,8,116,92.7710843373494,9.63855421686747
34445_marine,83,33,77,8,116,92.7710843373494,9.63855421686747
34446_marine,83,33,77,8,116,92.7710843373494,9.63855421686747
34447_marine,83,33,77,8,116,92.7710843373494,9.63855421686747
34448_marine,83,33,77,8,116,92.7710843373494,9.63855421686747
34449_marine,83,32,77,8,115,92.7710843373494,9.63855421686747
34450_marine,88,32,82,9,120,93.18181818181817,10.227272727272728
34451_marine,515,117,346,297,632,67.18446601941747,57.66990291262136
34452_marine,527,125,354,308,652,67.17267552182163,58.44402277039848
34453_marine,528,124,355,308,652,67.23484848484848,58.333333333333336
34454_marine,517,112,348,298,629,67.31141199226306,57.640232108317214
34455_marine,98,32,92,13,130,93.87755102040816,13.26530612244898
34456_marine,92,30,86,8,122,93.47826086956522,8.695652173913043
34457_marine,89,30,83,8,119,93.25842696629213,8.98876404494382
34458_marine,87,30,82,7,117,94.25287356321839,8.045977011494253
34459_marine,85,30,80,7,115,94.11764705882352,8.235294117647058
34460_marine,85,30,80,7,115,94.11764705882352,8.235294117647058
34461_marine,83,30,78,7,113,93.97590361445783,8.433734939759036
34462_marine,82,31,77,7,113,93.90243902439023,8.536585365853659
34463_marine,82,31,77,7,113,93.90243902439023,8.536585365853659
34464_marine,82,31,77,7,113,93.90243902439023,8.536585365853659
34465_marine,82,31,77,7,113,93.90243902439023,8.536585365853659
34466_marine,82,31,77,7,113,93.90243902439023,8.536585365853659
34467_marine,82,31,77,7,113,93.90243902439023,8.536585365853659
34468_marine,82,31,77,7,113,93.90243902439023,8.536585365853659
34469_marine,82,31,77,7,113,93.90243902439023,8.536585365853659
34470_marine,82,31,77,7,113,93.90243902439023,8.536585365853659
34471_marine,81,32,77,6,113,95.06172839506173,7.4074074074074066
34472_marine,81,32,77,6,113,95.06172839506173,7.4074074074074066
34473_marine,81,32,77,6,113,95.06172839506173,7.4074074074074066
34474_marine,81,32,77,6,113,95.06172839506173,7.4074074074074066
34475_marine,81,33,77,6,114,95.06172839506173,7.4074074074074066
34476_marine,81,33,77,6,114,95.06172839506173,7.4074074074074066
34477_marine,84,33,80,7,117,95.23809523809523,8.333333333333332
34478_marine,89,32,85,9,121,95.50561797752809,10.112359550561797
34479_marine,97,33,92,11,130,94.84536082474226,11.34020618556701
34480_marine,107,33,102,13,140,95.32710280373831,12.149532710280374
34481_marine,129,37,123,20,166,95.34883720930233,15.503875968992247
34482_marine,707,209,450,409,916,63.64922206506365,57.85007072135785
34489_marine,987,401,650,542,1388,65.85612968591693,54.913880445795336
34490_marine,880,295,570,474,1175,64.77272727272727,53.86363636363637
34491_marine,960,347,633,519,1307,65.9375,54.0625
34492_marine,866,292,570,459,1158,65.81986143187068,53.002309468822176
34493_marine,1024,375,668,582,1399,65.234375,56.8359375
34494_marine,854,287,560,455,1141,65.57377049180327,53.278688524590166
34495_marine,917,336,600,494,1253,65.43075245365321,53.871319520174474
34496_marine,849,282,554,461,1131,65.2532391048292,54.29917550058892
34497_marine,831,275,541,459,1106,65.1022864019254,55.23465703971119
34498_marine,1006,374,631,581,1380,62.72365805168986,57.75347912524851
34499_marine,1019,383,631,593,1402,61.9234543670265,58.194308145240434
34505_marine,1042,427,636,626,1469,61.036468330134355,60.076775431861805
34506_marine,934,344,555,571,1278,59.421841541755896,61.13490364025695
34507_marine,910,338,544,555,1248,59.78021978021978,60.98901098901099
34508_marine,976,380,594,587,1356,60.86065573770492,60.143442622950815
34509_marine,930,362,547,569,1292,58.817204301075265,61.18279569892473
34510_marine,928,358,547,567,1286,58.94396551724138,61.099137931034484
34511_marine,936,366,554,570,1302,59.18803418803419,60.89743589743589
34512_marine,1004,422,608,597,1426,60.55776892430279,59.462151394422314
34516_marine,846,342,550,483,1188,65.01182033096927,57.09219858156028
34517_marine,385,209,291,147,594,75.58441558441558,38.18181818181819
34534_marine,882,332,519,550,1214,58.843537414965986,62.358276643990926
34537_marine,845,297,500,533,1142,59.171597633136095,63.07692307692307
34538_marine,835,294,494,525,1129,59.16167664670658,62.874251497005986
34539_marine,642,192,426,380,834,66.35514018691589,59.19003115264797
34540_marine,686,226,459,405,912,66.90962099125365,59.037900874635575
34541_marine,631,191,415,376,822,65.76862123613311,59.587955625990496
34542_marine,105,33,94,13,138,89.52380952380953,12.380952380952381
34543_marine,105,33,94,13,138,89.52380952380953,12.380952380952381
34544_marine,99,35,91,11,134,91.91919191919192,11.11111111111111
34545_marine,101,36,93,11,137,92.07920792079209,10.891089108910892
34546_marine,99,37,92,10,136,92.92929292929293,10.1010101010101
34547_marine,99,37,92,10,136,92.92929292929293,10.1010101010101
34548_marine,99,37,92,10,136,92.92929292929293,10.1010101010101
34549_marine,98,38,91,10,136,92.85714285714286,10.204081632653061
34550_marine,97,38,90,9,135,92.78350515463917,9.278350515463918
34551_marine,97,39,90,9,136,92.78350515463917,9.278350515463918
34552_marine,99,40,92,11,139,92.92929292929293,11.11111111111111
34553_marine,99,40,92,11,139,92.92929292929293,11.11111111111111
34554_marine,99,40,92,11,139,92.92929292929293,11.11111111111111
34555_marine,99,41,92,11,140,92.92929292929293,11.11111111111111
34556_marine,531,149,368,320,680,69.30320150659134,60.263653483992464
34557_marine,550,172,383,331,722,69.63636363636364,60.18181818181818
34558_marine,529,147,367,319,676,69.37618147448015,60.30245746691871
34559_marine,523,140,363,313,663,69.40726577437859,59.847036328871894
34560_marine,99,40,93,9,139,93.93939393939394,9.090909090909092
34561_marine,99,40,93,8,139,93.93939393939394,8.080808080808081
34562_marine,99,39,93,8,138,93.93939393939394,8.080808080808081
34563_marine,99,39,93,8,138,93.93939393939394,8.080808080808081
34564_marine,99,39,93,8,138,93.93939393939394,8.080808080808081
34565_marine,99,38,93,8,137,93.93939393939394,8.080808080808081
34566_marine,99,39,93,8,138,93.93939393939394,8.080808080808081
34567_marine,99,39,93,10,138,93.93939393939394,10.1010101010101
34568_marine,97,39,91,10,136,93.81443298969072,10.309278350515463
34569_marine,97,39,91,10,136,93.81443298969072,10.309278350515463
34570_marine,97,39,91,10,136,93.81443298969072,10.309278350515463
34571_marine,99,39,93,12,138,93.93939393939394,12.121212121212121
34572_marine,99,39,93,12,138,93.93939393939394,12.121212121212121
34573_marine,99,39,93,12,138,93.93939393939394,12.121212121212121
34574_marine,99,40,93,12,139,93.93939393939394,12.121212121212121
34575_marine,99,40,93,12,139,93.93939393939394,12.121212121212121
34576_marine,98,40,92,12,138,93.87755102040816,12.244897959183673
34577_marine,98,40,92,12,138,93.87755102040816,12.244897959183673
34578_marine,99,40,93,12,139,93.93939393939394,12.121212121212121
34579_marine,99,39,93,12,138,93.93939393939394,12.121212121212121
34580_marine,99,39,93,11,138,93.93939393939394,11.11111111111111
34581_marine,99,39,93,11,138,93.93939393939394,11.11111111111111
34582_marine,97,39,91,10,136,93.81443298969072,10.309278350515463
34583_marine,96,39,90,10,135,93.75,10.416666666666668
34584_marine,350,88,252,202,438,72,57.714285714285715
34585_marine,349,89,251,202,438,71.91977077363897,57.879656160458445
34586_marine,98,43,92,12,141,93.87755102040816,12.244897959183673
34587_marine,99,40,93,13,139,93.93939393939394,13.131313131313133
34588_marine,99,40,93,13,139,93.93939393939394,13.131313131313133
34589_marine,97,41,91,12,138,93.81443298969072,12.371134020618557
34590_marine,97,41,91,12,138,93.81443298969072,12.371134020618557
34591_marine,97,41,91,12,138,93.81443298969072,12.371134020618557
34592_marine,97,42,91,12,139,93.81443298969072,12.371134020618557
34593_marine,97,42,91,12,139,93.81443298969072,12.371134020618557
34594_marine,98,43,92,13,141,93.87755102040816,13.26530612244898
34595_marine,98,43,92,13,141,93.87755102040816,13.26530612244898
34596_marine,98,43,92,13,141,93.87755102040816,13.26530612244898
34597_marine,99,43,93,12,142,93.93939393939394,12.121212121212121
34598_marine,103,43,97,14,146,94.1747572815534,13.592233009708737
34599_marine,107,43,101,14,150,94.39252336448598,13.084112149532709
34600_marine,317,110,220,174,427,69.4006309148265,54.889589905362776
34601_marine,271,98,184,151,369,67.89667896678966,55.71955719557196
34602_marine,100,41,94,13,141,94,13
34603_marine,100,40,94,13,140,94,13
34604_marine,100,40,94,11,140,94,11
34605_marine,98,38,92,9,136,93.87755102040816,9.183673469387756
34606_marine,95,38,89,8,133,93.6842105263158,8.421052631578947
34607_marine,95,37,89,8,132,93.6842105263158,8.421052631578947
34608_marine,95,37,89,8,132,93.6842105263158,8.421052631578947
34609_marine,95,37,89,8,132,93.6842105263158,8.421052631578947
34610_marine,93,37,88,7,130,94.6236559139785,7.526881720430108
34611_marine,93,37,88,7,130,94.6236559139785,7.526881720430108
34612_marine,93,37,88,7,130,94.6236559139785,7.526881720430108
34613_marine,92,37,87,7,129,94.56521739130434,7.608695652173914
34614_marine,92,37,87,7,129,94.56521739130434,7.608695652173914
34615_marine,92,37,87,7,129,94.56521739130434,7.608695652173914
34616_marine,93,37,88,7,130,94.6236559139785,7.526881720430108
34617_marine,93,37,88,7,130,94.6236559139785,7.526881720430108
34618_marine,92,37,87,6,129,94.56521739130434,6.521739130434782
34619_marine,92,37,87,6,129,94.56521739130434,6.521739130434782
34620_marine,93,36,88,6,129,94.6236559139785,6.451612903225806
34621_marine,92,38,87,6,130,94.56521739130434,6.521739130434782
34622_marine,91,38,86,5,129,94.5054945054945,5.4945054945054945
34623_marine,91,38,86,5,129,94.5054945054945,5.4945054945054945
34624_marine,90,38,85,5,128,94.44444444444444,5.555555555555555
34625_marine,88,38,83,5,126,94.31818181818183,5.681818181818182
34626_marine,88,37,83,5,125,94.31818181818183,5.681818181818182
34627_marine,86,38,81,5,124,94.18604651162791,5.813953488372093
34628_marine,85,38,80,5,123,94.11764705882352,5.88235294117647
34629_marine,83,39,78,5,122,93.97590361445783,6.024096385542169
34630_marine,83,39,78,5,122,93.97590361445783,6.024096385542169
34631_marine,83,39,78,5,122,93.97590361445783,6.024096385542169
34632_marine,83,39,78,5,122,93.97590361445783,6.024096385542169
34633_marine,83,39,78,5,122,93.97590361445783,6.024096385542169
34634_marine,83,39,78,5,122,93.97590361445783,6.024096385542169
34635_marine,83,39,78,5,122,93.97590361445783,6.024096385542169
34636_marine,82,39,77,5,121,93.90243902439023,6.097560975609756
34637_marine,84,40,79,5,124,94.04761904761905,5.952380952380952
34638_marine,84,40,79,5,124,94.04761904761905,5.952380952380952
34639_marine,84,39,79,5,123,94.04761904761905,5.952380952380952
34640_marine,84,40,79,5,124,94.04761904761905,5.952380952380952
34641_marine,84,39,79,5,123,94.04761904761905,5.952380952380952
34642_marine,82,41,77,5,123,93.90243902439023,6.097560975609756
34643_marine,81,40,76,5,121,93.82716049382715,6.172839506172839
34644_marine,83,40,78,6,123,93.97590361445783,7.228915662650602
34645_marine,83,41,78,6,124,93.97590361445783,7.228915662650602
34646_marine,84,41,80,6,125,95.23809523809523,7.142857142857142
34647_marine,83,43,79,5,126,95.18072289156626,6.024096385542169
34648_marine,83,43,79,5,126,95.18072289156626,6.024096385542169
34649_marine,84,43,79,5,127,94.04761904761905,5.952380952380952
34650_marine,84,42,79,5,126,94.04761904761905,5.952380952380952
34651_marine,85,42,80,5,127,94.11764705882352,5.88235294117647
34652_marine,89,42,83,6,131,93.25842696629213,6.741573033707865
34653_marine,89,43,83,6,132,93.25842696629213,6.741573033707865
34654_marine,88,44,82,6,132,93.18181818181817,6.8181818181818175
34655_marine,93,43,88,5,136,94.6236559139785,5.376344086021505
34656_marine,95,48,90,5,143,94.73684210526315,5.263157894736842
34657_marine,102,48,97,5,150,95.09803921568627,4.901960784313726
34658_marine,218,98,182,40,316,83.4862385321101,18.34862385321101
34659_marine,295,173,206,103,468,69.83050847457626,34.91525423728813
34660_marine,365,303,245,147,668,67.12328767123287,40.273972602739725
34661_marine,341,266,227,139,607,66.56891495601172,40.76246334310851
34707_marine,318,134,258,101,452,81.13207547169812,31.761006289308174
34708_marine,119,36,112,10,155,94.11764705882352,8.403361344537815
34709_marine,105,36,98,10,141,93.33333333333333,9.523809523809524
34710_marine,97,37,90,8,134,92.78350515463917,8.24742268041237
34711_marine,95,37,88,8,132,92.63157894736842,8.421052631578947
34712_marine,94,37,87,7,131,92.5531914893617,7.446808510638298
34713_marine,90,37,85,5,127,94.44444444444444,5.555555555555555
34714_marine,90,37,85,5,127,94.44444444444444,5.555555555555555
34715_marine,90,37,85,5,127,94.44444444444444,5.555555555555555
34716_marine,89,37,84,5,126,94.3820224719101,5.617977528089887
34717_marine,89,37,84,5,126,94.3820224719101,5.617977528089887
34718_marine,89,37,84,5,126,94.3820224719101,5.617977528089887
34719_marine,91,37,85,6,128,93.4065934065934,6.593406593406594
34720_marine,91,37,85,6,128,93.4065934065934,6.593406593406594
34721_marine,90,37,84,6,127,93.33333333333333,6.666666666666667
34722_marine,90,37,84,6,127,93.33333333333333,6.666666666666667
34723_marine,90,37,84,7,127,93.33333333333333,7.777777777777778
34724_marine,92,35,86,7,127,93.47826086956522,7.608695652173914
34725_marine,98,36,92,9,134,93.87755102040816,9.183673469387756
34726_marine,120,61,110,22,181,91.66666666666666,18.333333333333332
34727_marine,95,36,89,9,131,93.6842105263158,9.473684210526317
34728_marine,95,36,89,9,131,93.6842105263158,9.473684210526317
34729_marine,88,34,82,6,122,93.18181818181817,6.8181818181818175
34730_marine,89,34,83,6,123,93.25842696629213,6.741573033707865
34731_marine,86,33,79,6,119,91.86046511627907,6.976744186046512
34732_marine,86,35,79,6,121,91.86046511627907,6.976744186046512
34733_marine,86,34,79,6,120,91.86046511627907,6.976744186046512
34734_marine,84,34,77,6,118,91.66666666666666,7.142857142857142
34735_marine,84,34,77,6,118,91.66666666666666,7.142857142857142
34736_marine,83,34,76,5,117,91.56626506024097,6.024096385542169
34737_marine,83,34,76,5,117,91.56626506024097,6.024096385542169
34738_marine,83,34,76,5,117,91.56626506024097,6.024096385542169
34739_marine,82,34,76,4,116,92.6829268292683,4.878048780487805
34740_marine,83,37,77,4,120,92.7710843373494,4.819277108433735
34741_marine,83,37,77,4,120,92.7710843373494,4.819277108433735
34742_marine,83,37,77,4,120,92.7710843373494,4.819277108433735
34743_marine,80,35,74,4,115,92.5,5
34744_marine,81,37,75,4,118,92.5925925925926,4.938271604938271
34745_marine,83,37,77,4,120,92.7710843373494,4.819277108433735
34746_marine,84,37,78,4,121,92.85714285714286,4.761904761904762
34747_marine,83,39,78,3,122,93.97590361445783,3.614457831325301
34748_marine,90,41,85,3,131,94.44444444444444,3.3333333333333335
34749_marine,89,40,84,4,129,94.3820224719101,4.49438202247191
34750_marine,92,37,87,3,129,94.56521739130434,3.260869565217391
34751_marine,102,50,97,5,152,95.09803921568627,4.901960784313726
34752_marine,249,123,232,26,372,93.17269076305222,10.441767068273093
34781_marine,690,254,475,365,944,68.84057971014492,52.89855072463768
34782_marine,107,34,100,17,141,93.45794392523365,15.887850467289718
34783_marine,105,34,97,13,139,92.38095238095238,12.380952380952381
34784_marine,104,34,96,13,138,92.3076923076923,12.5
34785_marine,96,34,88,11,130,91.66666666666666,11.458333333333332
34786_marine,94,34,86,11,128,91.48936170212765,11.702127659574469
34787_marine,90,34,83,10,124,92.22222222222223,11.11111111111111
34788_marine,92,34,85,12,126,92.3913043478261,13.043478260869565
34789_marine,96,38,90,16,134,93.75,16.666666666666664
34790_marine,96,37,90,16,133,93.75,16.666666666666664
34791_marine,97,37,91,16,134,93.81443298969072,16.49484536082474
34792_marine,521,163,348,308,684,66.79462571976967,59.11708253358925
34793_marine,577,192,394,333,769,68.2842287694974,57.712305025996535
34794_marine,578,192,394,334,770,68.16608996539793,57.785467128027676
34795_marine,552,177,367,325,729,66.48550724637681,58.87681159420289
34796_marine,545,181,360,322,726,66.05504587155964,59.082568807339456
34797_marine,550,186,367,321,736,66.72727272727272,58.36363636363636
34798_marine,505,149,338,300,654,66.93069306930694,59.4059405940594
34799_marine,92,34,86,9,126,93.47826086956522,9.782608695652174
34800_marine,90,34,84,9,124,93.33333333333333,10
34801_marine,86,34,80,9,120,93.02325581395348,10.465116279069768
34802_marine,84,34,78,9,118,92.85714285714286,10.714285714285714
34803_marine,83,33,77,8,116,92.7710843373494,9.63855421686747
34804_marine,83,33,77,8,116,92.7710843373494,9.63855421686747
34805_marine,83,33,77,8,116,92.7710843373494,9.63855421686747
34806_marine,83,33,77,8,116,92.7710843373494,9.63855421686747
34807_marine,83,33,77,8,116,92.7710843373494,9.63855421686747
34808_marine,83,32,77,8,115,92.7710843373494,9.63855421686747
34809_marine,84,32,78,9,116,92.85714285714286,10.714285714285714
34810_marine,88,32,82,9,120,93.18181818181817,10.227272727272728
34811_marine,515,120,346,297,635,67.18446601941747,57.66990291262136
34812_marine,527,125,355,309,652,67.36242884250474,58.63377609108159
34813_marine,515,120,347,298,635,67.37864077669903,57.86407766990291
34814_marine,518,114,349,299,632,67.37451737451737,57.72200772200772
34815_marine,93,33,87,13,126,93.54838709677419,13.978494623655912
34816_marine,91,31,85,9,122,93.4065934065934,9.89010989010989
34817_marine,87,31,81,8,118,93.10344827586206,9.195402298850574
34818_marine,84,30,79,7,114,94.04761904761905,8.333333333333332
34819_marine,85,30,80,7,115,94.11764705882352,8.235294117647058
34820_marine,85,30,80,7,115,94.11764705882352,8.235294117647058
34821_marine,81,30,76,7,111,93.82716049382715,8.641975308641975
34822_marine,80,31,75,7,111,93.75,8.75
34823_marine,80,31,75,7,111,93.75,8.75
34824_marine,80,31,75,7,111,93.75,8.75
34825_marine,80,31,75,7,111,93.75,8.75
34826_marine,82,31,77,7,113,93.90243902439023,8.536585365853659
34827_marine,82,31,77,7,113,93.90243902439023,8.536585365853659
34828_marine,82,31,77,7,113,93.90243902439023,8.536585365853659
34829_marine,82,31,77,7,113,93.90243902439023,8.536585365853659
34830_marine,82,31,77,7,113,93.90243902439023,8.536585365853659
34831_marine,82,31,77,7,113,93.90243902439023,8.536585365853659
34832_marine,82,31,77,7,113,93.90243902439023,8.536585365853659
34833_marine,82,32,77,7,114,93.90243902439023,8.536585365853659
34834_marine,82,32,77,7,114,93.90243902439023,8.536585365853659
34835_marine,82,32,77,7,114,93.90243902439023,8.536585365853659
34836_marine,82,33,77,7,115,93.90243902439023,8.536585365853659
34837_marine,82,33,78,7,115,95.1219512195122,8.536585365853659
34838_marine,86,33,82,9,119,95.34883720930233,10.465116279069768
34839_marine,93,32,89,9,125,95.6989247311828,9.67741935483871
34840_marine,101,34,96,13,135,95.04950495049505,12.871287128712872
34841_marine,111,34,105,17,145,94.5945945945946,15.315315315315313
34842_marine,687,199,435,407,886,63.31877729257642,59.243085880640464
34843_marine,706,210,448,411,916,63.45609065155807,58.21529745042493
34844_marine,760,222,490,435,982,64.47368421052632,57.23684210526315
34845_marine,823,284,529,468,1107,64.27703523693803,56.865127582017
34857_marine,1055,404,660,607,1459,62.55924170616114,57.53554502369668
34858_marine,962,340,582,570,1302,60.4989604989605,59.25155925155925
34859_marine,1042,390,637,619,1432,61.13243761996161,59.40499040307101
34860_marine,1061,405,649,627,1466,61.168708765315735,59.0951932139491
34862_marine,1068,435,646,638,1503,60.48689138576779,59.737827715355806
34863_marine,1076,438,648,647,1514,60.223048327137555,60.13011152416357
34864_marine,979,363,576,599,1342,58.83554647599591,61.18488253319714
34865_marine,1051,431,629,639,1482,59.84776403425309,60.79923882017126
34866_marine,950,348,556,586,1298,58.526315789473685,61.68421052631579
34867_marine,982,374,583,600,1356,59.36863543788188,61.099796334012225
34868_marine,926,342,549,565,1268,59.28725701943844,61.01511879049676
34869_marine,926,340,555,559,1266,59.93520518358532,60.367170626349896
34870_marine,986,389,606,582,1375,61.4604462474645,59.02636916835699
34871_marine,956,374,586,567,1330,61.29707112970711,59.30962343096235
34872_marine,1021,408,624,612,1429,61.116552399608224,59.94123408423114
34873_marine,1059,435,642,645,1494,60.62322946175638,60.90651558073654
34874_marine,904,353,567,524,1257,62.72123893805309,57.9646017699115
34876_marine,836,320,546,478,1156,65.311004784689,57.17703349282297
34877_marine,365,158,273,138,523,74.79452054794521,37.80821917808219
34878_marine,357,175,269,132,532,75.35014005602241,36.97478991596639
34893_marine,876,313,515,544,1189,58.789954337899545,62.10045662100456
34894_marine,825,286,486,525,1111,58.909090909090914,63.63636363636363
34899_marine,839,296,497,528,1135,59.23718712753278,62.93206197854588
34900_marine,836,292,497,524,1128,59.44976076555024,62.67942583732058
34901_marine,825,283,486,523,1108,58.909090909090914,63.39393939393939
34902_marine,109,34,98,17,143,89.90825688073394,15.59633027522936
34903_marine,106,35,95,15,141,89.62264150943396,14.150943396226415
34904_marine,100,35,90,11,135,90,11
34905_marine,104,36,94,11,140,90.38461538461539,10.576923076923077
34906_marine,100,36,92,11,136,92,11
34907_marine,99,36,92,10,135,92.92929292929293,10.1010101010101
34908_marine,99,36,92,10,135,92.92929292929293,10.1010101010101
34909_marine,98,37,91,10,135,92.85714285714286,10.204081632653061
34910_marine,98,37,91,10,135,92.85714285714286,10.204081632653061
34911_marine,97,38,90,9,135,92.78350515463917,9.278350515463918
34912_marine,97,39,90,9,136,92.78350515463917,9.278350515463918
34913_marine,99,39,92,11,138,92.92929292929293,11.11111111111111
34914_marine,99,40,92,11,139,92.92929292929293,11.11111111111111
34915_marine,99,41,92,11,140,92.92929292929293,11.11111111111111
34916_marine,532,149,369,319,681,69.3609022556391,59.962406015037594
34917_marine,558,171,390,330,729,69.89247311827957,59.13978494623656
34918_marine,560,172,388,334,732,69.28571428571428,59.64285714285714
34919_marine,532,150,368,317,682,69.17293233082707,59.58646616541353
34920_marine,529,143,365,317,672,68.99810964083176,59.92438563327032
34921_marine,103,40,97,8,143,94.1747572815534,7.766990291262135
34922_marine,98,39,92,8,137,93.87755102040816,8.16326530612245
34923_marine,98,39,92,8,137,93.87755102040816,8.16326530612245
34924_marine,99,39,93,8,138,93.93939393939394,8.080808080808081
34925_marine,97,39,91,8,136,93.81443298969072,8.24742268041237
34926_marine,99,38,93,10,137,93.93939393939394,10.1010101010101
34927_marine,462,114,314,288,576,67.96536796536796,62.33766233766234
34928_marine,460,114,312,288,574,67.82608695652173,62.60869565217392
34929_marine,460,114,312,288,574,67.82608695652173,62.60869565217392
34930_marine,97,38,91,10,135,93.81443298969072,10.309278350515463
34931_marine,99,38,93,12,137,93.93939393939394,12.121212121212121
34932_marine,99,38,93,12,137,93.93939393939394,12.121212121212121
34933_marine,99,38,93,12,137,93.93939393939394,12.121212121212121
34934_marine,99,39,93,12,138,93.93939393939394,12.121212121212121
34935_marine,96,39,90,10,135,93.75,10.416666666666668
34936_marine,98,39,92,12,137,93.87755102040816,12.244897959183673
34937_marine,99,39,93,12,138,93.93939393939394,12.121212121212121
34938_marine,99,41,93,12,140,93.93939393939394,12.121212121212121
34939_marine,99,40,93,12,139,93.93939393939394,12.121212121212121
34940_marine,98,40,92,11,138,93.87755102040816,11.224489795918368
34941_marine,97,38,91,10,135,93.81443298969072,10.309278350515463
34942_marine,96,40,90,10,136,93.75,10.416666666666668
34943_marine,97,40,91,10,137,93.81443298969072,10.309278350515463
34944_marine,99,38,93,12,137,93.93939393939394,12.121212121212121
34945_marine,98,39,92,12,137,93.87755102040816,12.244897959183673
34946_marine,98,39,92,12,137,93.87755102040816,12.244897959183673
34947_marine,98,39,92,12,137,93.87755102040816,12.244897959183673
34948_marine,99,40,93,13,139,93.93939393939394,13.131313131313133
34949_marine,98,40,92,13,138,93.87755102040816,13.26530612244898
34950_marine,98,41,92,13,139,93.87755102040816,13.26530612244898
34951_marine,98,41,92,13,139,93.87755102040816,13.26530612244898
34952_marine,98,41,92,13,139,93.87755102040816,13.26530612244898
34953_marine,98,41,92,13,139,93.87755102040816,13.26530612244898
34954_marine,100,41,94,13,141,94,13
34955_marine,97,42,91,10,139,93.81443298969072,10.309278350515463
34956_marine,99,41,93,12,140,93.93939393939394,12.121212121212121
34957_marine,101,41,95,14,142,94.05940594059405,13.861386138613863
34958_marine,105,42,99,14,147,94.28571428571428,13.333333333333334
34959_marine,314,115,217,173,429,69.10828025477707,55.095541401273884
34960_marine,343,134,239,188,477,69.67930029154519,54.81049562682215
34961_marine,317,115,220,174,432,69.4006309148265,54.889589905362776
34962_marine,105,44,99,14,149,94.28571428571428,13.333333333333334
34963_marine,100,41,94,13,141,94,13
34964_marine,98,41,92,11,139,93.87755102040816,11.224489795918368
34965_marine,96,40,90,9,136,93.75,9.375
34966_marine,97,39,91,9,136,93.81443298969072,9.278350515463918
34967_marine,94,38,88,9,132,93.61702127659575,9.574468085106384
34968_marine,93,37,87,8,130,93.54838709677419,8.60215053763441
34969_marine,93,37,87,8,130,93.54838709677419,8.60215053763441
34970_marine,92,37,86,8,129,93.47826086956522,8.695652173913043
34971_marine,92,37,86,8,129,93.47826086956522,8.695652173913043
34972_marine,89,37,84,7,126,94.3820224719101,7.865168539325842
34973_marine,88,37,83,7,125,94.31818181818183,7.954545454545454
34974_marine,88,37,83,7,125,94.31818181818183,7.954545454545454
34975_marine,88,37,83,7,125,94.31818181818183,7.954545454545454
34976_marine,88,37,83,7,125,94.31818181818183,7.954545454545454
34977_marine,89,37,84,7,126,94.3820224719101,7.865168539325842
34978_marine,88,36,83,6,124,94.31818181818183,6.8181818181818175
34979_marine,88,36,83,6,124,94.31818181818183,6.8181818181818175
34980_marine,88,36,83,6,124,94.31818181818183,6.8181818181818175
34981_marine,88,36,83,6,124,94.31818181818183,6.8181818181818175
34982_marine,88,38,83,6,126,94.31818181818183,6.8181818181818175
34983_marine,87,38,82,5,125,94.25287356321839,5.747126436781609
34984_marine,84,37,79,5,121,94.04761904761905,5.952380952380952
34985_marine,84,37,79,5,121,94.04761904761905,5.952380952380952
34986_marine,84,37,79,5,121,94.04761904761905,5.952380952380952
34987_marine,83,37,78,5,120,93.97590361445783,6.024096385542169
34988_marine,83,36,78,5,119,93.97590361445783,6.024096385542169
34989_marine,83,36,78,5,119,93.97590361445783,6.024096385542169
34990_marine,83,36,78,5,119,93.97590361445783,6.024096385542169
34991_marine,83,36,78,5,119,93.97590361445783,6.024096385542169
34992_marine,83,36,78,5,119,93.97590361445783,6.024096385542169
34993_marine,83,38,78,5,121,93.97590361445783,6.024096385542169
34994_marine,83,38,78,5,121,93.97590361445783,6.024096385542169
34995_marine,83,38,78,5,121,93.97590361445783,6.024096385542169
34996_marine,83,38,78,5,121,93.97590361445783,6.024096385542169
34997_marine,82,39,77,5,121,93.90243902439023,6.097560975609756
34998_marine,82,38,77,5,120,93.90243902439023,6.097560975609756
34999_marine,82,38,77,5,120,93.90243902439023,6.097560975609756
35000_marine,84,37,79,5,121,94.04761904761905,5.952380952380952
35001_marine,84,37,79,5,121,94.04761904761905,5.952380952380952
35002_marine,84,37,79,5,121,94.04761904761905,5.952380952380952
35003_marine,84,37,79,5,121,94.04761904761905,5.952380952380952
35004_marine,86,39,81,6,125,94.18604651162791,6.976744186046512
35005_marine,83,39,78,6,122,93.97590361445783,7.228915662650602
35006_marine,83,40,79,5,123,95.18072289156626,6.024096385542169
35007_marine,83,42,79,5,125,95.18072289156626,6.024096385542169
35008_marine,83,42,79,5,125,95.18072289156626,6.024096385542169
35009_marine,83,43,79,5,126,95.18072289156626,6.024096385542169
35010_marine,84,42,79,5,126,94.04761904761905,5.952380952380952
35011_marine,84,42,79,5,126,94.04761904761905,5.952380952380952
35012_marine,84,42,79,5,126,94.04761904761905,5.952380952380952
35013_marine,86,43,80,6,129,93.02325581395348,6.976744186046512
35014_marine,86,44,81,5,130,94.18604651162791,5.813953488372093
35015_marine,90,43,85,5,133,94.44444444444444,5.555555555555555
35016_marine,95,45,90,5,140,94.73684210526315,5.263157894736842
35017_marine,98,44,93,4,142,94.89795918367348,4.081632653061225
35018_marine,104,48,99,8,152,95.1923076923077,7.6923076923076925
35019_marine,223,102,184,42,325,82.51121076233184,18.83408071748879
35020_marine,232,165,189,47,397,81.46551724137932,20.25862068965517
35021_marine,343,267,228,142,610,66.47230320699708,41.39941690962099
35067_marine,316,134,256,101,450,81.0126582278481,31.962025316455694
35068_marine,113,38,106,8,151,93.80530973451327,7.079646017699115
35069_marine,102,36,95,8,138,93.13725490196079,7.8431372549019605
35070_marine,96,36,89,8,132,92.70833333333334,8.333333333333332
35071_marine,93,37,86,7,130,92.47311827956989,7.526881720430108
35072_marine,93,37,86,7,130,92.47311827956989,7.526881720430108
35073_marine,91,37,86,5,128,94.5054945054945,5.4945054945054945
35074_marine,89,37,84,5,126,94.3820224719101,5.617977528089887
35075_marine,88,37,83,5,125,94.31818181818183,5.681818181818182
35076_marine,88,37,83,5,125,94.31818181818183,5.681818181818182
35077_marine,88,37,83,5,125,94.31818181818183,5.681818181818182
35078_marine,88,37,83,5,125,94.31818181818183,5.681818181818182
35079_marine,89,37,83,6,126,93.25842696629213,6.741573033707865
35080_marine,90,37,84,6,127,93.33333333333333,6.666666666666667
35081_marine,89,35,83,6,124,93.25842696629213,6.741573033707865
35082_marine,88,35,82,6,123,93.18181818181817,6.8181818181818175
35083_marine,90,35,83,8,125,92.22222222222223,8.88888888888889
35084_marine,91,37,84,9,128,92.3076923076923,9.89010989010989
35085_marine,119,62,108,23,181,90.75630252100841,19.327731092436977
35086_marine,139,70,120,38,209,86.33093525179856,27.33812949640288
35087_marine,121,62,110,23,183,90.9090909090909,19.00826446280992
35088_marine,93,36,87,9,129,93.54838709677419,9.67741935483871
35089_marine,90,36,84,7,126,93.33333333333333,7.777777777777778
35090_marine,89,36,83,6,125,93.25842696629213,6.741573033707865
35091_marine,86,36,79,6,122,91.86046511627907,6.976744186046512
35092_marine,86,35,79,6,121,91.86046511627907,6.976744186046512
35093_marine,86,32,79,6,118,91.86046511627907,6.976744186046512
35094_marine,84,34,77,6,118,91.66666666666666,7.142857142857142
35095_marine,84,34,77,6,118,91.66666666666666,7.142857142857142
35096_marine,84,34,77,6,118,91.66666666666666,7.142857142857142
35097_marine,83,34,76,5,117,91.56626506024097,6.024096385542169
35098_marine,83,35,76,5,118,91.56626506024097,6.024096385542169
35099_marine,82,35,76,4,117,92.6829268292683,4.878048780487805
35100_marine,81,35,75,4,116,92.5925925925926,4.938271604938271
35101_marine,83,37,77,4,120,92.7710843373494,4.819277108433735
35102_marine,83,37,77,4,120,92.7710843373494,4.819277108433735
35103_marine,80,35,74,4,115,92.5,5
35104_marine,79,37,73,4,116,92.40506329113924,5.063291139240507
35105_marine,83,37,77,4,120,92.7710843373494,4.819277108433735
35106_marine,83,37,78,3,120,93.97590361445783,3.614457831325301
35107_marine,84,37,78,3,121,92.85714285714286,3.571428571428571
35108_marine,86,41,81,3,127,94.18604651162791,3.488372093023256
35109_marine,90,40,85,3,130,94.44444444444444,3.3333333333333335
35110_marine,94,37,89,3,131,94.68085106382979,3.1914893617021276
35111_marine,103,38,98,5,141,95.14563106796116,4.854368932038835
35112_marine,216,112,204,22,328,94.44444444444444,10.185185185185185
35141_marine,670,247,457,365,917,68.2089552238806,54.47761194029851
35142_marine,109,34,102,17,143,93.57798165137615,15.59633027522936
35143_marine,105,34,97,13,139,92.38095238095238,12.380952380952381
35144_marine,108,34,100,15,142,92.5925925925926,13.88888888888889
35145_marine,102,34,94,15,136,92.15686274509804,14.705882352941178
35146_marine,100,36,92,15,136,92,15
35147_marine,98,37,91,16,135,92.85714285714286,16.3265306122449
35148_marine,99,42,92,15,141,92.92929292929293,15.151515151515152
35149_marine,99,38,92,17,137,92.92929292929293,17.17171717171717
35150_marine,96,40,90,16,136,93.75,16.666666666666664
35151_marine,98,39,92,16,137,93.87755102040816,16.3265306122449
35152_marine,520,163,347,309,683,66.73076923076923,59.42307692307692
35153_marine,573,188,393,329,761,68.58638743455498,57.417102966841185
35154_marine,530,170,357,311,700,67.35849056603773,58.679245283018865
35155_marine,106,37,100,18,143,94.33962264150944,16.9811320754717
35156_marine,504,148,337,300,652,66.86507936507937,59.523809523809526
35157_marine,538,162,367,313,700,68.21561338289963,58.17843866171004
35158_marine,507,152,340,297,659,67.0611439842209,58.57988165680473
35159_marine,91,33,85,9,124,93.4065934065934,9.89010989010989
35160_marine,94,33,88,9,127,93.61702127659575,9.574468085106384
35161_marine,90,33,84,9,123,93.33333333333333,10
35162_marine,87,34,82,8,121,94.25287356321839,9.195402298850574
35163_marine,82,34,77,7,116,93.90243902439023,8.536585365853659
35164_marine,82,33,77,7,115,93.90243902439023,8.536585365853659
35165_marine,82,32,77,7,114,93.90243902439023,8.536585365853659
35166_marine,82,32,77,7,114,93.90243902439023,8.536585365853659
35167_marine,82,31,77,7,113,93.90243902439023,8.536585365853659
35168_marine,83,32,77,8,115,92.7710843373494,9.63855421686747
35169_marine,84,32,78,9,116,92.85714285714286,10.714285714285714
35170_marine,90,32,84,11,122,93.33333333333333,12.222222222222221
35171_marine,513,118,344,294,631,67.05653021442495,57.30994152046783
35172_marine,516,118,347,299,634,67.24806201550388,57.94573643410853
35173_marine,534,124,361,311,658,67.60299625468164,58.239700374531836
35174_marine,518,114,349,299,632,67.37451737451737,57.72200772200772
35175_marine,92,31,86,12,123,93.47826086956522,13.043478260869565
35176_marine,88,31,82,9,119,93.18181818181817,10.227272727272728
35177_marine,86,31,81,7,117,94.18604651162791,8.13953488372093
35178_marine,82,31,77,7,113,93.90243902439023,8.536585365853659
35179_marine,80,31,75,7,111,93.75,8.75
35180_marine,78,31,73,7,109,93.58974358974359,8.974358974358974
35181_marine,78,31,73,7,109,93.58974358974359,8.974358974358974
35182_marine,80,32,75,7,112,93.75,8.75
35183_marine,80,32,75,7,112,93.75,8.75
35184_marine,80,32,75,7,112,93.75,8.75
35185_marine,80,31,75,7,111,93.75,8.75
35186_marine,80,31,75,7,111,93.75,8.75
35187_marine,80,31,75,7,111,93.75,8.75
35188_marine,80,31,75,7,111,93.75,8.75
35189_marine,82,31,77,7,113,93.90243902439023,8.536585365853659
35190_marine,82,31,77,7,113,93.90243902439023,8.536585365853659
35191_marine,82,31,77,7,113,93.90243902439023,8.536585365853659
35192_marine,82,31,77,7,113,93.90243902439023,8.536585365853659
35193_marine,82,31,77,7,113,93.90243902439023,8.536585365853659
35194_marine,84,31,79,7,115,94.04761904761905,8.333333333333332
35195_marine,84,32,79,7,116,94.04761904761905,8.333333333333332
35196_marine,84,33,79,7,117,94.04761904761905,8.333333333333332
35197_marine,82,33,77,7,115,93.90243902439023,8.536585365853659
35198_marine,83,33,78,8,116,93.97590361445783,9.63855421686747
35199_marine,87,33,82,10,120,94.25287356321839,11.494252873563218
35200_marine,92,32,88,9,124,95.65217391304348,9.782608695652174
35201_marine,100,34,94,12,134,94,12
35202_marine,109,34,103,17,143,94.4954128440367,15.59633027522936
35203_marine,122,36,114,21,158,93.44262295081968,17.21311475409836
35204_marine,130,41,122,22,171,93.84615384615384,16.923076923076923
35205_marine,787,236,498,460,1023,63.27827191867853,58.449809402795424
35206_marine,966,371,615,575,1337,63.66459627329193,59.523809523809526
35217_marine,1027,386,629,594,1413,61.24634858812074,57.8383641674781
35218_marine,1048,395,650,614,1443,62.02290076335878,58.587786259541986
35219_marine,1056,400,654,619,1456,61.93181818181818,58.61742424242424
35220_marine,1006,379,601,604,1385,59.741550695825055,60.039761431411534
35221_marine,1149,470,696,698,1619,60.574412532637076,60.74847693646649
35222_marine,1103,449,660,663,1552,59.836808703535816,60.10879419764279
35223_marine,1066,423,637,645,1489,59.756097560975604,60.50656660412758
35224_marine,1049,394,618,646,1443,58.91325071496664,61.58245948522403
35225_marine,975,370,570,601,1345,58.46153846153847,61.641025641025635
35226_marine,1124,495,673,702,1619,59.87544483985765,62.45551601423488
35227_marine,1117,493,673,692,1610,60.250671441360794,61.951656222023274
35228_marine,1072,446,642,659,1518,59.88805970149254,61.473880597014926
35229_marine,1037,430,626,635,1467,60.36644165863066,61.23432979749277
35230_marine,1051,432,635,644,1483,60.418648905804,61.27497621313035
35231_marine,1036,433,629,631,1469,60.71428571428571,60.907335907335906
35233_marine,946,365,590,548,1311,62.36786469344609,57.928118393234676
35234_marine,835,312,543,476,1147,65.02994011976048,57.00598802395209
35236_marine,392,189,296,143,581,75.51020408163265,36.47959183673469
35237_marine,368,155,280,134,523,76.08695652173914,36.41304347826087
35238_marine,405,261,308,155,666,76.04938271604938,38.2716049382716
35249_marine,937,384,571,556,1321,60.939167556029886,59.33831376734259
35250_marine,909,358,543,552,1267,59.73597359735974,60.726072607260726
35251_marine,916,364,550,552,1280,60.043668122270745,60.26200873362445
35252_marine,900,359,538,548,1259,59.77777777777777,60.88888888888889
35253_marine,873,329,518,540,1202,59.335624284077895,61.855670103092784
35254_marine,119,36,108,20,155,90.75630252100841,16.80672268907563
35255_marine,836,302,494,530,1138,59.09090909090909,63.397129186602875
35261_marine,924,346,551,584,1270,59.63203463203464,63.20346320346321
35262_marine,833,295,493,526,1128,59.183673469387756,63.1452581032413
35263_marine,744,258,457,461,1002,61.424731182795696,61.96236559139785
35264_marine,734,256,447,457,990,60.89918256130791,62.26158038147139
35265_marine,104,36,94,11,140,90.38461538461539,10.576923076923077
35266_marine,104,36,94,11,140,90.38461538461539,10.576923076923077
35267_marine,100,36,92,11,136,92,11
35268_marine,100,36,92,11,136,92,11
35269_marine,99,36,92,10,135,92.92929292929293,10.1010101010101
35270_marine,98,37,91,10,135,92.85714285714286,10.204081632653061
35271_marine,98,37,91,10,135,92.85714285714286,10.204081632653061
35272_marine,97,39,90,9,136,92.78350515463917,9.278350515463918
35273_marine,101,39,94,11,140,93.06930693069307,10.891089108910892
35274_marine,101,39,94,11,140,93.06930693069307,10.891089108910892
35275_marine,101,39,94,11,140,93.06930693069307,10.891089108910892
35276_marine,532,144,369,319,676,69.3609022556391,59.962406015037594
35277_marine,535,151,372,319,686,69.53271028037383,59.62616822429907
35278_marine,557,172,387,331,729,69.47935368043088,59.42549371633752
35279_marine,565,172,391,333,737,69.20353982300885,58.93805309734513
35280_marine,534,147,365,321,681,68.35205992509363,60.1123595505618
35281_marine,435,131,290,275,566,66.66666666666666,63.2183908045977
35282_marine,96,39,90,8,135,93.75,8.333333333333332
35283_marine,96,39,90,8,135,93.75,8.333333333333332
35284_marine,96,39,90,8,135,93.75,8.333333333333332
35285_marine,96,39,90,8,135,93.75,8.333333333333332
35286_marine,99,39,93,10,138,93.93939393939394,10.1010101010101
35287_marine,462,117,314,288,579,67.96536796536796,62.33766233766234
35288_marine,464,126,315,291,590,67.88793103448276,62.71551724137932
35289_marine,460,118,312,288,578,67.82608695652173,62.60869565217392
35290_marine,458,117,312,286,575,68.12227074235808,62.44541484716157
35291_marine,97,39,91,10,136,93.81443298969072,10.309278350515463
35292_marine,99,39,93,12,138,93.93939393939394,12.121212121212121
35293_marine,99,39,93,12,138,93.93939393939394,12.121212121212121
35294_marine,97,40,91,10,137,93.81443298969072,10.309278350515463
35295_marine,97,40,91,10,137,93.81443298969072,10.309278350515463
35296_marine,99,40,93,12,139,93.93939393939394,12.121212121212121
35297_marine,99,40,93,12,139,93.93939393939394,12.121212121212121
35298_marine,100,42,94,13,142,94,13
35299_marine,132,48,120,31,180,90.9090909090909,23.484848484848484
35300_marine,98,41,92,11,139,93.87755102040816,11.224489795918368
35301_marine,98,39,92,10,137,93.87755102040816,10.204081632653061
35302_marine,389,102,272,229,491,69.9228791773779,58.86889460154242
35303_marine,388,101,271,229,489,69.84536082474226,59.02061855670103
35304_marine,377,94,261,226,471,69.23076923076923,59.94694960212201
35305_marine,97,38,91,12,135,93.81443298969072,12.371134020618557
35306_marine,97,38,91,12,135,93.81443298969072,12.371134020618557
35307_marine,95,38,89,10,133,93.6842105263158,10.526315789473683
35308_marine,94,38,88,10,132,93.61702127659575,10.638297872340425
35309_marine,98,39,92,13,137,93.87755102040816,13.26530612244898
35310_marine,316,87,220,188,403,69.62025316455697,59.49367088607595
35311_marine,99,42,93,12,141,93.93939393939394,12.121212121212121
35312_marine,99,40,93,12,139,93.93939393939394,12.121212121212121
35313_marine,101,40,95,12,141,94.05940594059405,11.881188118811881
35314_marine,101,40,95,12,141,94.05940594059405,11.881188118811881
35315_marine,99,40,93,10,139,93.93939393939394,10.1010101010101
35316_marine,97,40,91,10,137,93.81443298969072,10.309278350515463
35317_marine,105,41,99,14,146,94.28571428571428,13.333333333333334
35318_marine,105,41,99,14,146,94.28571428571428,13.333333333333334
35319_marine,315,115,218,174,430,69.2063492063492,55.23809523809524
35320_marine,347,139,243,187,486,70.02881844380403,53.89048991354467
35321_marine,347,141,243,187,488,70.02881844380403,53.89048991354467
35322_marine,315,117,218,174,432,69.2063492063492,55.23809523809524
35323_marine,105,42,99,14,147,94.28571428571428,13.333333333333334
35324_marine,96,41,90,11,137,93.75,11.458333333333332
35325_marine,94,41,88,9,135,93.61702127659575,9.574468085106384
35326_marine,94,40,88,9,134,93.61702127659575,9.574468085106384
35327_marine,95,40,89,9,135,93.6842105263158,9.473684210526317
35328_marine,92,38,86,9,130,93.47826086956522,9.782608695652174
35329_marine,91,37,85,9,128,93.4065934065934,9.89010989010989
35330_marine,90,37,84,8,127,93.33333333333333,8.88888888888889
35331_marine,90,37,84,8,127,93.33333333333333,8.88888888888889
35332_marine,90,37,84,8,127,93.33333333333333,8.88888888888889
35333_marine,89,37,83,8,126,93.25842696629213,8.98876404494382
35334_marine,88,37,83,7,125,94.31818181818183,7.954545454545454
35335_marine,88,37,83,7,125,94.31818181818183,7.954545454545454
35336_marine,88,37,83,7,125,94.31818181818183,7.954545454545454
35337_marine,88,36,83,7,124,94.31818181818183,7.954545454545454
35338_marine,88,36,83,7,124,94.31818181818183,7.954545454545454
35339_marine,87,36,82,6,123,94.25287356321839,6.896551724137931
35340_marine,87,36,82,6,123,94.25287356321839,6.896551724137931
35341_marine,87,36,82,6,123,94.25287356321839,6.896551724137931
35342_marine,87,36,82,6,123,94.25287356321839,6.896551724137931
35343_marine,87,35,82,6,122,94.25287356321839,6.896551724137931
35344_marine,85,37,80,5,122,94.11764705882352,5.88235294117647
35345_marine,85,37,80,5,122,94.11764705882352,5.88235294117647
35346_marine,84,37,79,5,121,94.04761904761905,5.952380952380952
35347_marine,83,36,78,5,119,93.97590361445783,6.024096385542169
35348_marine,83,36,78,5,119,93.97590361445783,6.024096385542169
35349_marine,83,36,78,5,119,93.97590361445783,6.024096385542169
35350_marine,83,36,78,5,119,93.97590361445783,6.024096385542169
35351_marine,83,36,78,5,119,93.97590361445783,6.024096385542169
35352_marine,83,36,78,5,119,93.97590361445783,6.024096385542169
35353_marine,83,36,78,5,119,93.97590361445783,6.024096385542169
35354_marine,83,36,78,5,119,93.97590361445783,6.024096385542169
35355_marine,83,36,78,5,119,93.97590361445783,6.024096385542169
35356_marine,83,35,78,5,118,93.97590361445783,6.024096385542169
35357_marine,83,37,78,5,120,93.97590361445783,6.024096385542169
35358_marine,82,38,77,5,120,93.90243902439023,6.097560975609756
35359_marine,82,38,77,5,120,93.90243902439023,6.097560975609756
35360_marine,82,38,77,5,120,93.90243902439023,6.097560975609756
35361_marine,82,38,77,5,120,93.90243902439023,6.097560975609756
35362_marine,82,37,77,5,119,93.90243902439023,6.097560975609756
35363_marine,84,37,79,4,121,94.04761904761905,4.761904761904762
35364_marine,85,37,80,5,122,94.11764705882352,5.88235294117647
35365_marine,84,37,80,5,121,95.23809523809523,5.952380952380952
35366_marine,86,37,82,5,123,95.34883720930233,5.813953488372093
35367_marine,83,39,79,5,122,95.18072289156626,6.024096385542169
35368_marine,83,40,79,5,123,95.18072289156626,6.024096385542169
35369_marine,83,40,79,5,123,95.18072289156626,6.024096385542169
35370_marine,84,39,79,5,123,94.04761904761905,5.952380952380952
35371_marine,84,39,79,5,123,94.04761904761905,5.952380952380952
35372_marine,84,39,79,5,123,94.04761904761905,5.952380952380952
35373_marine,85,40,79,6,125,92.94117647058823,7.0588235294117645
35374_marine,84,42,79,5,126,94.04761904761905,5.952380952380952
35375_marine,84,42,79,5,126,94.04761904761905,5.952380952380952
35376_marine,91,43,86,5,134,94.5054945054945,5.4945054945054945
35377_marine,95,44,90,5,139,94.73684210526315,5.263157894736842
35378_marine,102,44,97,7,146,95.09803921568627,6.862745098039216
35379_marine,113,53,107,11,166,94.69026548672566,9.734513274336283
35380_marine,207,125,172,37,332,83.09178743961353,17.874396135265698
35381_marine,331,254,222,135,585,67.06948640483384,40.78549848942598
35382_marine,327,256,219,131,583,66.97247706422019,40.0611620795107
35427_marine,315,140,254,102,455,80.63492063492063,32.38095238095238
35428_marine,111,36,104,8,147,93.69369369369369,7.207207207207207
35429_marine,102,34,95,8,136,93.13725490196079,7.8431372549019605
35430_marine,96,36,89,8,132,92.70833333333334,8.333333333333332
35431_marine,93,36,86,7,129,92.47311827956989,7.526881720430108
35432_marine,91,37,86,5,128,94.5054945054945,5.4945054945054945
35433_marine,91,37,86,5,128,94.5054945054945,5.4945054945054945
35434_marine,88,37,83,5,125,94.31818181818183,5.681818181818182
35435_marine,88,37,83,5,125,94.31818181818183,5.681818181818182
35436_marine,88,37,83,5,125,94.31818181818183,5.681818181818182
35437_marine,88,37,83,5,125,94.31818181818183,5.681818181818182
35438_marine,88,37,83,5,125,94.31818181818183,5.681818181818182
35439_marine,89,35,83,6,124,93.25842696629213,6.741573033707865
35440_marine,90,35,84,6,125,93.33333333333333,6.666666666666667
35441_marine,90,35,83,7,125,92.22222222222223,7.777777777777778
35442_marine,87,35,80,7,122,91.95402298850574,8.045977011494253
35443_marine,90,35,83,8,125,92.22222222222223,8.88888888888889
35444_marine,97,37,90,10,134,92.78350515463917,10.309278350515463
35445_marine,120,62,109,23,182,90.83333333333333,19.166666666666668
35446_marine,121,63,110,23,184,90.9090909090909,19.00826446280992
35447_marine,119,62,108,23,181,90.75630252100841,19.327731092436977
35448_marine,95,36,88,10,131,92.63157894736842,10.526315789473683
35449_marine,90,36,84,7,126,93.33333333333333,7.777777777777778
35450_marine,87,36,81,6,123,93.10344827586206,6.896551724137931
35451_marine,83,36,77,6,119,92.7710843373494,7.228915662650602
35452_marine,84,36,77,6,120,91.66666666666666,7.142857142857142
35453_marine,83,34,76,6,117,91.56626506024097,7.228915662650602
35454_marine,82,32,75,6,114,91.46341463414635,7.317073170731707
35455_marine,82,32,75,6,114,91.46341463414635,7.317073170731707
35456_marine,84,35,77,6,119,91.66666666666666,7.142857142857142
35457_marine,84,35,77,6,119,91.66666666666666,7.142857142857142
35458_marine,83,35,76,5,118,91.56626506024097,6.024096385542169
35459_marine,82,35,76,4,117,92.6829268292683,4.878048780487805
35460_marine,81,35,75,4,116,92.5925925925926,4.938271604938271
35461_marine,83,37,77,4,120,92.7710843373494,4.819277108433735
35462_marine,81,35,75,4,116,92.5925925925926,4.938271604938271
35463_marine,80,35,74,4,115,92.5,5
35464_marine,79,37,73,4,116,92.40506329113924,5.063291139240507
35465_marine,80,37,75,3,117,93.75,3.75
35466_marine,80,37,75,3,117,93.75,3.75
35467_marine,82,37,76,3,119,92.6829268292683,3.6585365853658534
35468_marine,84,39,78,2,123,92.85714285714286,2.380952380952381
35469_marine,87,40,82,2,127,94.25287356321839,2.2988505747126435
35470_marine,93,36,88,3,129,94.6236559139785,3.225806451612903
35471_marine,97,36,92,5,133,94.84536082474226,5.154639175257731
35472_marine,102,51,97,7,153,95.09803921568627,6.862745098039216
35473_marine,242,120,225,29,362,92.97520661157024,11.983471074380166
35501_marine,669,225,456,362,894,68.16143497757847,54.11061285500748
35502_marine,111,34,104,15,145,93.69369369369369,13.513513513513514
35503_marine,107,34,99,13,141,92.5233644859813,12.149532710280374
35504_marine,112,34,104,17,146,92.85714285714286,15.178571428571427
35505_marine,109,34,101,16,143,92.66055045871559,14.678899082568808
35506_marine,527,151,350,303,678,66.41366223908919,57.49525616698292
35507_marine,530,159,354,303,689,66.79245283018868,57.16981132075472
35508_marine,527,158,353,301,685,66.98292220113852,57.1157495256167
35509_marine,510,142,340,295,652,66.66666666666666,57.84313725490197
35510_marine,492,139,325,293,631,66.05691056910568,59.552845528455286
35511_marine,496,148,328,294,644,66.12903225806451,59.2741935483871
35512_marine,495,152,327,294,647,66.06060606060606,59.3939393939394
35513_marine,521,163,348,307,684,66.79462571976967,58.92514395393474
35514_marine,519,163,346,305,682,66.66666666666666,58.76685934489403
35515_marine,97,36,91,10,133,93.81443298969072,10.309278350515463
35516_marine,498,144,331,296,642,66.46586345381526,59.43775100401606
35517_marine,502,143,335,295,645,66.73306772908366,58.76494023904383
35518_marine,98,35,92,9,133,93.87755102040816,9.183673469387756
35519_marine,99,34,93,9,133,93.93939393939394,9.090909090909092
35520_marine,93,36,87,9,129,93.54838709677419,9.67741935483871
35521_marine,104,41,95,17,145,91.34615384615384,16.346153846153847
35522_marine,89,33,84,8,122,94.3820224719101,8.98876404494382
35523_marine,88,33,83,7,121,94.31818181818183,7.954545454545454
35524_marine,84,32,79,7,116,94.04761904761905,8.333333333333332
35525_marine,84,32,79,7,116,94.04761904761905,8.333333333333332
35526_marine,84,32,79,7,116,94.04761904761905,8.333333333333332
35527_marine,84,31,79,7,115,94.04761904761905,8.333333333333332
35528_marine,84,31,79,7,115,94.04761904761905,8.333333333333332
35529_marine,84,31,79,7,115,94.04761904761905,8.333333333333332
35530_marine,89,32,83,11,121,93.25842696629213,12.359550561797752
35531_marine,92,33,86,10,125,93.47826086956522,10.869565217391305
35532_marine,518,114,350,297,632,67.56756756756756,57.33590733590733
35533_marine,518,114,350,298,632,67.56756756756756,57.52895752895753
35534_marine,518,114,350,298,632,67.56756756756756,57.52895752895753
35535_marine,94,31,88,13,125,93.61702127659575,13.829787234042554
35536_marine,89,31,84,8,120,94.3820224719101,8.98876404494382
35537_marine,80,31,75,7,111,93.75,8.75
35538_marine,80,31,75,7,111,93.75,8.75
35539_marine,80,31,75,7,111,93.75,8.75
35540_marine,80,31,75,7,111,93.75,8.75
35541_marine,79,31,74,7,110,93.67088607594937,8.860759493670885
35542_marine,79,31,74,7,110,93.67088607594937,8.860759493670885
35543_marine,81,32,76,7,113,93.82716049382715,8.641975308641975
35544_marine,81,32,76,7,113,93.82716049382715,8.641975308641975
35545_marine,81,32,76,7,113,93.82716049382715,8.641975308641975
35546_marine,82,31,77,7,113,93.90243902439023,8.536585365853659
35547_marine,82,31,77,7,113,93.90243902439023,8.536585365853659
35548_marine,82,31,77,7,113,93.90243902439023,8.536585365853659
35549_marine,82,31,77,7,113,93.90243902439023,8.536585365853659
35550_marine,82,31,77,7,113,93.90243902439023,8.536585365853659
35551_marine,84,31,79,7,115,94.04761904761905,8.333333333333332
35552_marine,84,31,79,7,115,94.04761904761905,8.333333333333332
35553_marine,86,31,81,7,117,94.18604651162791,8.13953488372093
35554_marine,86,31,81,7,117,94.18604651162791,8.13953488372093
35555_marine,86,31,81,7,117,94.18604651162791,8.13953488372093
35556_marine,86,31,81,7,117,94.18604651162791,8.13953488372093
35557_marine,86,31,81,7,117,94.18604651162791,8.13953488372093
35558_marine,86,33,81,7,119,94.18604651162791,8.13953488372093
35559_marine,85,33,80,8,118,94.11764705882352,9.411764705882353
35560_marine,86,32,81,10,118,94.18604651162791,11.627906976744185
35561_marine,94,32,89,10,126,94.68085106382979,10.638297872340425
35562_marine,102,32,95,13,134,93.13725490196079,12.745098039215685
35563_marine,106,34,98,14,140,92.45283018867924,13.20754716981132
35564_marine,120,34,112,19,154,93.33333333333333,15.833333333333332
35565_marine,126,36,118,21,162,93.65079365079364,16.666666666666664
35566_marine,807,225,500,481,1032,61.957868649318456,59.603469640644356
35567_marine,813,230,506,488,1043,62.23862238622387,60.02460024600246
35568_marine,855,262,535,505,1117,62.57309941520468,59.06432748538012
35569_marine,874,294,561,499,1168,64.18764302059496,57.09382151029748
35570_marine,882,295,565,503,1177,64.05895691609977,57.02947845804989
35589_marine,1049,435,628,651,1484,59.86653956148713,62.05910390848427
35590_marine,1039,442,629,638,1481,60.53897978825794,61.405197305101055
35591_marine,1034,428,633,624,1462,61.21856866537717,60.34816247582205
35593_marine,929,372,576,546,1301,62.002152852529605,58.77287405812702
35594_marine,387,190,290,145,577,74.93540051679587,37.46770025839793
35595_marine,392,196,293,147,588,74.74489795918367,37.5
35596_marine,407,202,300,155,609,73.71007371007371,38.08353808353808
35597_marine,387,179,292,140,566,75.45219638242894,36.17571059431525
35605_marine,656,278,450,332,934,68.59756097560977,50.609756097560975
35608_marine,911,371,548,553,1282,60.1536772777168,60.70252469813392
35614_marine,888,340,528,546,1228,59.45945945945946,61.48648648648649
35615_marine,901,353,535,552,1254,59.37846836847947,61.26526082130965
35616_marine,834,297,493,528,1131,59.11270983213429,63.30935251798561
35623_marine,874,314,523,555,1188,59.839816933638446,63.50114416475973
35624_marine,743,258,456,459,1001,61.37281292059219,61.776581426648725
35625_marine,104,38,94,11,142,90.38461538461539,10.576923076923077
35626_marine,104,38,94,11,142,90.38461538461539,10.576923076923077
35627_marine,602,205,393,364,807,65.28239202657808,60.46511627906976
35628_marine,602,205,393,364,807,65.28239202657808,60.46511627906976
35629_marine,99,36,91,11,135,91.91919191919192,11.11111111111111
35630_marine,100,37,92,11,137,92,11
35631_marine,100,37,92,11,137,92,11
35632_marine,98,37,91,9,135,92.85714285714286,9.183673469387756
35633_marine,100,39,93,11,139,93,11
35634_marine,100,39,93,11,139,93,11
35635_marine,100,39,93,11,139,93,11
35636_marine,100,39,93,11,139,93,11
35637_marine,530,144,369,315,674,69.62264150943396,59.43396226415094
35638_marine,538,148,373,319,686,69.33085501858736,59.29368029739776
35639_marine,562,169,389,334,731,69.21708185053382,59.430604982206404
35640_marine,563,169,389,333,732,69.09413854351686,59.14742451154529
35641_marine,435,129,290,275,564,66.66666666666666,63.2183908045977
35642_marine,96,39,90,8,135,93.75,8.333333333333332
35643_marine,96,39,90,8,135,93.75,8.333333333333332
35644_marine,96,39,90,8,135,93.75,8.333333333333332
35645_marine,96,39,90,8,135,93.75,8.333333333333332
35646_marine,98,39,92,10,137,93.87755102040816,10.204081632653061
35647_marine,462,115,314,289,577,67.96536796536796,62.55411255411255
35648_marine,463,118,315,289,581,68.03455723542116,62.419006479481645
35649_marine,471,126,322,292,597,68.36518046709129,61.995753715498935
35650_marine,458,118,312,286,576,68.12227074235808,62.44541484716157
35651_marine,97,39,91,10,136,93.81443298969072,10.309278350515463
35652_marine,98,39,92,10,137,93.87755102040816,10.204081632653061
35653_marine,98,39,92,10,137,93.87755102040816,10.204081632653061
35654_marine,416,102,282,256,518,67.78846153846155,61.53846153846154
35655_marine,416,102,282,256,518,67.78846153846155,61.53846153846154
35656_marine,97,40,91,10,137,93.81443298969072,10.309278350515463
35657_marine,98,40,92,11,138,93.87755102040816,11.224489795918368
35658_marine,98,42,92,11,140,93.87755102040816,11.224489795918368
35659_marine,395,100,268,240,495,67.84810126582278,60.75949367088608
35660_marine,393,98,267,238,491,67.93893129770993,60.55979643765903
35661_marine,98,39,92,10,137,93.87755102040816,10.204081632653061
35662_marine,385,102,268,229,487,69.61038961038962,59.480519480519476
35663_marine,388,102,271,229,490,69.84536082474226,59.02061855670103
35664_marine,376,95,260,226,471,69.14893617021278,60.1063829787234
35665_marine,95,40,89,10,135,93.6842105263158,10.526315789473683
35666_marine,103,44,94,17,147,91.2621359223301,16.50485436893204
35667_marine,102,45,93,17,147,91.17647058823529,16.666666666666664
35668_marine,96,41,90,10,137,93.75,10.416666666666668
35669_marine,359,93,253,210,452,70.47353760445682,58.495821727019504
35670_marine,377,110,265,223,487,70.29177718832891,59.15119363395226
35671_marine,361,96,255,212,457,70.6371191135734,58.72576177285319
35672_marine,101,38,95,12,139,94.05940594059405,11.881188118811881
35673_marine,101,39,95,12,140,94.05940594059405,11.881188118811881
35674_marine,101,39,95,12,140,94.05940594059405,11.881188118811881
35675_marine,99,40,93,10,139,93.93939393939394,10.1010101010101
35676_marine,99,40,93,10,139,93.93939393939394,10.1010101010101
35677_marine,105,40,99,12,145,94.28571428571428,11.428571428571429
35678_marine,109,41,103,14,150,94.4954128440367,12.844036697247708
35679_marine,317,115,220,174,432,69.4006309148265,54.889589905362776
35680_marine,349,140,246,187,489,70.48710601719198,53.581661891117484
35681_marine,350,139,245,186,489,70,53.142857142857146
35682_marine,352,142,247,187,494,70.17045454545455,53.125
35683_marine,313,110,216,172,423,69.00958466453673,54.9520766773163
35684_marine,100,41,94,11,141,94,11
35685_marine,94,40,88,9,134,93.61702127659575,9.574468085106384
35686_marine,94,41,88,9,135,93.61702127659575,9.574468085106384
35687_marine,95,40,89,9,135,93.6842105263158,9.473684210526317
35688_marine,95,40,89,9,135,93.6842105263158,9.473684210526317
35689_marine,91,38,85,9,129,93.4065934065934,9.89010989010989
35690_marine,91,37,85,9,128,93.4065934065934,9.89010989010989
35691_marine,90,37,84,8,127,93.33333333333333,8.88888888888889
35692_marine,90,37,84,8,127,93.33333333333333,8.88888888888889
35693_marine,89,37,83,8,126,93.25842696629213,8.98876404494382
35694_marine,89,37,83,8,126,93.25842696629213,8.98876404494382
35695_marine,89,36,83,8,125,93.25842696629213,8.98876404494382
35696_marine,88,36,83,7,124,94.31818181818183,7.954545454545454
35697_marine,88,36,83,7,124,94.31818181818183,7.954545454545454
35698_marine,88,36,83,7,124,94.31818181818183,7.954545454545454
35699_marine,88,36,83,7,124,94.31818181818183,7.954545454545454
35700_marine,87,36,82,7,123,94.25287356321839,8.045977011494253
35701_marine,86,36,81,6,122,94.18604651162791,6.976744186046512
35702_marine,87,35,82,6,122,94.25287356321839,6.896551724137931
35703_marine,85,35,80,6,120,94.11764705882352,7.0588235294117645
35704_marine,85,35,80,6,120,94.11764705882352,7.0588235294117645
35705_marine,84,37,79,5,121,94.04761904761905,5.952380952380952
35706_marine,84,37,79,5,121,94.04761904761905,5.952380952380952
35707_marine,83,36,78,5,119,93.97590361445783,6.024096385542169
35708_marine,83,36,78,5,119,93.97590361445783,6.024096385542169
35709_marine,83,36,78,5,119,93.97590361445783,6.024096385542169
35710_marine,83,36,78,5,119,93.97590361445783,6.024096385542169
35711_marine,83,36,78,5,119,93.97590361445783,6.024096385542169
35712_marine,83,36,78,5,119,93.97590361445783,6.024096385542169
35713_marine,83,36,78,5,119,93.97590361445783,6.024096385542169
35714_marine,83,36,78,5,119,93.97590361445783,6.024096385542169
35715_marine,83,35,78,5,118,93.97590361445783,6.024096385542169
35716_marine,83,35,78,5,118,93.97590361445783,6.024096385542169
35717_marine,83,35,78,5,118,93.97590361445783,6.024096385542169
35718_marine,83,36,78,5,119,93.97590361445783,6.024096385542169
35719_marine,82,36,77,5,118,93.90243902439023,6.097560975609756
35720_marine,82,36,77,5,118,93.90243902439023,6.097560975609756
35721_marine,81,36,76,4,117,93.82716049382715,4.938271604938271
35722_marine,81,38,76,4,119,93.82716049382715,4.938271604938271
35723_marine,81,37,77,4,118,95.06172839506173,4.938271604938271
35724_marine,81,37,77,4,118,95.06172839506173,4.938271604938271
35725_marine,82,37,78,5,119,95.1219512195122,6.097560975609756
35726_marine,82,37,78,5,119,95.1219512195122,6.097560975609756
35727_marine,84,37,80,5,121,95.23809523809523,5.952380952380952
35728_marine,85,39,81,5,124,95.29411764705881,5.88235294117647
35729_marine,83,40,79,5,123,95.18072289156626,6.024096385542169
35730_marine,83,39,79,5,122,95.18072289156626,6.024096385542169
35731_marine,84,39,79,5,123,94.04761904761905,5.952380952380952
35732_marine,84,40,79,5,124,94.04761904761905,5.952380952380952
35733_marine,82,41,78,4,123,95.1219512195122,4.878048780487805
35734_marine,83,42,78,5,125,93.97590361445783,6.024096385542169
35735_marine,84,43,79,5,127,94.04761904761905,5.952380952380952
35736_marine,89,42,84,5,131,94.3820224719101,5.617977528089887
35737_marine,93,44,88,5,137,94.6236559139785,5.376344086021505
35738_marine,96,44,91,4,140,94.79166666666666,4.166666666666666
35739_marine,105,48,100,8,153,95.23809523809523,7.6190476190476195
35740_marine,119,63,113,11,182,94.9579831932773,9.243697478991598
35741_marine,213,142,176,41,355,82.62910798122066,19.248826291079812
35742_marine,326,247,218,134,573,66.87116564417178,41.104294478527606
35786_marine,332,167,269,107,499,81.02409638554217,32.22891566265061
35787_marine,123,45,116,12,168,94.3089430894309,9.75609756097561
35788_marine,107,37,100,9,144,93.45794392523365,8.411214953271028
35789_marine,97,35,90,9,132,92.78350515463917,9.278350515463918
35790_marine,97,35,90,9,132,92.78350515463917,9.278350515463918
35791_marine,92,36,87,6,128,94.56521739130434,6.521739130434782
35792_marine,91,37,86,5,128,94.5054945054945,5.4945054945054945
35793_marine,91,37,86,5,128,94.5054945054945,5.4945054945054945
35794_marine,88,37,83,5,125,94.31818181818183,5.681818181818182
35795_marine,88,37,83,5,125,94.31818181818183,5.681818181818182
35796_marine,88,37,83,5,125,94.31818181818183,5.681818181818182
35797_marine,88,37,83,5,125,94.31818181818183,5.681818181818182
35798_marine,88,35,83,5,123,94.31818181818183,5.681818181818182
35799_marine,89,35,83,6,124,93.25842696629213,6.741573033707865
35800_marine,90,35,83,7,125,92.22222222222223,7.777777777777778
35801_marine,88,35,81,7,123,92.04545454545455,7.954545454545454
35802_marine,87,35,80,7,122,91.95402298850574,8.045977011494253
35803_marine,86,35,79,7,121,91.86046511627907,8.13953488372093
35804_marine,91,35,84,8,126,92.3076923076923,8.791208791208792
35805_marine,95,36,88,10,131,92.63157894736842,10.526315789473683
35806_marine,92,36,85,10,128,92.3913043478261,10.869565217391305
35807_marine,92,36,85,10,128,92.3913043478261,10.869565217391305
35808_marine,95,36,88,10,131,92.63157894736842,10.526315789473683
35809_marine,88,36,81,7,124,92.04545454545455,7.954545454545454
35810_marine,87,37,81,6,124,93.10344827586206,6.896551724137931
35811_marine,83,37,77,6,120,92.7710843373494,7.228915662650602
35812_marine,84,37,77,6,121,91.66666666666666,7.142857142857142
35813_marine,83,37,76,6,120,91.56626506024097,7.228915662650602
35814_marine,82,33,75,6,115,91.46341463414635,7.317073170731707
35815_marine,84,35,77,6,119,91.66666666666666,7.142857142857142
35816_marine,82,33,75,6,115,91.46341463414635,7.317073170731707
35817_marine,82,35,75,6,117,91.46341463414635,7.317073170731707
35818_marine,81,35,75,5,116,92.5925925925926,6.172839506172839
35819_marine,80,35,74,4,115,92.5,5
35820_marine,81,37,75,4,118,92.5925925925926,4.938271604938271
35821_marine,81,37,75,4,118,92.5925925925926,4.938271604938271
35822_marine,79,35,73,4,114,92.40506329113924,5.063291139240507
35823_marine,78,35,72,4,113,92.3076923076923,5.128205128205128
35824_marine,77,37,71,4,114,92.20779220779221,5.194805194805195
35825_marine,76,37,71,3,113,93.42105263157895,3.9473684210526314
35826_marine,80,37,75,3,117,93.75,3.75
35827_marine,82,37,76,2,119,92.6829268292683,2.4390243902439024
35828_marine,84,36,78,2,120,92.85714285714286,2.380952380952381
35829_marine,88,38,83,2,126,94.31818181818183,2.272727272727273
35830_marine,95,36,90,5,131,94.73684210526315,5.263157894736842
35831_marine,96,37,91,4,133,94.79166666666666,4.166666666666666
35832_marine,99,50,95,6,149,95.95959595959596,6.0606060606060606
35861_marine,673,257,466,355,930,69.24219910846953,52.748885586924224
35862_marine,656,216,453,349,872,69.0548780487805,53.20121951219512
35863_marine,111,34,103,17,145,92.7927927927928,15.315315315315313
35864_marine,114,34,106,19,148,92.98245614035088,16.666666666666664
35865_marine,111,34,103,18,145,92.7927927927928,16.216216216216218
35866_marine,527,152,351,302,679,66.60341555977229,57.3055028462998
35867_marine,584,188,392,330,772,67.12328767123287,56.5068493150685
35868_marine,569,180,387,319,749,68.0140597539543,56.06326889279437
35869_marine,514,149,340,299,663,66.14785992217898,58.17120622568094
35870_marine,489,138,322,290,627,65.84867075664621,59.30470347648262
35871_marine,527,160,354,304,687,67.17267552182163,57.685009487666036
35872_marine,526,159,352,305,685,66.92015209125475,57.98479087452472
35873_marine,485,136,318,289,621,65.56701030927834,59.58762886597938
35874_marine,93,36,87,10,129,93.54838709677419,10.75268817204301
35875_marine,99,35,93,10,134,93.93939393939394,10.1010101010101
35876_marine,437,112,293,262,549,67.04805491990847,59.95423340961098
35877_marine,441,114,297,264,555,67.3469387755102,59.863945578231295
35878_marine,438,111,294,263,549,67.12328767123287,60.04566210045662
35879_marine,99,33,93,9,132,93.93939393939394,9.090909090909092
35880_marine,108,39,98,17,147,90.74074074074075,15.74074074074074
35881_marine,102,39,93,16,141,91.17647058823529,15.686274509803921
35882_marine,103,39,94,16,142,91.2621359223301,15.53398058252427
35883_marine,87,35,82,7,122,94.25287356321839,8.045977011494253
35884_marine,85,32,80,7,117,94.11764705882352,8.235294117647058
35885_marine,83,32,78,7,115,93.97590361445783,8.433734939759036
35886_marine,83,32,78,7,115,93.97590361445783,8.433734939759036
35887_marine,83,31,78,7,114,93.97590361445783,8.433734939759036
35888_marine,84,31,79,7,115,94.04761904761905,8.333333333333332
35889_marine,84,31,79,7,115,94.04761904761905,8.333333333333332
35890_marine,87,31,82,10,118,94.25287356321839,11.494252873563218
35891_marine,87,30,82,10,117,94.25287356321839,11.494252873563218
35892_marine,90,31,85,10,121,94.44444444444444,11.11111111111111
35893_marine,91,31,86,9,122,94.5054945054945,9.89010989010989
35894_marine,91,31,86,9,122,94.5054945054945,9.89010989010989
35895_marine,85,31,80,10,116,94.11764705882352,11.76470588235294
35896_marine,80,31,75,7,111,93.75,8.75
35897_marine,80,31,75,7,111,93.75,8.75
35898_marine,80,30,75,7,110,93.75,8.75
35899_marine,80,30,75,7,110,93.75,8.75
35900_marine,79,30,74,7,109,93.67088607594937,8.860759493670885
35901_marine,79,31,74,7,110,93.67088607594937,8.860759493670885
35902_marine,79,31,74,7,110,93.67088607594937,8.860759493670885
35903_marine,81,32,76,7,113,93.82716049382715,8.641975308641975
35904_marine,81,32,76,7,113,93.82716049382715,8.641975308641975
35905_marine,81,32,76,7,113,93.82716049382715,8.641975308641975
35906_marine,81,32,76,7,113,93.82716049382715,8.641975308641975
35907_marine,81,32,76,7,113,93.82716049382715,8.641975308641975
35908_marine,81,31,76,7,112,93.82716049382715,8.641975308641975
35909_marine,81,31,76,7,112,93.82716049382715,8.641975308641975
35910_marine,81,31,76,7,112,93.82716049382715,8.641975308641975
35911_marine,81,31,76,7,112,93.82716049382715,8.641975308641975
35912_marine,83,31,78,7,114,93.97590361445783,8.433734939759036
35913_marine,85,31,80,7,116,94.11764705882352,8.235294117647058
35914_marine,85,31,80,7,116,94.11764705882352,8.235294117647058
35915_marine,86,31,81,8,117,94.18604651162791,9.30232558139535
35916_marine,86,31,81,8,117,94.18604651162791,9.30232558139535
35917_marine,86,31,81,8,117,94.18604651162791,9.30232558139535
35918_marine,86,31,81,8,117,94.18604651162791,9.30232558139535
35919_marine,85,31,80,9,116,94.11764705882352,10.588235294117647
35920_marine,84,32,79,8,116,94.04761904761905,9.523809523809524
35921_marine,88,32,83,10,120,94.31818181818183,11.363636363636363
35922_marine,89,32,83,11,121,93.25842696629213,12.359550561797752
35923_marine,98,32,90,14,130,91.83673469387756,14.285714285714285
35924_marine,105,32,97,16,137,92.38095238095238,15.238095238095239
35925_marine,551,129,359,341,680,65.15426497277676,61.88747731397459
35926_marine,553,131,359,343,684,64.91862567811934,62.0253164556962
35927_marine,558,131,364,345,689,65.23297491039428,61.82795698924731
35928_marine,120,37,112,19,157,93.33333333333333,15.833333333333332
35929_marine,125,37,117,18,162,93.60000000000001,14.399999999999999
35930_marine,130,38,121,19,168,93.07692307692308,14.615384615384617
35931_marine,824,244,517,493,1068,62.74271844660194,59.83009708737864
35932_marine,830,248,526,494,1078,63.373493975903614,59.518072289156635
35933_marine,842,257,532,502,1099,63.18289786223278,59.61995249406176
35934_marine,896,303,557,531,1199,62.16517857142857,59.26339285714286
35935_marine,1000,369,606,604,1369,60.6,60.4
35936_marine,997,373,605,605,1370,60.682046138415245,60.682046138415245
35942_marine,950,343,559,589,1293,58.8421052631579,62
35943_marine,955,352,563,587,1307,58.95287958115183,61.46596858638743
35948_marine,974,409,593,572,1383,60.8829568788501,58.72689938398358
35949_marine,949,385,584,560,1334,61.53846153846154,59.00948366701792
35950_marine,953,391,590,556,1344,61.90975865687304,58.3420776495278
35951_marine,939,383,584,545,1322,62.19382321618744,58.04046858359957
35952_marine,950,390,592,546,1340,62.31578947368421,57.47368421052632
35953_marine,421,225,314,161,646,74.58432304038006,38.242280285035626
35954_marine,409,215,306,148,624,74.81662591687042,36.18581907090464
35955_marine,400,212,299,143,612,74.75,35.75
35956_marine,401,225,303,142,626,75.56109725685786,35.41147132169576
35957_marine,409,213,305,150,622,74.57212713936431,36.674816625916876
35958_marine,402,182,302,148,584,75.12437810945273,36.81592039800995
35959_marine,387,174,291,136,561,75.1937984496124,35.14211886304909
35960_marine,388,176,290,132,564,74.74226804123711,34.02061855670103
35965_marine,751,337,501,396,1088,66.711051930759,52.729693741677764
35966_marine,680,236,459,351,916,67.5,51.617647058823536
35975_marine,877,331,519,541,1208,59.17901938426454,61.68757126567846
35976_marine,827,290,489,522,1117,59.12938331318017,63.119709794437725
35977_marine,837,299,497,525,1136,59.37873357228196,62.72401433691756
35978_marine,836,300,495,526,1136,59.210526315789465,62.91866028708134
35979_marine,924,376,545,593,1300,58.98268398268398,64.17748917748918
35983_marine,858,322,513,533,1180,59.790209790209794,62.121212121212125
35984_marine,749,255,463,463,1004,61.815754339118826,61.815754339118826
35985_marine,685,240,416,433,925,60.72992700729927,63.21167883211679
35986_marine,694,251,420,438,945,60.51873198847262,63.112391930835734
35987_marine,686,251,414,436,937,60.34985422740525,63.55685131195335
35988_marine,694,281,437,427,975,62.96829971181557,61.527377521613836
35989_marine,601,208,392,364,809,65.22462562396007,60.56572379367721
35990_marine,101,37,93,11,138,92.07920792079209,10.891089108910892
35991_marine,100,37,92,11,137,92,11
35992_marine,100,37,92,11,137,92,11
35993_marine,99,39,91,10,138,91.91919191919192,10.1010101010101
35994_marine,101,39,93,12,140,92.07920792079209,11.881188118811881
35995_marine,101,39,93,12,140,92.07920792079209,11.881188118811881
35996_marine,100,39,93,11,139,93,11
35997_marine,101,39,94,11,140,93.06930693069307,10.891089108910892
35998_marine,102,40,95,11,142,93.13725490196079,10.784313725490197
35999_marine,534,148,365,323,682,68.35205992509363,60.48689138576779
36000_marine,559,170,385,333,729,68.87298747763863,59.570661896243294
36001_marine,451,127,302,287,578,66.96230598669624,63.63636363636363
36002_marine,98,39,92,8,137,93.87755102040816,8.16326530612245
36003_marine,98,39,92,8,137,93.87755102040816,8.16326530612245
36004_marine,98,39,92,8,137,93.87755102040816,8.16326530612245
36005_marine,99,39,93,9,138,93.93939393939394,9.090909090909092
36006_marine,101,39,95,11,140,94.05940594059405,10.891089108910892
36007_marine,101,39,95,11,140,94.05940594059405,10.891089108910892
36008_marine,461,115,315,286,576,68.32971800433839,62.039045553145336
36009_marine,478,125,326,293,603,68.20083682008368,61.29707112970711
36010_marine,478,124,326,293,602,68.20083682008368,61.29707112970711
36011_marine,105,39,99,11,144,94.28571428571428,10.476190476190476
36012_marine,105,39,99,11,144,94.28571428571428,10.476190476190476
36013_marine,100,40,94,11,140,94,11
36014_marine,420,109,286,257,529,68.0952380952381,61.1904761904762
36015_marine,431,115,295,260,546,68.44547563805105,60.32482598607889
36016_marine,417,106,283,257,523,67.86570743405275,61.63069544364509
36017_marine,98,40,92,11,138,93.87755102040816,11.224489795918368
36018_marine,97,40,91,10,137,93.81443298969072,10.309278350515463
36019_marine,398,103,270,241,501,67.8391959798995,60.55276381909548
36020_marine,400,102,272,243,502,68,60.75000000000001
36021_marine,100,39,94,12,139,94,12
36022_marine,379,95,263,228,474,69.39313984168865,60.15831134564644
36023_marine,379,95,263,228,474,69.39313984168865,60.15831134564644
36024_marine,97,39,91,12,136,93.81443298969072,12.371134020618557
36025_marine,95,40,89,10,135,93.6842105263158,10.526315789473683
36026_marine,102,43,93,17,145,91.17647058823529,16.666666666666664
36027_marine,104,43,95,17,147,91.34615384615384,16.346153846153847
36028_marine,372,103,255,222,475,68.54838709677419,59.67741935483871
36029_marine,371,101,255,222,472,68.73315363881402,59.83827493261455
36030_marine,386,113,265,233,499,68.65284974093264,60.362694300518136
36031_marine,363,96,257,212,459,70.79889807162535,58.40220385674931
36032_marine,100,38,94,12,138,94,12
36033_marine,100,38,94,12,138,94,12
36034_marine,100,38,94,12,138,94,12
36035_marine,99,38,93,10,137,93.93939393939394,10.1010101010101
36036_marine,101,39,95,10,140,94.05940594059405,9.900990099009901
36037_marine,105,40,99,10,145,94.28571428571428,9.523809523809524
36038_marine,107,40,101,12,147,94.39252336448598,11.214953271028037
36039_marine,107,41,101,12,148,94.39252336448598,11.214953271028037
36040_marine,317,112,220,172,429,69.4006309148265,54.25867507886435
36041_marine,340,140,237,184,480,69.70588235294117,54.11764705882353
36042_marine,347,140,244,185,487,70.31700288184439,53.31412103746398
36043_marine,315,110,218,172,425,69.2063492063492,54.6031746031746
36044_marine,100,41,94,11,141,94,11
36045_marine,94,41,88,9,135,93.61702127659575,9.574468085106384
36046_marine,94,40,88,9,134,93.61702127659575,9.574468085106384
36047_marine,95,39,89,9,134,93.6842105263158,9.473684210526317
36048_marine,95,39,89,9,134,93.6842105263158,9.473684210526317
36049_marine,94,39,88,9,133,93.61702127659575,9.574468085106384
36050_marine,93,37,87,9,130,93.54838709677419,9.67741935483871
36051_marine,91,37,85,9,128,93.4065934065934,9.89010989010989
36052_marine,91,37,85,9,128,93.4065934065934,9.89010989010989
36053_marine,89,37,83,8,126,93.25842696629213,8.98876404494382
36054_marine,89,36,83,8,125,93.25842696629213,8.98876404494382
36055_marine,89,36,83,8,125,93.25842696629213,8.98876404494382
36056_marine,89,36,83,8,125,93.25842696629213,8.98876404494382
36057_marine,89,36,83,8,125,93.25842696629213,8.98876404494382
36058_marine,88,36,83,7,124,94.31818181818183,7.954545454545454
36059_marine,87,36,82,7,123,94.25287356321839,8.045977011494253
36060_marine,87,35,82,7,122,94.25287356321839,8.045977011494253
36061_marine,87,35,82,7,122,94.25287356321839,8.045977011494253
36062_marine,84,35,79,6,119,94.04761904761905,7.142857142857142
36063_marine,85,35,80,6,120,94.11764705882352,7.0588235294117645
36064_marine,85,35,80,6,120,94.11764705882352,7.0588235294117645
36065_marine,85,35,80,6,120,94.11764705882352,7.0588235294117645
36066_marine,84,37,79,5,121,94.04761904761905,5.952380952380952
36067_marine,83,36,78,5,119,93.97590361445783,6.024096385542169
36068_marine,83,36,78,5,119,93.97590361445783,6.024096385542169
36069_marine,82,36,77,5,118,93.90243902439023,6.097560975609756
36070_marine,83,36,78,5,119,93.97590361445783,6.024096385542169
36071_marine,83,36,78,5,119,93.97590361445783,6.024096385542169
36072_marine,83,36,78,5,119,93.97590361445783,6.024096385542169
36073_marine,83,35,78,5,118,93.97590361445783,6.024096385542169
36074_marine,83,35,78,5,118,93.97590361445783,6.024096385542169
36075_marine,83,35,78,5,118,93.97590361445783,6.024096385542169
36076_marine,83,35,78,5,118,93.97590361445783,6.024096385542169
36077_marine,83,35,78,5,118,93.97590361445783,6.024096385542169
36078_marine,83,35,78,5,118,93.97590361445783,6.024096385542169
36079_marine,81,36,76,4,117,93.82716049382715,4.938271604938271
36080_marine,81,36,76,4,117,93.82716049382715,4.938271604938271
36081_marine,80,36,76,4,116,95,5
36082_marine,80,36,76,4,116,95,5
36083_marine,81,36,77,4,117,95.06172839506173,4.938271604938271
36084_marine,81,35,77,4,116,95.06172839506173,4.938271604938271
36085_marine,82,35,78,5,117,95.1219512195122,6.097560975609756
36086_marine,82,35,78,5,117,95.1219512195122,6.097560975609756
36087_marine,84,37,80,5,121,95.23809523809523,5.952380952380952
36088_marine,84,38,80,5,122,95.23809523809523,5.952380952380952
36089_marine,83,39,79,5,122,95.18072289156626,6.024096385542169
36090_marine,83,39,79,5,122,95.18072289156626,6.024096385542169
36091_marine,83,40,79,5,123,95.18072289156626,6.024096385542169
36092_marine,84,41,79,5,125,94.04761904761905,5.952380952380952
36093_marine,81,41,77,4,122,95.06172839506173,4.938271604938271
36094_marine,83,42,78,5,125,93.97590361445783,6.024096385542169
36095_marine,84,42,79,5,126,94.04761904761905,5.952380952380952
36096_marine,89,43,84,5,132,94.3820224719101,5.617977528089887
36097_marine,89,43,84,5,132,94.3820224719101,5.617977528089887
36098_marine,97,44,92,5,141,94.84536082474226,5.154639175257731
36099_marine,98,46,93,7,144,94.89795918367348,7.142857142857142
36100_marine,114,54,109,8,168,95.6140350877193,7.017543859649122
36101_marine,196,116,167,30,312,85.20408163265306,15.306122448979592
36102_marine,319,247,213,128,566,66.77115987460816,40.12539184952978
36103_marine,309,227,208,124,536,67.31391585760518,40.1294498381877
36145_marine,338,185,274,107,523,81.06508875739645,31.65680473372781
36146_marine,312,135,252,102,447,80.76923076923077,32.69230769230769
36147_marine,112,43,105,11,155,93.75,9.821428571428571
36148_marine,105,37,98,9,142,93.33333333333333,8.571428571428571
36149_marine,97,35,90,9,132,92.78350515463917,9.278350515463918
36150_marine,96,35,89,8,131,92.70833333333334,8.333333333333332
36151_marine,92,35,87,6,127,94.56521739130434,6.521739130434782
36152_marine,92,38,87,6,130,94.56521739130434,6.521739130434782
36153_marine,91,38,86,6,129,94.5054945054945,6.593406593406594
36154_marine,89,38,84,6,127,94.3820224719101,6.741573033707865
36155_marine,89,38,84,6,127,94.3820224719101,6.741573033707865
36156_marine,89,36,84,6,125,94.3820224719101,6.741573033707865
36157_marine,88,36,84,5,124,95.45454545454545,5.681818181818182
36158_marine,87,36,83,4,123,95.40229885057471,4.597701149425287
36159_marine,87,36,81,6,123,93.10344827586206,6.896551724137931
36160_marine,87,36,80,7,123,91.95402298850574,8.045977011494253
36161_marine,88,36,81,7,124,92.04545454545455,7.954545454545454
36162_marine,87,36,80,7,123,91.95402298850574,8.045977011494253
36163_marine,86,36,79,7,122,91.86046511627907,8.13953488372093
36164_marine,88,36,81,7,124,92.04545454545455,7.954545454545454
36165_marine,88,35,81,7,123,92.04545454545455,7.954545454545454
36166_marine,89,35,82,9,124,92.13483146067416,10.112359550561797
36167_marine,90,35,83,9,125,92.22222222222223,10
36168_marine,88,35,81,7,123,92.04545454545455,7.954545454545454
36169_marine,88,37,81,7,125,92.04545454545455,7.954545454545454
36170_marine,84,37,77,7,121,91.66666666666666,8.333333333333332
36171_marine,83,37,77,6,120,92.7710843373494,7.228915662650602
36172_marine,83,37,77,6,120,92.7710843373494,7.228915662650602
36173_marine,83,35,76,6,118,91.56626506024097,7.228915662650602
36174_marine,82,35,75,6,117,91.46341463414635,7.317073170731707
36175_marine,82,33,75,6,115,91.46341463414635,7.317073170731707
36176_marine,81,33,75,5,114,92.5925925925926,6.172839506172839
36177_marine,81,33,75,5,114,92.5925925925926,6.172839506172839
36178_marine,81,35,75,5,116,92.5925925925926,6.172839506172839
36179_marine,81,35,75,5,116,92.5925925925926,6.172839506172839
36180_marine,79,35,73,4,114,92.40506329113924,5.063291139240507
36181_marine,79,35,73,4,114,92.40506329113924,5.063291139240507
36182_marine,79,35,73,4,114,92.40506329113924,5.063291139240507
36183_marine,78,35,72,4,113,92.3076923076923,5.128205128205128
36184_marine,76,37,71,3,113,93.42105263157895,3.9473684210526314
36185_marine,76,37,71,3,113,93.42105263157895,3.9473684210526314
36186_marine,80,37,74,2,117,92.5,2.5
36187_marine,81,37,75,2,118,92.5925925925926,2.4691358024691357
36188_marine,84,36,78,2,120,92.85714285714286,2.380952380952381
36189_marine,88,35,83,2,123,94.31818181818183,2.272727272727273
36190_marine,95,38,90,5,133,94.73684210526315,5.263157894736842
36191_marine,96,37,91,4,133,94.79166666666666,4.166666666666666
36192_marine,97,38,93,4,135,95.87628865979381,4.123711340206185
36193_marine,233,109,219,25,342,93.99141630901288,10.72961373390558
36222_marine,662,230,457,350,892,69.03323262839879,52.87009063444109
36223_marine,555,182,375,308,737,67.56756756756756,55.4954954954955
36224_marine,557,180,377,309,737,67.68402154398564,55.475763016157984
36225_marine,551,178,371,308,729,67.33212341197822,55.898366606170605
36226_marine,523,147,349,301,670,66.73040152963671,57.55258126195029
36227_marine,556,157,364,317,713,65.46762589928058,57.014388489208635
36228_marine,580,181,386,327,761,66.55172413793103,56.37931034482758
36229_marine,534,150,352,305,684,65.91760299625467,57.11610486891385
36230_marine,113,42,106,17,155,93.80530973451327,15.04424778761062
36231_marine,497,155,329,292,652,66.19718309859155,58.752515090543255
36232_marine,524,161,350,303,685,66.79389312977099,57.82442748091603
36233_marine,480,135,313,287,615,65.20833333333333,59.791666666666664
36234_marine,91,33,85,10,124,93.4065934065934,10.989010989010989
36235_marine,97,33,91,10,130,93.81443298969072,10.309278350515463
36236_marine,438,109,294,262,547,67.12328767123287,59.817351598173516
36237_marine,452,122,305,273,574,67.47787610619469,60.39823008849557
36238_marine,436,112,292,263,548,66.97247706422019,60.321100917431195
36239_marine,97,33,91,9,130,93.81443298969072,9.278350515463918
36240_marine,106,39,96,17,145,90.56603773584906,16.037735849056602
36241_marine,104,43,95,16,147,91.34615384615384,15.384615384615385
36242_marine,103,43,94,16,146,91.2621359223301,15.53398058252427
36243_marine,101,38,92,16,139,91.0891089108911,15.841584158415841
36244_marine,85,32,80,7,117,94.11764705882352,8.235294117647058
36245_marine,83,32,78,7,115,93.97590361445783,8.433734939759036
36246_marine,84,32,79,7,116,94.04761904761905,8.333333333333332
36247_marine,84,31,79,7,115,94.04761904761905,8.333333333333332
36248_marine,84,31,79,7,115,94.04761904761905,8.333333333333332
36249_marine,84,31,79,7,115,94.04761904761905,8.333333333333332
36250_marine,86,31,81,9,117,94.18604651162791,10.465116279069768
36251_marine,86,30,81,9,116,94.18604651162791,10.465116279069768
36252_marine,87,30,82,10,117,94.25287356321839,11.494252873563218
36253_marine,87,31,82,10,118,94.25287356321839,11.494252873563218
36254_marine,85,31,80,10,116,94.11764705882352,11.76470588235294
36255_marine,83,30,78,10,113,93.97590361445783,12.048192771084338
36256_marine,80,30,75,7,110,93.75,8.75
36257_marine,80,30,75,7,110,93.75,8.75
36258_marine,80,30,75,7,110,93.75,8.75
36259_marine,79,30,74,7,109,93.67088607594937,8.860759493670885
36260_marine,79,30,74,7,109,93.67088607594937,8.860759493670885
36261_marine,79,30,74,7,109,93.67088607594937,8.860759493670885
36262_marine,77,30,72,7,107,93.5064935064935,9.090909090909092
36263_marine,77,31,72,7,108,93.5064935064935,9.090909090909092
36264_marine,79,32,74,7,111,93.67088607594937,8.860759493670885
36265_marine,79,32,74,7,111,93.67088607594937,8.860759493670885
36266_marine,78,32,73,7,110,93.58974358974359,8.974358974358974
36267_marine,80,32,75,7,112,93.75,8.75
36268_marine,80,32,75,7,112,93.75,8.75
36269_marine,80,31,75,7,111,93.75,8.75
36270_marine,80,31,75,7,111,93.75,8.75
36271_marine,80,31,75,7,111,93.75,8.75
36272_marine,80,31,75,7,111,93.75,8.75
36273_marine,82,31,77,7,113,93.90243902439023,8.536585365853659
36274_marine,85,31,80,8,116,94.11764705882352,9.411764705882353
36275_marine,85,31,80,8,116,94.11764705882352,9.411764705882353
36276_marine,88,33,83,9,121,94.31818181818183,10.227272727272728
36277_marine,481,105,328,286,586,68.1912681912682,59.45945945945946
36278_marine,481,105,328,286,586,68.1912681912682,59.45945945945946
36279_marine,87,33,82,10,120,94.25287356321839,11.494252873563218
36280_marine,84,31,79,9,115,94.04761904761905,10.714285714285714
36281_marine,86,32,81,8,118,94.18604651162791,9.30232558139535
36282_marine,87,32,81,9,119,93.10344827586206,10.344827586206897
36283_marine,91,31,84,12,122,92.3076923076923,13.186813186813188
36284_marine,97,33,89,15,130,91.75257731958763,15.463917525773196
36285_marine,545,128,353,339,673,64.77064220183486,62.20183486238532
36286_marine,591,149,385,374,740,65.14382402707277,63.28257191201354
36287_marine,545,130,353,339,675,64.77064220183486,62.20183486238532
36288_marine,109,33,101,15,142,92.66055045871559,13.761467889908257
36289_marine,107,31,99,16,138,92.5233644859813,14.953271028037381
36290_marine,111,33,103,16,144,92.7927927927928,14.414414414414415
36291_marine,111,33,103,16,144,92.7927927927928,14.414414414414415
36292_marine,112,33,105,16,145,93.75,14.285714285714285
36293_marine,119,32,112,18,151,94.11764705882352,15.126050420168067
36294_marine,124,32,117,20,156,94.35483870967742,16.129032258064516
36295_marine,117,32,110,19,149,94.01709401709401,16.23931623931624
36296_marine,119,32,112,18,151,94.11764705882352,15.126050420168067
36297_marine,896,288,539,552,1184,60.15625,61.60714285714286
36298_marine,895,290,538,553,1185,60.11173184357542,61.7877094972067
36299_marine,913,307,551,554,1220,60.35049288061336,60.67907995618839
36302_marine,1063,424,652,649,1487,61.33584195672624,61.05362182502352
36303_marine,1104,457,674,675,1561,61.050724637681164,61.141304347826086
36306_marine,974,391,592,573,1365,60.78028747433265,58.82956878850103
36307_marine,967,383,594,569,1350,61.427094105480876,58.84177869700103
36308_marine,423,178,313,166,601,73.99527186761229,39.2434988179669
36309_marine,423,194,313,164,617,73.99527186761229,38.77068557919622
36310_marine,454,269,326,178,723,71.80616740088107,39.20704845814978
36311_marine,457,289,329,182,746,71.99124726477024,39.82494529540481
36312_marine,439,289,325,163,728,74.03189066059225,37.12984054669704
36313_marine,537,352,358,243,889,66.66666666666666,45.2513966480447
36314_marine,524,339,353,235,863,67.36641221374046,44.847328244274806
36315_marine,401,230,298,143,631,74.3142144638404,35.66084788029925
36316_marine,402,228,301,141,630,74.87562189054727,35.07462686567165
36317_marine,440,298,329,155,738,74.77272727272727,35.22727272727273
36318_marine,411,267,303,154,678,73.72262773722628,37.469586374695865
36319_marine,372,180,279,131,552,75,35.215053763440864
36320_marine,377,175,281,130,552,74.53580901856765,34.48275862068966
36321_marine,389,196,292,133,585,75.06426735218508,34.19023136246786
36322_marine,489,330,349,190,819,71.37014314928425,38.85480572597137
36324_marine,999,499,627,566,1498,62.76276276276276,56.65665665665666
36325_marine,871,395,560,470,1266,64.2939150401837,53.9609644087256
36326_marine,180,85,162,36,265,90,20
36327_marine,848,318,536,485,1166,63.20754716981132,57.193396226415096
36334_marine,954,401,569,582,1355,59.64360587002096,61.0062893081761
36335_marine,890,339,525,549,1229,58.98876404494382,61.68539325842697
36336_marine,878,311,522,539,1189,59.453302961275625,61.38952164009112
36337_marine,121,39,109,20,160,90.08264462809917,16.528925619834713
36338_marine,118,35,106,21,153,89.83050847457628,17.796610169491526
36339_marine,825,298,488,523,1123,59.151515151515156,63.39393939393939
36340_marine,832,304,492,525,1136,59.13461538461539,63.10096153846154
36341_marine,833,303,494,526,1136,59.30372148859544,63.1452581032413
36344_marine,832,296,494,524,1128,59.375,62.980769230769226
36345_marine,696,243,424,436,939,60.91954022988506,62.643678160919535
36346_marine,774,305,482,469,1079,62.273901808785524,60.594315245478036
36347_marine,758,307,467,468,1065,61.60949868073878,61.74142480211082
36348_marine,700,252,424,441,952,60.57142857142858,63
36349_marine,607,210,396,366,817,65.23887973640856,60.29654036243822
36350_marine,107,38,97,11,145,90.65420560747664,10.2803738317757
36351_marine,104,37,96,11,141,92.3076923076923,10.576923076923077
36352_marine,102,37,94,11,139,92.15686274509804,10.784313725490197
36353_marine,102,39,94,11,141,92.15686274509804,10.784313725490197
36354_marine,103,39,95,12,142,92.23300970873787,11.650485436893204
36355_marine,103,39,95,12,142,92.23300970873787,11.650485436893204
36356_marine,104,39,96,12,143,92.3076923076923,11.538461538461538
36357_marine,103,39,95,12,142,92.23300970873787,11.650485436893204
36358_marine,103,39,95,12,142,92.23300970873787,11.650485436893204
36359_marine,103,40,95,12,143,92.23300970873787,11.650485436893204
36360_marine,541,158,373,323,699,68.94639556377079,59.70425138632163
36361_marine,115,46,103,21,161,89.56521739130436,18.26086956521739
36362_marine,110,46,98,19,156,89.0909090909091,17.272727272727273
36363_marine,98,40,91,10,138,92.85714285714286,10.204081632653061
36364_marine,98,40,91,10,138,92.85714285714286,10.204081632653061
36365_marine,97,40,91,9,137,93.81443298969072,9.278350515463918
36366_marine,101,40,95,10,141,94.05940594059405,9.900990099009901
36367_marine,105,39,99,10,144,94.28571428571428,9.523809523809524
36368_marine,103,39,97,10,142,94.1747572815534,9.70873786407767
36369_marine,487,138,331,301,625,67.96714579055441,61.80698151950719
36370_marine,478,122,324,294,600,67.78242677824268,61.50627615062761
36371_marine,103,39,97,10,142,94.1747572815534,9.70873786407767
36372_marine,104,39,98,10,143,94.23076923076923,9.615384615384617
36373_marine,104,40,98,10,144,94.23076923076923,9.615384615384617
36374_marine,420,113,286,256,533,68.0952380952381,60.952380952380956
36375_marine,424,114,288,259,538,67.9245283018868,61.08490566037735
36376_marine,417,108,283,256,525,67.86570743405275,61.39088729016786
36377_marine,98,40,92,10,138,93.87755102040816,10.204081632653061
36378_marine,99,40,93,10,139,93.93939393939394,10.1010101010101
36379_marine,394,96,268,238,490,68.02030456852792,60.40609137055838
36380_marine,396,95,270,240,491,68.18181818181817,60.60606060606061
36381_marine,100,39,94,12,139,94,12
36382_marine,99,39,93,12,138,93.93939393939394,12.121212121212121
36383_marine,99,37,93,12,136,93.93939393939394,12.121212121212121
36384_marine,98,37,92,12,135,93.87755102040816,12.244897959183673
36385_marine,97,38,91,12,135,93.81443298969072,12.371134020618557
36386_marine,99,38,93,12,137,93.93939393939394,12.121212121212121
36387_marine,97,38,91,10,135,93.81443298969072,10.309278350515463
36388_marine,372,101,256,222,473,68.81720430107528,59.67741935483871
36389_marine,374,102,257,222,476,68.71657754010695,59.35828877005348
36390_marine,374,98,258,222,472,68.98395721925134,59.35828877005348
36391_marine,99,37,93,10,136,93.93939393939394,10.1010101010101
36392_marine,99,37,93,10,136,93.93939393939394,10.1010101010101
36393_marine,99,38,93,10,137,93.93939393939394,10.1010101010101
36394_marine,99,38,93,10,137,93.93939393939394,10.1010101010101
36395_marine,101,38,95,10,139,94.05940594059405,9.900990099009901
36396_marine,101,38,95,10,139,94.05940594059405,9.900990099009901
36397_marine,105,38,99,10,143,94.28571428571428,9.523809523809524
36398_marine,105,38,99,10,143,94.28571428571428,9.523809523809524
36399_marine,108,39,102,12,147,94.44444444444444,11.11111111111111
36400_marine,108,43,102,12,151,94.44444444444444,11.11111111111111
36401_marine,318,112,221,172,430,69.49685534591194,54.088050314465406
36402_marine,315,114,218,171,429,69.2063492063492,54.285714285714285
36403_marine,316,112,219,172,428,69.30379746835443,54.43037974683544
36404_marine,98,41,92,12,139,93.87755102040816,12.244897959183673
36405_marine,95,41,89,9,136,93.6842105263158,9.473684210526317
36406_marine,95,40,89,9,135,93.6842105263158,9.473684210526317
36407_marine,96,39,90,9,135,93.75,9.375
36408_marine,95,39,89,9,134,93.6842105263158,9.473684210526317
36409_marine,95,39,89,9,134,93.6842105263158,9.473684210526317
36410_marine,96,39,90,11,135,93.75,11.458333333333332
36411_marine,96,37,90,11,133,93.75,11.458333333333332
36412_marine,92,36,86,9,128,93.47826086956522,9.782608695652174
36413_marine,91,36,85,9,127,93.4065934065934,9.89010989010989
36414_marine,91,36,85,9,127,93.4065934065934,9.89010989010989
36415_marine,90,35,84,8,125,93.33333333333333,8.88888888888889
36416_marine,90,36,84,8,126,93.33333333333333,8.88888888888889
36417_marine,90,36,84,8,126,93.33333333333333,8.88888888888889
36418_marine,90,36,84,8,126,93.33333333333333,8.88888888888889
36419_marine,88,35,83,7,123,94.31818181818183,7.954545454545454
36420_marine,88,35,83,7,123,94.31818181818183,7.954545454545454
36421_marine,88,35,83,7,123,94.31818181818183,7.954545454545454
36422_marine,86,35,81,7,121,94.18604651162791,8.13953488372093
36423_marine,85,35,80,6,120,94.11764705882352,7.0588235294117645
36424_marine,85,35,80,6,120,94.11764705882352,7.0588235294117645
36425_marine,86,35,81,6,121,94.18604651162791,6.976744186046512
36426_marine,85,35,80,6,120,94.11764705882352,7.0588235294117645
36427_marine,84,34,79,5,118,94.04761904761905,5.952380952380952
36428_marine,84,36,79,5,120,94.04761904761905,5.952380952380952
36429_marine,84,36,79,5,120,94.04761904761905,5.952380952380952
36430_marine,83,36,78,5,119,93.97590361445783,6.024096385542169
36431_marine,83,36,78,5,119,93.97590361445783,6.024096385542169
36432_marine,83,35,78,5,118,93.97590361445783,6.024096385542169
36433_marine,84,35,79,5,119,94.04761904761905,5.952380952380952
36434_marine,84,35,79,5,119,94.04761904761905,5.952380952380952
36435_marine,84,35,79,5,119,94.04761904761905,5.952380952380952
36436_marine,84,35,79,5,119,94.04761904761905,5.952380952380952
36437_marine,83,35,78,4,118,93.97590361445783,4.819277108433735
36438_marine,83,35,78,4,118,93.97590361445783,4.819277108433735
36439_marine,82,36,78,4,118,95.1219512195122,4.878048780487805
36440_marine,80,36,76,4,116,95,5
36441_marine,80,36,76,4,116,95,5
36442_marine,81,36,77,4,117,95.06172839506173,4.938271604938271
36443_marine,81,36,77,4,117,95.06172839506173,4.938271604938271
36444_marine,81,36,77,4,117,95.06172839506173,4.938271604938271
36445_marine,82,37,78,5,119,95.1219512195122,6.097560975609756
36446_marine,82,36,78,5,118,95.1219512195122,6.097560975609756
36447_marine,82,36,78,5,118,95.1219512195122,6.097560975609756
36448_marine,84,37,80,5,121,95.23809523809523,5.952380952380952
36449_marine,84,37,80,5,121,95.23809523809523,5.952380952380952
36450_marine,85,37,81,5,122,95.29411764705881,5.88235294117647
36451_marine,85,38,81,5,123,95.29411764705881,5.88235294117647
36452_marine,82,41,78,4,123,95.1219512195122,4.878048780487805
36453_marine,82,41,78,4,123,95.1219512195122,4.878048780487805
36454_marine,80,41,76,4,121,95,5
36455_marine,82,43,77,5,125,93.90243902439023,6.097560975609756
36456_marine,83,43,78,5,126,93.97590361445783,6.024096385542169
36457_marine,87,42,82,5,129,94.25287356321839,5.747126436781609
36458_marine,87,42,82,5,129,94.25287356321839,5.747126436781609
36459_marine,96,43,91,4,139,94.79166666666666,4.166666666666666
36460_marine,107,46,102,8,153,95.32710280373831,7.476635514018691
36461_marine,116,52,110,10,168,94.82758620689656,8.620689655172415
36462_marine,203,121,169,36,324,83.2512315270936,17.733990147783253
36463_marine,320,264,216,132,584,67.5,41.25
36504_marine,326,174,266,103,500,81.59509202453987,31.595092024539877
36505_marine,310,139,251,101,449,80.96774193548387,32.58064516129032
36506_marine,112,41,107,10,153,95.53571428571429,8.928571428571429
36507_marine,110,37,104,10,147,94.54545454545455,9.090909090909092
36508_marine,98,37,92,8,135,93.87755102040816,8.16326530612245
36509_marine,96,35,90,8,131,93.75,8.333333333333332
36510_marine,93,35,89,5,128,95.6989247311828,5.376344086021505
36511_marine,90,35,86,4,125,95.55555555555556,4.444444444444445
36512_marine,90,38,86,4,128,95.55555555555556,4.444444444444445
36513_marine,89,38,85,4,127,95.50561797752809,4.49438202247191
36514_marine,87,38,83,4,125,95.40229885057471,4.597701149425287
36515_marine,87,36,83,4,123,95.40229885057471,4.597701149425287
36516_marine,87,36,83,4,123,95.40229885057471,4.597701149425287
36517_marine,87,36,83,4,123,95.40229885057471,4.597701149425287
36518_marine,86,36,81,5,122,94.18604651162791,5.813953488372093
36519_marine,87,36,81,6,123,93.10344827586206,6.896551724137931
36520_marine,86,36,80,6,122,93.02325581395348,6.976744186046512
36521_marine,85,36,79,6,121,92.94117647058823,7.0588235294117645
36522_marine,86,36,80,6,122,93.02325581395348,6.976744186046512
36523_marine,83,36,77,6,119,92.7710843373494,7.228915662650602
36524_marine,88,36,81,7,124,92.04545454545455,7.954545454545454
36525_marine,88,35,81,7,123,92.04545454545455,7.954545454545454
36526_marine,89,35,82,7,124,92.13483146067416,7.865168539325842
36527_marine,88,35,81,7,123,92.04545454545455,7.954545454545454
36528_marine,88,35,81,7,123,92.04545454545455,7.954545454545454
36529_marine,88,35,81,7,123,92.04545454545455,7.954545454545454
36530_marine,84,35,77,7,119,91.66666666666666,8.333333333333332
36531_marine,83,35,77,6,118,92.7710843373494,7.228915662650602
36532_marine,83,35,77,6,118,92.7710843373494,7.228915662650602
36533_marine,82,35,75,6,117,91.46341463414635,7.317073170731707
36534_marine,81,35,75,5,116,92.5925925925926,6.172839506172839
36535_marine,83,37,77,5,120,92.7710843373494,6.024096385542169
36536_marine,83,35,77,5,118,92.7710843373494,6.024096385542169
36537_marine,81,33,75,5,114,92.5925925925926,6.172839506172839
36538_marine,81,33,75,5,114,92.5925925925926,6.172839506172839
36539_marine,83,37,77,5,120,92.7710843373494,6.024096385542169
36540_marine,81,37,75,4,118,92.5925925925926,4.938271604938271
36541_marine,79,35,73,4,114,92.40506329113924,5.063291139240507
36542_marine,79,35,73,4,114,92.40506329113924,5.063291139240507
36543_marine,77,35,72,3,112,93.5064935064935,3.896103896103896
36544_marine,76,37,71,3,113,93.42105263157895,3.9473684210526314
36545_marine,75,37,70,2,112,93.33333333333333,2.666666666666667
36546_marine,78,37,72,2,115,92.3076923076923,2.564102564102564
36547_marine,81,37,75,2,118,92.5925925925926,2.4691358024691357
36548_marine,85,34,79,2,119,92.94117647058823,2.3529411764705883
36549_marine,88,35,83,2,123,94.31818181818183,2.272727272727273
36550_marine,94,38,89,4,132,94.68085106382979,4.25531914893617
36551_marine,94,38,89,4,132,94.68085106382979,4.25531914893617
36552_marine,101,41,97,6,142,96.03960396039604,5.9405940594059405
36553_marine,215,103,202,22,318,93.95348837209302,10.232558139534884
36582_marine,662,235,459,349,897,69.33534743202418,52.7190332326284
36583_marine,557,186,376,309,743,67.50448833034112,55.475763016157984
36584_marine,634,235,430,358,869,67.82334384858044,56.46687697160884
36585_marine,555,183,374,311,738,67.38738738738739,56.03603603603604
36586_marine,554,182,371,313,736,66.96750902527076,56.49819494584838
36587_marine,535,143,355,306,678,66.35514018691589,57.19626168224299
36588_marine,672,228,456,353,900,67.85714285714286,52.529761904761905
36589_marine,666,213,452,352,879,67.86786786786787,52.85285285285285
36591_marine,627,202,418,342,829,66.66666666666666,54.54545454545454
36592_marine,484,133,317,287,617,65.49586776859503,59.29752066115702
36593_marine,95,34,89,10,129,93.6842105263158,10.526315789473683
36594_marine,92,32,86,10,124,93.47826086956522,10.869565217391305
36595_marine,93,32,87,9,125,93.54838709677419,9.67741935483871
36596_marine,438,110,294,262,548,67.12328767123287,59.817351598173516
36597_marine,438,112,294,265,550,67.12328767123287,60.50228310502283
36598_marine,438,112,294,265,550,67.12328767123287,60.50228310502283
36599_marine,90,33,84,9,123,93.33333333333333,10
36600_marine,94,33,88,9,127,93.61702127659575,9.574468085106384
36601_marine,103,41,94,16,144,91.2621359223301,15.53398058252427
36602_marine,104,43,95,16,147,91.34615384615384,15.384615384615385
36603_marine,102,38,93,16,140,91.17647058823529,15.686274509803921
36604_marine,86,32,81,7,118,94.18604651162791,8.13953488372093
36605_marine,84,32,79,7,116,94.04761904761905,8.333333333333332
36606_marine,84,32,79,7,116,94.04761904761905,8.333333333333332
36607_marine,84,31,79,7,115,94.04761904761905,8.333333333333332
36608_marine,84,31,79,7,115,94.04761904761905,8.333333333333332
36609_marine,84,31,79,7,115,94.04761904761905,8.333333333333332
36610_marine,84,31,79,7,115,94.04761904761905,8.333333333333332
36611_marine,86,29,81,9,115,94.18604651162791,10.465116279069768
36612_marine,86,29,81,9,115,94.18604651162791,10.465116279069768
36613_marine,84,29,79,9,113,94.04761904761905,10.714285714285714
36614_marine,80,29,75,7,109,93.75,8.75
36615_marine,79,30,74,7,109,93.67088607594937,8.860759493670885
36616_marine,79,30,74,7,109,93.67088607594937,8.860759493670885
36617_marine,78,30,73,7,108,93.58974358974359,8.974358974358974
36618_marine,78,30,73,7,108,93.58974358974359,8.974358974358974
36619_marine,76,30,71,7,106,93.42105263157895,9.210526315789473
36620_marine,76,30,71,7,106,93.42105263157895,9.210526315789473
36621_marine,76,30,71,7,106,93.42105263157895,9.210526315789473
36622_marine,76,30,71,7,106,93.42105263157895,9.210526315789473
36623_marine,76,30,71,7,106,93.42105263157895,9.210526315789473
36624_marine,78,31,73,7,109,93.58974358974359,8.974358974358974
36625_marine,78,31,73,7,109,93.58974358974359,8.974358974358974
36626_marine,78,31,73,7,109,93.58974358974359,8.974358974358974
36627_marine,78,32,73,7,110,93.58974358974359,8.974358974358974
36628_marine,78,32,73,7,110,93.58974358974359,8.974358974358974
36629_marine,78,31,73,7,109,93.58974358974359,8.974358974358974
36630_marine,78,31,73,7,109,93.58974358974359,8.974358974358974
36631_marine,78,31,73,7,109,93.58974358974359,8.974358974358974
36632_marine,78,31,73,7,109,93.58974358974359,8.974358974358974
36633_marine,80,31,75,7,111,93.75,8.75
36634_marine,81,31,76,8,112,93.82716049382715,9.876543209876543
36635_marine,84,33,79,7,117,94.04761904761905,8.333333333333332
36636_marine,479,106,326,286,585,68.05845511482255,59.707724425887264
36637_marine,498,118,341,299,616,68.47389558232932,60.040160642570285
36638_marine,481,109,328,286,590,68.1912681912682,59.45945945945946
36639_marine,86,33,81,11,119,94.18604651162791,12.790697674418606
36640_marine,85,31,80,10,116,94.11764705882352,11.76470588235294
36641_marine,83,31,78,8,114,93.97590361445783,9.63855421686747
36642_marine,87,31,81,10,118,93.10344827586206,11.494252873563218
36643_marine,90,32,83,10,122,92.22222222222223,11.11111111111111
36644_marine,91,31,84,9,122,92.3076923076923,9.89010989010989
36645_marine,536,128,344,337,664,64.17910447761194,62.873134328358205
36646_marine,541,130,349,337,671,64.51016635859519,62.292051756007396
36647_marine,541,128,349,337,669,64.51016635859519,62.292051756007396
36648_marine,98,33,90,12,131,91.83673469387756,12.244897959183673
36649_marine,97,30,89,11,127,91.75257731958763,11.34020618556701
36650_marine,97,30,89,11,127,91.75257731958763,11.34020618556701
36651_marine,100,31,92,11,131,92,11
36652_marine,100,31,92,11,131,92,11
36653_marine,99,31,92,11,130,92.92929292929293,11.11111111111111
36654_marine,101,30,94,11,131,93.06930693069307,10.891089108910892
36655_marine,101,30,94,11,131,93.06930693069307,10.891089108910892
36656_marine,98,30,92,10,128,93.87755102040816,10.204081632653061
36657_marine,100,30,94,12,130,94,12
36658_marine,103,30,96,12,133,93.20388349514563,11.650485436893204
36659_marine,103,30,96,12,133,93.20388349514563,11.650485436893204
36660_marine,860,281,514,536,1141,59.76744186046512,62.32558139534884
36661_marine,867,285,517,541,1152,59.63091118800461,62.399077277970015
36662_marine,887,311,532,543,1198,59.97745208568207,61.21758737316798
36663_marine,1011,404,621,604,1415,61.42433234421365,59.74282888229476
36664_marine,959,368,599,554,1327,62.46089676746611,57.76850886339937
36665_marine,973,378,605,566,1351,62.17882836587872,58.17060637204522
36666_marine,470,183,349,196,653,74.25531914893617,41.702127659574465
36667_marine,453,194,335,177,647,73.9514348785872,39.0728476821192
36668_marine,438,191,323,166,629,73.74429223744292,37.89954337899543
36669_marine,433,205,315,167,638,72.74826789838336,38.56812933025404
36670_marine,452,276,324,178,728,71.68141592920354,39.38053097345133
36671_marine,642,457,394,323,1099,61.37071651090342,50.31152647975078
36678_marine,391,265,289,140,656,73.91304347826086,35.80562659846547
36679_marine,348,177,263,115,525,75.57471264367817,33.04597701149425
36680_marine,348,170,265,115,518,76.14942528735632,33.04597701149425
36681_marine,372,223,277,130,595,74.46236559139786,34.946236559139784
36685_marine,913,410,575,531,1323,62.97918948521358,58.15991237677984
36686_marine,133,44,121,17,177,90.97744360902256,12.781954887218044
36687_marine,132,33,120,16,165,90.9090909090909,12.121212121212121
36688_marine,847,285,536,487,1132,63.282172373081465,57.497048406139314
36689_marine,879,303,554,505,1182,63.026166097838455,57.45164960182025
36690_marine,916,341,571,528,1257,62.33624454148472,57.64192139737992
36691_marine,966,385,591,565,1351,61.18012422360248,58.488612836438925
36692_marine,971,405,589,571,1376,60.65911431513903,58.8053553038105
36693_marine,974,391,587,587,1365,60.26694045174538,60.26694045174538
36696_marine,868,309,512,539,1177,58.986175115207374,62.096774193548384
36697_marine,119,39,107,16,158,89.91596638655463,13.445378151260504
36698_marine,113,37,101,14,150,89.38053097345133,12.389380530973451
36699_marine,808,277,476,517,1085,58.91089108910891,63.98514851485149
36700_marine,912,356,541,574,1268,59.32017543859649,62.93859649122807
36701_marine,922,362,549,576,1284,59.54446854663774,62.47288503253796
36702_marine,836,300,496,525,1136,59.33014354066985,62.79904306220095
36703_marine,838,298,498,526,1136,59.427207637231504,62.76849642004774
36704_marine,832,298,494,524,1130,59.375,62.980769230769226
36705_marine,698,244,426,436,942,61.03151862464183,62.46418338108882
36706_marine,705,254,429,440,959,60.851063829787236,62.4113475177305
36707_marine,763,301,471,468,1064,61.730013106159895,61.33682830930537
36708_marine,731,275,445,451,1006,60.87551299589603,61.696306429548564
36709_marine,631,204,404,383,835,64.02535657686212,60.697305863708394
36710_marine,637,213,407,386,850,63.89324960753532,60.596546310832025
36711_marine,115,51,102,15,166,88.69565217391305,13.043478260869565
36712_marine,106,37,96,11,143,90.56603773584906,10.377358490566039
36713_marine,116,46,102,22,162,87.93103448275862,18.96551724137931
36714_marine,115,45,101,20,160,87.82608695652175,17.391304347826086
36715_marine,116,45,104,22,161,89.65517241379311,18.96551724137931
36716_marine,118,46,106,23,164,89.83050847457628,19.491525423728813
36717_marine,553,182,367,336,735,66.36528028933093,60.75949367088608
36718_marine,553,182,367,336,735,66.36528028933093,60.75949367088608
36719_marine,103,39,95,12,142,92.23300970873787,11.650485436893204
36720_marine,99,39,91,12,138,91.91919191919192,12.121212121212121
36721_marine,118,46,104,22,164,88.13559322033898,18.64406779661017
36722_marine,102,39,92,10,141,90.19607843137256,9.803921568627452
36723_marine,568,174,355,360,742,62.5,63.38028169014085
36724_marine,568,180,355,359,748,62.5,63.20422535211267
36725_marine,566,180,353,359,746,62.36749116607774,63.427561837455826
36726_marine,103,40,94,11,143,91.2621359223301,10.679611650485436
36727_marine,595,205,377,364,800,63.36134453781512,61.1764705882353
36728_marine,595,207,377,364,802,63.36134453781512,61.1764705882353
36729_marine,594,205,377,363,799,63.468013468013474,61.111111111111114
36730_marine,104,40,98,10,144,94.23076923076923,9.615384615384617
36731_marine,103,39,97,10,142,94.1747572815534,9.70873786407767
36732_marine,103,39,97,10,142,94.1747572815534,9.70873786407767
36733_marine,103,40,97,10,143,94.1747572815534,9.70873786407767
36734_marine,419,104,285,256,523,68.01909307875896,61.09785202863962
36735_marine,419,106,285,256,525,68.01909307875896,61.09785202863962
36736_marine,417,104,283,256,521,67.86570743405275,61.39088729016786
36737_marine,415,114,277,256,529,66.74698795180723,61.686746987951814
36738_marine,415,114,277,256,529,66.74698795180723,61.686746987951814
36739_marine,99,40,93,10,139,93.93939393939394,10.1010101010101
36740_marine,101,37,95,12,138,94.05940594059405,11.881188118811881
36741_marine,99,37,93,12,136,93.93939393939394,12.121212121212121
36742_marine,99,37,93,12,136,93.93939393939394,12.121212121212121
36743_marine,98,37,92,12,135,93.87755102040816,12.244897959183673
36744_marine,98,38,92,12,136,93.87755102040816,12.244897959183673
36745_marine,97,38,91,12,135,93.81443298969072,12.371134020618557
36746_marine,99,38,93,12,137,93.93939393939394,12.121212121212121
36747_marine,99,37,93,12,136,93.93939393939394,12.121212121212121
36748_marine,374,96,258,224,470,68.98395721925134,59.893048128342244
36749_marine,376,98,260,224,474,69.14893617021278,59.57446808510638
36750_marine,101,37,95,12,138,94.05940594059405,11.881188118811881
36751_marine,101,39,95,12,140,94.05940594059405,11.881188118811881
36752_marine,99,39,93,10,138,93.93939393939394,10.1010101010101
36753_marine,101,39,95,10,140,94.05940594059405,9.900990099009901
36754_marine,101,40,95,10,141,94.05940594059405,9.900990099009901
36755_marine,101,40,95,10,141,94.05940594059405,9.900990099009901
36756_marine,101,40,95,10,141,94.05940594059405,9.900990099009901
36757_marine,101,40,95,10,141,94.05940594059405,9.900990099009901
36758_marine,101,40,95,10,141,94.05940594059405,9.900990099009901
36759_marine,105,40,99,10,145,94.28571428571428,9.523809523809524
36760_marine,107,40,101,12,147,94.39252336448598,11.214953271028037
36761_marine,107,41,101,12,148,94.39252336448598,11.214953271028037
36762_marine,101,42,95,12,143,94.05940594059405,11.881188118811881
36763_marine,99,42,93,11,141,93.93939393939394,11.11111111111111
36764_marine,98,42,92,10,140,93.87755102040816,10.204081632653061
36765_marine,97,40,91,11,137,93.81443298969072,11.34020618556701
36766_marine,97,40,91,11,137,93.81443298969072,11.34020618556701
36767_marine,98,39,92,11,137,93.87755102040816,11.224489795918368
36768_marine,97,39,91,11,136,93.81443298969072,11.34020618556701
36769_marine,97,39,91,11,136,93.81443298969072,11.34020618556701
36770_marine,97,39,91,11,136,93.81443298969072,11.34020618556701
36771_marine,96,37,90,11,133,93.75,11.458333333333332
36772_marine,96,36,90,11,132,93.75,11.458333333333332
36773_marine,93,36,87,11,129,93.54838709677419,11.827956989247312
36774_marine,91,36,85,9,127,93.4065934065934,9.89010989010989
36775_marine,91,36,85,9,127,93.4065934065934,9.89010989010989
36776_marine,91,36,85,9,127,93.4065934065934,9.89010989010989
36777_marine,91,36,85,9,127,93.4065934065934,9.89010989010989
36778_marine,89,35,83,8,124,93.25842696629213,8.98876404494382
36779_marine,89,35,83,8,124,93.25842696629213,8.98876404494382
36780_marine,89,35,83,8,124,93.25842696629213,8.98876404494382
36781_marine,86,36,81,7,122,94.18604651162791,8.13953488372093
36782_marine,86,36,81,7,122,94.18604651162791,8.13953488372093
36783_marine,86,36,81,7,122,94.18604651162791,8.13953488372093
36784_marine,86,36,81,7,122,94.18604651162791,8.13953488372093
36785_marine,85,36,80,6,121,94.11764705882352,7.0588235294117645
36786_marine,85,35,80,6,120,94.11764705882352,7.0588235294117645
36787_marine,85,35,80,6,120,94.11764705882352,7.0588235294117645
36788_marine,84,35,79,6,119,94.04761904761905,7.142857142857142
36789_marine,83,37,78,5,120,93.97590361445783,6.024096385542169
36790_marine,83,37,78,5,120,93.97590361445783,6.024096385542169
36791_marine,83,36,78,5,119,93.97590361445783,6.024096385542169
36792_marine,82,36,77,5,118,93.90243902439023,6.097560975609756
36793_marine,82,36,77,5,118,93.90243902439023,6.097560975609756
36794_marine,82,36,77,5,118,93.90243902439023,6.097560975609756
36795_marine,82,36,77,4,118,93.90243902439023,4.878048780487805
36796_marine,82,36,77,4,118,93.90243902439023,4.878048780487805
36797_marine,81,36,77,4,117,95.06172839506173,4.938271604938271
36798_marine,81,36,77,4,117,95.06172839506173,4.938271604938271
36799_marine,81,37,77,4,118,95.06172839506173,4.938271604938271
36800_marine,80,37,76,4,117,95,5
36801_marine,80,37,76,4,117,95,5
36802_marine,81,37,77,4,118,95.06172839506173,4.938271604938271
36803_marine,81,37,77,4,118,95.06172839506173,4.938271604938271
36804_marine,81,37,77,4,118,95.06172839506173,4.938271604938271
36805_marine,81,37,77,4,118,95.06172839506173,4.938271604938271
36806_marine,82,37,78,5,119,95.1219512195122,6.097560975609756
36807_marine,82,37,78,5,119,95.1219512195122,6.097560975609756
36808_marine,82,37,78,5,119,95.1219512195122,6.097560975609756
36809_marine,82,37,78,5,119,95.1219512195122,6.097560975609756
36810_marine,84,37,80,5,121,95.23809523809523,5.952380952380952
36811_marine,82,37,79,4,119,96.34146341463415,4.878048780487805
36812_marine,80,40,77,4,120,96.25,5
36813_marine,81,40,77,4,121,95.06172839506173,4.938271604938271
36814_marine,77,39,73,4,116,94.8051948051948,5.194805194805195
36815_marine,79,43,75,4,122,94.9367088607595,5.063291139240507
36816_marine,82,43,77,5,125,93.90243902439023,6.097560975609756
36817_marine,83,42,78,5,125,93.97590361445783,6.024096385542169
36818_marine,89,42,84,5,131,94.3820224719101,5.617977528089887
36819_marine,93,42,88,5,135,94.6236559139785,5.376344086021505
36820_marine,102,46,97,7,148,95.09803921568627,6.862745098039216
36821_marine,104,49,99,8,153,95.1923076923077,7.6923076923076925
36822_marine,188,93,157,31,281,83.51063829787235,16.48936170212766
36823_marine,324,271,214,138,595,66.0493827160494,42.592592592592595
36824_marine,308,250,204,131,558,66.23376623376623,42.532467532467535
36864_marine,310,139,256,96,449,82.58064516129032,30.967741935483872
36865_marine,112,43,107,9,155,95.53571428571429,8.035714285714286
36866_marine,111,39,106,9,150,95.4954954954955,8.108108108108109
36867_marine,109,37,103,9,146,94.4954128440367,8.256880733944955
36868_marine,99,39,93,7,138,93.93939393939394,7.07070707070707
36869_marine,95,37,91,5,132,95.78947368421052,5.263157894736842
36870_marine,92,35,88,4,127,95.65217391304348,4.3478260869565215
36871_marine,92,36,88,4,128,95.65217391304348,4.3478260869565215
36872_marine,91,36,87,4,127,95.6043956043956,4.395604395604396
36873_marine,91,38,87,4,129,95.6043956043956,4.395604395604396
36874_marine,89,36,85,4,125,95.50561797752809,4.49438202247191
36875_marine,89,36,85,4,125,95.50561797752809,4.49438202247191
36876_marine,89,36,85,4,125,95.50561797752809,4.49438202247191
36877_marine,88,36,83,5,124,94.31818181818183,5.681818181818182
36878_marine,88,36,83,5,124,94.31818181818183,5.681818181818182
36879_marine,88,36,83,5,124,94.31818181818183,5.681818181818182
36880_marine,87,36,81,6,123,93.10344827586206,6.896551724137931
36881_marine,82,36,76,5,118,92.6829268292683,6.097560975609756
36882_marine,83,36,77,5,119,92.7710843373494,6.024096385542169
36883_marine,82,36,76,5,118,92.6829268292683,6.097560975609756
36884_marine,82,36,76,5,118,92.6829268292683,6.097560975609756
36885_marine,87,35,81,6,122,93.10344827586206,6.896551724137931
36886_marine,88,35,82,6,123,93.18181818181817,6.8181818181818175
36887_marine,89,35,82,7,124,92.13483146067416,7.865168539325842
36888_marine,88,35,81,7,123,92.04545454545455,7.954545454545454
36889_marine,84,35,77,7,119,91.66666666666666,8.333333333333332
36890_marine,84,35,77,7,119,91.66666666666666,8.333333333333332
36891_marine,83,35,77,6,118,92.7710843373494,7.228915662650602
36892_marine,83,35,77,6,118,92.7710843373494,7.228915662650602
36893_marine,80,35,75,5,115,93.75,6.25
36894_marine,89,37,83,5,126,93.25842696629213,5.617977528089887
36895_marine,89,37,83,5,126,93.25842696629213,5.617977528089887
36896_marine,85,35,79,5,120,92.94117647058823,5.88235294117647
36897_marine,85,33,79,5,118,92.94117647058823,5.88235294117647
36898_marine,87,35,81,5,122,93.10344827586206,5.747126436781609
36899_marine,81,33,75,5,114,92.5925925925926,6.172839506172839
36900_marine,80,35,74,5,115,92.5,6.25
36901_marine,79,35,73,4,114,92.40506329113924,5.063291139240507
36902_marine,78,35,73,3,113,93.58974358974359,3.8461538461538463
36903_marine,77,35,72,3,112,93.5064935064935,3.896103896103896
36904_marine,75,35,70,2,110,93.33333333333333,2.666666666666667
36905_marine,75,37,70,2,112,93.33333333333333,2.666666666666667
36906_marine,79,37,73,2,116,92.40506329113924,2.5316455696202533
36907_marine,81,36,75,2,117,92.5925925925926,2.4691358024691357
36908_marine,83,33,77,2,116,92.7710843373494,2.4096385542168677
36909_marine,87,34,82,1,121,94.25287356321839,1.1494252873563218
36910_marine,92,36,87,2,128,94.56521739130434,2.1739130434782608
36911_marine,96,39,91,4,135,94.79166666666666,4.166666666666666
36912_marine,193,94,181,19,287,93.78238341968913,9.844559585492227
36942_marine,663,240,458,349,903,69.07993966817496,52.6395173453997
36943_marine,553,184,373,308,737,67.45027124773961,55.69620253164557
36944_marine,627,235,428,350,862,68.2615629984051,55.8213716108453
36945_marine,632,235,426,360,867,67.40506329113924,56.9620253164557
36946_marine,632,229,425,359,861,67.24683544303798,56.80379746835443
36947_marine,596,193,397,330,789,66.61073825503355,55.369127516778526
36948_marine,675,239,467,349,914,69.18518518518518,51.70370370370371
36951_marine,642,197,444,338,839,69.1588785046729,52.64797507788161
36952_marine,99,33,93,13,132,93.93939393939394,13.131313131313133
36953_marine,95,32,89,10,127,93.6842105263158,10.526315789473683
36954_marine,90,32,84,9,122,93.33333333333333,10
36955_marine,93,32,87,9,125,93.54838709677419,9.67741935483871
36956_marine,94,33,88,11,127,93.61702127659575,11.702127659574469
36957_marine,94,35,88,11,129,93.61702127659575,11.702127659574469
36958_marine,94,35,88,11,129,93.61702127659575,11.702127659574469
36959_marine,92,33,86,11,125,93.47826086956522,11.956521739130435
36960_marine,92,33,86,9,125,93.47826086956522,9.782608695652174
36961_marine,91,37,86,8,128,94.5054945054945,8.791208791208792
36962_marine,103,41,94,16,144,91.2621359223301,15.53398058252427
36963_marine,89,32,84,8,121,94.3820224719101,8.98876404494382
36964_marine,86,32,81,7,118,94.18604651162791,8.13953488372093
36965_marine,84,32,79,7,116,94.04761904761905,8.333333333333332
36966_marine,84,31,79,7,115,94.04761904761905,8.333333333333332
36967_marine,84,31,79,7,115,94.04761904761905,8.333333333333332
36968_marine,84,30,79,7,114,94.04761904761905,8.333333333333332
36969_marine,84,30,79,7,114,94.04761904761905,8.333333333333332
36970_marine,83,30,78,7,113,93.97590361445783,8.433734939759036
36971_marine,83,29,78,7,112,93.97590361445783,8.433734939759036
36972_marine,81,29,76,7,110,93.82716049382715,8.641975308641975
36973_marine,78,29,73,7,107,93.58974358974359,8.974358974358974
36974_marine,78,29,73,7,107,93.58974358974359,8.974358974358974
36975_marine,78,29,73,7,107,93.58974358974359,8.974358974358974
36976_marine,78,29,73,7,107,93.58974358974359,8.974358974358974
36977_marine,78,30,73,7,108,93.58974358974359,8.974358974358974
36978_marine,76,30,71,7,106,93.42105263157895,9.210526315789473
36979_marine,76,30,71,7,106,93.42105263157895,9.210526315789473
36980_marine,76,30,71,7,106,93.42105263157895,9.210526315789473
36981_marine,76,30,71,7,106,93.42105263157895,9.210526315789473
36982_marine,76,30,71,7,106,93.42105263157895,9.210526315789473
36983_marine,76,30,71,7,106,93.42105263157895,9.210526315789473
36984_marine,76,31,71,7,107,93.42105263157895,9.210526315789473
36985_marine,78,31,73,7,109,93.58974358974359,8.974358974358974
36986_marine,78,31,73,7,109,93.58974358974359,8.974358974358974
36987_marine,78,31,73,7,109,93.58974358974359,8.974358974358974
36988_marine,78,31,73,7,109,93.58974358974359,8.974358974358974
36989_marine,78,31,73,7,109,93.58974358974359,8.974358974358974
36990_marine,78,31,73,7,109,93.58974358974359,8.974358974358974
36991_marine,78,31,73,7,109,93.58974358974359,8.974358974358974
36992_marine,78,31,73,7,109,93.58974358974359,8.974358974358974
36993_marine,78,31,73,7,109,93.58974358974359,8.974358974358974
36994_marine,81,31,76,8,112,93.82716049382715,9.876543209876543
36995_marine,83,33,78,8,116,93.97590361445783,9.63855421686747
36996_marine,479,106,326,286,585,68.05845511482255,59.707724425887264
36997_marine,499,121,342,300,620,68.5370741482966,60.120240480961925
36998_marine,481,109,328,286,590,68.1912681912682,59.45945945945946
36999_marine,87,33,82,12,120,94.25287356321839,13.793103448275861
37000_marine,85,31,80,10,116,94.11764705882352,11.76470588235294
37001_marine,82,31,77,7,113,93.90243902439023,8.536585365853659
37002_marine,85,31,79,8,116,92.94117647058823,9.411764705882353
37003_marine,87,31,80,9,118,91.95402298850574,10.344827586206897
37004_marine,87,31,80,8,118,91.95402298850574,9.195402298850574
37005_marine,87,33,80,8,120,91.95402298850574,9.195402298850574
37006_marine,95,32,87,10,127,91.57894736842105,10.526315789473683
37007_marine,97,32,89,11,129,91.75257731958763,11.34020618556701
37008_marine,97,32,89,11,129,91.75257731958763,11.34020618556701
37009_marine,92,30,84,10,122,91.30434782608695,10.869565217391305
37010_marine,92,30,84,10,122,91.30434782608695,10.869565217391305
37011_marine,92,30,84,10,122,91.30434782608695,10.869565217391305
37012_marine,96,31,88,10,127,91.66666666666666,10.416666666666668
37013_marine,96,31,89,10,127,92.70833333333334,10.416666666666668
37014_marine,96,31,89,10,127,92.70833333333334,10.416666666666668
37015_marine,95,30,89,9,125,93.6842105263158,9.473684210526317
37016_marine,97,30,91,9,127,93.81443298969072,9.278350515463918
37017_marine,97,30,91,9,127,93.81443298969072,9.278350515463918
37018_marine,95,30,89,9,125,93.6842105263158,9.473684210526317
37019_marine,97,32,91,9,129,93.81443298969072,9.278350515463918
37020_marine,98,32,91,9,130,92.85714285714286,9.183673469387756
37021_marine,102,36,95,9,138,93.13725490196079,8.823529411764707
37022_marine,123,51,114,10,174,92.6829268292683,8.130081300813007
37023_marine,719,225,484,399,944,67.31571627260084,55.493741307371344
37024_marine,832,327,559,447,1159,67.1875,53.72596153846154
37025_marine,805,319,549,428,1124,68.19875776397517,53.16770186335403
37026_marine,488,203,361,204,691,73.97540983606558,41.80327868852459
37027_marine,482,198,355,198,680,73.65145228215768,41.078838174273855
37028_marine,451,202,331,178,653,73.39246119733924,39.467849223946786
37029_marine,434,205,317,169,639,73.04147465437788,38.94009216589861
37030_marine,454,281,324,180,735,71.36563876651982,39.647577092511014
37038_marine,381,264,281,134,645,73.75328083989501,35.170603674540686
37039_marine,344,175,261,113,519,75.87209302325581,32.848837209302324
37040_marine,344,165,261,113,509,75.87209302325581,32.848837209302324
37041_marine,359,215,266,124,574,74.09470752089136,34.540389972144844
37045_marine,887,392,557,519,1279,62.79594137542277,58.511837655016905
37046_marine,143,47,130,23,190,90.9090909090909,16.083916083916083
37047_marine,134,42,122,14,176,91.04477611940298,10.44776119402985
37048_marine,131,35,119,13,166,90.83969465648855,9.923664122137405
37049_marine,126,31,116,14,157,92.06349206349206,11.11111111111111
37050_marine,127,31,117,14,158,92.1259842519685,11.023622047244094
37051_marine,127,31,117,16,158,92.1259842519685,12.598425196850393
37052_marine,878,305,517,543,1183,58.88382687927107,61.84510250569476
37053_marine,877,310,515,544,1187,58.72291904218928,62.02964652223489
37054_marine,873,320,515,540,1193,58.99198167239405,61.855670103092784
37055_marine,875,320,517,540,1195,59.08571428571429,61.71428571428571
37056_marine,114,40,103,16,154,90.35087719298247,14.035087719298245
37057_marine,105,37,94,12,142,89.52380952380953,11.428571428571429
37058_marine,111,37,99,14,148,89.1891891891892,12.612612612612612
37059_marine,114,33,102,16,147,89.47368421052632,14.035087719298245
37060_marine,809,283,475,515,1092,58.71446229913473,63.658838071693445
37061_marine,822,286,488,518,1108,59.36739659367397,63.017031630170315
37062_marine,814,283,480,518,1097,58.96805896805897,63.63636363636363
37063_marine,121,34,110,19,155,90.9090909090909,15.702479338842975
37064_marine,118,35,107,14,153,90.67796610169492,11.864406779661017
37065_marine,115,35,105,14,150,91.30434782608695,12.173913043478262
37066_marine,717,271,432,452,988,60.25104602510461,63.04044630404463
37067_marine,728,287,439,456,1015,60.302197802197796,62.637362637362635
37068_marine,726,286,437,456,1012,60.19283746556474,62.8099173553719
37069_marine,740,287,448,468,1027,60.54054054054055,63.24324324324324
37070_marine,626,203,399,384,829,63.73801916932907,61.34185303514377
37071_marine,109,39,99,13,148,90.82568807339449,11.926605504587156
37072_marine,106,40,96,13,146,90.56603773584906,12.264150943396226
37073_marine,118,44,104,23,162,88.13559322033898,19.491525423728813
37074_marine,104,39,94,12,143,90.38461538461539,11.538461538461538
37075_marine,106,39,96,14,145,90.56603773584906,13.20754716981132
37076_marine,106,41,96,14,147,90.56603773584906,13.20754716981132
37077_marine,573,199,381,343,772,66.49214659685863,59.860383944153575
37078_marine,600,213,402,361,813,67,60.16666666666667
37079_marine,559,178,371,338,737,66.3685152057245,60.46511627906976
37080_marine,105,39,95,14,144,90.47619047619048,13.333333333333334
37081_marine,563,169,357,350,732,63.41030195381882,62.16696269982238
37082_marine,554,174,348,345,728,62.8158844765343,62.27436823104693
37083_marine,581,190,364,365,771,62.65060240963856,62.822719449225474
37084_marine,591,191,370,372,782,62.605752961082906,62.944162436548226
37085_marine,569,181,355,360,750,62.39015817223199,63.2688927943761
37086_marine,101,39,92,9,140,91.0891089108911,8.91089108910891
37087_marine,597,207,377,364,804,63.14907872696818,60.971524288107204
37088_marine,662,256,426,397,918,64.35045317220543,59.969788519637454
37089_marine,664,257,425,399,921,64.00602409638554,60.09036144578314
37090_marine,605,209,382,367,814,63.1404958677686,60.66115702479339
37091_marine,593,205,377,362,798,63.57504215851601,61.04553119730185
37092_marine,575,191,365,352,766,63.47826086956522,61.21739130434782
37093_marine,103,40,97,10,143,94.1747572815534,9.70873786407767
37094_marine,99,40,93,10,139,93.93939393939394,10.1010101010101
37095_marine,100,40,94,10,140,94,10
37096_marine,415,108,277,256,523,66.74698795180723,61.686746987951814
37097_marine,430,116,290,260,546,67.44186046511628,60.46511627906976
37098_marine,415,113,277,256,528,66.74698795180723,61.686746987951814
37099_marine,99,38,93,10,137,93.93939393939394,10.1010101010101
37100_marine,101,37,95,12,138,94.05940594059405,11.881188118811881
37101_marine,99,37,93,12,136,93.93939393939394,12.121212121212121
37102_marine,99,37,93,12,136,93.93939393939394,12.121212121212121
37103_marine,98,37,92,12,135,93.87755102040816,12.244897959183673
37104_marine,97,38,91,12,135,93.81443298969072,12.371134020618557
37105_marine,97,38,91,12,135,93.81443298969072,12.371134020618557
37106_marine,99,37,93,12,136,93.93939393939394,12.121212121212121
37107_marine,99,37,93,12,136,93.93939393939394,12.121212121212121
37108_marine,101,39,95,12,140,94.05940594059405,11.881188118811881
37109_marine,101,39,95,12,140,94.05940594059405,11.881188118811881
37110_marine,101,39,95,12,140,94.05940594059405,11.881188118811881
37111_marine,387,103,251,243,490,64.85788113695091,62.7906976744186
37112_marine,450,115,300,272,565,66.66666666666666,60.44444444444444
37113_marine,454,117,304,276,571,66.96035242290749,60.792951541850215
37114_marine,450,113,304,272,563,67.55555555555556,60.44444444444444
37115_marine,450,115,304,272,565,67.55555555555556,60.44444444444444
37116_marine,448,116,302,272,564,67.41071428571429,60.71428571428571
37117_marine,103,42,97,10,145,94.1747572815534,9.70873786407767
37118_marine,404,92,276,246,496,68.31683168316832,60.89108910891089
37119_marine,404,97,276,246,501,68.31683168316832,60.89108910891089
37120_marine,404,96,276,246,500,68.31683168316832,60.89108910891089
37121_marine,370,86,258,222,456,69.72972972972973,60
37122_marine,368,89,256,222,457,69.56521739130434,60.32608695652174
37123_marine,96,41,90,9,137,93.75,9.375
37124_marine,97,41,91,10,138,93.81443298969072,10.309278350515463
37125_marine,96,40,90,11,136,93.75,11.458333333333332
37126_marine,96,40,90,11,136,93.75,11.458333333333332
37127_marine,96,40,90,11,136,93.75,11.458333333333332
37128_marine,96,39,90,11,135,93.75,11.458333333333332
37129_marine,97,38,91,11,135,93.81443298969072,11.34020618556701
37130_marine,97,38,91,11,135,93.81443298969072,11.34020618556701
37131_marine,97,38,91,11,135,93.81443298969072,11.34020618556701
37132_marine,95,37,89,11,132,93.6842105263158,11.578947368421053
37133_marine,95,36,89,11,131,93.6842105263158,11.578947368421053
37134_marine,93,36,87,9,129,93.54838709677419,9.67741935483871
37135_marine,91,36,85,9,127,93.4065934065934,9.89010989010989
37136_marine,91,35,85,9,126,93.4065934065934,9.89010989010989
37137_marine,91,35,85,9,126,93.4065934065934,9.89010989010989
37138_marine,90,35,84,9,125,93.33333333333333,10
37139_marine,90,35,84,9,125,93.33333333333333,10
37140_marine,87,35,81,8,122,93.10344827586206,9.195402298850574
37141_marine,86,35,80,8,121,93.02325581395348,9.30232558139535
37142_marine,85,35,80,7,120,94.11764705882352,8.235294117647058
37143_marine,85,35,80,7,120,94.11764705882352,8.235294117647058
37144_marine,85,35,80,7,120,94.11764705882352,8.235294117647058
37145_marine,85,35,80,7,120,94.11764705882352,8.235294117647058
37146_marine,83,35,78,6,118,93.97590361445783,7.228915662650602
37147_marine,84,35,79,6,119,94.04761904761905,7.142857142857142
37148_marine,84,35,79,6,119,94.04761904761905,7.142857142857142
37149_marine,83,34,78,5,117,93.97590361445783,6.024096385542169
37150_marine,83,34,78,5,117,93.97590361445783,6.024096385542169
37151_marine,83,36,78,5,119,93.97590361445783,6.024096385542169
37152_marine,83,36,78,5,119,93.97590361445783,6.024096385542169
37153_marine,83,36,78,5,119,93.97590361445783,6.024096385542169
37154_marine,81,36,76,4,117,93.82716049382715,4.938271604938271
37155_marine,80,36,76,4,116,95,5
37156_marine,82,36,78,4,118,95.1219512195122,4.878048780487805
37157_marine,82,36,78,4,118,95.1219512195122,4.878048780487805
37158_marine,83,36,79,4,119,95.18072289156626,4.819277108433735
37159_marine,83,36,79,4,119,95.18072289156626,4.819277108433735
37160_marine,82,37,78,4,119,95.1219512195122,4.878048780487805
37161_marine,82,37,78,4,119,95.1219512195122,4.878048780487805
37162_marine,83,37,79,4,120,95.18072289156626,4.819277108433735
37163_marine,83,37,79,4,120,95.18072289156626,4.819277108433735
37164_marine,83,37,79,4,120,95.18072289156626,4.819277108433735
37165_marine,83,37,79,4,120,95.18072289156626,4.819277108433735
37166_marine,84,37,80,5,121,95.23809523809523,5.952380952380952
37167_marine,84,38,80,5,122,95.23809523809523,5.952380952380952
37168_marine,84,37,80,5,121,95.23809523809523,5.952380952380952
37169_marine,86,37,82,5,123,95.34883720930233,5.813953488372093
37170_marine,85,37,81,5,122,95.29411764705881,5.88235294117647
37171_marine,83,39,80,4,122,96.3855421686747,4.819277108433735
37172_marine,82,38,79,4,120,96.34146341463415,4.878048780487805
37173_marine,82,38,79,4,120,96.34146341463415,4.878048780487805
37174_marine,83,39,79,4,122,95.18072289156626,4.819277108433735
37175_marine,80,39,76,4,119,95,5
37176_marine,81,41,76,5,122,93.82716049382715,6.172839506172839
37177_marine,82,40,77,5,122,93.90243902439023,6.097560975609756
37178_marine,91,42,86,5,133,94.5054945054945,5.4945054945054945
37179_marine,89,42,84,5,131,94.3820224719101,5.617977528089887
37180_marine,96,42,91,4,138,94.79166666666666,4.166666666666666
37181_marine,100,46,95,5,146,95,5
37182_marine,109,49,102,10,158,93.57798165137615,9.174311926605505
37183_marine,201,121,168,34,322,83.5820895522388,16.91542288557214
37184_marine,304,261,205,123,565,67.43421052631578,40.46052631578947
37223_marine,311,147,257,96,458,82.63665594855306,30.86816720257235
37224_marine,118,45,113,9,163,95.76271186440678,7.627118644067797
37225_marine,112,37,107,9,149,95.53571428571429,8.035714285714286
37226_marine,109,39,104,9,148,95.41284403669725,8.256880733944955
37227_marine,100,39,94,7,139,94,7.000000000000001
37228_marine,95,37,91,5,132,95.78947368421052,5.263157894736842
37229_marine,92,35,88,4,127,95.65217391304348,4.3478260869565215
37230_marine,92,35,88,4,127,95.65217391304348,4.3478260869565215
37231_marine,92,36,88,4,128,95.65217391304348,4.3478260869565215
37232_marine,91,36,87,4,127,95.6043956043956,4.395604395604396
37233_marine,91,36,87,4,127,95.6043956043956,4.395604395604396
37234_marine,89,36,85,4,125,95.50561797752809,4.49438202247191
37235_marine,89,36,85,4,125,95.50561797752809,4.49438202247191
37236_marine,88,36,83,5,124,94.31818181818183,5.681818181818182
37237_marine,88,36,83,5,124,94.31818181818183,5.681818181818182
37238_marine,88,36,83,5,124,94.31818181818183,5.681818181818182
37239_marine,84,36,79,5,120,94.04761904761905,5.952380952380952
37240_marine,85,36,79,6,121,92.94117647058823,7.0588235294117645
37241_marine,85,36,79,6,121,92.94117647058823,7.0588235294117645
37242_marine,85,36,79,5,121,92.94117647058823,5.88235294117647
37243_marine,85,36,79,5,121,92.94117647058823,5.88235294117647
37244_marine,84,36,78,5,120,92.85714285714286,5.952380952380952
37245_marine,85,35,79,5,120,92.94117647058823,5.88235294117647
37246_marine,89,35,83,5,124,93.25842696629213,5.617977528089887
37247_marine,90,35,84,6,125,93.33333333333333,6.666666666666667
37248_marine,86,35,79,7,121,91.86046511627907,8.13953488372093
37249_marine,86,35,79,7,121,91.86046511627907,8.13953488372093
37250_marine,86,35,79,7,121,91.86046511627907,8.13953488372093
37251_marine,85,35,79,6,120,92.94117647058823,7.0588235294117645
37252_marine,84,35,79,5,119,94.04761904761905,5.952380952380952
37253_marine,82,37,77,5,119,93.90243902439023,6.097560975609756
37254_marine,89,39,83,5,128,93.25842696629213,5.617977528089887
37255_marine,89,39,83,5,128,93.25842696629213,5.617977528089887
37256_marine,89,37,83,5,126,93.25842696629213,5.617977528089887
37257_marine,89,36,83,5,125,93.25842696629213,5.617977528089887
37258_marine,87,33,81,5,120,93.10344827586206,5.747126436781609
37259_marine,85,33,79,5,118,92.94117647058823,5.88235294117647
37260_marine,81,35,75,5,116,92.5925925925926,6.172839506172839
37261_marine,78,35,73,3,113,93.58974358974359,3.8461538461538463
37262_marine,78,35,73,3,113,93.58974358974359,3.8461538461538463
37263_marine,76,35,71,2,111,93.42105263157895,2.631578947368421
37264_marine,76,35,71,2,111,93.42105263157895,2.631578947368421
37265_marine,75,37,70,2,112,93.33333333333333,2.666666666666667
37266_marine,77,37,71,2,114,92.20779220779221,2.5974025974025974
37267_marine,81,34,75,2,115,92.5925925925926,2.4691358024691357
37268_marine,82,33,76,1,115,92.6829268292683,1.2195121951219512
37269_marine,89,34,84,1,123,94.3820224719101,1.1235955056179776
37270_marine,92,38,87,2,130,94.56521739130434,2.1739130434782608
37271_marine,98,38,93,2,136,94.89795918367348,2.0408163265306123
37272_marine,196,96,183,21,292,93.36734693877551,10.714285714285714
37302_marine,655,237,450,343,892,68.70229007633588,52.36641221374045
37303_marine,544,182,365,303,726,67.09558823529412,55.69852941176471
37304_marine,553,180,373,308,733,67.45027124773961,55.69620253164557
37305_marine,561,189,377,316,750,67.20142602495544,56.32798573975044
37306_marine,626,224,421,358,850,67.25239616613419,57.18849840255591
37307_marine,677,238,460,361,915,67.94682422451994,53.32348596750369
37312_marine,597,163,400,323,760,67.00167504187606,54.10385259631491
37313_marine,92,32,86,8,124,93.47826086956522,8.695652173913043
37314_marine,90,32,84,8,122,93.33333333333333,8.88888888888889
37315_marine,89,33,83,8,122,93.25842696629213,8.98876404494382
37316_marine,92,33,86,10,125,93.47826086956522,10.869565217391305
37317_marine,92,35,86,10,127,93.47826086956522,10.869565217391305
37318_marine,92,35,86,10,127,93.47826086956522,10.869565217391305
37319_marine,90,33,84,10,123,93.33333333333333,11.11111111111111
37320_marine,89,33,83,8,122,93.25842696629213,8.98876404494382
37321_marine,97,39,88,15,136,90.72164948453609,15.463917525773196
37322_marine,98,37,89,15,135,90.81632653061224,15.306122448979592
37323_marine,87,32,82,7,119,94.25287356321839,8.045977011494253
37324_marine,82,32,77,6,114,93.90243902439023,7.317073170731707
37325_marine,82,32,77,6,114,93.90243902439023,7.317073170731707
37326_marine,82,31,77,6,113,93.90243902439023,7.317073170731707
37327_marine,83,30,78,7,113,93.97590361445783,8.433734939759036
37328_marine,83,30,78,7,113,93.97590361445783,8.433734939759036
37329_marine,83,30,78,7,113,93.97590361445783,8.433734939759036
37330_marine,83,29,78,7,112,93.97590361445783,8.433734939759036
37331_marine,80,29,75,7,109,93.75,8.75
37332_marine,78,29,73,7,107,93.58974358974359,8.974358974358974
37333_marine,78,29,73,7,107,93.58974358974359,8.974358974358974
37334_marine,78,29,73,7,107,93.58974358974359,8.974358974358974
37335_marine,78,29,73,7,107,93.58974358974359,8.974358974358974
37336_marine,78,29,73,7,107,93.58974358974359,8.974358974358974
37337_marine,76,29,71,7,105,93.42105263157895,9.210526315789473
37338_marine,76,29,71,7,105,93.42105263157895,9.210526315789473
37339_marine,76,30,71,7,106,93.42105263157895,9.210526315789473
37340_marine,76,30,71,7,106,93.42105263157895,9.210526315789473
37341_marine,76,30,71,7,106,93.42105263157895,9.210526315789473
37342_marine,76,30,71,7,106,93.42105263157895,9.210526315789473
37343_marine,76,30,71,7,106,93.42105263157895,9.210526315789473
37344_marine,76,30,71,7,106,93.42105263157895,9.210526315789473
37345_marine,78,30,73,7,108,93.58974358974359,8.974358974358974
37346_marine,78,31,73,7,109,93.58974358974359,8.974358974358974
37347_marine,78,31,73,7,109,93.58974358974359,8.974358974358974
37348_marine,78,31,73,7,109,93.58974358974359,8.974358974358974
37349_marine,78,31,73,7,109,93.58974358974359,8.974358974358974
37350_marine,78,31,73,7,109,93.58974358974359,8.974358974358974
37351_marine,78,30,73,7,108,93.58974358974359,8.974358974358974
37352_marine,78,30,73,7,108,93.58974358974359,8.974358974358974
37353_marine,78,30,73,7,108,93.58974358974359,8.974358974358974
37354_marine,78,31,73,7,109,93.58974358974359,8.974358974358974
37355_marine,79,31,74,8,110,93.67088607594937,10.126582278481013
37356_marine,85,33,80,12,118,94.11764705882352,14.117647058823529
37357_marine,481,110,328,288,591,68.1912681912682,59.87525987525988
37358_marine,478,105,325,287,583,67.99163179916317,60.04184100418411
37359_marine,87,33,82,10,120,94.25287356321839,11.494252873563218
37360_marine,82,31,77,7,113,93.90243902439023,8.536585365853659
37361_marine,82,31,77,7,113,93.90243902439023,8.536585365853659
37362_marine,82,31,77,7,113,93.90243902439023,8.536585365853659
37363_marine,85,31,80,8,116,94.11764705882352,9.411764705882353
37364_marine,88,31,81,9,119,92.04545454545455,10.227272727272728
37365_marine,89,30,82,9,119,92.13483146067416,10.112359550561797
37366_marine,89,30,82,10,119,92.13483146067416,11.235955056179774
37367_marine,90,29,82,11,119,91.11111111111111,12.222222222222221
37368_marine,91,29,83,10,120,91.20879120879121,10.989010989010989
37369_marine,92,29,84,10,121,91.30434782608695,10.869565217391305
37370_marine,91,29,83,10,120,91.20879120879121,10.989010989010989
37371_marine,91,29,83,10,120,91.20879120879121,10.989010989010989
37372_marine,92,30,84,10,122,91.30434782608695,10.869565217391305
37373_marine,91,30,84,9,121,92.3076923076923,9.89010989010989
37374_marine,90,30,84,9,120,93.33333333333333,10
37375_marine,94,29,88,9,123,93.61702127659575,9.574468085106384
37376_marine,95,29,89,9,124,93.6842105263158,9.473684210526317
37377_marine,95,29,89,9,124,93.6842105263158,9.473684210526317
37378_marine,99,29,93,9,128,93.93939393939394,9.090909090909092
37379_marine,100,31,94,9,131,94,9
37380_marine,103,33,97,9,136,94.1747572815534,8.737864077669903
37381_marine,124,53,117,11,177,94.35483870967742,8.870967741935484
37382_marine,476,123,327,267,599,68.69747899159664,56.09243697478992
37383_marine,833,294,552,459,1127,66.26650660264104,55.10204081632652
37384_marine,827,336,555,448,1163,67.11003627569528,54.17170495767836
37385_marine,507,258,371,216,765,73.17554240631164,42.60355029585799
37389_marine,437,246,319,171,683,72.99771167048054,39.130434782608695
37398_marine,366,250,275,125,616,75.13661202185791,34.15300546448087
37399_marine,357,203,265,122,560,74.2296918767507,34.173669467787114
37400_marine,344,168,261,113,512,75.87209302325581,32.848837209302324
37401_marine,364,249,269,123,613,73.9010989010989,33.791208791208796
37405_marine,947,451,592,545,1398,62.51319957761352,57.55015839493136
37406_marine,902,386,557,532,1288,61.75166297117517,58.98004434589801
37407_marine,898,355,558,526,1253,62.1380846325167,58.57461024498887
37408_marine,133,39,119,19,172,89.47368421052632,14.285714285714285
37409_marine,125,33,115,13,158,92,10.4
37410_marine,121,32,111,11,153,91.73553719008265,9.090909090909092
37411_marine,117,32,107,12,149,91.45299145299145,10.256410256410255
37412_marine,109,32,99,16,141,90.82568807339449,14.678899082568808
37413_marine,109,32,99,16,141,90.82568807339449,14.678899082568808
37414_marine,106,34,95,16,140,89.62264150943396,15.09433962264151
37415_marine,102,33,91,14,135,89.2156862745098,13.725490196078432
37416_marine,104,35,93,14,139,89.42307692307693,13.461538461538462
37417_marine,103,35,92,12,138,89.32038834951457,11.650485436893204
37418_marine,105,35,93,12,140,88.57142857142857,11.428571428571429
37419_marine,109,33,97,14,142,88.9908256880734,12.844036697247708
37420_marine,111,33,99,14,144,89.1891891891892,12.612612612612612
37421_marine,133,56,114,30,189,85.71428571428571,22.55639097744361
37422_marine,113,33,102,14,146,90.2654867256637,12.389380530973451
37423_marine,114,34,103,14,148,90.35087719298247,12.280701754385964
37424_marine,114,35,103,14,149,90.35087719298247,12.280701754385964
37425_marine,113,35,103,14,148,91.1504424778761,12.389380530973451
37426_marine,710,249,427,452,959,60.140845070422536,63.66197183098592
37427_marine,797,329,485,500,1126,60.85319949811794,62.735257214554586
37428_marine,812,336,499,501,1148,61.45320197044335,61.69950738916257
37429_marine,733,273,442,462,1006,60.30013642564802,63.02864938608458
37430_marine,627,196,403,383,823,64.274322169059,61.08452950558214
37431_marine,109,39,99,13,148,90.82568807339449,11.926605504587156
37432_marine,106,40,96,13,146,90.56603773584906,12.264150943396226
37433_marine,107,38,97,13,145,90.65420560747664,12.149532710280374
37434_marine,121,45,107,23,166,88.42975206611571,19.00826446280992
37435_marine,108,39,98,14,147,90.74074074074075,12.962962962962962
37436_marine,110,39,100,15,149,90.9090909090909,13.636363636363635
37437_marine,560,182,372,339,742,66.42857142857143,60.535714285714285
37438_marine,562,182,374,339,744,66.54804270462633,60.320284697508896
37439_marine,108,39,98,15,147,90.74074074074075,13.88888888888889
37440_marine,110,41,100,15,151,90.9090909090909,13.636363636363635
37441_marine,657,217,394,428,874,59.96955859969558,65.14459665144597
37442_marine,576,197,363,358,773,63.020833333333336,62.15277777777778
37443_marine,574,189,362,357,763,63.06620209059234,62.19512195121951
37444_marine,597,199,378,367,796,63.31658291457286,61.47403685092128
37445_marine,597,199,378,367,796,63.31658291457286,61.47403685092128
37446_marine,561,177,356,343,738,63.45811051693404,61.14081996434938
37447_marine,618,218,394,368,836,63.75404530744336,59.54692556634305
37448_marine,597,207,376,365,804,62.981574539363486,61.13902847571189
37449_marine,660,257,421,399,917,63.787878787878796,60.45454545454545
37450_marine,651,240,418,390,891,64.20890937019969,59.907834101382484
37451_marine,640,229,414,384,869,64.6875,60
37452_marine,579,194,366,355,773,63.212435233160626,61.3126079447323
37453_marine,103,39,97,10,142,94.1747572815534,9.70873786407767
37454_marine,98,39,92,10,137,93.87755102040816,10.204081632653061
37455_marine,98,38,92,10,136,93.87755102040816,10.204081632653061
37456_marine,98,38,92,10,136,93.87755102040816,10.204081632653061
37457_marine,415,108,277,256,523,66.74698795180723,61.686746987951814
37458_marine,415,108,277,256,523,66.74698795180723,61.686746987951814
37459_marine,99,38,93,10,137,93.93939393939394,10.1010101010101
37460_marine,98,37,92,10,135,93.87755102040816,10.204081632653061
37461_marine,99,37,93,12,136,93.93939393939394,12.121212121212121
37462_marine,99,37,93,12,136,93.93939393939394,12.121212121212121
37463_marine,97,38,91,12,135,93.81443298969072,12.371134020618557
37464_marine,97,40,91,12,137,93.81443298969072,12.371134020618557
37465_marine,397,117,252,256,514,63.476070528967256,64.48362720403023
37466_marine,469,131,306,291,600,65.2452025586354,62.046908315565034
37467_marine,99,39,93,12,138,93.93939393939394,12.121212121212121
37468_marine,101,39,95,12,140,94.05940594059405,11.881188118811881
37469_marine,103,39,97,12,142,94.1747572815534,11.650485436893204
37470_marine,103,39,97,12,142,94.1747572815534,11.650485436893204
37471_marine,454,119,304,274,573,66.96035242290749,60.352422907488986
37472_marine,482,138,325,291,620,67.42738589211619,60.37344398340249
37473_marine,484,138,327,292,622,67.56198347107438,60.33057851239669
37474_marine,480,136,324,291,616,67.5,60.62499999999999
37475_marine,476,138,324,287,614,68.0672268907563,60.29411764705882
37476_marine,472,136,320,285,608,67.79661016949152,60.381355932203384
37477_marine,448,113,302,272,561,67.41071428571429,60.71428571428571
37478_marine,442,110,296,277,552,66.9683257918552,62.66968325791855
37479_marine,441,121,295,275,562,66.89342403628117,62.358276643990926
37480_marine,426,105,284,264,531,66.66666666666666,61.97183098591549
37481_marine,368,93,256,222,461,69.56521739130434,60.32608695652174
37482_marine,383,109,267,233,492,69.71279373368147,60.835509138381205
37483_marine,366,91,254,222,457,69.39890710382514,60.65573770491803
37484_marine,97,41,91,10,138,93.81443298969072,10.309278350515463
37485_marine,96,39,90,11,135,93.75,11.458333333333332
37486_marine,96,39,90,11,135,93.75,11.458333333333332
37487_marine,96,39,90,11,135,93.75,11.458333333333332
37488_marine,96,39,90,11,135,93.75,11.458333333333332
37489_marine,96,38,90,11,134,93.75,11.458333333333332
37490_marine,96,38,90,11,134,93.75,11.458333333333332
37491_marine,96,38,90,11,134,93.75,11.458333333333332
37492_marine,96,37,90,11,133,93.75,11.458333333333332
37493_marine,94,37,88,11,131,93.61702127659575,11.702127659574469
37494_marine,92,36,86,9,128,93.47826086956522,9.782608695652174
37495_marine,92,35,86,9,127,93.47826086956522,9.782608695652174
37496_marine,90,35,84,9,125,93.33333333333333,10
37497_marine,90,35,84,9,125,93.33333333333333,10
37498_marine,90,35,84,9,125,93.33333333333333,10
37499_marine,88,35,82,9,123,93.18181818181817,10.227272727272728
37500_marine,88,35,82,9,123,93.18181818181817,10.227272727272728
37501_marine,88,35,82,9,123,93.18181818181817,10.227272727272728
37502_marine,89,35,83,9,124,93.25842696629213,10.112359550561797
37503_marine,88,35,83,8,123,94.31818181818183,9.090909090909092
37504_marine,87,35,82,7,122,94.25287356321839,8.045977011494253
37505_marine,87,35,82,7,122,94.25287356321839,8.045977011494253
37506_marine,86,35,81,7,121,94.18604651162791,8.13953488372093
37507_marine,86,34,81,7,120,94.18604651162791,8.13953488372093
37508_marine,86,33,81,6,119,94.18604651162791,6.976744186046512
37509_marine,86,33,81,6,119,94.18604651162791,6.976744186046512
37510_marine,85,33,80,5,118,94.11764705882352,5.88235294117647
37511_marine,85,34,80,5,119,94.11764705882352,5.88235294117647
37512_marine,84,36,79,4,120,94.04761904761905,4.761904761904762
37513_marine,83,36,79,4,119,95.18072289156626,4.819277108433735
37514_marine,83,36,79,4,119,95.18072289156626,4.819277108433735
37515_marine,83,36,79,4,119,95.18072289156626,4.819277108433735
37516_marine,83,36,79,4,119,95.18072289156626,4.819277108433735
37517_marine,82,36,78,4,118,95.1219512195122,4.878048780487805
37518_marine,82,36,78,4,118,95.1219512195122,4.878048780487805
37519_marine,82,36,78,4,118,95.1219512195122,4.878048780487805
37520_marine,81,37,77,4,118,95.06172839506173,4.938271604938271
37521_marine,82,37,78,4,119,95.1219512195122,4.878048780487805
37522_marine,83,37,79,4,120,95.18072289156626,4.819277108433735
37523_marine,83,37,79,4,120,95.18072289156626,4.819277108433735
37524_marine,83,37,79,4,120,95.18072289156626,4.819277108433735
37525_marine,83,37,79,4,120,95.18072289156626,4.819277108433735
37526_marine,83,37,79,4,120,95.18072289156626,4.819277108433735
37527_marine,84,38,80,5,122,95.23809523809523,5.952380952380952
37528_marine,83,39,79,5,122,95.18072289156626,6.024096385542169
37529_marine,84,38,80,5,122,95.23809523809523,5.952380952380952
37530_marine,83,37,80,4,120,96.3855421686747,4.819277108433735
37531_marine,83,38,80,4,121,96.3855421686747,4.819277108433735
37532_marine,82,38,79,4,120,96.34146341463415,4.878048780487805
37533_marine,82,38,79,4,120,96.34146341463415,4.878048780487805
37534_marine,83,38,79,4,121,95.18072289156626,4.819277108433735
37535_marine,84,39,80,4,123,95.23809523809523,4.761904761904762
37536_marine,82,41,78,4,123,95.1219512195122,4.878048780487805
37537_marine,83,40,78,5,123,93.97590361445783,6.024096385542169
37538_marine,85,42,80,5,127,94.11764705882352,5.88235294117647
37539_marine,91,42,86,5,133,94.5054945054945,5.4945054945054945
37540_marine,90,44,85,5,134,94.44444444444444,5.555555555555555
37541_marine,98,42,93,5,140,94.89795918367348,5.1020408163265305
37542_marine,103,48,97,6,151,94.1747572815534,5.825242718446602
37543_marine,185,93,158,27,278,85.4054054054054,14.594594594594595
37544_marine,296,230,202,118,526,68.24324324324324,39.86486486486486
37545_marine,283,223,195,108,506,68.90459363957598,38.16254416961131
37583_marine,119,49,114,10,168,95.7983193277311,8.403361344537815
37584_marine,112,43,107,9,155,95.53571428571429,8.035714285714286
37585_marine,111,37,106,9,148,95.4954954954955,8.108108108108109
37586_marine,99,37,94,7,136,94.94949494949495,7.07070707070707
37587_marine,96,37,90,7,133,93.75,7.291666666666667
37588_marine,92,39,88,5,131,95.65217391304348,5.434782608695652
37589_marine,91,35,87,4,126,95.6043956043956,4.395604395604396
37590_marine,92,35,88,4,127,95.65217391304348,4.3478260869565215
37591_marine,92,36,88,4,128,95.65217391304348,4.3478260869565215
37592_marine,91,34,87,4,125,95.6043956043956,4.395604395604396
37593_marine,89,36,85,4,125,95.50561797752809,4.49438202247191
37594_marine,89,36,85,4,125,95.50561797752809,4.49438202247191
37595_marine,90,36,85,5,126,94.44444444444444,5.555555555555555
37596_marine,88,36,83,5,124,94.31818181818183,5.681818181818182
37597_marine,88,36,83,5,124,94.31818181818183,5.681818181818182
37598_marine,86,36,81,5,122,94.18604651162791,5.813953488372093
37599_marine,84,36,79,5,120,94.04761904761905,5.952380952380952
37600_marine,84,36,79,5,120,94.04761904761905,5.952380952380952
37601_marine,85,36,79,6,121,92.94117647058823,7.0588235294117645
37602_marine,84,36,78,5,120,92.85714285714286,5.952380952380952
37603_marine,85,36,79,5,121,92.94117647058823,5.88235294117647
37604_marine,85,36,79,5,121,92.94117647058823,5.88235294117647
37605_marine,85,35,79,5,120,92.94117647058823,5.88235294117647
37606_marine,85,35,79,5,120,92.94117647058823,5.88235294117647
37607_marine,85,35,79,5,120,92.94117647058823,5.88235294117647
37608_marine,86,35,80,6,121,93.02325581395348,6.976744186046512
37609_marine,85,35,79,6,120,92.94117647058823,7.0588235294117645
37610_marine,86,35,79,7,121,91.86046511627907,8.13953488372093
37611_marine,85,35,79,6,120,92.94117647058823,7.0588235294117645
37612_marine,83,35,78,5,118,93.97590361445783,6.024096385542169
37613_marine,90,37,85,5,127,94.44444444444444,5.555555555555555
37614_marine,92,37,87,7,129,94.56521739130434,7.608695652173914
37615_marine,115,53,107,13,168,93.04347826086956,11.304347826086957
37616_marine,95,37,89,7,132,93.6842105263158,7.368421052631578
37617_marine,93,39,87,5,132,93.54838709677419,5.376344086021505
37618_marine,91,34,85,5,125,93.4065934065934,5.4945054945054945
37619_marine,91,33,85,5,124,93.4065934065934,5.4945054945054945
37620_marine,82,33,77,4,115,93.90243902439023,4.878048780487805
37621_marine,81,35,76,4,116,93.82716049382715,4.938271604938271
37622_marine,79,35,74,2,114,93.67088607594937,2.5316455696202533
37623_marine,78,35,73,2,113,93.58974358974359,2.564102564102564
37624_marine,78,35,73,2,113,93.58974358974359,2.564102564102564
37625_marine,77,37,72,2,114,93.5064935064935,2.5974025974025974
37626_marine,79,37,73,2,116,92.40506329113924,2.5316455696202533
37627_marine,82,34,76,1,116,92.6829268292683,1.2195121951219512
37628_marine,81,34,75,1,115,92.5925925925926,1.2345679012345678
37629_marine,89,35,84,1,124,94.3820224719101,1.1235955056179776
37630_marine,94,36,89,2,130,94.68085106382979,2.127659574468085
37631_marine,100,39,95,4,139,95,4
37632_marine,208,112,193,20,320,92.78846153846155,9.615384615384617
37662_marine,656,239,451,347,895,68.75,52.89634146341463
37663_marine,104,36,97,12,140,93.26923076923077,11.538461538461538
37664_marine,110,37,103,13,147,93.63636363636364,11.818181818181818
37665_marine,116,39,110,16,155,94.82758620689656,13.793103448275861
37666_marine,623,184,434,331,807,69.66292134831461,53.13001605136437
37667_marine,653,203,457,338,856,69.98468606431854,51.76110260336907
37672_marine,604,161,407,326,765,67.3841059602649,53.973509933774835
37673_marine,90,32,84,8,122,93.33333333333333,8.88888888888889
37674_marine,90,32,84,8,122,93.33333333333333,8.88888888888889
37675_marine,189,51,139,92,240,73.54497354497354,48.67724867724868
37676_marine,92,33,86,10,125,93.47826086956522,10.869565217391305
37677_marine,92,35,86,10,127,93.47826086956522,10.869565217391305
37678_marine,93,35,87,11,128,93.54838709677419,11.827956989247312
37679_marine,91,35,85,11,126,93.4065934065934,12.087912087912088
37680_marine,90,33,84,9,123,93.33333333333333,10
37681_marine,98,37,89,16,135,90.81632653061224,16.3265306122449
37682_marine,99,37,90,16,136,90.9090909090909,16.161616161616163
37683_marine,87,32,82,7,119,94.25287356321839,8.045977011494253
37684_marine,82,32,77,6,114,93.90243902439023,7.317073170731707
37685_marine,82,31,77,6,113,93.90243902439023,7.317073170731707
37686_marine,82,31,77,6,113,93.90243902439023,7.317073170731707
37687_marine,82,30,77,6,112,93.90243902439023,7.317073170731707
37688_marine,82,30,77,6,112,93.90243902439023,7.317073170731707
37689_marine,81,30,76,6,111,93.82716049382715,7.4074074074074066
37690_marine,81,29,76,6,110,93.82716049382715,7.4074074074074066
37691_marine,77,29,72,6,106,93.5064935064935,7.792207792207792
37692_marine,77,29,72,6,106,93.5064935064935,7.792207792207792
37693_marine,78,29,73,7,107,93.58974358974359,8.974358974358974
37694_marine,78,29,73,7,107,93.58974358974359,8.974358974358974
37695_marine,78,29,73,7,107,93.58974358974359,8.974358974358974
37696_marine,76,29,71,7,105,93.42105263157895,9.210526315789473
37697_marine,76,29,71,7,105,93.42105263157895,9.210526315789473
37698_marine,76,29,71,7,105,93.42105263157895,9.210526315789473
37699_marine,76,29,71,7,105,93.42105263157895,9.210526315789473
37700_marine,76,29,71,7,105,93.42105263157895,9.210526315789473
37701_marine,76,30,71,7,106,93.42105263157895,9.210526315789473
37702_marine,76,30,71,7,106,93.42105263157895,9.210526315789473
37703_marine,76,30,71,7,106,93.42105263157895,9.210526315789473
37704_marine,76,30,71,7,106,93.42105263157895,9.210526315789473
37705_marine,76,30,71,7,106,93.42105263157895,9.210526315789473
37706_marine,78,30,73,7,108,93.58974358974359,8.974358974358974
37707_marine,78,31,73,7,109,93.58974358974359,8.974358974358974
37708_marine,78,31,73,7,109,93.58974358974359,8.974358974358974
37709_marine,78,31,73,7,109,93.58974358974359,8.974358974358974
37710_marine,78,31,73,7,109,93.58974358974359,8.974358974358974
37711_marine,78,31,73,7,109,93.58974358974359,8.974358974358974
37712_marine,78,30,73,7,108,93.58974358974359,8.974358974358974
37713_marine,78,30,73,7,108,93.58974358974359,8.974358974358974
37714_marine,78,30,73,7,108,93.58974358974359,8.974358974358974
37715_marine,77,30,73,6,107,94.8051948051948,7.792207792207792
37716_marine,77,30,73,6,107,94.8051948051948,7.792207792207792
37717_marine,80,32,75,7,112,93.75,8.75
37718_marine,85,32,80,8,117,94.11764705882352,9.411764705882353
37719_marine,83,30,78,8,113,93.97590361445783,9.63855421686747
37720_marine,82,30,77,7,112,93.90243902439023,8.536585365853659
37721_marine,82,30,77,7,112,93.90243902439023,8.536585365853659
37722_marine,82,30,77,7,112,93.90243902439023,8.536585365853659
37723_marine,82,30,77,7,112,93.90243902439023,8.536585365853659
37724_marine,85,30,79,7,115,92.94117647058823,8.235294117647058
37725_marine,86,30,80,7,116,93.02325581395348,8.13953488372093
37726_marine,86,30,80,7,116,93.02325581395348,8.13953488372093
37727_marine,88,30,81,9,118,92.04545454545455,10.227272727272728
37728_marine,88,29,81,9,117,92.04545454545455,10.227272727272728
37729_marine,88,29,81,9,117,92.04545454545455,10.227272727272728
37730_marine,89,29,82,9,118,92.13483146067416,10.112359550561797
37731_marine,90,29,83,9,119,92.22222222222223,10
37732_marine,90,29,83,9,119,92.22222222222223,10
37733_marine,90,30,83,9,120,92.22222222222223,10
37734_marine,89,30,83,9,119,93.25842696629213,10.112359550561797
37735_marine,89,30,83,9,119,93.25842696629213,10.112359550561797
37736_marine,90,29,84,9,119,93.33333333333333,10
37737_marine,94,29,88,9,123,93.61702127659575,9.574468085106384
37738_marine,102,29,96,9,131,94.11764705882352,8.823529411764707
37739_marine,104,33,98,11,137,94.23076923076923,10.576923076923077
37740_marine,114,39,108,13,153,94.73684210526315,11.403508771929824
37741_marine,136,68,128,13,204,94.11764705882352,9.558823529411764
37742_marine,719,269,497,371,988,69.12378303198888,51.599443671766345
37743_marine,729,277,496,387,1006,68.03840877914952,53.086419753086425
37744_marine,576,289,396,275,865,68.75,47.74305555555556
37745_marine,663,351,418,356,1014,63.04675716440422,53.69532428355958
37757_marine,477,370,309,213,847,64.77987421383648,44.65408805031446
37758_marine,362,248,271,121,610,74.86187845303867,33.42541436464088
37759_marine,354,205,261,121,559,73.72881355932203,34.18079096045198
37760_marine,353,205,261,120,558,73.93767705382436,33.994334277620396
37761_marine,360,248,265,123,608,73.61111111111111,34.166666666666664
37767_marine,899,358,556,531,1257,61.846496106785324,59.06562847608454
37768_marine,135,42,121,21,177,89.62962962962962,15.555555555555555
37769_marine,127,47,117,15,174,92.1259842519685,11.811023622047244
37770_marine,127,45,117,15,172,92.1259842519685,11.811023622047244
37771_marine,123,47,113,13,170,91.869918699187,10.569105691056912
37772_marine,106,34,96,13,140,90.56603773584906,12.264150943396226
37773_marine,104,32,94,14,136,90.38461538461539,13.461538461538462
37774_marine,100,32,89,12,132,89,12
37775_marine,100,31,89,12,131,89,12
37776_marine,100,32,89,12,132,89,12
37777_marine,106,33,95,12,139,89.62264150943396,11.320754716981133
37778_marine,106,33,95,12,139,89.62264150943396,11.320754716981133
37779_marine,107,33,95,12,140,88.78504672897196,11.214953271028037
37780_marine,108,33,96,12,141,88.88888888888889,11.11111111111111
37781_marine,105,33,94,12,138,89.52380952380953,11.428571428571429
37782_marine,109,34,98,14,143,89.90825688073394,12.844036697247708
37783_marine,111,34,100,14,145,90.09009009009009,12.612612612612612
37784_marine,113,35,102,14,148,90.2654867256637,12.389380530973451
37785_marine,115,35,105,16,150,91.30434782608695,13.91304347826087
37786_marine,716,254,429,457,970,59.91620111731844,63.8268156424581
37787_marine,814,362,497,509,1176,61.056511056511056,62.53071253071253
37788_marine,823,362,503,512,1185,61.11786148238153,62.21142162818955
37789_marine,821,347,503,508,1168,61.26674786845311,61.875761266747865
37790_marine,719,243,433,457,962,60.22253129346314,63.56050069541029
37791_marine,110,37,100,13,147,90.9090909090909,11.818181818181818
37792_marine,109,38,99,13,147,90.82568807339449,11.926605504587156
37793_marine,107,38,97,13,145,90.65420560747664,12.149532710280374
37794_marine,107,39,97,13,146,90.65420560747664,12.149532710280374
37795_marine,109,39,99,13,148,90.82568807339449,11.926605504587156
37796_marine,112,41,102,13,153,91.07142857142857,11.607142857142858
37797_marine,110,42,100,12,152,90.9090909090909,10.909090909090908
37798_marine,112,41,102,14,153,91.07142857142857,12.5
37799_marine,113,43,103,14,156,91.1504424778761,12.389380530973451
37800_marine,567,178,332,380,745,58.553791887125215,67.01940035273368
37801_marine,751,283,470,463,1034,62.5832223701731,61.65113182423435
37802_marine,699,263,429,433,962,61.37339055793991,61.945636623748214
37803_marine,550,170,345,345,720,62.727272727272734,62.727272727272734
37804_marine,561,175,356,343,736,63.45811051693404,61.14081996434938
37805_marine,589,199,378,358,788,64.17657045840407,60.78098471986417
37806_marine,559,182,354,343,741,63.327370304114496,61.35957066189624
37807_marine,585,201,378,355,786,64.61538461538461,60.68376068376068
37808_marine,553,173,352,341,726,63.65280289330922,61.66365280289331
37809_marine,590,201,373,361,791,63.22033898305085,61.186440677966104
37810_marine,592,201,373,363,793,63.00675675675676,61.317567567567565
37811_marine,571,188,361,352,759,63.22241681260946,61.646234676007005
37812_marine,571,186,361,352,757,63.22241681260946,61.646234676007005
37813_marine,98,38,92,10,136,93.87755102040816,10.204081632653061
37814_marine,98,39,92,10,137,93.87755102040816,10.204081632653061
37815_marine,98,39,92,10,137,93.87755102040816,10.204081632653061
37816_marine,96,38,90,10,134,93.75,10.416666666666668
37817_marine,96,38,90,10,134,93.75,10.416666666666668
37818_marine,97,38,91,10,135,93.81443298969072,10.309278350515463
37819_marine,97,38,91,10,135,93.81443298969072,10.309278350515463
37820_marine,98,37,92,10,135,93.87755102040816,10.204081632653061
37821_marine,99,37,93,12,136,93.93939393939394,12.121212121212121
37822_marine,98,37,92,12,135,93.87755102040816,12.244897959183673
37823_marine,97,40,91,12,137,93.81443298969072,12.371134020618557
37824_marine,97,40,91,12,137,93.81443298969072,12.371134020618557
37825_marine,474,137,309,297,611,65.18987341772153,62.65822784810127
37826_marine,490,149,319,307,639,65.10204081632654,62.65306122448979
37827_marine,491,138,316,307,629,64.35845213849288,62.52545824847251
37828_marine,491,140,316,307,631,64.35845213849288,62.52545824847251
37829_marine,491,143,316,307,634,64.35845213849288,62.52545824847251
37830_marine,491,138,316,307,629,64.35845213849288,62.52545824847251
37831_marine,456,119,304,276,575,66.66666666666666,60.526315789473685
37832_marine,485,141,326,292,626,67.21649484536083,60.20618556701031
37833_marine,484,134,325,294,618,67.14876033057851,60.74380165289256
37834_marine,479,134,322,292,613,67.22338204592901,60.96033402922756
37835_marine,474,136,322,287,610,67.9324894514768,60.54852320675106
37836_marine,472,138,320,287,610,67.79661016949152,60.80508474576271
37837_marine,452,117,304,274,569,67.2566371681416,60.61946902654868
37838_marine,470,130,320,283,600,68.08510638297872,60.21276595744681
37839_marine,452,115,304,279,567,67.2566371681416,61.72566371681416
37840_marine,460,121,310,284,581,67.3913043478261,61.73913043478261
37841_marine,418,105,284,258,523,67.94258373205741,61.72248803827751
37842_marine,370,95,256,224,465,69.1891891891892,60.54054054054055
37843_marine,366,90,254,222,456,69.39890710382514,60.65573770491803
37844_marine,98,41,92,11,139,93.87755102040816,11.224489795918368
37845_marine,97,40,91,10,137,93.81443298969072,10.309278350515463
37846_marine,96,38,90,11,134,93.75,11.458333333333332
37847_marine,98,38,92,11,136,93.87755102040816,11.224489795918368
37848_marine,98,38,92,11,136,93.87755102040816,11.224489795918368
37849_marine,98,38,92,11,136,93.87755102040816,11.224489795918368
37850_marine,98,38,92,11,136,93.87755102040816,11.224489795918368
37851_marine,98,38,92,11,136,93.87755102040816,11.224489795918368
37852_marine,98,37,92,11,135,93.87755102040816,11.224489795918368
37853_marine,97,35,91,11,132,93.81443298969072,11.34020618556701
37854_marine,91,35,85,9,126,93.4065934065934,9.89010989010989
37855_marine,91,34,85,9,125,93.4065934065934,9.89010989010989
37856_marine,90,34,84,9,124,93.33333333333333,10
37857_marine,90,35,84,9,125,93.33333333333333,10
37858_marine,88,35,82,9,123,93.18181818181817,10.227272727272728
37859_marine,86,35,80,9,121,93.02325581395348,10.465116279069768
37860_marine,86,35,80,9,121,93.02325581395348,10.465116279069768
37861_marine,86,35,80,9,121,93.02325581395348,10.465116279069768
37862_marine,86,35,80,9,121,93.02325581395348,10.465116279069768
37863_marine,86,35,80,9,121,93.02325581395348,10.465116279069768
37864_marine,86,35,80,9,121,93.02325581395348,10.465116279069768
37865_marine,85,35,80,8,120,94.11764705882352,9.411764705882353
37866_marine,86,35,81,8,121,94.18604651162791,9.30232558139535
37867_marine,85,33,80,7,118,94.11764705882352,8.235294117647058
37868_marine,85,33,80,7,118,94.11764705882352,8.235294117647058
37869_marine,84,33,79,6,117,94.04761904761905,7.142857142857142
37870_marine,84,33,79,5,117,94.04761904761905,5.952380952380952
37871_marine,82,33,78,4,115,95.1219512195122,4.878048780487805
37872_marine,82,33,78,4,115,95.1219512195122,4.878048780487805
37873_marine,82,35,78,4,117,95.1219512195122,4.878048780487805
37874_marine,82,35,78,4,117,95.1219512195122,4.878048780487805
37875_marine,82,35,78,4,117,95.1219512195122,4.878048780487805
37876_marine,82,35,78,4,117,95.1219512195122,4.878048780487805
37877_marine,82,36,78,4,118,95.1219512195122,4.878048780487805
37878_marine,82,36,78,4,118,95.1219512195122,4.878048780487805
37879_marine,81,36,77,4,117,95.06172839506173,4.938271604938271
37880_marine,80,37,76,4,117,95,5
37881_marine,81,37,77,4,118,95.06172839506173,4.938271604938271
37882_marine,81,37,77,4,118,95.06172839506173,4.938271604938271
37883_marine,81,37,77,4,118,95.06172839506173,4.938271604938271
37884_marine,82,37,78,4,119,95.1219512195122,4.878048780487805
37885_marine,82,37,78,4,119,95.1219512195122,4.878048780487805
37886_marine,81,38,77,4,119,95.06172839506173,4.938271604938271
37887_marine,82,39,78,5,121,95.1219512195122,6.097560975609756
37888_marine,84,39,80,5,123,95.23809523809523,5.952380952380952
37889_marine,83,38,80,4,121,96.3855421686747,4.819277108433735
37890_marine,83,36,80,4,119,96.3855421686747,4.819277108433735
37891_marine,83,38,80,4,121,96.3855421686747,4.819277108433735
37892_marine,83,38,80,4,121,96.3855421686747,4.819277108433735
37893_marine,82,38,79,4,120,96.34146341463415,4.878048780487805
37894_marine,83,38,80,4,121,96.3855421686747,4.819277108433735
37895_marine,83,38,80,4,121,96.3855421686747,4.819277108433735
37896_marine,82,39,78,4,121,95.1219512195122,4.878048780487805
37897_marine,82,42,78,4,124,95.1219512195122,4.878048780487805
37898_marine,83,42,78,5,125,93.97590361445783,6.024096385542169
37899_marine,86,42,81,5,128,94.18604651162791,5.813953488372093
37900_marine,89,42,84,5,131,94.3820224719101,5.617977528089887
37901_marine,92,43,87,5,135,94.56521739130434,5.434782608695652
37902_marine,103,43,97,5,146,94.1747572815534,4.854368932038835
37903_marine,116,56,109,12,172,93.96551724137932,10.344827586206897
37904_marine,189,100,159,31,289,84.12698412698413,16.402116402116402
37905_marine,290,229,202,110,519,69.6551724137931,37.93103448275862
37906_marine,282,209,196,105,491,69.50354609929079,37.234042553191486
37943_marine,325,163,272,94,488,83.6923076923077,28.923076923076923
37944_marine,112,41,107,9,153,95.53571428571429,8.035714285714286
37945_marine,107,39,102,7,146,95.32710280373831,6.5420560747663545
37946_marine,99,37,94,7,136,94.94949494949495,7.07070707070707
37947_marine,94,37,90,5,131,95.74468085106383,5.319148936170213
37948_marine,91,37,87,4,128,95.6043956043956,4.395604395604396
37949_marine,91,35,87,4,126,95.6043956043956,4.395604395604396
37950_marine,91,36,87,4,127,95.6043956043956,4.395604395604396
37951_marine,92,34,88,4,126,95.65217391304348,4.3478260869565215
37952_marine,91,34,87,4,125,95.6043956043956,4.395604395604396
37953_marine,90,36,85,5,126,94.44444444444444,5.555555555555555
37954_marine,90,36,85,5,126,94.44444444444444,5.555555555555555
37955_marine,88,36,83,5,124,94.31818181818183,5.681818181818182
37956_marine,86,36,81,5,122,94.18604651162791,5.813953488372093
37957_marine,86,36,81,5,122,94.18604651162791,5.813953488372093
37958_marine,85,36,80,5,121,94.11764705882352,5.88235294117647
37959_marine,84,36,79,5,120,94.04761904761905,5.952380952380952
37960_marine,84,36,79,5,120,94.04761904761905,5.952380952380952
37961_marine,84,36,79,5,120,94.04761904761905,5.952380952380952
37962_marine,85,36,79,6,121,92.94117647058823,7.0588235294117645
37963_marine,85,36,79,5,121,92.94117647058823,5.88235294117647
37964_marine,85,36,79,5,121,92.94117647058823,5.88235294117647
37965_marine,85,35,79,5,120,92.94117647058823,5.88235294117647
37966_marine,85,35,79,5,120,92.94117647058823,5.88235294117647
37967_marine,85,35,79,5,120,92.94117647058823,5.88235294117647
37968_marine,85,35,79,5,120,92.94117647058823,5.88235294117647
37969_marine,86,35,80,6,121,93.02325581395348,6.976744186046512
37970_marine,84,35,79,5,119,94.04761904761905,5.952380952380952
37971_marine,84,35,79,5,119,94.04761904761905,5.952380952380952
37972_marine,85,37,80,5,122,94.11764705882352,5.88235294117647
37973_marine,94,39,89,7,133,94.68085106382979,7.446808510638298
37974_marine,114,57,107,13,171,93.85964912280701,11.403508771929824
37975_marine,128,65,117,24,193,91.40625,18.75
37976_marine,115,54,107,13,169,93.04347826086956,11.304347826086957
37977_marine,91,37,85,5,128,93.4065934065934,5.4945054945054945
37978_marine,91,34,85,5,125,93.4065934065934,5.4945054945054945
37979_marine,91,33,85,5,124,93.4065934065934,5.4945054945054945
37980_marine,85,33,80,3,118,94.11764705882352,3.5294117647058822
37981_marine,80,35,75,3,115,93.75,3.75
37982_marine,79,35,74,2,114,93.67088607594937,2.5316455696202533
37983_marine,78,35,73,2,113,93.58974358974359,2.564102564102564
37984_marine,78,35,73,2,113,93.58974358974359,2.564102564102564
37985_marine,77,37,71,1,114,92.20779220779221,1.2987012987012987
37986_marine,78,34,72,1,112,92.3076923076923,1.282051282051282
37987_marine,80,34,74,1,114,92.5,1.25
37988_marine,83,34,77,1,117,92.7710843373494,1.2048192771084338
37989_marine,94,36,88,1,130,93.61702127659575,1.0638297872340425
37990_marine,92,36,87,2,128,94.56521739130434,2.1739130434782608
37991_marine,184,92,171,17,276,92.93478260869566,9.239130434782608
38022_marine,660,231,457,345,891,69.24242424242424,52.27272727272727
38023_marine,108,38,101,12,146,93.51851851851852,11.11111111111111
38024_marine,621,184,430,323,805,69.24315619967794,52.012882447665056
38025_marine,644,203,454,330,847,70.4968944099379,51.24223602484472
38032_marine,603,161,406,327,764,67.33001658374793,54.22885572139303
38033_marine,90,31,84,8,121,93.33333333333333,8.88888888888889
38034_marine,191,50,141,92,241,73.82198952879581,48.167539267015705
38035_marine,196,54,145,98,250,73.9795918367347,50
38036_marine,194,55,144,91,249,74.22680412371135,46.90721649484536
38037_marine,94,35,88,8,129,93.61702127659575,8.51063829787234
38038_marine,92,35,86,8,127,93.47826086956522,8.695652173913043
38039_marine,90,35,84,8,125,93.33333333333333,8.88888888888889
38040_marine,222,74,174,98,296,78.37837837837837,44.14414414414414
38041_marine,220,74,172,98,294,78.18181818181819,44.54545454545455
38042_marine,97,37,88,15,134,90.72164948453609,15.463917525773196
38043_marine,86,32,81,6,118,94.18604651162791,6.976744186046512
38044_marine,83,32,78,5,115,93.97590361445783,6.024096385542169
38045_marine,81,31,76,5,112,93.82716049382715,6.172839506172839
38046_marine,81,30,76,5,111,93.82716049382715,6.172839506172839
38047_marine,81,30,76,5,111,93.82716049382715,6.172839506172839
38048_marine,81,30,76,6,111,93.82716049382715,7.4074074074074066
38049_marine,81,30,76,6,111,93.82716049382715,7.4074074074074066
38050_marine,77,29,72,6,106,93.5064935064935,7.792207792207792
38051_marine,77,29,72,6,106,93.5064935064935,7.792207792207792
38052_marine,77,29,72,6,106,93.5064935064935,7.792207792207792
38053_marine,77,29,72,6,106,93.5064935064935,7.792207792207792
38054_marine,77,29,72,6,106,93.5064935064935,7.792207792207792
38055_marine,75,29,70,6,104,93.33333333333333,8
38056_marine,75,29,70,6,104,93.33333333333333,8
38057_marine,75,29,70,6,104,93.33333333333333,8
38058_marine,75,29,70,6,104,93.33333333333333,8
38059_marine,76,29,71,7,105,93.42105263157895,9.210526315789473
38060_marine,76,29,71,7,105,93.42105263157895,9.210526315789473
38061_marine,76,29,71,7,105,93.42105263157895,9.210526315789473
38062_marine,76,29,71,7,105,93.42105263157895,9.210526315789473
38063_marine,76,30,71,7,106,93.42105263157895,9.210526315789473
38064_marine,76,30,71,7,106,93.42105263157895,9.210526315789473
38065_marine,76,30,71,7,106,93.42105263157895,9.210526315789473
38066_marine,78,30,73,7,108,93.58974358974359,8.974358974358974
38067_marine,78,30,73,7,108,93.58974358974359,8.974358974358974
38068_marine,78,31,73,7,109,93.58974358974359,8.974358974358974
38069_marine,78,31,73,7,109,93.58974358974359,8.974358974358974
38070_marine,78,31,73,7,109,93.58974358974359,8.974358974358974
38071_marine,78,31,73,7,109,93.58974358974359,8.974358974358974
38072_marine,78,30,73,7,108,93.58974358974359,8.974358974358974
38073_marine,77,30,73,6,107,94.8051948051948,7.792207792207792
38074_marine,77,30,73,6,107,94.8051948051948,7.792207792207792
38075_marine,77,30,73,6,107,94.8051948051948,7.792207792207792
38076_marine,77,30,73,6,107,94.8051948051948,7.792207792207792
38077_marine,79,30,75,6,109,94.9367088607595,7.59493670886076
38078_marine,79,30,75,6,109,94.9367088607595,7.59493670886076
38079_marine,82,30,77,7,112,93.90243902439023,8.536585365853659
38080_marine,82,30,77,7,112,93.90243902439023,8.536585365853659
38081_marine,82,30,77,7,112,93.90243902439023,8.536585365853659
38082_marine,82,30,77,7,112,93.90243902439023,8.536585365853659
38083_marine,82,30,77,7,112,93.90243902439023,8.536585365853659
38084_marine,83,30,77,7,113,92.7710843373494,8.433734939759036
38085_marine,86,30,80,7,116,93.02325581395348,8.13953488372093
38086_marine,86,30,80,7,116,93.02325581395348,8.13953488372093
38087_marine,87,30,81,8,117,93.10344827586206,9.195402298850574
38088_marine,88,29,81,9,117,92.04545454545455,10.227272727272728
38089_marine,88,29,81,9,117,92.04545454545455,10.227272727272728
38090_marine,88,29,81,9,117,92.04545454545455,10.227272727272728
38091_marine,89,29,82,9,118,92.13483146067416,10.112359550561797
38092_marine,88,29,81,9,117,92.04545454545455,10.227272727272728
38093_marine,90,30,83,9,120,92.22222222222223,10
38094_marine,89,30,83,9,119,93.25842696629213,10.112359550561797
38095_marine,93,30,87,9,123,93.54838709677419,9.67741935483871
38096_marine,97,29,91,9,126,93.81443298969072,9.278350515463918
38097_marine,104,29,98,11,133,94.23076923076923,10.576923076923077
38098_marine,105,33,100,10,138,95.23809523809523,9.523809523809524
38099_marine,120,61,113,9,181,94.16666666666667,7.5
38100_marine,396,93,265,224,489,66.91919191919192,56.56565656565656
38101_marine,678,250,461,352,928,67.99410029498524,51.91740412979351
38102_marine,756,282,515,399,1038,68.12169312169311,52.77777777777778
38103_marine,725,295,491,388,1020,67.72413793103448,53.51724137931034
38104_marine,632,319,415,326,951,65.66455696202532,51.58227848101266
38119_marine,361,247,266,124,608,73.68421052631578,34.34903047091413
38120_marine,361,247,266,124,608,73.68421052631578,34.34903047091413
38121_marine,363,254,268,124,617,73.82920110192838,34.15977961432507
38127_marine,894,370,551,527,1264,61.6331096196868,58.94854586129754
38128_marine,150,65,138,22,215,92,14.666666666666666
38129_marine,654,195,418,405,849,63.91437308868502,61.92660550458715
38130_marine,661,191,425,402,852,64.2965204236006,60.816944024205746
38131_marine,637,166,401,400,803,62.95133437990581,62.79434850863422
38132_marine,116,52,106,16,168,91.37931034482759,13.793103448275861
38133_marine,102,36,92,14,138,90.19607843137256,13.725490196078432
38134_marine,101,33,90,13,134,89.10891089108911,12.871287128712872
38135_marine,99,33,88,11,132,88.88888888888889,11.11111111111111
38136_marine,100,34,89,12,134,89,12
38137_marine,104,32,93,12,136,89.42307692307693,11.538461538461538
38138_marine,108,32,97,14,140,89.81481481481481,12.962962962962962
38139_marine,108,33,96,14,141,88.88888888888889,12.962962962962962
38140_marine,108,33,96,14,141,88.88888888888889,12.962962962962962
38141_marine,108,34,96,14,142,88.88888888888889,12.962962962962962
38142_marine,112,34,101,14,146,90.17857142857143,12.5
38143_marine,111,34,100,14,145,90.09009009009009,12.612612612612612
38144_marine,112,35,102,14,147,91.07142857142857,12.5
38145_marine,115,35,105,16,150,91.30434782608695,13.91304347826087
38146_marine,716,256,429,457,972,59.91620111731844,63.8268156424581
38147_marine,819,359,498,514,1178,60.8058608058608,62.75946275946276
38148_marine,843,373,522,513,1216,61.92170818505338,60.854092526690394
38149_marine,819,342,500,508,1161,61.05006105006105,62.02686202686203
38150_marine,722,245,434,459,967,60.11080332409973,63.57340720221607
38151_marine,112,36,102,13,148,91.07142857142857,11.607142857142858
38152_marine,109,38,99,13,147,90.82568807339449,11.926605504587156
38153_marine,107,39,97,13,146,90.65420560747664,12.149532710280374
38154_marine,107,39,97,13,146,90.65420560747664,12.149532710280374
38155_marine,110,41,100,13,151,90.9090909090909,11.818181818181818
38156_marine,126,52,112,21,178,88.88888888888889,16.666666666666664
38157_marine,576,180,339,382,756,58.854166666666664,66.31944444444444
38158_marine,706,239,438,436,945,62.03966005665722,61.756373937677054
38159_marine,714,248,446,436,962,62.46498599439776,61.06442577030813
38160_marine,714,257,446,437,971,62.46498599439776,61.20448179271709
38161_marine,792,328,503,480,1120,63.510101010101,60.60606060606061
38162_marine,702,244,432,431,946,61.53846153846154,61.396011396011396
38163_marine,675,226,409,428,901,60.592592592592595,63.40740740740741
38164_marine,559,171,354,343,730,63.327370304114496,61.35957066189624
38165_marine,559,176,354,343,735,63.327370304114496,61.35957066189624
38166_marine,556,183,351,343,739,63.12949640287769,61.69064748201439
38167_marine,554,179,353,339,733,63.718411552346566,61.191335740072205
38168_marine,552,173,351,339,725,63.58695652173913,61.41304347826087
38169_marine,99,37,90,11,136,90.9090909090909,11.11111111111111
38170_marine,96,37,90,10,133,93.75,10.416666666666668
38171_marine,96,37,90,10,133,93.75,10.416666666666668
38172_marine,96,37,90,10,133,93.75,10.416666666666668
38173_marine,96,38,90,10,134,93.75,10.416666666666668
38174_marine,96,38,90,10,134,93.75,10.416666666666668
38175_marine,96,39,90,10,135,93.75,10.416666666666668
38176_marine,96,38,90,10,134,93.75,10.416666666666668
38177_marine,96,38,90,10,134,93.75,10.416666666666668
38178_marine,97,37,91,10,134,93.81443298969072,10.309278350515463
38179_marine,97,37,91,10,134,93.81443298969072,10.309278350515463
38180_marine,96,36,90,10,132,93.75,10.416666666666668
38181_marine,97,36,91,12,133,93.81443298969072,12.371134020618557
38182_marine,95,37,89,12,132,93.6842105263158,12.631578947368421
38183_marine,97,40,91,12,137,93.81443298969072,12.371134020618557
38184_marine,97,40,91,12,137,93.81443298969072,12.371134020618557
38185_marine,474,137,309,297,611,65.18987341772153,62.65822784810127
38186_marine,498,147,327,307,645,65.66265060240963,61.64658634538153
38187_marine,512,154,331,319,666,64.6484375,62.3046875
38188_marine,518,159,336,322,677,64.86486486486487,62.16216216216216
38189_marine,530,164,346,325,694,65.28301886792453,61.32075471698113
38190_marine,526,164,344,324,690,65.39923954372624,61.59695817490495
38191_marine,529,165,347,327,694,65.59546313799622,61.81474480151229
38192_marine,503,151,328,309,654,65.20874751491054,61.431411530815105
38193_marine,488,127,323,299,615,66.18852459016394,61.270491803278695
38194_marine,482,143,328,290,625,68.04979253112033,60.16597510373444
38195_marine,472,135,320,287,607,67.79661016949152,60.80508474576271
38196_marine,473,135,321,288,608,67.8646934460888,60.887949260042284
38197_marine,470,130,320,283,600,68.08510638297872,60.21276595744681
38198_marine,471,128,321,284,599,68.15286624203821,60.29723991507431
38199_marine,459,126,309,283,585,67.3202614379085,61.6557734204793
38200_marine,453,124,311,275,577,68.65342163355407,60.70640176600441
38201_marine,424,104,286,262,528,67.45283018867924,61.79245283018868
38202_marine,418,98,280,260,516,66.98564593301435,62.20095693779905
38203_marine,416,97,278,260,513,66.82692307692307,62.5
38204_marine,95,36,89,10,131,93.6842105263158,10.526315789473683
38205_marine,97,36,91,10,133,93.81443298969072,10.309278350515463
38206_marine,97,37,91,12,134,93.81443298969072,12.371134020618557
38207_marine,96,35,90,11,131,93.75,11.458333333333332
38208_marine,97,37,91,11,134,93.81443298969072,11.34020618556701
38209_marine,96,37,90,11,133,93.75,11.458333333333332
38210_marine,96,37,90,11,133,93.75,11.458333333333332
38211_marine,95,36,89,11,131,93.6842105263158,11.578947368421053
38212_marine,95,34,89,11,129,93.6842105263158,11.578947368421053
38213_marine,92,35,86,9,127,93.47826086956522,9.782608695652174
38214_marine,92,35,86,9,127,93.47826086956522,9.782608695652174
38215_marine,92,35,86,9,127,93.47826086956522,9.782608695652174
38216_marine,90,35,84,9,125,93.33333333333333,10
38217_marine,90,34,84,9,124,93.33333333333333,10
38218_marine,88,34,82,9,122,93.18181818181817,10.227272727272728
38219_marine,88,34,82,9,122,93.18181818181817,10.227272727272728
38220_marine,86,34,80,9,120,93.02325581395348,10.465116279069768
38221_marine,86,35,80,9,121,93.02325581395348,10.465116279069768
38222_marine,86,35,80,9,121,93.02325581395348,10.465116279069768
38223_marine,86,35,80,9,121,93.02325581395348,10.465116279069768
38224_marine,86,35,80,9,121,93.02325581395348,10.465116279069768
38225_marine,86,34,80,9,120,93.02325581395348,10.465116279069768
38226_marine,85,34,79,9,119,92.94117647058823,10.588235294117647
38227_marine,84,33,79,8,117,94.04761904761905,9.523809523809524
38228_marine,83,33,79,8,116,95.18072289156626,9.63855421686747
38229_marine,83,33,79,8,116,95.18072289156626,9.63855421686747
38230_marine,81,33,77,6,114,95.06172839506173,7.4074074074074066
38231_marine,80,33,76,4,113,95,5
38232_marine,80,33,76,4,113,95,5
38233_marine,80,33,76,4,113,95,5
38234_marine,80,33,76,4,113,95,5
38235_marine,82,35,78,4,117,95.1219512195122,4.878048780487805
38236_marine,82,35,78,4,117,95.1219512195122,4.878048780487805
38237_marine,82,35,78,4,117,95.1219512195122,4.878048780487805
38238_marine,82,35,78,4,117,95.1219512195122,4.878048780487805
38239_marine,82,35,78,4,117,95.1219512195122,4.878048780487805
38240_marine,81,36,77,4,117,95.06172839506173,4.938271604938271
38241_marine,82,36,78,4,118,95.1219512195122,4.878048780487805
38242_marine,81,36,77,4,117,95.06172839506173,4.938271604938271
38243_marine,81,36,77,4,117,95.06172839506173,4.938271604938271
38244_marine,80,37,76,4,117,95,5
38245_marine,80,37,76,4,117,95,5
38246_marine,78,37,74,4,115,94.87179487179486,5.128205128205128
38247_marine,81,38,77,4,119,95.06172839506173,4.938271604938271
38248_marine,82,38,78,5,120,95.1219512195122,6.097560975609756
38249_marine,81,38,78,4,119,96.29629629629629,4.938271604938271
38250_marine,81,37,78,4,118,96.29629629629629,4.938271604938271
38251_marine,81,38,78,4,119,96.29629629629629,4.938271604938271
38252_marine,81,38,78,4,119,96.29629629629629,4.938271604938271
38253_marine,81,38,78,4,119,96.29629629629629,4.938271604938271
38254_marine,81,38,78,4,119,96.29629629629629,4.938271604938271
38255_marine,79,38,76,4,117,96.20253164556962,5.063291139240507
38256_marine,79,40,76,4,119,96.20253164556962,5.063291139240507
38257_marine,80,41,76,4,121,95,5
38258_marine,82,42,78,4,124,95.1219512195122,4.878048780487805
38259_marine,83,42,78,5,125,93.97590361445783,6.024096385542169
38260_marine,85,42,80,5,127,94.11764705882352,5.88235294117647
38261_marine,90,41,85,5,131,94.44444444444444,5.555555555555555
38262_marine,99,44,94,5,143,94.94949494949495,5.05050505050505
38263_marine,102,48,96,5,150,94.11764705882352,4.901960784313726
38264_marine,114,53,105,11,167,92.10526315789474,9.649122807017543
38265_marine,185,96,157,30,281,84.86486486486487,16.216216216216218
38266_marine,276,178,195,104,454,70.65217391304348,37.68115942028986
38267_marine,277,219,190,104,496,68.59205776173285,37.545126353790614
38268_marine,277,219,189,107,496,68.23104693140795,38.628158844765345
38303_marine,325,163,272,94,488,83.6923076923077,28.923076923076923
38304_marine,112,45,107,9,157,95.53571428571429,8.035714285714286
38305_marine,101,41,96,7,142,95.04950495049505,6.9306930693069315
38306_marine,100,37,94,7,137,94,7.000000000000001
38307_marine,92,37,88,5,129,95.65217391304348,5.434782608695652
38308_marine,91,37,87,4,128,95.6043956043956,4.395604395604396
38309_marine,92,35,87,5,127,94.56521739130434,5.434782608695652
38310_marine,92,34,87,5,126,94.56521739130434,5.434782608695652
38311_marine,90,34,85,5,124,94.44444444444444,5.555555555555555
38312_marine,90,34,85,5,124,94.44444444444444,5.555555555555555
38313_marine,90,34,85,5,124,94.44444444444444,5.555555555555555
38314_marine,90,36,85,5,126,94.44444444444444,5.555555555555555
38315_marine,86,36,81,5,122,94.18604651162791,5.813953488372093
38316_marine,86,36,81,5,122,94.18604651162791,5.813953488372093
38317_marine,85,36,80,5,121,94.11764705882352,5.88235294117647
38318_marine,85,36,80,5,121,94.11764705882352,5.88235294117647
38319_marine,84,36,79,5,120,94.04761904761905,5.952380952380952
38320_marine,84,36,79,5,120,94.04761904761905,5.952380952380952
38321_marine,84,36,79,5,120,94.04761904761905,5.952380952380952
38322_marine,84,36,79,5,120,94.04761904761905,5.952380952380952
38323_marine,85,36,80,4,121,94.11764705882352,4.705882352941177
38324_marine,85,36,79,5,121,92.94117647058823,5.88235294117647
38325_marine,85,35,79,5,120,92.94117647058823,5.88235294117647
38326_marine,85,35,79,5,120,92.94117647058823,5.88235294117647
38327_marine,85,35,79,5,120,92.94117647058823,5.88235294117647
38328_marine,84,35,79,4,119,94.04761904761905,4.761904761904762
38329_marine,84,35,79,4,119,94.04761904761905,4.761904761904762
38330_marine,85,35,80,5,120,94.11764705882352,5.88235294117647
38331_marine,84,37,80,4,121,95.23809523809523,4.761904761904762
38332_marine,84,37,79,5,121,94.04761904761905,5.952380952380952
38333_marine,88,37,83,7,125,94.31818181818183,7.954545454545454
38334_marine,111,55,104,13,166,93.69369369369369,11.711711711711711
38335_marine,126,65,116,24,191,92.06349206349206,19.047619047619047
38336_marine,114,54,106,13,168,92.98245614035088,11.403508771929824
38337_marine,90,37,84,5,127,93.33333333333333,5.555555555555555
38338_marine,90,34,84,5,124,93.33333333333333,5.555555555555555
38339_marine,88,33,83,3,121,94.31818181818183,3.4090909090909087
38340_marine,84,33,79,3,117,94.04761904761905,3.571428571428571
38341_marine,78,35,73,3,113,93.58974358974359,3.8461538461538463
38342_marine,76,35,71,2,111,93.42105263157895,2.631578947368421
38343_marine,75,35,70,2,110,93.33333333333333,2.666666666666667
38344_marine,75,35,70,1,110,93.33333333333333,1.3333333333333335
38345_marine,76,33,70,1,109,92.10526315789474,1.3157894736842104
38346_marine,76,34,70,1,110,92.10526315789474,1.3157894736842104
38347_marine,80,34,74,1,114,92.5,1.25
38348_marine,85,34,79,1,119,92.94117647058823,1.1764705882352942
38349_marine,90,36,84,1,126,93.33333333333333,1.1111111111111112
38350_marine,91,38,85,2,129,93.4065934065934,2.197802197802198
38351_marine,182,92,169,17,274,92.85714285714286,9.340659340659341
38382_marine,656,232,451,342,888,68.75,52.13414634146341
38383_marine,542,112,378,290,654,69.74169741697416,53.50553505535055
38384_marine,675,229,481,336,904,71.25925925925925,49.77777777777778
38392_marine,602,160,407,325,762,67.60797342192691,53.98671096345515
38393_marine,91,31,85,7,122,93.4065934065934,7.6923076923076925
38394_marine,189,50,139,91,239,73.54497354497354,48.148148148148145
38395_marine,192,53,142,91,245,73.95833333333334,47.39583333333333
38396_marine,193,55,143,92,248,74.09326424870466,47.66839378238342
38397_marine,94,35,88,8,129,93.61702127659575,8.51063829787234
38398_marine,94,35,88,8,129,93.61702127659575,8.51063829787234
38399_marine,227,78,178,99,305,78.41409691629956,43.61233480176212
38400_marine,228,82,177,105,310,77.63157894736842,46.05263157894737
38401_marine,219,76,171,98,295,78.08219178082192,44.74885844748858
38402_marine,84,33,79,7,117,94.04761904761905,8.333333333333332
38403_marine,83,32,78,6,115,93.97590361445783,7.228915662650602
38404_marine,83,31,78,5,114,93.97590361445783,6.024096385542169
38405_marine,81,31,76,5,112,93.82716049382715,6.172839506172839
38406_marine,81,30,76,5,111,93.82716049382715,6.172839506172839
38407_marine,80,30,75,5,110,93.75,6.25
38408_marine,80,30,75,5,110,93.75,6.25
38409_marine,78,29,73,5,107,93.58974358974359,6.41025641025641
38410_marine,76,29,71,5,105,93.42105263157895,6.578947368421052
38411_marine,76,29,71,5,105,93.42105263157895,6.578947368421052
38412_marine,76,29,71,5,105,93.42105263157895,6.578947368421052
38413_marine,76,29,71,5,105,93.42105263157895,6.578947368421052
38414_marine,74,29,69,5,103,93.24324324324324,6.756756756756757
38415_marine,74,29,69,5,103,93.24324324324324,6.756756756756757
38416_marine,74,29,69,5,103,93.24324324324324,6.756756756756757
38417_marine,74,29,69,5,103,93.24324324324324,6.756756756756757
38418_marine,74,29,69,5,103,93.24324324324324,6.756756756756757
38419_marine,74,29,69,5,103,93.24324324324324,6.756756756756757
38420_marine,74,27,69,5,101,93.24324324324324,6.756756756756757
38421_marine,74,27,69,5,101,93.24324324324324,6.756756756756757
38422_marine,74,27,69,5,101,93.24324324324324,6.756756756756757
38423_marine,74,27,69,5,101,93.24324324324324,6.756756756756757
38424_marine,75,27,70,6,102,93.33333333333333,8
38425_marine,75,27,70,6,102,93.33333333333333,8
38426_marine,75,28,70,6,103,93.33333333333333,8
38427_marine,77,28,72,6,105,93.5064935064935,7.792207792207792
38428_marine,77,28,72,6,105,93.5064935064935,7.792207792207792
38429_marine,77,29,72,6,106,93.5064935064935,7.792207792207792
38430_marine,76,29,72,5,105,94.73684210526315,6.578947368421052
38431_marine,76,29,72,5,105,94.73684210526315,6.578947368421052
38432_marine,76,29,72,5,105,94.73684210526315,6.578947368421052
38433_marine,76,28,72,5,104,94.73684210526315,6.578947368421052
38434_marine,76,28,72,5,104,94.73684210526315,6.578947368421052
38435_marine,77,28,73,6,105,94.8051948051948,7.792207792207792
38436_marine,79,28,75,6,107,94.9367088607595,7.59493670886076
38437_marine,79,28,75,6,107,94.9367088607595,7.59493670886076
38438_marine,79,28,75,6,107,94.9367088607595,7.59493670886076
38439_marine,79,30,75,6,109,94.9367088607595,7.59493670886076
38440_marine,79,30,75,6,109,94.9367088607595,7.59493670886076
38441_marine,82,30,77,7,112,93.90243902439023,8.536585365853659
38442_marine,82,30,77,7,112,93.90243902439023,8.536585365853659
38443_marine,82,30,77,7,112,93.90243902439023,8.536585365853659
38444_marine,82,30,77,7,112,93.90243902439023,8.536585365853659
38445_marine,84,30,78,7,114,92.85714285714286,8.333333333333332
38446_marine,83,30,77,7,113,92.7710843373494,8.433734939759036
38447_marine,86,30,80,7,116,93.02325581395348,8.13953488372093
38448_marine,88,29,81,9,117,92.04545454545455,10.227272727272728
38449_marine,88,29,81,9,117,92.04545454545455,10.227272727272728
38450_marine,88,29,81,9,117,92.04545454545455,10.227272727272728
38451_marine,90,29,83,9,119,92.22222222222223,10
38452_marine,89,29,82,9,118,92.13483146067416,10.112359550561797
38453_marine,90,30,83,9,120,92.22222222222223,10
38454_marine,93,30,87,8,123,93.54838709677419,8.60215053763441
38455_marine,100,30,95,10,130,95,10
38456_marine,106,29,101,12,135,95.28301886792453,11.320754716981133
38457_marine,105,31,100,10,136,95.23809523809523,9.523809523809524
38458_marine,125,59,118,12,184,94.39999999999999,9.6
38459_marine,189,112,176,25,301,93.12169312169311,13.227513227513226
38460_marine,469,151,327,243,620,69.7228144989339,51.812366737739865
38461_marine,702,270,483,359,972,68.80341880341881,51.13960113960114
38462_marine,713,301,491,366,1014,68.86395511921458,51.332398316970554
38487_marine,1121,556,657,693,1677,58.60838537020518,61.81980374665478
38488_marine,180,84,161,32,264,89.44444444444444,17.77777777777778
38489_marine,676,211,438,405,887,64.79289940828401,59.9112426035503
38490_marine,693,224,444,425,917,64.06926406926407,61.327561327561334
38491_marine,661,205,423,402,866,63.993948562783665,60.816944024205746
38492_marine,618,184,388,388,802,62.7831715210356,62.7831715210356
38493_marine,606,173,380,384,779,62.70627062706271,63.366336633663366
38494_marine,601,147,374,384,748,62.229617304492514,63.89351081530782
38495_marine,101,35,90,13,136,89.10891089108911,12.871287128712872
38496_marine,591,164,367,378,755,62.098138747884946,63.95939086294417
38497_marine,594,164,370,378,758,62.2895622895623,63.63636363636363
38498_marine,107,34,96,14,141,89.7196261682243,13.084112149532709
38499_marine,107,32,96,14,139,89.7196261682243,13.084112149532709
38500_marine,109,33,97,14,142,88.9908256880734,12.844036697247708
38501_marine,109,34,97,14,143,88.9908256880734,12.844036697247708
38502_marine,111,34,100,14,145,90.09009009009009,12.612612612612612
38503_marine,113,43,103,14,156,91.1504424778761,12.389380530973451
38504_marine,114,46,104,14,160,91.22807017543859,12.280701754385964
38505_marine,111,37,101,14,148,90.990990990991,12.612612612612612
38506_marine,716,250,430,456,966,60.055865921787714,63.687150837988824
38507_marine,725,265,434,462,990,59.862068965517246,63.724137931034484
38508_marine,815,353,497,508,1168,60.98159509202454,62.33128834355828
38509_marine,824,344,505,509,1168,61.286407766990294,61.771844660194176
38510_marine,728,261,437,462,989,60.027472527472526,63.46153846153846
38511_marine,112,38,102,13,150,91.07142857142857,11.607142857142858
38512_marine,110,38,100,13,148,90.9090909090909,11.818181818181818
38513_marine,108,39,98,13,147,90.74074074074075,12.037037037037036
38514_marine,108,39,98,13,147,90.74074074074075,12.037037037037036
38515_marine,111,40,101,13,151,90.990990990991,11.711711711711711
38516_marine,706,235,439,433,941,62.18130311614731,61.331444759206796
38517_marine,710,248,442,436,958,62.25352112676056,61.408450704225345
38518_marine,784,306,497,476,1090,63.39285714285714,60.71428571428571
38519_marine,809,343,512,492,1152,63.28800988875154,60.81582200247219
38520_marine,818,357,518,495,1175,63.325183374083124,60.51344743276283
38521_marine,768,291,486,461,1059,63.28125,60.026041666666664
38522_marine,744,274,462,456,1018,62.096774193548384,61.29032258064516
38523_marine,677,226,411,428,903,60.70901033973413,63.22008862629247
38524_marine,102,39,93,9,141,91.17647058823529,8.823529411764707
38525_marine,663,206,406,415,869,61.236802413273004,62.594268476621416
38526_marine,672,213,415,415,885,61.75595238095239,61.75595238095239
38527_marine,666,210,409,415,876,61.41141141141141,62.312312312312315
38528_marine,97,37,88,9,134,90.72164948453609,9.278350515463918
38529_marine,98,36,89,9,134,90.81632653061224,9.183673469387756
38530_marine,97,36,91,10,133,93.81443298969072,10.309278350515463
38531_marine,399,106,267,249,505,66.9172932330827,62.40601503759399
38532_marine,96,36,90,10,132,93.75,10.416666666666668
38533_marine,96,37,90,10,133,93.75,10.416666666666668
38534_marine,96,37,90,10,133,93.75,10.416666666666668
38535_marine,96,37,90,10,133,93.75,10.416666666666668
38536_marine,94,37,88,10,131,93.61702127659575,10.638297872340425
38537_marine,114,47,102,20,161,89.47368421052632,17.543859649122805
38538_marine,99,40,93,10,139,93.93939393939394,10.1010101010101
38539_marine,97,37,91,10,134,93.81443298969072,10.309278350515463
38540_marine,432,108,288,270,540,66.66666666666666,62.5
38541_marine,434,108,290,272,542,66.82027649769586,62.67281105990783
38542_marine,95,36,89,12,131,93.6842105263158,12.631578947368421
38543_marine,95,37,89,12,132,93.6842105263158,12.631578947368421
38544_marine,95,37,89,12,132,93.6842105263158,12.631578947368421
38545_marine,467,129,304,291,596,65.0963597430407,62.31263383297645
38546_marine,471,132,306,293,603,64.96815286624204,62.20806794055201
38547_marine,483,137,312,299,620,64.59627329192547,61.904761904761905
38548_marine,494,142,319,305,636,64.5748987854251,61.74089068825911
38549_marine,496,147,321,305,643,64.71774193548387,61.49193548387096
38550_marine,519,163,337,323,682,64.9325626204239,62.23506743737958
38551_marine,537,169,350,333,706,65.17690875232775,62.01117318435754
38552_marine,510,156,329,322,666,64.50980392156863,63.13725490196078
38553_marine,472,118,309,289,590,65.46610169491525,61.228813559322035
38554_marine,450,117,302,276,567,67.11111111111111,61.33333333333333
38555_marine,472,134,319,288,606,67.58474576271186,61.016949152542374
38556_marine,470,132,320,285,602,68.08510638297872,60.63829787234043
38557_marine,468,130,318,283,598,67.94871794871796,60.470085470085465
38558_marine,466,127,316,283,593,67.81115879828327,60.72961373390557
38559_marine,458,125,312,279,583,68.12227074235808,60.91703056768559
38560_marine,456,126,314,275,582,68.85964912280701,60.30701754385965
38561_marine,432,102,294,264,534,68.05555555555556,61.111111111111114
38562_marine,443,114,301,275,557,67.94582392776523,62.07674943566591
38563_marine,416,97,278,260,513,66.82692307692307,62.5
38564_marine,412,97,278,256,509,67.47572815533981,62.13592233009708
38565_marine,412,93,278,256,505,67.47572815533981,62.13592233009708
38566_marine,93,36,87,10,129,93.54838709677419,10.75268817204301
38567_marine,93,35,87,10,128,93.54838709677419,10.75268817204301
38568_marine,92,35,86,9,127,93.47826086956522,9.782608695652174
38569_marine,92,35,86,9,127,93.47826086956522,9.782608695652174
38570_marine,95,34,89,11,129,93.6842105263158,11.578947368421053
38571_marine,95,36,89,11,131,93.6842105263158,11.578947368421053
38572_marine,95,34,89,11,129,93.6842105263158,11.578947368421053
38573_marine,92,34,86,9,126,93.47826086956522,9.782608695652174
38574_marine,92,34,86,9,126,93.47826086956522,9.782608695652174
38575_marine,91,34,85,9,125,93.4065934065934,9.89010989010989
38576_marine,91,35,85,9,126,93.4065934065934,9.89010989010989
38577_marine,88,35,82,9,123,93.18181818181817,10.227272727272728
38578_marine,88,35,82,9,123,93.18181818181817,10.227272727272728
38579_marine,88,35,82,9,123,93.18181818181817,10.227272727272728
38580_marine,88,34,82,9,122,93.18181818181817,10.227272727272728
38581_marine,86,34,80,9,120,93.02325581395348,10.465116279069768
38582_marine,86,34,80,9,120,93.02325581395348,10.465116279069768
38583_marine,86,34,80,9,120,93.02325581395348,10.465116279069768
38584_marine,86,33,80,9,119,93.02325581395348,10.465116279069768
38585_marine,84,33,79,9,117,94.04761904761905,10.714285714285714
38586_marine,84,34,79,9,118,94.04761904761905,10.714285714285714
38587_marine,84,33,79,9,117,94.04761904761905,10.714285714285714
38588_marine,84,33,79,9,117,94.04761904761905,10.714285714285714
38589_marine,82,33,78,7,115,95.1219512195122,8.536585365853659
38590_marine,82,33,78,7,115,95.1219512195122,8.536585365853659
38591_marine,81,33,77,6,114,95.06172839506173,7.4074074074074066
38592_marine,82,33,78,6,115,95.1219512195122,7.317073170731707
38593_marine,81,33,77,5,114,95.06172839506173,6.172839506172839
38594_marine,80,33,76,4,113,95,5
38595_marine,80,33,76,4,113,95,5
38596_marine,80,33,76,4,113,95,5
38597_marine,80,35,76,4,115,95,5
38598_marine,80,35,76,4,115,95,5
38599_marine,80,35,76,4,115,95,5
38600_marine,82,36,78,4,118,95.1219512195122,4.878048780487805
38601_marine,82,36,78,4,118,95.1219512195122,4.878048780487805
38602_marine,79,37,75,4,116,94.9367088607595,5.063291139240507
38603_marine,79,37,75,4,116,94.9367088607595,5.063291139240507
38604_marine,78,37,74,4,115,94.87179487179486,5.128205128205128
38605_marine,80,37,76,4,117,95,5
38606_marine,80,37,76,4,117,95,5
38607_marine,80,38,76,4,118,95,5
38608_marine,80,38,77,4,118,96.25,5
38609_marine,80,38,77,4,118,96.25,5
38610_marine,81,38,78,4,119,96.29629629629629,4.938271604938271
38611_marine,81,38,78,4,119,96.29629629629629,4.938271604938271
38612_marine,81,38,78,4,119,96.29629629629629,4.938271604938271
38613_marine,81,38,78,4,119,96.29629629629629,4.938271604938271
38614_marine,80,38,77,4,118,96.25,5
38615_marine,79,40,76,4,119,96.20253164556962,5.063291139240507
38616_marine,79,40,76,4,119,96.20253164556962,5.063291139240507
38617_marine,81,40,78,4,121,96.29629629629629,4.938271604938271
38618_marine,80,41,76,4,121,95,5
38619_marine,79,42,74,5,121,93.67088607594937,6.329113924050633
38620_marine,80,42,75,5,122,93.75,6.25
38621_marine,82,43,77,5,125,93.90243902439023,6.097560975609756
38622_marine,82,43,77,5,125,93.90243902439023,6.097560975609756
38623_marine,91,44,85,5,135,93.4065934065934,5.4945054945054945
38624_marine,100,48,94,5,148,94,5
38625_marine,106,52,100,9,158,94.33962264150944,8.49056603773585
38626_marine,177,93,151,24,270,85.31073446327684,13.559322033898304
38627_marine,181,95,151,28,276,83.42541436464089,15.469613259668508
38628_marine,273,192,186,107,465,68.13186813186813,39.1941391941392
38662_marine,363,187,291,117,550,80.16528925619835,32.231404958677686
38663_marine,325,165,274,92,490,84.3076923076923,28.307692307692307
38664_marine,116,69,111,11,185,95.6896551724138,9.482758620689655
38665_marine,111,61,106,11,172,95.4954954954955,9.90990990990991
38666_marine,94,39,90,5,133,95.74468085106383,5.319148936170213
38667_marine,91,37,87,4,128,95.6043956043956,4.395604395604396
38668_marine,92,37,87,5,129,94.56521739130434,5.434782608695652
38669_marine,92,33,87,5,125,94.56521739130434,5.434782608695652
38670_marine,90,34,85,5,124,94.44444444444444,5.555555555555555
38671_marine,90,34,85,5,124,94.44444444444444,5.555555555555555
38672_marine,89,34,84,5,123,94.3820224719101,5.617977528089887
38673_marine,88,34,83,5,122,94.31818181818183,5.681818181818182
38674_marine,86,36,81,5,122,94.18604651162791,5.813953488372093
38675_marine,86,36,81,5,122,94.18604651162791,5.813953488372093
38676_marine,86,36,81,5,122,94.18604651162791,5.813953488372093
38677_marine,85,36,80,5,121,94.11764705882352,5.88235294117647
38678_marine,85,36,80,5,121,94.11764705882352,5.88235294117647
38679_marine,84,36,79,5,120,94.04761904761905,5.952380952380952
38680_marine,84,36,79,5,120,94.04761904761905,5.952380952380952
38681_marine,85,35,80,5,120,94.11764705882352,5.88235294117647
38682_marine,86,35,81,5,121,94.18604651162791,5.813953488372093
38683_marine,85,35,80,4,120,94.11764705882352,4.705882352941177
38684_marine,84,35,79,4,119,94.04761904761905,4.761904761904762
38685_marine,84,34,79,4,118,94.04761904761905,4.761904761904762
38686_marine,84,34,79,4,118,94.04761904761905,4.761904761904762
38687_marine,83,34,79,3,117,95.18072289156626,3.614457831325301
38688_marine,82,34,78,3,116,95.1219512195122,3.6585365853658534
38689_marine,82,34,78,3,116,95.1219512195122,3.6585365853658534
38690_marine,81,35,77,3,116,95.06172839506173,3.7037037037037033
38691_marine,81,35,77,4,116,95.06172839506173,4.938271604938271
38692_marine,81,35,77,4,116,95.06172839506173,4.938271604938271
38693_marine,86,37,81,5,123,94.18604651162791,5.813953488372093
38694_marine,87,37,82,7,124,94.25287356321839,8.045977011494253
38695_marine,93,37,88,7,130,94.6236559139785,7.526881720430108
38696_marine,93,37,88,7,130,94.6236559139785,7.526881720430108
38697_marine,87,37,81,4,124,93.10344827586206,4.597701149425287
38698_marine,82,34,77,3,116,93.90243902439023,3.6585365853658534
38699_marine,82,33,77,3,115,93.90243902439023,3.6585365853658534
38700_marine,80,33,75,3,113,93.75,3.75
38701_marine,76,35,71,3,111,93.42105263157895,3.9473684210526314
38702_marine,74,35,69,2,109,93.24324324324324,2.7027027027027026
38703_marine,72,35,67,1,107,93.05555555555556,1.3888888888888888
38704_marine,73,35,68,1,108,93.15068493150685,1.36986301369863
38705_marine,73,32,67,1,105,91.78082191780823,1.36986301369863
38706_marine,75,34,69,1,109,92,1.3333333333333335
38707_marine,77,34,71,1,111,92.20779220779221,1.2987012987012987
38708_marine,80,36,74,1,116,92.5,1.25
38709_marine,80,36,74,1,116,92.5,1.25
38710_marine,87,36,81,2,123,93.10344827586206,2.2988505747126435
38711_marine,158,78,148,12,236,93.67088607594937,7.59493670886076
38741_marine,634,219,442,332,853,69.71608832807571,52.36593059936908
38742_marine,521,104,358,287,625,68.71401151631477,55.08637236084453
38743_marine,549,112,383,294,661,69.76320582877959,53.551912568306015
38751_marine,625,185,437,321,810,69.92,51.35999999999999
38752_marine,106,32,100,11,138,94.33962264150944,10.377358490566039
38753_marine,91,30,85,7,121,93.4065934065934,7.6923076923076925
38754_marine,93,31,87,7,124,93.54838709677419,7.526881720430108
38755_marine,92,34,86,8,126,93.47826086956522,8.695652173913043
38756_marine,92,36,86,8,128,93.47826086956522,8.695652173913043
38757_marine,94,36,88,8,130,93.61702127659575,8.51063829787234
38758_marine,94,36,88,8,130,93.61702127659575,8.51063829787234
38759_marine,227,79,178,99,306,78.41409691629956,43.61233480176212
38760_marine,226,81,178,98,307,78.76106194690266,43.36283185840708
38761_marine,218,77,170,98,295,77.98165137614679,44.95412844036697
38762_marine,84,33,79,7,117,94.04761904761905,8.333333333333332
38763_marine,83,33,78,6,116,93.97590361445783,7.228915662650602
38764_marine,82,30,77,5,112,93.90243902439023,6.097560975609756
38765_marine,80,30,75,5,110,93.75,6.25
38766_marine,80,29,75,5,109,93.75,6.25
38767_marine,80,29,75,5,109,93.75,6.25
38768_marine,78,28,73,5,106,93.58974358974359,6.41025641025641
38769_marine,76,28,71,5,104,93.42105263157895,6.578947368421052
38770_marine,76,28,71,5,104,93.42105263157895,6.578947368421052
38771_marine,76,27,71,5,103,93.42105263157895,6.578947368421052
38772_marine,74,27,69,5,101,93.24324324324324,6.756756756756757
38773_marine,72,27,67,5,99,93.05555555555556,6.944444444444445
38774_marine,72,27,67,5,99,93.05555555555556,6.944444444444445
38775_marine,72,27,67,5,99,93.05555555555556,6.944444444444445
38776_marine,72,27,67,5,99,93.05555555555556,6.944444444444445
38777_marine,71,27,67,4,98,94.36619718309859,5.633802816901409
38778_marine,71,27,67,4,98,94.36619718309859,5.633802816901409
38779_marine,71,27,67,4,98,94.36619718309859,5.633802816901409
38780_marine,71,27,67,4,98,94.36619718309859,5.633802816901409
38781_marine,71,27,67,4,98,94.36619718309859,5.633802816901409
38782_marine,71,27,67,4,98,94.36619718309859,5.633802816901409
38783_marine,71,27,67,4,98,94.36619718309859,5.633802816901409
38784_marine,71,27,67,4,98,94.36619718309859,5.633802816901409
38785_marine,71,27,67,4,98,94.36619718309859,5.633802816901409
38786_marine,71,27,67,4,98,94.36619718309859,5.633802816901409
38787_marine,73,27,69,4,100,94.52054794520548,5.47945205479452
38788_marine,75,28,71,4,103,94.66666666666667,5.333333333333334
38789_marine,76,28,72,5,104,94.73684210526315,6.578947368421052
38790_marine,76,29,72,5,105,94.73684210526315,6.578947368421052
38791_marine,76,29,72,5,105,94.73684210526315,6.578947368421052
38792_marine,76,29,72,5,105,94.73684210526315,6.578947368421052
38793_marine,76,29,72,5,105,94.73684210526315,6.578947368421052
38794_marine,76,28,72,5,104,94.73684210526315,6.578947368421052
38795_marine,78,28,74,5,106,94.87179487179486,6.41025641025641
38796_marine,78,28,74,5,106,94.87179487179486,6.41025641025641
38797_marine,78,28,74,5,106,94.87179487179486,6.41025641025641
38798_marine,78,28,74,5,106,94.87179487179486,6.41025641025641
38799_marine,78,28,74,5,106,94.87179487179486,6.41025641025641
38800_marine,78,28,74,5,106,94.87179487179486,6.41025641025641
38801_marine,78,28,74,5,106,94.87179487179486,6.41025641025641
38802_marine,78,28,74,5,106,94.87179487179486,6.41025641025641
38803_marine,81,28,76,6,109,93.82716049382715,7.4074074074074066
38804_marine,81,28,76,6,109,93.82716049382715,7.4074074074074066
38805_marine,83,28,77,6,111,92.7710843373494,7.228915662650602
38806_marine,83,28,77,6,111,92.7710843373494,7.228915662650602
38807_marine,83,28,77,7,111,92.7710843373494,8.433734939759036
38808_marine,86,27,81,7,113,94.18604651162791,8.13953488372093
38809_marine,87,27,81,8,114,93.10344827586206,9.195402298850574
38810_marine,87,27,81,8,114,93.10344827586206,9.195402298850574
38811_marine,89,27,83,8,116,93.25842696629213,8.98876404494382
38812_marine,93,27,87,8,120,93.54838709677419,8.60215053763441
38813_marine,94,30,88,8,124,93.61702127659575,8.51063829787234
38814_marine,99,30,93,8,129,93.93939393939394,8.080808080808081
38815_marine,108,30,103,12,138,95.37037037037037,11.11111111111111
38816_marine,112,34,107,12,146,95.53571428571429,10.714285714285714
38817_marine,130,61,123,14,191,94.61538461538461,10.76923076923077
38818_marine,177,94,153,48,271,86.4406779661017,27.11864406779661
38819_marine,243,160,209,63,403,86.0082304526749,25.925925925925924
38820_marine,751,317,521,387,1068,69.37416777629826,51.53129161118508
38821_marine,730,298,493,388,1028,67.53424657534246,53.15068493150685
38822_marine,704,307,477,370,1011,67.75568181818183,52.55681818181818
38848_marine,860,355,557,485,1215,64.76744186046511,56.395348837209305
38849_marine,664,228,435,394,892,65.51204819277109,59.337349397590366
38850_marine,655,223,429,395,878,65.49618320610688,60.30534351145038
38851_marine,659,225,424,405,884,64.33990895295902,61.45675265553869
38852_marine,651,202,416,398,853,63.90168970814132,61.136712749615974
38853_marine,630,193,399,393,823,63.33333333333333,62.38095238095238
38854_marine,604,147,377,384,751,62.41721854304636,63.576158940397356
38855_marine,591,137,367,379,728,62.098138747884946,64.12859560067682
38856_marine,622,189,391,389,811,62.86173633440515,62.540192926045016
38857_marine,595,164,371,378,759,62.35294117647059,63.52941176470588
38858_marine,107,35,96,13,142,89.7196261682243,12.149532710280374
38859_marine,106,36,95,14,142,89.62264150943396,13.20754716981132
38860_marine,109,36,97,14,145,88.9908256880734,12.844036697247708
38861_marine,110,34,98,14,144,89.0909090909091,12.727272727272727
38862_marine,109,45,98,14,154,89.90825688073394,12.844036697247708
38863_marine,128,73,114,25,201,89.0625,19.53125
38864_marine,136,73,122,27,209,89.70588235294117,19.852941176470587
38865_marine,114,51,104,16,165,91.22807017543859,14.035087719298245
38866_marine,120,46,110,18,166,91.66666666666666,15
38867_marine,722,252,434,461,974,60.11080332409973,63.850415512465375
38868_marine,724,264,433,462,988,59.806629834254146,63.812154696132595
38869_marine,828,355,506,516,1183,61.111111111111114,62.31884057971014
38870_marine,719,267,436,456,986,60.639777468706534,63.42141863699583
38871_marine,112,39,102,16,151,91.07142857142857,14.285714285714285
38872_marine,109,38,99,13,147,90.82568807339449,11.926605504587156
38873_marine,110,38,100,13,148,90.9090909090909,11.818181818181818
38874_marine,108,39,98,13,147,90.74074074074075,12.037037037037036
38875_marine,109,40,99,13,149,90.82568807339449,11.926605504587156
38876_marine,708,234,440,434,942,62.14689265536724,61.29943502824858
38877_marine,778,305,492,474,1083,63.239074550128535,60.9254498714653
38878_marine,813,343,517,492,1156,63.59163591635917,60.51660516605166
38879_marine,823,355,527,493,1178,64.03402187120292,59.902794653705946
38880_marine,812,346,516,489,1158,63.54679802955665,60.22167487684729
38881_marine,752,281,471,460,1033,62.63297872340425,61.170212765957444
38882_marine,746,281,462,460,1027,61.93029490616622,61.66219839142091
38883_marine,680,226,413,427,906,60.73529411764705,62.794117647058826
38884_marine,102,40,93,9,142,91.17647058823529,8.823529411764707
38885_marine,667,211,410,415,878,61.46926536731634,62.21889055472264
38886_marine,714,238,445,439,952,62.324929971988794,61.484593837535016
38887_marine,714,236,445,437,950,62.324929971988794,61.20448179271709
38888_marine,98,38,91,9,136,92.85714285714286,9.183673469387756
38889_marine,98,36,91,9,134,92.85714285714286,9.183673469387756
38890_marine,466,125,318,284,591,68.24034334763948,60.94420600858369
38891_marine,493,137,339,300,630,68.76267748478702,60.85192697768763
38892_marine,467,120,319,286,587,68.3083511777302,61.24197002141327
38893_marine,98,37,92,10,135,93.87755102040816,10.204081632653061
38894_marine,98,37,92,10,135,93.87755102040816,10.204081632653061
38895_marine,98,37,92,10,135,93.87755102040816,10.204081632653061
38896_marine,98,37,92,10,135,93.87755102040816,10.204081632653061
38897_marine,117,48,104,21,165,88.88888888888889,17.94871794871795
38898_marine,101,40,95,10,141,94.05940594059405,9.900990099009901
38899_marine,99,38,93,10,137,93.93939393939394,10.1010101010101
38900_marine,434,114,290,270,548,66.82027649769586,62.21198156682027
38901_marine,457,123,308,282,580,67.39606126914661,61.70678336980306
38902_marine,434,112,288,272,546,66.3594470046083,62.67281105990783
38903_marine,407,103,275,256,510,67.56756756756756,62.8992628992629
38904_marine,95,36,89,12,131,93.6842105263158,12.631578947368421
38905_marine,97,37,91,12,134,93.81443298969072,12.371134020618557
38906_marine,99,37,93,12,136,93.93939393939394,12.121212121212121
38907_marine,99,37,93,10,136,93.93939393939394,10.1010101010101
38908_marine,101,37,95,10,138,94.05940594059405,9.900990099009901
38909_marine,491,136,316,305,627,64.35845213849288,62.11812627291242
38910_marine,494,142,319,307,636,64.5748987854251,62.145748987854255
38911_marine,492,143,317,307,635,64.43089430894308,62.398373983739845
38912_marine,496,143,321,309,639,64.71774193548387,62.298387096774185
38913_marine,472,118,309,289,590,65.46610169491525,61.228813559322035
38914_marine,448,109,302,274,557,67.41071428571429,61.16071428571429
38915_marine,459,111,313,278,570,68.1917211328976,60.56644880174292
38916_marine,457,113,311,276,570,68.05251641137856,60.393873085339166
38917_marine,438,114,296,268,552,67.57990867579909,61.18721461187214
38918_marine,457,125,315,276,582,68.9277899343545,60.393873085339166
38919_marine,457,122,315,276,579,68.9277899343545,60.393873085339166
38920_marine,456,124,314,275,580,68.85964912280701,60.30701754385965
38921_marine,445,120,303,275,565,68.08988764044945,61.79775280898876
38922_marine,439,115,297,275,554,67.65375854214123,62.64236902050114
38923_marine,438,114,296,273,552,67.57990867579909,62.328767123287676
38924_marine,433,112,295,267,545,68.12933025404158,61.662817551963045
38925_marine,412,95,278,256,507,67.47572815533981,62.13592233009708
38926_marine,93,36,87,9,129,93.54838709677419,9.67741935483871
38927_marine,94,36,88,10,130,93.61702127659575,10.638297872340425
38928_marine,95,35,89,10,130,93.6842105263158,10.526315789473683
38929_marine,95,34,89,10,129,93.6842105263158,10.526315789473683
38930_marine,95,34,89,11,129,93.6842105263158,11.578947368421053
38931_marine,95,34,89,11,129,93.6842105263158,11.578947368421053
38932_marine,95,33,89,11,128,93.6842105263158,11.578947368421053
38933_marine,92,32,86,9,124,93.47826086956522,9.782608695652174
38934_marine,93,34,87,9,127,93.54838709677419,9.67741935483871
38935_marine,93,34,87,9,127,93.54838709677419,9.67741935483871
38936_marine,93,34,87,9,127,93.54838709677419,9.67741935483871
38937_marine,91,34,85,9,125,93.4065934065934,9.89010989010989
38938_marine,91,34,85,9,125,93.4065934065934,9.89010989010989
38939_marine,90,35,84,9,125,93.33333333333333,10
38940_marine,90,35,84,9,125,93.33333333333333,10
38941_marine,90,35,84,9,125,93.33333333333333,10
38942_marine,89,34,84,9,123,94.3820224719101,10.112359550561797
38943_marine,87,33,82,9,120,94.25287356321839,10.344827586206897
38944_marine,87,33,82,9,120,94.25287356321839,10.344827586206897
38945_marine,84,33,79,9,117,94.04761904761905,10.714285714285714
38946_marine,84,33,79,9,117,94.04761904761905,10.714285714285714
38947_marine,84,32,79,9,116,94.04761904761905,10.714285714285714
38948_marine,85,32,80,8,117,94.11764705882352,9.411764705882353
38949_marine,85,33,80,8,118,94.11764705882352,9.411764705882353
38950_marine,85,33,80,8,118,94.11764705882352,9.411764705882353
38951_marine,84,33,79,7,117,94.04761904761905,8.333333333333332
38952_marine,83,33,79,6,116,95.18072289156626,7.228915662650602
38953_marine,83,33,79,6,116,95.18072289156626,7.228915662650602
38954_marine,84,33,80,6,117,95.23809523809523,7.142857142857142
38955_marine,82,33,78,4,115,95.1219512195122,4.878048780487805
38956_marine,82,33,78,4,115,95.1219512195122,4.878048780487805
38957_marine,82,33,78,4,115,95.1219512195122,4.878048780487805
38958_marine,80,33,76,4,113,95,5
38959_marine,81,36,77,4,117,95.06172839506173,4.938271604938271
38960_marine,79,37,75,4,116,94.9367088607595,5.063291139240507
38961_marine,79,37,75,4,116,94.9367088607595,5.063291139240507
38962_marine,81,37,77,4,118,95.06172839506173,4.938271604938271
38963_marine,81,37,77,4,118,95.06172839506173,4.938271604938271
38964_marine,81,37,77,4,118,95.06172839506173,4.938271604938271
38965_marine,81,37,77,4,118,95.06172839506173,4.938271604938271
38966_marine,80,37,76,4,117,95,5
38967_marine,79,38,76,3,117,96.20253164556962,3.79746835443038
38968_marine,79,38,76,3,117,96.20253164556962,3.79746835443038
38969_marine,80,38,77,4,118,96.25,5
38970_marine,80,39,77,4,119,96.25,5
38971_marine,79,39,76,4,118,96.20253164556962,5.063291139240507
38972_marine,77,40,74,4,117,96.1038961038961,5.194805194805195
38973_marine,79,41,76,4,120,96.20253164556962,5.063291139240507
38974_marine,79,41,76,4,120,96.20253164556962,5.063291139240507
38975_marine,78,41,75,4,119,96.15384615384616,5.128205128205128
38976_marine,78,41,75,4,119,96.15384615384616,5.128205128205128
38977_marine,79,40,76,4,119,96.20253164556962,5.063291139240507
38978_marine,75,40,72,4,115,96,5.333333333333334
38979_marine,76,41,72,4,117,94.73684210526315,5.263157894736842
38980_marine,76,43,72,4,119,94.73684210526315,5.263157894736842
38981_marine,79,43,74,5,122,93.67088607594937,6.329113924050633
38982_marine,80,42,75,5,122,93.75,6.25
38983_marine,81,45,75,5,126,92.5925925925926,6.172839506172839
38984_marine,88,46,82,5,134,93.18181818181817,5.681818181818182
38985_marine,92,49,86,5,141,93.47826086956522,5.434782608695652
38986_marine,91,52,85,6,143,93.4065934065934,6.593406593406594
38987_marine,91,51,85,6,142,93.4065934065934,6.593406593406594
38988_marine,164,83,138,24,247,84.14634146341463,14.634146341463413
38989_marine,176,117,146,29,293,82.95454545454545,16.477272727272727
39022_marine,343,176,282,106,519,82.21574344023324,30.903790087463555
39023_marine,321,166,270,92,487,84.11214953271028,28.66043613707165
39024_marine,108,51,103,7,159,95.37037037037037,6.481481481481481
39025_marine,106,55,100,11,161,94.33962264150944,10.377358490566039
39026_marine,94,39,90,5,133,95.74468085106383,5.319148936170213
39027_marine,91,37,87,4,128,95.6043956043956,4.395604395604396
39028_marine,92,33,87,5,125,94.56521739130434,5.434782608695652
39029_marine,90,33,85,5,123,94.44444444444444,5.555555555555555
39030_marine,90,34,85,5,124,94.44444444444444,5.555555555555555
39031_marine,90,34,85,5,124,94.44444444444444,5.555555555555555
39032_marine,87,34,82,5,121,94.25287356321839,5.747126436781609
39033_marine,85,34,80,5,119,94.11764705882352,5.88235294117647
39034_marine,85,36,80,5,121,94.11764705882352,5.88235294117647
39035_marine,86,36,81,5,122,94.18604651162791,5.813953488372093
39036_marine,85,36,80,5,121,94.11764705882352,5.88235294117647
39037_marine,85,35,80,5,120,94.11764705882352,5.88235294117647
39038_marine,86,35,81,5,121,94.18604651162791,5.813953488372093
39039_marine,85,35,80,5,120,94.11764705882352,5.88235294117647
39040_marine,85,35,80,5,120,94.11764705882352,5.88235294117647
39041_marine,85,35,80,5,120,94.11764705882352,5.88235294117647
39042_marine,85,35,80,5,120,94.11764705882352,5.88235294117647
39043_marine,85,35,80,5,120,94.11764705882352,5.88235294117647
39044_marine,84,35,79,4,119,94.04761904761905,4.761904761904762
39045_marine,82,34,78,3,116,95.1219512195122,3.6585365853658534
39046_marine,82,34,78,3,116,95.1219512195122,3.6585365853658534
39047_marine,82,34,78,3,116,95.1219512195122,3.6585365853658534
39048_marine,82,34,78,3,116,95.1219512195122,3.6585365853658534
39049_marine,82,34,78,3,116,95.1219512195122,3.6585365853658534
39050_marine,81,34,77,3,115,95.06172839506173,3.7037037037037033
39051_marine,81,34,77,3,115,95.06172839506173,3.7037037037037033
39052_marine,80,34,76,3,114,95,3.75
39053_marine,83,35,79,4,118,95.18072289156626,4.819277108433735
39054_marine,81,37,76,5,118,93.82716049382715,6.172839506172839
39055_marine,83,37,78,5,120,93.97590361445783,6.024096385542169
39056_marine,83,37,78,4,120,93.97590361445783,4.819277108433735
39057_marine,83,35,78,4,118,93.97590361445783,4.819277108433735
39058_marine,81,33,76,3,114,93.82716049382715,3.7037037037037033
39059_marine,81,33,76,3,114,93.82716049382715,3.7037037037037033
39060_marine,78,33,73,3,111,93.58974358974359,3.8461538461538463
39061_marine,76,33,71,3,109,93.42105263157895,3.9473684210526314
39062_marine,74,35,69,1,109,93.24324324324324,1.3513513513513513
39063_marine,72,35,67,1,107,93.05555555555556,1.3888888888888888
39064_marine,73,30,68,1,103,93.15068493150685,1.36986301369863
39065_marine,73,31,67,1,104,91.78082191780823,1.36986301369863
39066_marine,71,33,65,1,104,91.54929577464789,1.4084507042253522
39067_marine,75,33,69,1,108,92,1.3333333333333335
39068_marine,78,35,72,1,113,92.3076923076923,1.282051282051282
39069_marine,80,34,74,1,114,92.5,1.25
39070_marine,81,36,75,1,117,92.5925925925926,1.2345679012345678
39071_marine,143,78,135,9,221,94.4055944055944,6.293706293706294
39099_marine,634,212,440,336,846,69.4006309148265,52.99684542586751
39100_marine,620,212,426,326,832,68.70967741935485,52.58064516129032
39101_marine,103,38,97,11,141,94.1747572815534,10.679611650485436
39102_marine,109,37,103,11,146,94.4954128440367,10.091743119266056
39103_marine,418,79,280,248,497,66.98564593301435,59.33014354066985
39104_marine,675,232,483,336,907,71.55555555555554,49.77777777777778
39111_marine,598,163,411,316,761,68.72909698996655,52.84280936454849
39112_marine,94,34,88,7,128,93.61702127659575,7.446808510638298
39113_marine,91,31,85,7,122,93.4065934065934,7.6923076923076925
39114_marine,94,32,88,8,126,93.61702127659575,8.51063829787234
39115_marine,94,35,88,8,129,93.61702127659575,8.51063829787234
39116_marine,92,35,86,8,127,93.47826086956522,8.695652173913043
39117_marine,95,37,89,9,132,93.6842105263158,9.473684210526317
39118_marine,101,45,95,9,146,94.05940594059405,8.91089108910891
39119_marine,116,47,106,18,163,91.37931034482759,15.517241379310345
39120_marine,96,37,91,7,133,94.79166666666666,7.291666666666667
39121_marine,84,34,79,7,118,94.04761904761905,8.333333333333332
39122_marine,84,33,79,7,117,94.04761904761905,8.333333333333332
39123_marine,377,94,262,202,471,69.49602122015915,53.58090185676393
39124_marine,377,94,262,202,471,69.49602122015915,53.58090185676393
39125_marine,370,94,255,201,464,68.91891891891892,54.32432432432432
39126_marine,78,29,73,5,107,93.58974358974359,6.41025641025641
39127_marine,78,29,73,5,107,93.58974358974359,6.41025641025641
39128_marine,74,28,69,5,102,93.24324324324324,6.756756756756757
39129_marine,74,28,69,5,102,93.24324324324324,6.756756756756757
39130_marine,74,28,69,5,102,93.24324324324324,6.756756756756757
39131_marine,74,28,69,5,102,93.24324324324324,6.756756756756757
39132_marine,72,28,67,5,100,93.05555555555556,6.944444444444445
39133_marine,72,27,67,5,99,93.05555555555556,6.944444444444445
39134_marine,72,27,67,5,99,93.05555555555556,6.944444444444445
39135_marine,71,27,67,4,98,94.36619718309859,5.633802816901409
39136_marine,71,27,67,4,98,94.36619718309859,5.633802816901409
39137_marine,71,27,67,4,98,94.36619718309859,5.633802816901409
39138_marine,71,27,67,4,98,94.36619718309859,5.633802816901409
39139_marine,70,27,67,3,97,95.71428571428572,4.285714285714286
39140_marine,70,27,67,3,97,95.71428571428572,4.285714285714286
39141_marine,70,27,67,3,97,95.71428571428572,4.285714285714286
39142_marine,70,27,67,3,97,95.71428571428572,4.285714285714286
39143_marine,70,27,67,3,97,95.71428571428572,4.285714285714286
39144_marine,70,27,67,3,97,95.71428571428572,4.285714285714286
39145_marine,70,27,67,3,97,95.71428571428572,4.285714285714286
39146_marine,70,27,67,3,97,95.71428571428572,4.285714285714286
39147_marine,70,27,67,3,97,95.71428571428572,4.285714285714286
39148_marine,72,27,69,3,99,95.83333333333334,4.166666666666666
39149_marine,72,27,69,3,99,95.83333333333334,4.166666666666666
39150_marine,72,27,69,3,99,95.83333333333334,4.166666666666666
39151_marine,74,29,71,3,103,95.94594594594594,4.054054054054054
39152_marine,74,29,71,3,103,95.94594594594594,4.054054054054054
39153_marine,77,29,74,4,106,96.1038961038961,5.194805194805195
39154_marine,77,28,74,4,105,96.1038961038961,5.194805194805195
39155_marine,77,28,74,4,105,96.1038961038961,5.194805194805195
39156_marine,77,28,74,4,105,96.1038961038961,5.194805194805195
39157_marine,77,28,74,4,105,96.1038961038961,5.194805194805195
39158_marine,77,28,74,4,105,96.1038961038961,5.194805194805195
39159_marine,77,28,74,4,105,96.1038961038961,5.194805194805195
39160_marine,77,28,74,4,105,96.1038961038961,5.194805194805195
39161_marine,77,28,74,4,105,96.1038961038961,5.194805194805195
39162_marine,77,28,74,4,105,96.1038961038961,5.194805194805195
39163_marine,77,28,74,4,105,96.1038961038961,5.194805194805195
39164_marine,80,28,76,5,108,95,6.25
39165_marine,80,28,76,5,108,95,6.25
39166_marine,82,28,77,5,110,93.90243902439023,6.097560975609756
39167_marine,81,27,76,5,108,93.82716049382715,6.172839506172839
39168_marine,81,27,76,5,108,93.82716049382715,6.172839506172839
39169_marine,86,27,80,7,113,93.02325581395348,8.13953488372093
39170_marine,86,27,80,7,113,93.02325581395348,8.13953488372093
39171_marine,89,29,83,8,118,93.25842696629213,8.98876404494382
39172_marine,95,29,89,8,124,93.6842105263158,8.421052631578947
39173_marine,101,29,95,8,130,94.05940594059405,7.920792079207921
39174_marine,114,30,108,12,144,94.73684210526315,10.526315789473683
39175_marine,131,58,126,15,189,96.18320610687023,11.450381679389313
39176_marine,139,78,131,15,217,94.24460431654677,10.79136690647482
39177_marine,146,80,137,17,226,93.83561643835617,11.643835616438356
39178_marine,622,292,459,302,914,73.79421221864952,48.55305466237942
39179_marine,630,294,465,305,924,73.80952380952381,48.41269841269841
39180_marine,614,290,455,293,904,74.1042345276873,47.71986970684039
39181_marine,586,298,431,276,884,73.54948805460751,47.098976109215016
39208_marine,859,404,560,478,1263,65.19208381839347,55.64610011641443
39209_marine,831,371,545,462,1202,65.58363417569194,55.5956678700361
39210_marine,848,365,534,490,1213,62.97169811320755,57.78301886792453
39211_marine,640,212,414,390,852,64.6875,60.9375
39212_marine,634,205,406,390,839,64.03785488958991,61.51419558359621
39213_marine,617,169,392,383,786,63.533225283630465,62.07455429497569
39214_marine,113,51,102,17,164,90.2654867256637,15.04424778761062
39215_marine,109,35,98,16,144,89.90825688073394,14.678899082568808
39216_marine,593,138,369,378,731,62.22596964586846,63.74367622259697
39217_marine,594,138,370,378,732,62.2895622895623,63.63636363636363
39218_marine,580,150,368,360,730,63.44827586206897,62.06896551724138
39219_marine,588,178,372,365,766,63.26530612244898,62.074829931972786
39220_marine,592,186,371,370,778,62.66891891891891,62.5
39221_marine,588,175,367,368,763,62.414965986394556,62.585034013605444
39222_marine,111,53,99,16,164,89.1891891891892,14.414414414414415
39223_marine,774,311,471,474,1085,60.85271317829457,61.240310077519375
39224_marine,780,311,476,475,1091,61.02564102564103,60.89743589743589
39225_marine,777,299,475,473,1076,61.132561132561136,60.87516087516087
39226_marine,124,51,113,19,175,91.12903225806451,15.32258064516129
39227_marine,125,50,114,19,175,91.2,15.2
39228_marine,715,265,432,458,980,60.41958041958042,64.05594405594405
39229_marine,790,336,481,502,1126,60.88607594936709,63.54430379746835
39230_marine,798,336,489,502,1134,61.278195488721806,62.907268170426065
39231_marine,692,259,413,450,951,59.6820809248555,65.02890173410405
39232_marine,109,39,99,13,148,90.82568807339449,11.926605504587156
39233_marine,108,38,98,13,146,90.74074074074075,12.037037037037036
39234_marine,104,38,94,13,142,90.38461538461539,12.5
39235_marine,108,40,98,13,148,90.74074074074075,12.037037037037036
39236_marine,113,39,103,12,152,91.1504424778761,10.619469026548673
39237_marine,716,249,448,436,965,62.56983240223464,60.893854748603346
39238_marine,805,343,509,492,1148,63.22981366459627,61.118012422360245
39239_marine,817,355,518,494,1172,63.40269277845777,60.46511627906976
39240_marine,793,325,499,484,1118,62.92559899117276,61.03404791929382
39241_marine,740,278,457,462,1018,61.75675675675676,62.43243243243243
39242_marine,736,269,454,458,1005,61.684782608695656,62.22826086956522
39243_marine,675,222,411,423,897,60.88888888888889,62.66666666666667
39244_marine,657,197,404,409,854,61.49162861491628,62.25266362252664
39245_marine,714,231,444,439,945,62.18487394957983,61.484593837535016
39246_marine,715,234,447,440,949,62.51748251748251,61.53846153846154
39247_marine,677,207,422,415,884,62.33382570162481,61.29985228951256
39248_marine,102,38,95,9,140,93.13725490196079,8.823529411764707
39249_marine,101,37,95,8,138,94.05940594059405,7.920792079207921
39250_marine,472,125,322,286,597,68.22033898305084,60.59322033898306
39251_marine,497,137,343,298,634,69.01408450704226,59.95975855130785
39252_marine,467,121,319,284,588,68.3083511777302,60.81370449678801
39253_marine,101,38,95,10,139,94.05940594059405,9.900990099009901
39254_marine,101,38,95,10,139,94.05940594059405,9.900990099009901
39255_marine,103,38,97,10,141,94.1747572815534,9.70873786407767
39256_marine,101,38,95,10,139,94.05940594059405,9.900990099009901
39257_marine,100,38,94,10,138,94,10
39258_marine,98,36,92,10,134,93.87755102040816,10.204081632653061
39259_marine,100,35,94,10,135,94,10
39260_marine,437,113,293,270,550,67.04805491990847,61.784897025171624
39261_marine,435,114,291,270,549,66.89655172413794,62.06896551724138
39262_marine,463,130,312,284,593,67.3866090712743,61.33909287257019
39263_marine,431,122,295,266,553,68.44547563805105,61.7169373549884
39264_marine,408,107,276,254,515,67.64705882352942,62.254901960784316
39265_marine,100,35,94,10,135,94,10
39266_marine,99,36,93,10,135,93.93939393939394,10.1010101010101
39267_marine,99,36,93,10,135,93.93939393939394,10.1010101010101
39268_marine,101,38,95,10,139,94.05940594059405,9.900990099009901
39269_marine,123,50,111,24,173,90.2439024390244,19.51219512195122
39270_marine,103,38,97,10,141,94.1747572815534,9.70873786407767
39271_marine,103,38,97,10,141,94.1747572815534,9.70873786407767
39272_marine,103,38,97,10,141,94.1747572815534,9.70873786407767
39273_marine,103,38,97,10,141,94.1747572815534,9.70873786407767
39274_marine,101,39,95,10,140,94.05940594059405,9.900990099009901
39275_marine,421,100,286,253,521,67.93349168646081,60.09501187648456
39276_marine,444,114,305,266,558,68.69369369369369,59.909909909909906
39277_marine,417,96,283,254,513,67.86570743405275,60.91127098321343
39278_marine,445,106,307,268,551,68.98876404494382,60.22471910112359
39279_marine,458,123,316,275,581,68.99563318777294,60.043668122270745
39280_marine,458,123,316,275,581,68.99563318777294,60.043668122270745
39281_marine,452,119,310,275,571,68.58407079646017,60.84070796460177
39282_marine,448,117,306,275,565,68.30357142857143,61.38392857142857
39283_marine,419,98,281,262,517,67.06443914081146,62.52983293556086
39284_marine,413,96,279,256,509,67.55447941888619,61.98547215496368
39285_marine,413,94,279,256,507,67.55447941888619,61.98547215496368
39286_marine,96,36,90,10,132,93.75,10.416666666666668
39287_marine,93,36,87,9,129,93.54838709677419,9.67741935483871
39288_marine,93,34,87,9,127,93.54838709677419,9.67741935483871
39289_marine,95,35,89,10,130,93.6842105263158,10.526315789473683
39290_marine,96,35,90,12,131,93.75,12.5
39291_marine,96,35,90,12,131,93.75,12.5
39292_marine,94,34,88,10,128,93.61702127659575,10.638297872340425
39293_marine,91,34,85,9,125,93.4065934065934,9.89010989010989
39294_marine,91,33,85,9,124,93.4065934065934,9.89010989010989
39295_marine,91,33,85,9,124,93.4065934065934,9.89010989010989
39296_marine,89,35,83,9,124,93.25842696629213,10.112359550561797
39297_marine,89,35,83,9,124,93.25842696629213,10.112359550561797
39298_marine,89,35,83,9,124,93.25842696629213,10.112359550561797
39299_marine,88,35,83,9,123,94.31818181818183,10.227272727272728
39300_marine,88,35,83,9,123,94.31818181818183,10.227272727272728
39301_marine,89,36,84,9,125,94.3820224719101,10.112359550561797
39302_marine,89,35,84,9,124,94.3820224719101,10.112359550561797
39303_marine,89,35,84,9,124,94.3820224719101,10.112359550561797
39304_marine,89,34,84,9,123,94.3820224719101,10.112359550561797
39305_marine,86,34,81,9,120,94.18604651162791,10.465116279069768
39306_marine,86,34,81,9,120,94.18604651162791,10.465116279069768
39307_marine,85,33,80,8,118,94.11764705882352,9.411764705882353
39308_marine,85,33,80,8,118,94.11764705882352,9.411764705882353
39309_marine,85,32,80,8,117,94.11764705882352,9.411764705882353
39310_marine,85,32,80,8,117,94.11764705882352,9.411764705882353
39311_marine,85,32,80,8,117,94.11764705882352,9.411764705882353
39312_marine,84,34,79,7,118,94.04761904761905,8.333333333333332
39313_marine,84,34,79,7,118,94.04761904761905,8.333333333333332
39314_marine,84,34,79,7,118,94.04761904761905,8.333333333333332
39315_marine,81,34,77,6,115,95.06172839506173,7.4074074074074066
39316_marine,80,34,76,5,114,95,6.25
39317_marine,79,34,75,4,113,94.9367088607595,5.063291139240507
39318_marine,80,34,76,4,114,95,5
39319_marine,80,34,76,4,114,95,5
39320_marine,79,35,75,4,114,94.9367088607595,5.063291139240507
39321_marine,79,37,75,4,116,94.9367088607595,5.063291139240507
39322_marine,79,37,75,4,116,94.9367088607595,5.063291139240507
39323_marine,79,37,75,4,116,94.9367088607595,5.063291139240507
39324_marine,80,37,76,4,117,95,5
39325_marine,80,37,76,4,117,95,5
39326_marine,79,37,75,4,116,94.9367088607595,5.063291139240507
39327_marine,77,38,74,3,115,96.1038961038961,3.896103896103896
39328_marine,77,38,74,3,115,96.1038961038961,3.896103896103896
39329_marine,77,38,74,3,115,96.1038961038961,3.896103896103896
39330_marine,78,39,75,4,117,96.15384615384616,5.128205128205128
39331_marine,76,39,73,4,115,96.05263157894737,5.263157894736842
39332_marine,76,42,73,4,118,96.05263157894737,5.263157894736842
39333_marine,77,42,74,4,119,96.1038961038961,5.194805194805195
39334_marine,77,41,74,4,118,96.1038961038961,5.194805194805195
39335_marine,77,41,74,4,118,96.1038961038961,5.194805194805195
39336_marine,77,41,74,4,118,96.1038961038961,5.194805194805195
39337_marine,76,41,73,4,117,96.05263157894737,5.263157894736842
39338_marine,74,41,71,4,115,95.94594594594594,5.405405405405405
39339_marine,74,43,71,4,117,95.94594594594594,5.405405405405405
39340_marine,76,46,72,4,122,94.73684210526315,5.263157894736842
39341_marine,76,43,72,4,119,94.73684210526315,5.263157894736842
39342_marine,80,42,75,5,122,93.75,6.25
39343_marine,78,44,73,5,122,93.58974358974359,6.41025641025641
39344_marine,86,44,80,5,130,93.02325581395348,5.813953488372093
39345_marine,84,45,78,5,129,92.85714285714286,5.952380952380952
39346_marine,88,45,82,5,133,93.18181818181817,5.681818181818182
39347_marine,88,46,82,4,134,93.18181818181817,4.545454545454546
39348_marine,92,45,86,5,137,93.47826086956522,5.434782608695652
39349_marine,135,77,115,14,212,85.18518518518519,10.37037037037037
39350_marine,202,195,143,72,397,70.79207920792079,35.64356435643564
39382_marine,329,178,277,94,507,84.19452887537993,28.57142857142857
39383_marine,325,160,274,92,485,84.3076923076923,28.307692307692307
39384_marine,108,41,103,7,149,95.37037037037037,6.481481481481481
39385_marine,102,39,96,7,141,94.11764705882352,6.862745098039216
39386_marine,95,37,91,4,132,95.78947368421052,4.2105263157894735
39387_marine,96,35,91,5,131,94.79166666666666,5.208333333333334
39388_marine,92,33,87,5,125,94.56521739130434,5.434782608695652
39389_marine,92,34,87,5,126,94.56521739130434,5.434782608695652
39390_marine,131,47,118,33,178,90.07633587786259,25.190839694656486
39391_marine,129,47,116,33,176,89.92248062015504,25.581395348837212
39392_marine,128,47,115,33,175,89.84375,25.78125
39393_marine,87,34,82,5,121,94.25287356321839,5.747126436781609
39394_marine,87,35,82,5,122,94.25287356321839,5.747126436781609
39395_marine,87,35,82,5,122,94.25287356321839,5.747126436781609
39396_marine,88,35,83,5,123,94.31818181818183,5.681818181818182
39397_marine,88,35,83,5,123,94.31818181818183,5.681818181818182
39398_marine,88,35,83,5,123,94.31818181818183,5.681818181818182
39399_marine,87,35,82,5,122,94.25287356321839,5.747126436781609
39400_marine,86,35,81,5,121,94.18604651162791,5.813953488372093
39401_marine,87,35,82,5,122,94.25287356321839,5.747126436781609
39402_marine,87,35,82,5,122,94.25287356321839,5.747126436781609
39403_marine,87,35,82,5,122,94.25287356321839,5.747126436781609
39404_marine,84,35,80,3,119,95.23809523809523,3.571428571428571
39405_marine,84,34,80,3,118,95.23809523809523,3.571428571428571
39406_marine,84,33,80,3,117,95.23809523809523,3.571428571428571
39407_marine,84,33,80,3,117,95.23809523809523,3.571428571428571
39408_marine,84,33,80,3,117,95.23809523809523,3.571428571428571
39409_marine,83,34,79,3,117,95.18072289156626,3.614457831325301
39410_marine,83,34,79,3,117,95.18072289156626,3.614457831325301
39411_marine,83,35,79,3,118,95.18072289156626,3.614457831325301
39412_marine,82,35,78,3,117,95.1219512195122,3.6585365853658534
39413_marine,81,34,77,3,115,95.06172839506173,3.7037037037037033
39414_marine,81,34,77,2,115,95.06172839506173,2.4691358024691357
39415_marine,80,34,76,3,114,95,3.75
39416_marine,78,34,74,3,112,94.87179487179486,3.8461538461538463
39417_marine,80,31,76,3,111,95,3.75
39418_marine,80,31,76,3,111,95,3.75
39419_marine,79,31,74,3,110,93.67088607594937,3.79746835443038
39420_marine,78,31,73,2,109,93.58974358974359,2.564102564102564
39421_marine,78,31,73,2,109,93.58974358974359,2.564102564102564
39422_marine,77,33,72,1,110,93.5064935064935,1.2987012987012987
39423_marine,76,31,71,1,107,93.42105263157895,1.3157894736842104
39424_marine,75,32,70,1,107,93.33333333333333,1.3333333333333335
39425_marine,74,32,68,1,106,91.8918918918919,1.3513513513513513
39426_marine,75,33,69,1,108,92,1.3333333333333335
39427_marine,75,33,69,1,108,92,1.3333333333333335
39428_marine,78,35,72,1,113,92.3076923076923,1.282051282051282
39429_marine,83,37,76,2,120,91.56626506024097,2.4096385542168677
39430_marine,86,43,79,2,129,91.86046511627907,2.3255813953488373
39431_marine,96,64,89,5,160,92.70833333333334,5.208333333333334
39432_marine,158,108,146,13,266,92.40506329113924,8.227848101265822
39457_marine,673,255,477,341,928,70.87667161961367,50.66864784546805
39458_marine,661,241,466,333,902,70.49924357034796,50.378214826021186
39459_marine,117,42,107,11,159,91.45299145299145,9.401709401709402
39460_marine,106,36,100,11,142,94.33962264150944,10.377358490566039
39461_marine,106,36,100,11,142,94.33962264150944,10.377358490566039
39462_marine,104,36,98,11,140,94.23076923076923,10.576923076923077
39463_marine,111,36,106,15,147,95.4954954954955,13.513513513513514
39464_marine,623,188,436,323,811,69.98394863563404,51.84590690208668
39470_marine,637,192,448,323,829,70.32967032967034,50.706436420722135
39471_marine,592,165,406,311,757,68.58108108108108,52.53378378378378
39472_marine,97,34,91,7,131,93.81443298969072,7.216494845360824
39473_marine,92,33,86,7,125,93.47826086956522,7.608695652173914
39474_marine,97,34,91,8,131,93.81443298969072,8.24742268041237
39475_marine,448,126,280,270,574,62.5,60.26785714285714
39476_marine,572,174,375,319,746,65.55944055944056,55.769230769230774
39477_marine,619,212,399,342,831,64.45880452342489,55.25040387722132
39479_marine,614,219,394,340,833,64.16938110749186,55.37459283387622
39480_marine,96,37,91,7,133,94.79166666666666,7.291666666666667
39481_marine,84,34,79,7,118,94.04761904761905,8.333333333333332
39482_marine,100,38,89,17,138,89,17
39483_marine,381,100,266,203,481,69.81627296587926,53.28083989501312
39484_marine,406,106,284,219,512,69.95073891625616,53.94088669950739
39485_marine,373,100,258,202,473,69.16890080428955,54.15549597855228
39486_marine,77,31,72,5,108,93.5064935064935,6.493506493506493
39487_marine,73,28,68,5,101,93.15068493150685,6.8493150684931505
39488_marine,74,28,69,5,102,93.24324324324324,6.756756756756757
39489_marine,74,28,69,5,102,93.24324324324324,6.756756756756757
39490_marine,72,28,67,5,100,93.05555555555556,6.944444444444445
39491_marine,72,28,67,5,100,93.05555555555556,6.944444444444445
39492_marine,74,28,69,5,102,93.24324324324324,6.756756756756757
39493_marine,74,28,69,5,102,93.24324324324324,6.756756756756757
39494_marine,72,28,69,3,100,95.83333333333334,4.166666666666666
39495_marine,72,27,69,3,99,95.83333333333334,4.166666666666666
39496_marine,72,27,69,3,99,95.83333333333334,4.166666666666666
39497_marine,72,27,69,3,99,95.83333333333334,4.166666666666666
39498_marine,72,27,69,3,99,95.83333333333334,4.166666666666666
39499_marine,72,27,69,3,99,95.83333333333334,4.166666666666666
39500_marine,72,27,69,3,99,95.83333333333334,4.166666666666666
39501_marine,72,27,69,3,99,95.83333333333334,4.166666666666666
39502_marine,72,27,69,3,99,95.83333333333334,4.166666666666666
39503_marine,72,27,69,3,99,95.83333333333334,4.166666666666666
39504_marine,72,27,69,3,99,95.83333333333334,4.166666666666666
39505_marine,70,27,67,3,97,95.71428571428572,4.285714285714286
39506_marine,70,27,67,3,97,95.71428571428572,4.285714285714286
39507_marine,70,27,67,3,97,95.71428571428572,4.285714285714286
39508_marine,72,27,69,3,99,95.83333333333334,4.166666666666666
39509_marine,72,27,69,3,99,95.83333333333334,4.166666666666666
39510_marine,72,27,69,3,99,95.83333333333334,4.166666666666666
39511_marine,74,27,71,3,101,95.94594594594594,4.054054054054054
39512_marine,74,27,71,3,101,95.94594594594594,4.054054054054054
39513_marine,73,29,70,3,102,95.8904109589041,4.10958904109589
39514_marine,73,29,70,3,102,95.8904109589041,4.10958904109589
39515_marine,73,28,70,3,101,95.8904109589041,4.10958904109589
39516_marine,74,28,71,3,102,95.94594594594594,4.054054054054054
39517_marine,77,28,74,4,105,96.1038961038961,5.194805194805195
39518_marine,77,28,74,4,105,96.1038961038961,5.194805194805195
39519_marine,77,28,74,4,105,96.1038961038961,5.194805194805195
39520_marine,77,28,74,4,105,96.1038961038961,5.194805194805195
39521_marine,77,28,74,4,105,96.1038961038961,5.194805194805195
39522_marine,77,28,74,4,105,96.1038961038961,5.194805194805195
39523_marine,77,28,74,4,105,96.1038961038961,5.194805194805195
39524_marine,79,28,76,4,107,96.20253164556962,5.063291139240507
39525_marine,79,28,76,4,107,96.20253164556962,5.063291139240507
39526_marine,84,28,79,5,112,94.04761904761905,5.952380952380952
39527_marine,83,27,78,5,110,93.97590361445783,6.024096385542169
39528_marine,83,27,78,5,110,93.97590361445783,6.024096385542169
39529_marine,85,27,79,7,112,92.94117647058823,8.235294117647058
39530_marine,87,31,81,7,118,93.10344827586206,8.045977011494253
39531_marine,95,31,89,6,126,93.6842105263158,6.315789473684211
39532_marine,97,33,91,6,130,93.81443298969072,6.185567010309279
39533_marine,118,37,112,11,155,94.91525423728814,9.322033898305085
39534_marine,130,46,119,15,176,91.53846153846153,11.538461538461538
39535_marine,602,259,434,303,861,72.09302325581395,50.332225913621265
39536_marine,630,315,457,308,945,72.53968253968253,48.888888888888886
39537_marine,642,333,465,311,975,72.42990654205607,48.442367601246104
39538_marine,639,333,466,316,972,72.9264475743349,49.45226917057903
39539_marine,713,349,485,381,1062,68.02244039270687,53.43618513323983
39540_marine,826,448,529,477,1274,64.04358353510897,57.74818401937046
39570_marine,829,394,542,465,1223,65.37997587454765,56.09167671893848
39571_marine,802,364,523,455,1166,65.21197007481297,56.733167082294266
39572_marine,168,107,151,32,275,89.88095238095238,19.047619047619047
39573_marine,153,93,136,30,246,88.88888888888889,19.607843137254903
39574_marine,121,70,110,17,191,90.9090909090909,14.049586776859504
39575_marine,117,45,106,17,162,90.5982905982906,14.529914529914532
39576_marine,107,34,96,13,141,89.7196261682243,12.149532710280374
39577_marine,107,35,96,13,142,89.7196261682243,12.149532710280374
39578_marine,584,179,371,362,763,63.52739726027398,61.986301369863014
39579_marine,626,201,402,386,827,64.21725239616613,61.66134185303515
39580_marine,620,199,391,391,819,63.064516129032256,63.064516129032256
39581_marine,592,174,371,370,766,62.66891891891891,62.5
39582_marine,110,45,98,17,155,89.0909090909091,15.454545454545453
39583_marine,771,294,468,474,1065,60.70038910505836,61.478599221789885
39584_marine,858,412,529,516,1270,61.65501165501166,60.13986013986013
39585_marine,794,336,488,478,1130,61.46095717884131,60.20151133501259
39586_marine,795,340,484,483,1135,60.880503144654085,60.75471698113207
39587_marine,711,276,433,443,987,60.900140646976084,62.30661040787623
39588_marine,706,248,431,442,954,61.048158640226625,62.606232294617556
39589_marine,708,271,429,453,979,60.59322033898306,63.983050847457626
39590_marine,782,333,477,498,1115,60.99744245524297,63.68286445012787
39591_marine,761,328,461,490,1089,60.578186596583436,64.38896189224704
39592_marine,677,247,405,441,924,59.822747415066466,65.14032496307239
39593_marine,106,38,96,13,144,90.56603773584906,12.264150943396226
39594_marine,105,38,95,13,143,90.47619047619048,12.380952380952381
39595_marine,108,39,98,13,147,90.74074074074075,12.037037037037036
39596_marine,112,40,102,13,152,91.07142857142857,11.607142857142858
39597_marine,708,240,440,436,948,62.14689265536724,61.5819209039548
39598_marine,785,329,490,481,1114,62.42038216560509,61.273885350318466
39599_marine,792,331,496,484,1123,62.62626262626263,61.111111111111114
39600_marine,773,304,486,475,1077,62.8719275549806,61.448900388098316
39601_marine,681,230,411,434,911,60.352422907488986,63.729809104258436
39602_marine,662,231,427,401,893,64.50151057401813,60.57401812688822
39603_marine,608,203,386,371,811,63.48684210526315,61.01973684210527
39604_marine,637,201,402,391,838,63.108320251177396,61.38147566718995
39605_marine,705,231,438,435,936,62.12765957446808,61.702127659574465
39606_marine,704,231,440,434,935,62.5,61.64772727272727
39607_marine,660,202,407,409,862,61.66666666666667,61.969696969696976
39608_marine,100,37,93,9,137,93,9
39609_marine,99,38,93,8,137,93.93939393939394,8.080808080808081
39610_marine,467,122,319,284,589,68.3083511777302,60.81370449678801
39611_marine,467,121,319,284,588,68.3083511777302,60.81370449678801
39612_marine,99,37,93,8,136,93.93939393939394,8.080808080808081
39613_marine,99,38,93,8,137,93.93939393939394,8.080808080808081
39614_marine,97,38,91,8,135,93.81443298969072,8.24742268041237
39615_marine,97,36,91,8,133,93.81443298969072,8.24742268041237
39616_marine,97,36,91,10,133,93.81443298969072,10.309278350515463
39617_marine,97,36,91,10,133,93.81443298969072,10.309278350515463
39618_marine,97,36,91,10,133,93.81443298969072,10.309278350515463
39619_marine,96,35,90,10,131,93.75,10.416666666666668
39620_marine,403,105,269,250,508,66.74937965260546,62.03473945409429
39621_marine,446,118,292,284,564,65.47085201793722,63.67713004484305
39622_marine,467,135,308,296,602,65.95289079229121,63.38329764453962
39623_marine,429,124,293,266,553,68.29836829836829,62.004662004662
39624_marine,404,106,272,254,510,67.32673267326733,62.87128712871287
39625_marine,354,84,242,212,438,68.36158192090396,59.887005649717516
39626_marine,356,85,244,212,441,68.53932584269663,59.55056179775281
39627_marine,98,36,92,10,134,93.87755102040816,10.204081632653061
39628_marine,98,36,92,10,134,93.87755102040816,10.204081632653061
39629_marine,100,36,94,10,136,94,10
39630_marine,99,36,93,10,135,93.93939393939394,10.1010101010101
39631_marine,99,36,93,10,135,93.93939393939394,10.1010101010101
39632_marine,97,36,91,10,133,93.81443298969072,10.309278350515463
39633_marine,97,36,91,10,133,93.81443298969072,10.309278350515463
39634_marine,97,38,91,10,135,93.81443298969072,10.309278350515463
39635_marine,413,97,279,252,510,67.55447941888619,61.016949152542374
39636_marine,415,99,281,254,514,67.71084337349397,61.204819277108435
39637_marine,428,104,290,265,532,67.7570093457944,61.915887850467286
39638_marine,415,97,281,254,512,67.71084337349397,61.204819277108435
39639_marine,432,102,294,268,534,68.05555555555556,62.03703703703704
39640_marine,432,104,294,268,536,68.05555555555556,62.03703703703704
39641_marine,447,121,305,279,568,68.23266219239373,62.41610738255034
39642_marine,438,118,296,273,556,67.57990867579909,62.328767123287676
39643_marine,419,102,281,262,521,67.06443914081146,62.52983293556086
39644_marine,393,95,265,244,488,67.43002544529261,62.086513994910945
39645_marine,393,95,265,244,488,67.43002544529261,62.086513994910945
39646_marine,381,93,263,232,474,69.02887139107612,60.892388451443566
39647_marine,93,36,87,9,129,93.54838709677419,9.67741935483871
39648_marine,93,34,87,9,127,93.54838709677419,9.67741935483871
39649_marine,94,34,88,9,128,93.61702127659575,9.574468085106384
39650_marine,93,35,87,9,128,93.54838709677419,9.67741935483871
39651_marine,93,35,87,9,128,93.54838709677419,9.67741935483871
39652_marine,94,34,88,10,128,93.61702127659575,10.638297872340425
39653_marine,92,34,86,10,126,93.47826086956522,10.869565217391305
39654_marine,92,34,86,10,126,93.47826086956522,10.869565217391305
39655_marine,88,33,83,9,121,94.31818181818183,10.227272727272728
39656_marine,88,33,83,9,121,94.31818181818183,10.227272727272728
39657_marine,88,33,83,9,121,94.31818181818183,10.227272727272728
39658_marine,88,33,83,9,121,94.31818181818183,10.227272727272728
39659_marine,88,35,83,9,123,94.31818181818183,10.227272727272728
39660_marine,88,34,83,9,122,94.31818181818183,10.227272727272728
39661_marine,88,34,83,9,122,94.31818181818183,10.227272727272728
39662_marine,88,34,83,9,122,94.31818181818183,10.227272727272728
39663_marine,87,34,82,9,121,94.25287356321839,10.344827586206897
39664_marine,86,35,81,9,121,94.18604651162791,10.465116279069768
39665_marine,86,35,81,9,121,94.18604651162791,10.465116279069768
39666_marine,85,34,80,8,119,94.11764705882352,9.411764705882353
39667_marine,83,33,78,8,116,93.97590361445783,9.63855421686747
39668_marine,83,33,78,8,116,93.97590361445783,9.63855421686747
39669_marine,83,33,78,8,116,93.97590361445783,9.63855421686747
39670_marine,83,33,78,8,116,93.97590361445783,9.63855421686747
39671_marine,83,33,78,8,116,93.97590361445783,9.63855421686747
39672_marine,80,33,75,7,113,93.75,8.75
39673_marine,80,33,75,7,113,93.75,8.75
39674_marine,80,33,75,7,113,93.75,8.75
39675_marine,80,33,75,7,113,93.75,8.75
39676_marine,79,33,74,7,112,93.67088607594937,8.860759493670885
39677_marine,77,34,73,5,111,94.8051948051948,6.493506493506493
39678_marine,77,34,73,5,111,94.8051948051948,6.493506493506493
39679_marine,76,34,72,4,110,94.73684210526315,5.263157894736842
39680_marine,75,35,71,4,110,94.66666666666667,5.333333333333334
39681_marine,75,35,71,4,110,94.66666666666667,5.333333333333334
39682_marine,75,35,71,4,110,94.66666666666667,5.333333333333334
39683_marine,75,35,71,4,110,94.66666666666667,5.333333333333334
39684_marine,75,36,71,4,111,94.66666666666667,5.333333333333334
39685_marine,75,36,71,4,111,94.66666666666667,5.333333333333334
39686_marine,74,36,71,3,110,95.94594594594594,4.054054054054054
39687_marine,76,38,73,3,114,96.05263157894737,3.9473684210526314
39688_marine,75,38,72,3,113,96,4
39689_marine,73,40,70,3,113,95.8904109589041,4.10958904109589
39690_marine,73,41,70,3,114,95.8904109589041,4.10958904109589
39691_marine,74,43,71,4,117,95.94594594594594,5.405405405405405
39692_marine,74,42,71,4,116,95.94594594594594,5.405405405405405
39693_marine,75,42,72,4,117,96,5.333333333333334
39694_marine,74,42,71,4,116,95.94594594594594,5.405405405405405
39695_marine,72,41,69,4,113,95.83333333333334,5.555555555555555
39696_marine,73,39,70,4,112,95.8904109589041,5.47945205479452
39697_marine,73,39,70,4,112,95.8904109589041,5.47945205479452
39698_marine,72,43,69,4,115,95.83333333333334,5.555555555555555
39699_marine,72,48,69,4,120,95.83333333333334,5.555555555555555
39700_marine,74,52,70,4,126,94.5945945945946,5.405405405405405
39701_marine,74,41,70,4,115,94.5945945945946,5.405405405405405
39702_marine,75,41,71,4,116,94.66666666666667,5.333333333333334
39703_marine,78,43,73,5,121,93.58974358974359,6.41025641025641
39704_marine,83,41,78,5,124,93.97590361445783,6.024096385542169
39705_marine,84,43,78,5,127,92.85714285714286,5.952380952380952
39706_marine,84,43,78,5,127,92.85714285714286,5.952380952380952
39707_marine,86,41,80,4,127,93.02325581395348,4.651162790697675
39708_marine,88,41,82,5,129,93.18181818181817,5.681818181818182
39709_marine,128,77,109,13,205,85.15625,10.15625
39710_marine,189,188,136,61,377,71.95767195767195,32.27513227513227
39741_marine,336,182,283,95,518,84.22619047619048,28.273809523809522
39742_marine,322,156,271,90,478,84.16149068322981,27.95031055900621
39743_marine,120,67,115,11,187,95.83333333333334,9.166666666666666
39744_marine,121,63,115,11,184,95.0413223140496,9.090909090909092
39745_marine,105,55,101,8,160,96.19047619047619,7.6190476190476195
39746_marine,102,53,98,8,155,96.07843137254902,7.8431372549019605
39747_marine,99,49,94,7,148,94.94949494949495,7.07070707070707
39748_marine,95,33,90,5,128,94.73684210526315,5.263157894736842
39749_marine,92,34,87,5,126,94.56521739130434,5.434782608695652
39750_marine,129,46,116,33,175,89.92248062015504,25.581395348837212
39751_marine,133,51,118,37,184,88.7218045112782,27.819548872180448
39752_marine,128,52,113,35,180,88.28125,27.34375
39753_marine,126,46,113,33,172,89.68253968253968,26.190476190476193
39754_marine,88,35,83,5,123,94.31818181818183,5.681818181818182
39755_marine,88,35,83,5,123,94.31818181818183,5.681818181818182
39756_marine,87,35,82,5,122,94.25287356321839,5.747126436781609
39757_marine,87,35,82,5,122,94.25287356321839,5.747126436781609
39758_marine,87,35,82,5,122,94.25287356321839,5.747126436781609
39759_marine,87,35,82,5,122,94.25287356321839,5.747126436781609
39760_marine,88,34,83,5,122,94.31818181818183,5.681818181818182
39761_marine,88,34,83,5,122,94.31818181818183,5.681818181818182
39762_marine,87,34,83,4,121,95.40229885057471,4.597701149425287
39763_marine,86,34,82,4,120,95.34883720930233,4.651162790697675
39764_marine,85,34,81,3,119,95.29411764705881,3.5294117647058822
39765_marine,85,33,81,3,118,95.29411764705881,3.5294117647058822
39766_marine,85,34,81,3,119,95.29411764705881,3.5294117647058822
39767_marine,85,34,81,3,119,95.29411764705881,3.5294117647058822
39768_marine,85,34,81,3,119,95.29411764705881,3.5294117647058822
39769_marine,84,34,80,3,118,95.23809523809523,3.571428571428571
39770_marine,81,32,77,3,113,95.06172839506173,3.7037037037037033
39771_marine,80,32,76,2,112,95,2.5
39772_marine,78,32,74,2,110,94.87179487179486,2.564102564102564
39773_marine,78,32,74,2,110,94.87179487179486,2.564102564102564
39774_marine,77,32,73,2,109,94.8051948051948,2.5974025974025974
39775_marine,75,32,71,2,107,94.66666666666667,2.666666666666667
39776_marine,75,32,71,2,107,94.66666666666667,2.666666666666667
39777_marine,75,31,71,2,106,94.66666666666667,2.666666666666667
39778_marine,75,31,71,2,106,94.66666666666667,2.666666666666667
39779_marine,75,32,71,2,107,94.66666666666667,2.666666666666667
39780_marine,76,32,71,2,108,93.42105263157895,2.631578947368421
39781_marine,78,32,73,2,110,93.58974358974359,2.564102564102564
39782_marine,77,32,72,1,109,93.5064935064935,1.2987012987012987
39783_marine,76,31,71,1,107,93.42105263157895,1.3157894736842104
39784_marine,74,32,69,1,106,93.24324324324324,1.3513513513513513
39785_marine,76,31,70,1,107,92.10526315789474,1.3157894736842104
39786_marine,75,31,69,1,106,92,1.3333333333333335
39787_marine,77,34,71,1,111,92.20779220779221,1.2987012987012987
39788_marine,79,40,72,2,119,91.13924050632912,2.5316455696202533
39789_marine,95,52,88,2,147,92.63157894736842,2.1052631578947367
39790_marine,88,42,81,2,130,92.04545454545455,2.272727272727273
39791_marine,89,44,82,5,133,92.13483146067416,5.617977528089887
39792_marine,101,79,94,7,180,93.06930693069307,6.9306930693069315
39793_marine,152,112,136,18,264,89.47368421052632,11.842105263157894
39817_marine,676,262,480,341,938,71.00591715976331,50.44378698224852
39818_marine,117,45,109,13,162,93.16239316239316,11.11111111111111
39819_marine,110,37,102,11,147,92.72727272727272,10
39820_marine,117,37,109,13,154,93.16239316239316,11.11111111111111
39821_marine,113,37,107,13,150,94.69026548672566,11.504424778761061
39822_marine,105,37,99,11,142,94.28571428571428,10.476190476190476
39823_marine,604,171,416,323,775,68.87417218543047,53.47682119205298
39830_marine,604,167,418,316,771,69.20529801324503,52.317880794701985
39831_marine,104,36,99,8,140,95.1923076923077,7.6923076923076925
39832_marine,97,34,91,7,131,93.81443298969072,7.216494845360824
39833_marine,97,34,91,8,131,93.81443298969072,8.24742268041237
39834_marine,98,35,92,8,133,93.87755102040816,8.16326530612245
39835_marine,574,184,377,319,758,65.6794425087108,55.57491289198606
39837_marine,625,224,400,348,849,64,55.67999999999999
39839_marine,612,212,391,341,824,63.888888888888886,55.71895424836602
39840_marine,95,35,90,7,130,94.73684210526315,7.368421052631578
39841_marine,82,33,77,6,115,93.90243902439023,7.317073170731707
39842_marine,81,32,76,5,113,93.82716049382715,6.172839506172839
39843_marine,374,98,259,202,472,69.25133689839572,54.01069518716578
39844_marine,375,98,260,203,473,69.33333333333334,54.13333333333333
39845_marine,374,96,259,202,470,69.25133689839572,54.01069518716578
39846_marine,74,30,69,5,104,93.24324324324324,6.756756756756757
39847_marine,72,28,67,5,100,93.05555555555556,6.944444444444445
39848_marine,72,28,67,5,100,93.05555555555556,6.944444444444445
39849_marine,73,28,68,5,101,93.15068493150685,6.8493150684931505
39850_marine,73,28,68,5,101,93.15068493150685,6.8493150684931505
39851_marine,72,28,68,4,100,94.44444444444444,5.555555555555555
39852_marine,72,28,68,4,100,94.44444444444444,5.555555555555555
39853_marine,71,29,68,3,100,95.77464788732394,4.225352112676056
39854_marine,71,29,68,3,100,95.77464788732394,4.225352112676056
39855_marine,73,29,70,3,102,95.8904109589041,4.10958904109589
39856_marine,74,29,71,3,103,95.94594594594594,4.054054054054054
39857_marine,74,28,71,3,102,95.94594594594594,4.054054054054054
39858_marine,74,28,71,3,102,95.94594594594594,4.054054054054054
39859_marine,74,28,71,3,102,95.94594594594594,4.054054054054054
39860_marine,72,28,69,3,100,95.83333333333334,4.166666666666666
39861_marine,72,28,69,3,100,95.83333333333334,4.166666666666666
39862_marine,72,28,69,3,100,95.83333333333334,4.166666666666666
39863_marine,72,28,69,3,100,95.83333333333334,4.166666666666666
39864_marine,72,28,69,3,100,95.83333333333334,4.166666666666666
39865_marine,72,28,69,3,100,95.83333333333334,4.166666666666666
39866_marine,72,28,69,3,100,95.83333333333334,4.166666666666666
39867_marine,72,28,69,3,100,95.83333333333334,4.166666666666666
39868_marine,74,28,71,3,102,95.94594594594594,4.054054054054054
39869_marine,76,28,73,3,104,96.05263157894737,3.9473684210526314
39870_marine,76,28,73,3,104,96.05263157894737,3.9473684210526314
39871_marine,76,28,73,3,104,96.05263157894737,3.9473684210526314
39872_marine,76,28,73,3,104,96.05263157894737,3.9473684210526314
39873_marine,75,28,72,3,103,96,4
39874_marine,75,28,72,3,103,96,4
39875_marine,75,29,72,3,104,96,4
39876_marine,75,28,72,3,103,96,4
39877_marine,75,28,72,3,103,96,4
39878_marine,76,28,73,3,104,96.05263157894737,3.9473684210526314
39879_marine,76,28,73,3,104,96.05263157894737,3.9473684210526314
39880_marine,78,28,75,3,106,96.15384615384616,3.8461538461538463
39881_marine,78,28,75,3,106,96.15384615384616,3.8461538461538463
39882_marine,79,28,76,4,107,96.20253164556962,5.063291139240507
39883_marine,79,28,76,4,107,96.20253164556962,5.063291139240507
39884_marine,79,28,76,4,107,96.20253164556962,5.063291139240507
39885_marine,81,28,78,4,109,96.29629629629629,4.938271604938271
39886_marine,82,28,79,4,110,96.34146341463415,4.878048780487805
39887_marine,80,27,76,4,107,95,5
39888_marine,80,29,76,4,109,95,5
39889_marine,82,29,78,4,111,95.1219512195122,4.878048780487805
39890_marine,86,31,80,6,117,93.02325581395348,6.976744186046512
39891_marine,96,33,90,6,129,93.75,6.25
39892_marine,105,35,99,7,140,94.28571428571428,6.666666666666667
39893_marine,131,45,120,15,176,91.6030534351145,11.450381679389313
39894_marine,569,227,406,296,796,71.35325131810193,52.02108963093146
39895_marine,632,312,461,310,944,72.94303797468355,49.050632911392405
39896_marine,734,420,488,396,1154,66.4850136239782,53.950953678474114
39897_marine,844,513,537,485,1357,63.62559241706162,57.464454976303315
39898_marine,814,477,517,475,1291,63.51351351351351,58.353808353808354
39899_marine,813,452,516,473,1265,63.46863468634686,58.17958179581796
39900_marine,807,416,514,465,1223,63.69268897149938,57.62081784386617
39931_marine,846,415,550,475,1261,65.01182033096927,56.14657210401891
39932_marine,813,361,523,461,1174,64.32964329643296,56.70356703567035
39933_marine,785,328,512,447,1113,65.22292993630573,56.94267515923567
39934_marine,136,80,122,22,216,89.70588235294117,16.176470588235293
39935_marine,145,72,127,27,217,87.58620689655172,18.620689655172416
39936_marine,116,38,104,15,154,89.65517241379311,12.931034482758621
39937_marine,114,38,102,13,152,89.47368421052632,11.403508771929824
39938_marine,581,174,372,357,755,64.02753872633392,61.44578313253012
39939_marine,591,181,377,363,772,63.7901861252115,61.42131979695431
39940_marine,590,161,373,366,751,63.22033898305085,62.03389830508475
39941_marine,592,158,376,367,750,63.51351351351351,61.99324324324324
39942_marine,146,53,131,38,199,89.72602739726028,26.027397260273972
39943_marine,776,289,473,476,1065,60.953608247422686,61.34020618556701
39944_marine,902,436,557,544,1338,61.75166297117517,60.310421286031044
39945_marine,898,454,553,543,1352,61.581291759465486,60.467706013363035
39946_marine,904,453,552,549,1357,61.06194690265486,60.73008849557522
39947_marine,863,394,530,522,1257,61.41367323290846,60.48667439165701
39948_marine,789,355,489,482,1144,61.97718631178707,61.08998732572877
39949_marine,789,339,469,498,1128,59.442332065906214,63.11787072243346
39950_marine,778,336,473,497,1114,60.79691516709511,63.88174807197944
39951_marine,689,258,414,446,947,60.087082728592165,64.73149492017417
39952_marine,679,245,407,441,924,59.941089837997055,64.94845360824742
39953_marine,109,38,99,13,147,90.82568807339449,11.926605504587156
39954_marine,107,36,97,13,143,90.65420560747664,12.149532710280374
39955_marine,107,36,97,12,143,90.65420560747664,11.214953271028037
39956_marine,112,36,102,13,148,91.07142857142857,11.607142857142858
39957_marine,116,38,106,15,154,91.37931034482759,12.931034482758621
39958_marine,709,238,441,437,947,62.200282087447114,61.636107193229904
39959_marine,711,238,443,437,949,62.30661040787623,61.46272855133614
39960_marine,684,219,416,435,903,60.81871345029239,63.59649122807017
39961_marine,596,195,381,369,791,63.92617449664429,61.91275167785235
39962_marine,610,198,391,373,808,64.09836065573771,61.147540983606554
39963_marine,655,210,415,405,865,63.358778625954194,61.832061068702295
39964_marine,636,202,403,391,838,63.36477987421384,61.47798742138365
39965_marine,686,232,436,419,918,63.55685131195335,61.07871720116618
39966_marine,687,230,438,419,917,63.75545851528385,60.98981077147017
39967_marine,634,196,397,393,830,62.618296529968454,61.987381703470035
39968_marine,99,37,93,8,136,93.93939393939394,8.080808080808081
39969_marine,99,37,93,8,136,93.93939393939394,8.080808080808081
39970_marine,99,38,93,8,137,93.93939393939394,8.080808080808081
39971_marine,97,39,91,8,136,93.81443298969072,8.24742268041237
39972_marine,97,38,91,8,135,93.81443298969072,8.24742268041237
39973_marine,97,37,91,8,134,93.81443298969072,8.24742268041237
39974_marine,97,37,91,8,134,93.81443298969072,8.24742268041237
39975_marine,97,37,91,8,134,93.81443298969072,8.24742268041237
39976_marine,95,37,89,8,132,93.6842105263158,8.421052631578947
39977_marine,95,37,89,10,132,93.6842105263158,10.526315789473683
39978_marine,95,37,89,10,132,93.6842105263158,10.526315789473683
39979_marine,92,34,86,10,126,93.47826086956522,10.869565217391305
39980_marine,400,106,266,250,506,66.5,62.5
39981_marine,429,122,290,262,551,67.5990675990676,61.07226107226107
39982_marine,418,116,278,266,534,66.50717703349282,63.63636363636363
39983_marine,430,123,294,266,553,68.37209302325581,61.86046511627907
39984_marine,399,105,267,252,504,66.9172932330827,63.1578947368421
39985_marine,351,86,239,212,437,68.09116809116809,60.3988603988604
39986_marine,364,96,248,220,460,68.13186813186813,60.43956043956044
39987_marine,359,87,243,218,446,67.68802228412257,60.724233983286915
39988_marine,357,85,245,216,442,68.62745098039215,60.50420168067227
39989_marine,357,89,245,216,446,68.62745098039215,60.50420168067227
39990_marine,359,87,247,216,446,68.80222841225627,60.16713091922006
39991_marine,95,36,89,10,131,93.6842105263158,10.526315789473683
39992_marine,97,36,91,10,133,93.81443298969072,10.309278350515463
39993_marine,97,35,91,10,132,93.81443298969072,10.309278350515463
39994_marine,97,37,91,10,134,93.81443298969072,10.309278350515463
39995_marine,97,37,91,10,134,93.81443298969072,10.309278350515463
39996_marine,413,94,279,254,507,67.55447941888619,61.50121065375303
39997_marine,412,98,278,254,510,67.47572815533981,61.6504854368932
39998_marine,410,98,276,252,508,67.31707317073172,61.46341463414634
39999_marine,405,100,273,248,505,67.4074074074074,61.23456790123457
40000_marine,441,120,299,274,561,67.80045351473923,62.131519274376416
40001_marine,425,108,287,264,533,67.52941176470588,62.117647058823536
40002_marine,429,106,291,262,535,67.83216783216784,61.07226107226107
40003_marine,422,102,284,264,524,67.29857819905213,62.55924170616114
40004_marine,419,114,287,257,533,68.4964200477327,61.336515513126486
40005_marine,417,113,285,257,530,68.34532374100719,61.63069544364509
40006_marine,381,95,263,232,476,69.02887139107612,60.892388451443566
40007_marine,93,36,87,9,129,93.54838709677419,9.67741935483871
40008_marine,93,34,87,9,127,93.54838709677419,9.67741935483871
40009_marine,93,34,87,9,127,93.54838709677419,9.67741935483871
40010_marine,94,34,88,9,128,93.61702127659575,9.574468085106384
40011_marine,93,34,87,9,127,93.54838709677419,9.67741935483871
40012_marine,91,34,86,9,125,94.5054945054945,9.89010989010989
40013_marine,91,34,86,9,125,94.5054945054945,9.89010989010989
40014_marine,89,34,84,10,123,94.3820224719101,11.235955056179774
40015_marine,89,34,84,10,123,94.3820224719101,11.235955056179774
40016_marine,88,33,83,9,121,94.31818181818183,10.227272727272728
40017_marine,88,33,83,9,121,94.31818181818183,10.227272727272728
40018_marine,88,33,83,9,121,94.31818181818183,10.227272727272728
40019_marine,88,32,83,9,120,94.31818181818183,10.227272727272728
40020_marine,88,32,83,9,120,94.31818181818183,10.227272727272728
40021_marine,88,34,83,9,122,94.31818181818183,10.227272727272728
40022_marine,88,34,83,9,122,94.31818181818183,10.227272727272728
40023_marine,88,34,83,9,122,94.31818181818183,10.227272727272728
40024_marine,87,34,82,9,121,94.25287356321839,10.344827586206897
40025_marine,85,34,80,8,119,94.11764705882352,9.411764705882353
40026_marine,85,35,80,8,120,94.11764705882352,9.411764705882353
40027_marine,85,35,80,8,120,94.11764705882352,9.411764705882353
40028_marine,83,33,78,8,116,93.97590361445783,9.63855421686747
40029_marine,81,33,76,8,114,93.82716049382715,9.876543209876543
40030_marine,81,33,76,8,114,93.82716049382715,9.876543209876543
40031_marine,81,33,76,8,114,93.82716049382715,9.876543209876543
40032_marine,79,33,74,7,112,93.67088607594937,8.860759493670885
40033_marine,79,33,74,7,112,93.67088607594937,8.860759493670885
40034_marine,78,33,73,7,111,93.58974358974359,8.974358974358974
40035_marine,78,33,73,7,111,93.58974358974359,8.974358974358974
40036_marine,78,33,73,7,111,93.58974358974359,8.974358974358974
40037_marine,78,33,73,6,111,93.58974358974359,7.6923076923076925
40038_marine,78,33,73,6,111,93.58974358974359,7.6923076923076925
40039_marine,77,33,73,5,110,94.8051948051948,6.493506493506493
40040_marine,75,34,71,4,109,94.66666666666667,5.333333333333334
40041_marine,75,34,71,4,109,94.66666666666667,5.333333333333334
40042_marine,75,34,71,4,109,94.66666666666667,5.333333333333334
40043_marine,75,34,71,4,109,94.66666666666667,5.333333333333334
40044_marine,73,34,69,4,107,94.52054794520548,5.47945205479452
40045_marine,72,34,69,3,106,95.83333333333334,4.166666666666666
40046_marine,72,36,69,3,108,95.83333333333334,4.166666666666666
40047_marine,72,38,69,3,110,95.83333333333334,4.166666666666666
40048_marine,72,38,69,3,110,95.83333333333334,4.166666666666666
40049_marine,73,41,70,3,114,95.8904109589041,4.10958904109589
40050_marine,73,41,70,3,114,95.8904109589041,4.10958904109589
40051_marine,72,41,69,3,113,95.83333333333334,4.166666666666666
40052_marine,74,42,71,4,116,95.94594594594594,5.405405405405405
40053_marine,74,42,71,4,116,95.94594594594594,5.405405405405405
40054_marine,72,40,69,4,112,95.83333333333334,5.555555555555555
40055_marine,73,39,70,4,112,95.8904109589041,5.47945205479452
40056_marine,73,39,70,4,112,95.8904109589041,5.47945205479452
40057_marine,72,39,69,4,111,95.83333333333334,5.555555555555555
40058_marine,70,49,67,4,119,95.71428571428572,5.714285714285714
40059_marine,70,51,67,4,121,95.71428571428572,5.714285714285714
40060_marine,72,47,69,4,119,95.83333333333334,5.555555555555555
40061_marine,73,40,69,4,113,94.52054794520548,5.47945205479452
40062_marine,74,42,69,5,116,93.24324324324324,6.756756756756757
40063_marine,77,41,72,5,118,93.5064935064935,6.493506493506493
40064_marine,79,41,74,5,120,93.67088607594937,6.329113924050633
40065_marine,80,43,75,5,123,93.75,6.25
40066_marine,81,43,75,5,124,92.5925925925926,6.172839506172839
40067_marine,80,41,74,4,121,92.5,5
40068_marine,86,42,80,5,128,93.02325581395348,5.813953488372093
40069_marine,127,74,108,13,201,85.03937007874016,10.236220472440944
40070_marine,185,173,134,61,358,72.43243243243244,32.972972972972975
40101_marine,323,166,272,93,489,84.21052631578947,28.792569659442723
40102_marine,116,47,111,7,163,95.6896551724138,6.0344827586206895
40103_marine,110,42,104,7,152,94.54545454545455,6.363636363636363
40104_marine,104,39,98,6,143,94.23076923076923,5.769230769230769
40105_marine,98,35,94,4,133,95.91836734693877,4.081632653061225
40106_marine,96,39,92,4,135,95.83333333333334,4.166666666666666
40107_marine,95,35,90,5,130,94.73684210526315,5.263157894736842
40108_marine,93,32,88,4,125,94.6236559139785,4.301075268817205
40109_marine,87,32,82,4,119,94.25287356321839,4.597701149425287
40110_marine,126,46,113,32,172,89.68253968253968,25.396825396825395
40111_marine,124,46,111,32,170,89.51612903225806,25.806451612903224
40112_marine,123,46,110,32,169,89.43089430894308,26.01626016260163
40113_marine,85,33,80,4,118,94.11764705882352,4.705882352941177
40114_marine,87,35,82,4,122,94.25287356321839,4.597701149425287
40115_marine,86,35,81,4,121,94.18604651162791,4.651162790697675
40116_marine,85,35,80,4,120,94.11764705882352,4.705882352941177
40117_marine,85,35,80,4,120,94.11764705882352,4.705882352941177
40118_marine,87,34,82,5,121,94.25287356321839,5.747126436781609
40119_marine,88,34,83,5,122,94.31818181818183,5.681818181818182
40120_marine,86,35,82,4,121,95.34883720930233,4.651162790697675
40121_marine,86,35,82,4,121,95.34883720930233,4.651162790697675
40122_marine,86,35,82,4,121,95.34883720930233,4.651162790697675
40123_marine,85,33,81,3,118,95.29411764705881,3.5294117647058822
40124_marine,85,33,81,3,118,95.29411764705881,3.5294117647058822
40125_marine,85,32,81,3,117,95.29411764705881,3.5294117647058822
40126_marine,85,32,81,3,117,95.29411764705881,3.5294117647058822
40127_marine,83,32,79,3,115,95.18072289156626,3.614457831325301
40128_marine,81,32,77,3,113,95.06172839506173,3.7037037037037033
40129_marine,78,32,74,2,110,94.87179487179486,2.564102564102564
40130_marine,78,32,74,2,110,94.87179487179486,2.564102564102564
40131_marine,78,32,74,2,110,94.87179487179486,2.564102564102564
40132_marine,78,32,74,2,110,94.87179487179486,2.564102564102564
40133_marine,78,32,74,2,110,94.87179487179486,2.564102564102564
40134_marine,78,32,74,2,110,94.87179487179486,2.564102564102564
40135_marine,77,32,73,2,109,94.8051948051948,2.5974025974025974
40136_marine,77,32,73,2,109,94.8051948051948,2.5974025974025974
40137_marine,76,32,72,2,108,94.73684210526315,2.631578947368421
40138_marine,75,32,71,2,107,94.66666666666667,2.666666666666667
40139_marine,75,32,71,2,107,94.66666666666667,2.666666666666667
40140_marine,75,32,71,2,107,94.66666666666667,2.666666666666667
40141_marine,77,30,72,1,107,93.5064935064935,1.2987012987012987
40142_marine,77,30,72,1,107,93.5064935064935,1.2987012987012987
40143_marine,74,32,69,1,106,93.24324324324324,1.3513513513513513
40144_marine,76,32,71,1,108,93.42105263157895,1.3157894736842104
40145_marine,77,31,71,1,108,92.20779220779221,1.2987012987012987
40146_marine,75,31,69,1,106,92,1.3333333333333335
40147_marine,75,33,69,1,108,92,1.3333333333333335
40148_marine,81,38,74,2,119,91.35802469135803,2.4691358024691357
40149_marine,83,36,76,2,119,91.56626506024097,2.4096385542168677
40150_marine,83,36,76,2,119,91.56626506024097,2.4096385542168677
40151_marine,85,38,78,3,123,91.76470588235294,3.5294117647058822
40152_marine,95,53,88,5,148,92.63157894736842,5.263157894736842
40153_marine,148,111,138,10,259,93.24324324324324,6.756756756756757
40177_marine,654,237,457,340,891,69.8776758409786,51.98776758409785
40178_marine,112,40,103,15,152,91.96428571428571,13.392857142857142
40179_marine,111,38,103,11,149,92.7927927927928,9.90990990990991
40180_marine,502,90,349,271,592,69.52191235059762,53.98406374501992
40181_marine,486,84,337,268,570,69.34156378600824,55.144032921810705
40182_marine,485,82,337,268,567,69.48453608247422,55.25773195876289
40183_marine,626,182,436,327,808,69.6485623003195,52.23642172523961
40190_marine,599,162,413,315,761,68.9482470784641,52.587646076794655
40191_marine,99,35,94,7,134,94.94949494949495,7.07070707070707
40192_marine,96,34,91,6,130,94.79166666666666,6.25
40193_marine,96,34,90,8,130,93.75,8.333333333333332
40194_marine,98,35,92,8,133,93.87755102040816,8.16326530612245
40195_marine,572,184,375,319,756,65.55944055944056,55.769230769230774
40197_marine,624,229,399,349,853,63.942307692307686,55.92948717948718
40198_marine,613,212,393,342,825,64.11092985318108,55.791190864600324
40199_marine,607,208,388,338,815,63.92092257001647,55.6836902800659
40200_marine,92,32,87,6,124,94.56521739130434,6.521739130434782
40201_marine,79,31,74,5,110,93.67088607594937,6.329113924050633
40202_marine,78,29,73,5,107,93.58974358974359,6.41025641025641
40203_marine,78,29,73,5,107,93.58974358974359,6.41025641025641
40204_marine,76,29,71,5,105,93.42105263157895,6.578947368421052
40205_marine,74,28,69,5,102,93.24324324324324,6.756756756756757
40206_marine,72,28,67,5,100,93.05555555555556,6.944444444444445
40207_marine,72,28,67,5,100,93.05555555555556,6.944444444444445
40208_marine,71,29,67,4,100,94.36619718309859,5.633802816901409
40209_marine,71,29,67,4,100,94.36619718309859,5.633802816901409
40210_marine,72,29,68,4,101,94.44444444444444,5.555555555555555
40211_marine,72,29,68,4,101,94.44444444444444,5.555555555555555
40212_marine,71,29,68,3,100,95.77464788732394,4.225352112676056
40213_marine,71,29,68,3,100,95.77464788732394,4.225352112676056
40214_marine,71,28,68,3,99,95.77464788732394,4.225352112676056
40215_marine,69,28,66,3,97,95.65217391304348,4.3478260869565215
40216_marine,69,28,66,3,97,95.65217391304348,4.3478260869565215
40217_marine,69,28,66,3,97,95.65217391304348,4.3478260869565215
40218_marine,71,28,68,3,99,95.77464788732394,4.225352112676056
40219_marine,71,29,68,3,100,95.77464788732394,4.225352112676056
40220_marine,71,29,68,3,100,95.77464788732394,4.225352112676056
40221_marine,71,28,68,3,99,95.77464788732394,4.225352112676056
40222_marine,71,28,68,3,99,95.77464788732394,4.225352112676056
40223_marine,71,28,68,3,99,95.77464788732394,4.225352112676056
40224_marine,71,28,68,3,99,95.77464788732394,4.225352112676056
40225_marine,73,28,70,3,101,95.8904109589041,4.10958904109589
40226_marine,76,28,73,3,104,96.05263157894737,3.9473684210526314
40227_marine,76,28,73,3,104,96.05263157894737,3.9473684210526314
40228_marine,76,28,73,3,104,96.05263157894737,3.9473684210526314
40229_marine,76,28,73,3,104,96.05263157894737,3.9473684210526314
40230_marine,78,28,75,3,106,96.15384615384616,3.8461538461538463
40231_marine,78,28,75,3,106,96.15384615384616,3.8461538461538463
40232_marine,77,28,74,3,105,96.1038961038961,3.896103896103896
40233_marine,77,28,74,3,105,96.1038961038961,3.896103896103896
40234_marine,77,28,74,3,105,96.1038961038961,3.896103896103896
40235_marine,77,28,74,3,105,96.1038961038961,3.896103896103896
40236_marine,77,29,74,3,106,96.1038961038961,3.896103896103896
40237_marine,77,28,74,3,105,96.1038961038961,3.896103896103896
40238_marine,77,28,74,3,105,96.1038961038961,3.896103896103896
40239_marine,78,29,75,3,107,96.15384615384616,3.8461538461538463
40240_marine,78,29,75,3,107,96.15384615384616,3.8461538461538463
40241_marine,78,29,75,3,107,96.15384615384616,3.8461538461538463
40242_marine,80,29,77,3,109,96.25,3.75
40243_marine,78,29,75,3,107,96.15384615384616,3.8461538461538463
40244_marine,78,29,75,3,107,96.15384615384616,3.8461538461538463
40245_marine,78,29,75,3,107,96.15384615384616,3.8461538461538463
40246_marine,79,30,76,3,109,96.20253164556962,3.79746835443038
40247_marine,81,29,78,3,110,96.29629629629629,3.7037037037037033
40248_marine,81,29,77,3,110,95.06172839506173,3.7037037037037033
40249_marine,80,31,76,4,111,95,5
40250_marine,85,31,80,5,116,94.11764705882352,5.88235294117647
40251_marine,95,32,90,5,127,94.73684210526315,5.263157894736842
40252_marine,110,34,105,10,144,95.45454545454545,9.090909090909092
40253_marine,523,210,366,276,733,69.98087954110899,52.77246653919694
40254_marine,792,436,501,456,1228,63.25757575757576,57.57575757575758
40255_marine,832,528,523,483,1360,62.86057692307693,58.05288461538461
40256_marine,807,481,511,468,1288,63.320941759603464,57.99256505576208
40257_marine,616,301,443,311,917,71.9155844155844,50.48701298701299
40291_marine,999,454,592,625,1453,59.25925925925925,62.56256256256256
40292_marine,829,384,536,469,1213,64.6562123039807,56.57418576598311
40293_marine,800,341,523,449,1141,65.375,56.125
40294_marine,788,333,515,447,1121,65.35532994923858,56.7258883248731
40295_marine,138,75,122,28,213,88.40579710144928,20.28985507246377
40296_marine,138,51,122,24,189,88.40579710144928,17.391304347826086
40297_marine,114,40,102,13,154,89.47368421052632,11.403508771929824
40298_marine,115,43,103,13,158,89.56521739130436,11.304347826086957
40299_marine,591,154,383,356,745,64.80541455160744,60.236886632825716
40300_marine,581,143,374,356,724,64.37177280550775,61.2736660929432
40301_marine,104,37,94,14,141,90.38461538461539,13.461538461538462
40302_marine,126,49,111,25,175,88.09523809523809,19.841269841269842
40303_marine,120,45,109,19,165,90.83333333333333,15.833333333333332
40304_marine,785,319,480,476,1104,61.146496815286625,60.63694267515923
40305_marine,904,436,556,547,1340,61.504424778761056,60.508849557522126
40306_marine,908,448,555,553,1356,61.12334801762115,60.90308370044053
40307_marine,905,468,552,553,1373,60.99447513812155,61.1049723756906
40308_marine,866,423,534,522,1289,61.662817551963045,60.27713625866051
40309_marine,798,367,493,487,1165,61.77944862155389,61.02756892230576
40310_marine,770,312,457,494,1082,59.350649350649356,64.15584415584415
40311_marine,686,270,409,448,956,59.62099125364432,65.3061224489796
40312_marine,472,148,300,295,620,63.559322033898304,62.5
40313_marine,468,146,296,293,614,63.24786324786324,62.60683760683761
40314_marine,107,36,97,13,143,90.65420560747664,12.149532710280374
40315_marine,117,44,103,20,161,88.03418803418803,17.094017094017094
40316_marine,106,37,96,12,143,90.56603773584906,11.320754716981133
40317_marine,110,37,100,12,147,90.9090909090909,10.909090909090908
40318_marine,108,37,98,12,145,90.74074074074075,11.11111111111111
40319_marine,108,38,98,12,146,90.74074074074075,11.11111111111111
40320_marine,109,38,99,11,147,90.82568807339449,10.091743119266056
40321_marine,103,39,93,11,142,90.29126213592234,10.679611650485436
40322_marine,99,43,91,9,142,91.91919191919192,9.090909090909092
40323_marine,523,136,338,314,659,64.62715105162525,60.038240917782026
40324_marine,538,152,348,320,690,64.68401486988847,59.479553903345725
40325_marine,633,202,402,388,835,63.507109004739334,61.29541864139021
40326_marine,626,195,396,387,821,63.25878594249201,61.82108626198083
40327_marine,100,39,94,9,139,94,9
40328_marine,95,39,89,8,134,93.6842105263158,8.421052631578947
40329_marine,95,39,89,8,134,93.6842105263158,8.421052631578947
40330_marine,95,37,89,8,132,93.6842105263158,8.421052631578947
40331_marine,95,38,89,8,133,93.6842105263158,8.421052631578947
40332_marine,95,37,89,8,132,93.6842105263158,8.421052631578947
40333_marine,95,38,89,8,133,93.6842105263158,8.421052631578947
40334_marine,95,38,89,8,133,93.6842105263158,8.421052631578947
40335_marine,95,36,89,8,131,93.6842105263158,8.421052631578947
40336_marine,93,36,87,8,129,93.54838709677419,8.60215053763441
40337_marine,92,36,86,8,128,93.47826086956522,8.695652173913043
40338_marine,92,35,86,8,127,93.47826086956522,8.695652173913043
40339_marine,91,34,85,10,125,93.4065934065934,10.989010989010989
40340_marine,398,102,264,250,500,66.33165829145729,62.8140703517588
40341_marine,398,102,264,250,500,66.33165829145729,62.8140703517588
40342_marine,368,94,250,222,462,67.93478260869566,60.32608695652174
40343_marine,368,94,250,222,462,67.93478260869566,60.32608695652174
40344_marine,367,89,249,222,456,67.8474114441417,60.49046321525886
40345_marine,351,85,239,212,436,68.09116809116809,60.3988603988604
40346_marine,350,87,238,211,437,68,60.285714285714285
40347_marine,358,89,242,217,447,67.59776536312849,60.614525139664806
40348_marine,375,103,257,224,478,68.53333333333333,59.73333333333334
40349_marine,376,103,258,225,479,68.61702127659575,59.840425531914896
40350_marine,356,89,244,215,445,68.53932584269663,60.39325842696629
40351_marine,346,84,236,209,430,68.20809248554913,60.40462427745664
40352_marine,348,84,238,209,432,68.39080459770115,60.05747126436781
40353_marine,346,84,236,209,430,68.20809248554913,60.40462427745664
40354_marine,92,37,86,9,129,93.47826086956522,9.782608695652174
40355_marine,92,36,86,9,128,93.47826086956522,9.782608695652174
40356_marine,95,36,89,10,131,93.6842105263158,10.526315789473683
40357_marine,97,36,91,10,133,93.81443298969072,10.309278350515463
40358_marine,97,36,91,10,133,93.81443298969072,10.309278350515463
40359_marine,406,99,274,248,505,67.48768472906403,61.083743842364534
40360_marine,405,99,273,248,504,67.4074074074074,61.23456790123457
40361_marine,405,97,273,248,502,67.4074074074074,61.23456790123457
40362_marine,115,56,103,20,171,89.56521739130436,17.391304347826086
40363_marine,395,95,267,246,490,67.59493670886076,62.278481012658226
40364_marine,410,115,278,257,525,67.8048780487805,62.68292682926829
40365_marine,399,103,271,250,502,67.91979949874687,62.65664160401002
40366_marine,404,105,278,248,509,68.8118811881188,61.386138613861384
40367_marine,351,99,241,207,450,68.66096866096866,58.97435897435898
40368_marine,94,34,88,9,128,93.61702127659575,9.574468085106384
40369_marine,247,78,173,137,325,70.04048582995951,55.465587044534416
40370_marine,246,79,173,137,325,70.32520325203252,55.6910569105691
40371_marine,91,34,86,9,125,94.5054945054945,9.89010989010989
40372_marine,91,34,86,9,125,94.5054945054945,9.89010989010989
40373_marine,89,35,84,9,124,94.3820224719101,10.112359550561797
40374_marine,88,35,83,9,123,94.31818181818183,10.227272727272728
40375_marine,89,35,84,10,124,94.3820224719101,11.235955056179774
40376_marine,88,34,83,9,122,94.31818181818183,10.227272727272728
40377_marine,88,33,83,9,121,94.31818181818183,10.227272727272728
40378_marine,88,33,83,9,121,94.31818181818183,10.227272727272728
40379_marine,88,33,83,9,121,94.31818181818183,10.227272727272728
40380_marine,88,33,83,9,121,94.31818181818183,10.227272727272728
40381_marine,88,33,83,9,121,94.31818181818183,10.227272727272728
40382_marine,88,35,83,9,123,94.31818181818183,10.227272727272728
40383_marine,88,35,83,9,123,94.31818181818183,10.227272727272728
40384_marine,86,35,81,8,121,94.18604651162791,9.30232558139535
40385_marine,86,35,81,8,121,94.18604651162791,9.30232558139535
40386_marine,83,35,78,8,118,93.97590361445783,9.63855421686747
40387_marine,82,35,77,8,117,93.90243902439023,9.75609756097561
40388_marine,82,35,77,8,117,93.90243902439023,9.75609756097561
40389_marine,82,36,77,8,118,93.90243902439023,9.75609756097561
40390_marine,80,34,75,8,114,93.75,10
40391_marine,80,34,75,8,114,93.75,10
40392_marine,79,34,74,8,113,93.67088607594937,10.126582278481013
40393_marine,78,34,73,7,112,93.58974358974359,8.974358974358974
40394_marine,78,34,73,7,112,93.58974358974359,8.974358974358974
40395_marine,78,34,73,7,112,93.58974358974359,8.974358974358974
40396_marine,79,34,74,7,113,93.67088607594937,8.860759493670885
40397_marine,79,34,74,7,113,93.67088607594937,8.860759493670885
40398_marine,78,34,73,6,112,93.58974358974359,7.6923076923076925
40399_marine,78,34,73,6,112,93.58974358974359,7.6923076923076925
40400_marine,76,33,72,5,109,94.73684210526315,6.578947368421052
40401_marine,75,33,71,4,108,94.66666666666667,5.333333333333334
40402_marine,75,33,71,4,108,94.66666666666667,5.333333333333334
40403_marine,75,33,71,4,108,94.66666666666667,5.333333333333334
40404_marine,73,33,69,4,106,94.52054794520548,5.47945205479452
40405_marine,72,33,69,3,105,95.83333333333334,4.166666666666666
40406_marine,72,33,69,3,105,95.83333333333334,4.166666666666666
40407_marine,68,37,65,3,105,95.58823529411765,4.411764705882353
40408_marine,68,41,65,3,109,95.58823529411765,4.411764705882353
40409_marine,69,42,66,3,111,95.65217391304348,4.3478260869565215
40410_marine,71,42,68,3,113,95.77464788732394,4.225352112676056
40411_marine,71,42,68,3,113,95.77464788732394,4.225352112676056
40412_marine,70,42,67,3,112,95.71428571428572,4.285714285714286
40413_marine,71,43,68,4,114,95.77464788732394,5.633802816901409
40414_marine,73,41,70,4,114,95.8904109589041,5.47945205479452
40415_marine,73,40,70,4,113,95.8904109589041,5.47945205479452
40416_marine,73,41,70,4,114,95.8904109589041,5.47945205479452
40417_marine,72,44,69,4,116,95.83333333333334,5.555555555555555
40418_marine,70,50,67,4,120,95.71428571428572,5.714285714285714
40419_marine,70,54,67,4,124,95.71428571428572,5.714285714285714
40420_marine,71,44,68,4,115,95.77464788732394,5.633802816901409
40421_marine,73,39,69,4,112,94.52054794520548,5.47945205479452
40422_marine,74,41,69,5,115,93.24324324324324,6.756756756756757
40423_marine,75,41,70,5,116,93.33333333333333,6.666666666666667
40424_marine,77,41,72,5,118,93.5064935064935,6.493506493506493
40425_marine,74,42,69,5,116,93.24324324324324,6.756756756756757
40426_marine,79,42,73,5,121,92.40506329113924,6.329113924050633
40427_marine,76,41,70,4,117,92.10526315789474,5.263157894736842
40428_marine,85,42,79,4,127,92.94117647058823,4.705882352941177
40429_marine,125,72,105,15,197,84,12
40430_marine,181,150,133,59,331,73.48066298342542,32.59668508287293
40461_marine,318,164,269,91,482,84.59119496855347,28.61635220125786
40462_marine,111,44,106,7,155,95.4954954954955,6.306306306306306
40463_marine,119,53,113,11,172,94.9579831932773,9.243697478991598
40464_marine,100,36,94,6,136,94,6
40465_marine,95,36,91,3,131,95.78947368421052,3.1578947368421053
40466_marine,93,36,89,3,129,95.6989247311828,3.225806451612903
40467_marine,92,33,88,3,125,95.65217391304348,3.260869565217391
40468_marine,91,33,86,4,124,94.5054945054945,4.395604395604396
40469_marine,88,33,83,4,121,94.31818181818183,4.545454545454546
40470_marine,86,34,81,4,120,94.18604651162791,4.651162790697675
40471_marine,86,34,81,4,120,94.18604651162791,4.651162790697675
40472_marine,86,34,81,4,120,94.18604651162791,4.651162790697675
40473_marine,86,34,81,4,120,94.18604651162791,4.651162790697675
40474_marine,87,34,82,4,121,94.25287356321839,4.597701149425287
40475_marine,87,35,82,4,122,94.25287356321839,4.597701149425287
40476_marine,86,32,81,4,118,94.18604651162791,4.651162790697675
40477_marine,85,32,80,4,117,94.11764705882352,4.705882352941177
40478_marine,85,32,81,3,117,95.29411764705881,3.5294117647058822
40479_marine,85,32,81,3,117,95.29411764705881,3.5294117647058822
40480_marine,85,32,81,3,117,95.29411764705881,3.5294117647058822
40481_marine,85,32,81,3,117,95.29411764705881,3.5294117647058822
40482_marine,85,32,81,3,117,95.29411764705881,3.5294117647058822
40483_marine,82,32,78,2,114,95.1219512195122,2.4390243902439024
40484_marine,80,32,76,2,112,95,2.5
40485_marine,79,31,75,3,110,94.9367088607595,3.79746835443038
40486_marine,79,31,75,3,110,94.9367088607595,3.79746835443038
40487_marine,79,31,75,2,110,94.9367088607595,2.5316455696202533
40488_marine,79,31,75,2,110,94.9367088607595,2.5316455696202533
40489_marine,79,31,75,2,110,94.9367088607595,2.5316455696202533
40490_marine,79,31,75,2,110,94.9367088607595,2.5316455696202533
40491_marine,79,31,75,2,110,94.9367088607595,2.5316455696202533
40492_marine,79,31,75,2,110,94.9367088607595,2.5316455696202533
40493_marine,79,31,75,2,110,94.9367088607595,2.5316455696202533
40494_marine,79,31,75,2,110,94.9367088607595,2.5316455696202533
40495_marine,78,31,74,2,109,94.87179487179486,2.564102564102564
40496_marine,78,32,74,2,110,94.87179487179486,2.564102564102564
40497_marine,78,32,74,2,110,94.87179487179486,2.564102564102564
40498_marine,77,32,73,2,109,94.8051948051948,2.5974025974025974
40499_marine,77,32,73,2,109,94.8051948051948,2.5974025974025974
40500_marine,75,29,71,1,104,94.66666666666667,1.3333333333333335
40501_marine,73,29,69,1,102,94.52054794520548,1.36986301369863
40502_marine,75,29,70,1,104,93.33333333333333,1.3333333333333335
40503_marine,76,32,71,1,108,93.42105263157895,1.3157894736842104
40504_marine,76,31,71,1,107,93.42105263157895,1.3157894736842104
40505_marine,76,29,71,1,105,93.42105263157895,1.3157894736842104
40506_marine,75,31,69,1,106,92,1.3333333333333335
40507_marine,75,37,69,1,112,92,1.3333333333333335
40508_marine,77,36,70,2,113,90.9090909090909,2.5974025974025974
40509_marine,84,36,77,2,120,91.66666666666666,2.380952380952381
40510_marine,84,38,77,2,122,91.66666666666666,2.380952380952381
40511_marine,84,38,77,2,122,91.66666666666666,2.380952380952381
40512_marine,92,42,85,4,134,92.3913043478261,4.3478260869565215
40513_marine,98,82,91,4,180,92.85714285714286,4.081632653061225
40514_marine,148,128,134,12,276,90.54054054054053,8.108108108108109
40537_marine,656,238,457,342,894,69.66463414634147,52.13414634146341
40538_marine,111,40,102,15,151,91.8918918918919,13.513513513513514
40539_marine,111,36,103,11,147,92.7927927927928,9.90990990990991
40540_marine,485,84,334,267,569,68.8659793814433,55.05154639175258
40541_marine,503,92,349,278,595,69.38369781312127,55.26838966202783
40542_marine,486,82,338,269,568,69.54732510288066,55.349794238683124
40543_marine,631,182,441,328,813,69.88906497622821,51.98098256735341
40549_marine,634,188,447,320,822,70.50473186119874,50.473186119873816
40550_marine,594,162,408,313,756,68.68686868686868,52.69360269360269
40551_marine,97,33,92,6,130,94.84536082474226,6.185567010309279
40552_marine,94,33,89,6,127,94.68085106382979,6.382978723404255
40553_marine,91,34,86,6,125,94.5054945054945,6.593406593406594
40554_marine,96,34,90,7,130,93.75,7.291666666666667
40555_marine,570,177,373,319,747,65.43859649122807,55.96491228070175
40556_marine,569,177,372,319,746,65.37785588752196,56.06326889279437
40557_marine,569,177,372,319,746,65.37785588752196,56.06326889279437
40558_marine,94,36,89,9,130,94.68085106382979,9.574468085106384
40559_marine,88,34,83,6,122,94.31818181818183,6.8181818181818175
40560_marine,86,29,81,5,115,94.18604651162791,5.813953488372093
40561_marine,77,29,72,5,106,93.5064935064935,6.493506493506493
40562_marine,74,29,69,5,103,93.24324324324324,6.756756756756757
40563_marine,72,28,67,5,100,93.05555555555556,6.944444444444445
40564_marine,69,28,65,4,97,94.20289855072464,5.797101449275362
40565_marine,69,28,65,4,97,94.20289855072464,5.797101449275362
40566_marine,69,29,65,4,98,94.20289855072464,5.797101449275362
40567_marine,69,29,65,4,98,94.20289855072464,5.797101449275362
40568_marine,69,29,65,4,98,94.20289855072464,5.797101449275362
40569_marine,69,28,65,4,97,94.20289855072464,5.797101449275362
40570_marine,69,28,65,4,97,94.20289855072464,5.797101449275362
40571_marine,69,28,66,3,97,95.65217391304348,4.3478260869565215
40572_marine,67,28,64,3,95,95.52238805970148,4.477611940298507
40573_marine,67,28,64,3,95,95.52238805970148,4.477611940298507
40574_marine,68,28,65,3,96,95.58823529411765,4.411764705882353
40575_marine,70,28,67,3,98,95.71428571428572,4.285714285714286
40576_marine,70,28,67,3,98,95.71428571428572,4.285714285714286
40577_marine,70,28,67,3,98,95.71428571428572,4.285714285714286
40578_marine,70,28,67,3,98,95.71428571428572,4.285714285714286
40579_marine,70,28,67,3,98,95.71428571428572,4.285714285714286
40580_marine,70,28,67,3,98,95.71428571428572,4.285714285714286
40581_marine,72,28,69,3,100,95.83333333333334,4.166666666666666
40582_marine,72,28,69,3,100,95.83333333333334,4.166666666666666
40583_marine,74,28,71,3,102,95.94594594594594,4.054054054054054
40584_marine,74,29,71,3,103,95.94594594594594,4.054054054054054
40585_marine,74,29,71,3,103,95.94594594594594,4.054054054054054
40586_marine,74,28,71,3,102,95.94594594594594,4.054054054054054
40587_marine,74,28,71,3,102,95.94594594594594,4.054054054054054
40588_marine,75,28,72,3,103,96,4
40589_marine,75,28,72,3,103,96,4
40590_marine,75,28,72,3,103,96,4
40591_marine,76,28,73,3,104,96.05263157894737,3.9473684210526314
40592_marine,75,28,72,3,103,96,4
40593_marine,75,28,72,3,103,96,4
40594_marine,75,28,72,3,103,96,4
40595_marine,75,28,72,3,103,96,4
40596_marine,75,28,72,3,103,96,4
40597_marine,75,28,72,3,103,96,4
40598_marine,75,28,72,3,103,96,4
40599_marine,75,28,72,3,103,96,4
40600_marine,76,28,73,3,104,96.05263157894737,3.9473684210526314
40601_marine,76,28,73,3,104,96.05263157894737,3.9473684210526314
40602_marine,76,28,73,3,104,96.05263157894737,3.9473684210526314
40603_marine,76,28,73,3,104,96.05263157894737,3.9473684210526314
40604_marine,75,30,72,2,105,96,2.666666666666667
40605_marine,77,30,74,2,107,96.1038961038961,2.5974025974025974
40606_marine,79,29,76,2,108,96.20253164556962,2.5316455696202533
40607_marine,82,29,79,2,111,96.34146341463415,2.4390243902439024
40608_marine,82,29,78,2,111,95.1219512195122,2.4390243902439024
40609_marine,82,29,78,2,111,95.1219512195122,2.4390243902439024
40610_marine,88,29,83,4,117,94.31818181818183,4.545454545454546
40611_marine,102,33,97,4,135,95.09803921568627,3.9215686274509802
40612_marine,115,39,106,9,154,92.17391304347827,7.82608695652174
40613_marine,524,220,367,276,744,70.0381679389313,52.67175572519084
40614_marine,783,444,488,458,1227,62.324393358876115,58.49297573435505
40615_marine,790,421,489,466,1211,61.89873417721519,58.9873417721519
40652_marine,836,381,539,471,1217,64.47368421052632,56.33971291866029
40653_marine,800,379,521,448,1179,65.125,56.00000000000001
40654_marine,788,325,512,447,1113,64.9746192893401,56.7258883248731
40655_marine,137,79,125,22,216,91.24087591240875,16.05839416058394
40656_marine,144,51,128,26,195,88.88888888888889,18.055555555555554
40657_marine,118,40,106,16,158,89.83050847457628,13.559322033898304
40658_marine,111,37,99,13,148,89.1891891891892,11.711711711711711
40659_marine,112,39,100,13,151,89.28571428571429,11.607142857142858
40660_marine,121,46,107,21,167,88.42975206611571,17.355371900826448
40661_marine,107,38,98,13,145,91.58878504672897,12.149532710280374
40662_marine,103,43,93,13,146,90.29126213592234,12.62135922330097
40663_marine,109,41,98,16,150,89.90825688073394,14.678899082568808
40664_marine,122,48,111,19,170,90.98360655737704,15.573770491803279
40665_marine,779,291,476,476,1070,61.103979460847235,61.103979460847235
40666_marine,822,390,504,495,1212,61.31386861313869,60.21897810218978
40667_marine,902,472,555,547,1374,61.529933481153,60.6430155210643
40668_marine,909,479,556,554,1388,61.16611661166117,60.94609460946094
40669_marine,797,364,485,487,1161,60.85319949811794,61.10414052697616
40670_marine,677,245,416,422,922,61.44756277695716,62.33382570162481
40671_marine,471,159,298,293,630,63.26963906581741,62.20806794055201
40672_marine,480,162,303,300,642,63.125,62.5
40673_marine,480,161,303,300,641,63.125,62.5
40674_marine,106,38,96,12,144,90.56603773584906,11.320754716981133
40675_marine,106,38,96,11,144,90.56603773584906,10.377358490566039
40676_marine,106,38,96,11,144,90.56603773584906,10.377358490566039
40677_marine,102,38,92,11,140,90.19607843137256,10.784313725490197
40678_marine,102,38,92,11,140,90.19607843137256,10.784313725490197
40679_marine,108,38,98,11,146,90.74074074074075,10.185185185185185
40680_marine,104,38,94,11,142,90.38461538461539,10.576923076923077
40681_marine,117,46,106,22,163,90.5982905982906,18.803418803418804
40682_marine,112,45,102,20,157,91.07142857142857,17.857142857142858
40683_marine,97,38,91,8,135,93.81443298969072,8.24742268041237
40684_marine,521,134,337,312,655,64.68330134357005,59.88483685220729
40685_marine,521,134,337,312,655,64.68330134357005,59.88483685220729
40686_marine,99,38,93,8,137,93.93939393939394,8.080808080808081
40687_marine,98,38,92,9,136,93.87755102040816,9.183673469387756
40688_marine,96,36,90,9,132,93.75,9.375
40689_marine,96,36,90,9,132,93.75,9.375
40690_marine,96,36,90,9,132,93.75,9.375
40691_marine,95,36,90,8,131,94.73684210526315,8.421052631578947
40692_marine,94,36,89,8,130,94.68085106382979,8.51063829787234
40693_marine,94,37,89,8,131,94.68085106382979,8.51063829787234
40694_marine,94,38,89,8,132,94.68085106382979,8.51063829787234
40695_marine,94,38,89,8,132,94.68085106382979,8.51063829787234
40696_marine,92,38,87,8,130,94.56521739130434,8.695652173913043
40697_marine,92,37,87,8,129,94.56521739130434,8.695652173913043
40698_marine,91,36,86,8,127,94.5054945054945,8.791208791208792
40699_marine,89,35,84,8,124,94.3820224719101,8.98876404494382
40700_marine,88,35,83,8,123,94.31818181818183,9.090909090909092
40701_marine,88,33,83,8,121,94.31818181818183,9.090909090909092
40702_marine,88,33,83,8,121,94.31818181818183,9.090909090909092
40703_marine,90,33,85,9,123,94.44444444444444,10
40704_marine,89,33,84,8,122,94.3820224719101,8.98876404494382
40705_marine,89,33,84,8,122,94.3820224719101,8.98876404494382
40706_marine,91,34,86,8,125,94.5054945054945,8.791208791208792
40707_marine,349,83,242,208,432,69.34097421203438,59.598853868194844
40708_marine,355,85,244,214,440,68.73239436619718,60.281690140845065
40709_marine,355,87,244,214,442,68.73239436619718,60.281690140845065
40710_marine,355,87,244,214,442,68.73239436619718,60.281690140845065
40711_marine,367,99,252,218,466,68.66485013623979,59.40054495912806
40712_marine,343,85,234,208,428,68.22157434402332,60.64139941690962
40713_marine,366,100,250,219,466,68.30601092896174,59.83606557377049
40714_marine,346,83,236,209,429,68.20809248554913,60.40462427745664
40715_marine,97,40,89,13,137,91.75257731958763,13.402061855670103
40716_marine,97,37,89,13,134,91.75257731958763,13.402061855670103
40717_marine,92,35,86,9,127,93.47826086956522,9.782608695652174
40718_marine,92,34,86,9,126,93.47826086956522,9.782608695652174
40719_marine,96,36,90,9,132,93.75,9.375
40720_marine,96,36,90,10,132,93.75,10.416666666666668
40721_marine,96,38,90,10,134,93.75,10.416666666666668
40722_marine,96,38,90,10,134,93.75,10.416666666666668
40723_marine,109,53,97,22,162,88.9908256880734,20.18348623853211
40724_marine,332,85,226,209,417,68.07228915662651,62.951807228915655
40725_marine,369,116,255,220,485,69.10569105691057,59.62059620596206
40726_marine,376,117,262,220,493,69.68085106382979,58.51063829787234
40727_marine,351,99,241,209,450,68.66096866096866,59.54415954415955
40728_marine,94,35,89,9,129,94.68085106382979,9.574468085106384
40729_marine,287,91,206,160,378,71.77700348432056,55.749128919860624
40730_marine,299,98,215,166,397,71.90635451505017,55.51839464882943
40731_marine,292,96,209,162,388,71.57534246575342,55.47945205479452
40732_marine,256,90,191,134,346,74.609375,52.34375
40733_marine,254,90,189,134,344,74.40944881889764,52.75590551181102
40734_marine,87,35,82,9,122,94.25287356321839,10.344827586206897
40735_marine,203,80,162,93,283,79.80295566502463,45.812807881773395
40736_marine,203,79,162,93,282,79.80295566502463,45.812807881773395
40737_marine,88,33,83,9,121,94.31818181818183,10.227272727272728
40738_marine,88,33,83,9,121,94.31818181818183,10.227272727272728
40739_marine,88,33,83,9,121,94.31818181818183,10.227272727272728
40740_marine,87,33,82,9,120,94.25287356321839,10.344827586206897
40741_marine,87,33,82,9,120,94.25287356321839,10.344827586206897
40742_marine,86,33,81,8,119,94.18604651162791,9.30232558139535
40743_marine,85,33,80,8,118,94.11764705882352,9.411764705882353
40744_marine,83,35,78,8,118,93.97590361445783,9.63855421686747
40745_marine,83,35,78,8,118,93.97590361445783,9.63855421686747
40746_marine,83,35,78,8,118,93.97590361445783,9.63855421686747
40747_marine,83,35,78,8,118,93.97590361445783,9.63855421686747
40748_marine,83,35,78,8,118,93.97590361445783,9.63855421686747
40749_marine,82,35,77,8,117,93.90243902439023,9.75609756097561
40750_marine,81,35,76,8,116,93.82716049382715,9.876543209876543
40751_marine,79,33,74,8,112,93.67088607594937,10.126582278481013
40752_marine,79,32,74,8,111,93.67088607594937,10.126582278481013
40753_marine,78,32,73,7,110,93.58974358974359,8.974358974358974
40754_marine,78,32,73,7,110,93.58974358974359,8.974358974358974
40755_marine,78,32,73,7,110,93.58974358974359,8.974358974358974
40756_marine,78,32,73,7,110,93.58974358974359,8.974358974358974
40757_marine,78,32,73,7,110,93.58974358974359,8.974358974358974
40758_marine,78,32,73,7,110,93.58974358974359,8.974358974358974
40759_marine,76,32,71,6,108,93.42105263157895,7.894736842105263
40760_marine,75,33,71,5,108,94.66666666666667,6.666666666666667
40761_marine,75,33,71,5,108,94.66666666666667,6.666666666666667
40762_marine,73,33,69,4,106,94.52054794520548,5.47945205479452
40763_marine,73,33,69,4,106,94.52054794520548,5.47945205479452
40764_marine,70,33,67,3,103,95.71428571428572,4.285714285714286
40765_marine,70,33,67,3,103,95.71428571428572,4.285714285714286
40766_marine,68,35,65,3,103,95.58823529411765,4.411764705882353
40767_marine,68,37,65,3,105,95.58823529411765,4.411764705882353
40768_marine,68,39,65,3,107,95.58823529411765,4.411764705882353
40769_marine,67,40,64,3,107,95.52238805970148,4.477611940298507
40770_marine,71,42,68,3,113,95.77464788732394,4.225352112676056
40771_marine,70,42,67,3,112,95.71428571428572,4.285714285714286
40772_marine,70,42,67,3,112,95.71428571428572,4.285714285714286
40773_marine,70,43,67,3,113,95.71428571428572,4.285714285714286
40774_marine,72,41,69,3,113,95.83333333333334,4.166666666666666
40775_marine,73,40,70,4,113,95.8904109589041,5.47945205479452
40776_marine,73,47,70,4,120,95.8904109589041,5.47945205479452
40777_marine,72,53,69,4,125,95.83333333333334,5.555555555555555
40778_marine,70,47,67,4,117,95.71428571428572,5.714285714285714
40779_marine,70,48,67,4,118,95.71428571428572,5.714285714285714
40780_marine,69,43,66,4,112,95.65217391304348,5.797101449275362
40781_marine,70,42,66,4,112,94.28571428571428,5.714285714285714
40782_marine,73,40,68,5,113,93.15068493150685,6.8493150684931505
40783_marine,75,41,70,5,116,93.33333333333333,6.666666666666667
40784_marine,74,41,69,4,115,93.24324324324324,5.405405405405405
40785_marine,73,38,68,4,111,93.15068493150685,5.47945205479452
40786_marine,76,42,70,4,118,92.10526315789474,5.263157894736842
40787_marine,74,42,68,3,116,91.8918918918919,4.054054054054054
40788_marine,82,43,76,5,125,92.6829268292683,6.097560975609756
40789_marine,123,75,103,15,198,83.73983739837398,12.195121951219512
40790_marine,182,164,132,63,346,72.52747252747253,34.61538461538461
40818_marine,385,252,302,129,637,78.44155844155844,33.506493506493506
40819_marine,379,233,301,125,612,79.41952506596306,32.98153034300791
40820_marine,325,164,276,90,489,84.92307692307692,27.692307692307693
40821_marine,118,47,113,8,165,95.76271186440678,6.779661016949152
40822_marine,109,39,103,6,148,94.4954128440367,5.5045871559633035
40823_marine,108,38,102,5,146,94.44444444444444,4.62962962962963
40824_marine,100,38,94,5,138,94,5
40825_marine,96,37,92,3,133,95.83333333333334,3.125
40826_marine,92,36,88,3,128,95.65217391304348,3.260869565217391
40827_marine,90,32,86,3,122,95.55555555555556,3.3333333333333335
40828_marine,89,32,84,4,121,94.3820224719101,4.49438202247191
40829_marine,86,30,81,4,116,94.18604651162791,4.651162790697675
40830_marine,86,30,81,4,116,94.18604651162791,4.651162790697675
40831_marine,86,30,81,4,116,94.18604651162791,4.651162790697675
40832_marine,86,30,81,4,116,94.18604651162791,4.651162790697675
40833_marine,85,30,80,4,115,94.11764705882352,4.705882352941177
40834_marine,85,30,80,4,115,94.11764705882352,4.705882352941177
40835_marine,87,30,82,4,117,94.25287356321839,4.597701149425287
40836_marine,86,32,82,3,118,95.34883720930233,3.488372093023256
40837_marine,86,32,82,3,118,95.34883720930233,3.488372093023256
40838_marine,87,32,83,3,119,95.40229885057471,3.4482758620689653
40839_marine,87,32,83,3,119,95.40229885057471,3.4482758620689653
40840_marine,87,32,83,3,119,95.40229885057471,3.4482758620689653
40841_marine,85,32,81,3,117,95.29411764705881,3.5294117647058822
40842_marine,81,32,77,3,113,95.06172839506173,3.7037037037037033
40843_marine,80,32,76,2,112,95,2.5
40844_marine,79,32,75,1,111,94.9367088607595,1.2658227848101267
40845_marine,79,31,75,1,110,94.9367088607595,1.2658227848101267
40846_marine,79,31,75,1,110,94.9367088607595,1.2658227848101267
40847_marine,76,31,72,1,107,94.73684210526315,1.3157894736842104
40848_marine,76,31,72,1,107,94.73684210526315,1.3157894736842104
40849_marine,78,31,74,1,109,94.87179487179486,1.282051282051282
40850_marine,78,31,74,1,109,94.87179487179486,1.282051282051282
40851_marine,78,31,74,1,109,94.87179487179486,1.282051282051282
40852_marine,79,31,75,2,110,94.9367088607595,2.5316455696202533
40853_marine,79,29,75,2,108,94.9367088607595,2.5316455696202533
40854_marine,79,29,75,2,108,94.9367088607595,2.5316455696202533
40855_marine,79,31,75,2,110,94.9367088607595,2.5316455696202533
40856_marine,78,31,74,2,109,94.87179487179486,2.564102564102564
40857_marine,78,31,74,2,109,94.87179487179486,2.564102564102564
40858_marine,78,31,74,2,109,94.87179487179486,2.564102564102564
40859_marine,75,29,71,1,104,94.66666666666667,1.3333333333333335
40860_marine,74,29,70,1,103,94.5945945945946,1.3513513513513513
40861_marine,74,29,70,1,103,94.5945945945946,1.3513513513513513
40862_marine,75,27,71,1,102,94.66666666666667,1.3333333333333335
40863_marine,76,30,72,1,106,94.73684210526315,1.3157894736842104
40864_marine,77,30,72,1,107,93.5064935064935,1.2987012987012987
40865_marine,76,30,71,1,106,93.42105263157895,1.3157894736842104
40866_marine,77,33,71,1,110,92.20779220779221,1.2987012987012987
40867_marine,76,38,70,1,114,92.10526315789474,1.3157894736842104
40868_marine,78,36,71,2,114,91.02564102564102,2.564102564102564
40869_marine,88,40,81,2,128,92.04545454545455,2.272727272727273
40870_marine,85,38,78,1,123,91.76470588235294,1.1764705882352942
40871_marine,85,40,78,1,125,91.76470588235294,1.1764705882352942
40872_marine,89,40,82,2,129,92.13483146067416,2.247191011235955
40873_marine,98,86,91,4,184,92.85714285714286,4.081632653061225
40874_marine,148,129,137,10,277,92.56756756756756,6.756756756756757
40897_marine,660,249,459,342,909,69.54545454545455,51.81818181818182
40898_marine,111,41,102,15,152,91.8918918918919,13.513513513513514
40899_marine,107,37,99,11,144,92.5233644859813,10.2803738317757
40900_marine,486,83,335,268,569,68.93004115226337,55.144032921810705
40901_marine,486,85,337,268,571,69.34156378600824,55.144032921810705
40902_marine,485,84,337,267,569,69.48453608247422,55.05154639175258
40903_marine,633,179,440,329,812,69.51026856240127,51.97472353870458
40909_marine,612,169,426,316,781,69.6078431372549,51.633986928104584
40910_marine,102,35,97,7,137,95.09803921568627,6.862745098039216
40911_marine,97,33,92,6,130,94.84536082474226,6.185567010309279
40912_marine,92,33,87,6,125,94.56521739130434,6.521739130434782
40913_marine,89,32,84,6,121,94.3820224719101,6.741573033707865
40914_marine,86,32,81,6,118,94.18604651162791,6.976744186046512
40915_marine,85,32,81,5,117,95.29411764705881,5.88235294117647
40916_marine,89,32,85,6,121,95.50561797752809,6.741573033707865
40917_marine,89,32,85,6,121,95.50561797752809,6.741573033707865
40918_marine,89,32,85,5,121,95.50561797752809,5.617977528089887
40919_marine,84,32,80,4,116,95.23809523809523,4.761904761904762
40920_marine,81,32,77,4,113,95.06172839506173,4.938271604938271
40921_marine,75,29,71,4,104,94.66666666666667,5.333333333333334
40922_marine,71,28,67,4,99,94.36619718309859,5.633802816901409
40923_marine,69,29,65,4,98,94.20289855072464,5.797101449275362
40924_marine,69,29,65,4,98,94.20289855072464,5.797101449275362
40925_marine,69,29,65,4,98,94.20289855072464,5.797101449275362
40926_marine,69,29,65,4,98,94.20289855072464,5.797101449275362
40927_marine,69,29,65,4,98,94.20289855072464,5.797101449275362
40928_marine,69,28,65,4,97,94.20289855072464,5.797101449275362
40929_marine,68,28,65,3,96,95.58823529411765,4.411764705882353
40930_marine,69,28,66,3,97,95.65217391304348,4.3478260869565215
40931_marine,69,28,66,3,97,95.65217391304348,4.3478260869565215
40932_marine,70,28,67,3,98,95.71428571428572,4.285714285714286
40933_marine,70,26,67,3,96,95.71428571428572,4.285714285714286
40934_marine,70,26,67,3,96,95.71428571428572,4.285714285714286
40935_marine,70,26,67,3,96,95.71428571428572,4.285714285714286
40936_marine,70,26,67,3,96,95.71428571428572,4.285714285714286
40937_marine,70,26,67,3,96,95.71428571428572,4.285714285714286
40938_marine,70,26,67,3,96,95.71428571428572,4.285714285714286
40939_marine,72,26,69,3,98,95.83333333333334,4.166666666666666
40940_marine,72,26,69,3,98,95.83333333333334,4.166666666666666
40941_marine,72,26,69,3,98,95.83333333333334,4.166666666666666
40942_marine,72,26,69,3,98,95.83333333333334,4.166666666666666
40943_marine,72,26,69,3,98,95.83333333333334,4.166666666666666
40944_marine,74,26,71,3,100,95.94594594594594,4.054054054054054
40945_marine,74,26,71,3,100,95.94594594594594,4.054054054054054
40946_marine,74,26,71,3,100,95.94594594594594,4.054054054054054
40947_marine,74,27,71,3,101,95.94594594594594,4.054054054054054
40948_marine,74,27,71,3,101,95.94594594594594,4.054054054054054
40949_marine,75,27,72,3,102,96,4
40950_marine,75,27,72,3,102,96,4
40951_marine,74,26,71,3,100,95.94594594594594,4.054054054054054
40952_marine,76,26,73,3,102,96.05263157894737,3.9473684210526314
40953_marine,76,26,73,3,102,96.05263157894737,3.9473684210526314
40954_marine,76,26,73,3,102,96.05263157894737,3.9473684210526314
40955_marine,75,26,72,3,101,96,4
40956_marine,75,26,72,3,101,96,4
40957_marine,75,26,72,3,101,96,4
40958_marine,75,26,72,3,101,96,4
40959_marine,75,27,72,3,102,96,4
40960_marine,75,28,72,3,103,96,4
40961_marine,75,26,72,3,101,96,4
40962_marine,75,28,72,2,103,96,2.666666666666667
40963_marine,75,28,72,2,103,96,2.666666666666667
40964_marine,75,28,72,2,103,96,2.666666666666667
40965_marine,75,30,72,2,105,96,2.666666666666667
40966_marine,77,29,74,2,106,96.1038961038961,2.5974025974025974
40967_marine,78,29,75,2,107,96.15384615384616,2.564102564102564
40968_marine,82,29,78,2,111,95.1219512195122,2.4390243902439024
40969_marine,86,31,82,2,117,95.34883720930233,2.3255813953488373
40970_marine,90,31,85,4,121,94.44444444444444,4.444444444444445
40971_marine,98,35,93,4,133,94.89795918367348,4.081632653061225
40972_marine,128,81,118,10,209,92.1875,7.8125
40973_marine,550,268,382,282,818,69.45454545454545,51.272727272727266
40974_marine,758,427,464,451,1185,61.21372031662269,59.49868073878628
41013_marine,816,413,527,453,1229,64.58333333333334,55.51470588235294
41014_marine,626,296,405,330,922,64.6964856230032,52.715654952076676
41015_marine,160,88,145,23,248,90.625,14.374999999999998
41016_marine,150,57,134,31,207,89.33333333333333,20.666666666666668
41017_marine,119,43,107,16,162,89.91596638655463,13.445378151260504
41018_marine,112,39,100,13,151,89.28571428571429,11.607142857142858
41019_marine,111,40,100,13,151,90.09009009009009,11.711711711711711
41020_marine,121,48,107,21,169,88.42975206611571,17.355371900826448
41021_marine,109,47,100,13,156,91.74311926605505,11.926605504587156
41022_marine,109,45,99,13,154,90.82568807339449,11.926605504587156
41023_marine,111,42,101,15,153,90.990990990991,13.513513513513514
41024_marine,109,40,99,15,149,90.82568807339449,13.761467889908257
41025_marine,119,45,108,18,164,90.75630252100841,15.126050420168067
41026_marine,778,299,475,478,1077,61.05398457583547,61.43958868894601
41027_marine,780,319,476,479,1099,61.02564102564103,61.410256410256416
41028_marine,780,340,477,476,1120,61.15384615384616,61.02564102564103
41029_marine,761,329,461,470,1090,60.578186596583436,61.76084099868594
41030_marine,669,243,408,418,912,60.98654708520179,62.4813153961136
41031_marine,468,151,295,293,619,63.034188034188034,62.60683760683761
41032_marine,466,140,294,291,606,63.0901287553648,62.44635193133047
41033_marine,458,138,290,287,596,63.31877729257642,62.66375545851528
41034_marine,102,39,92,10,141,90.19607843137256,9.803921568627452
41035_marine,104,39,94,11,143,90.38461538461539,10.576923076923077
41036_marine,104,39,94,11,143,90.38461538461539,10.576923076923077
41037_marine,102,38,92,11,140,90.19607843137256,10.784313725490197
41038_marine,102,39,92,11,141,90.19607843137256,10.784313725490197
41039_marine,98,39,90,11,137,91.83673469387756,11.224489795918368
41040_marine,97,39,89,11,136,91.75257731958763,11.34020618556701
41041_marine,103,40,96,12,143,93.20388349514563,11.650485436893204
41042_marine,99,40,93,10,139,93.93939393939394,10.1010101010101
41043_marine,97,38,91,8,135,93.81443298969072,8.24742268041237
41044_marine,99,38,93,8,137,93.93939393939394,8.080808080808081
41045_marine,96,38,91,7,134,94.79166666666666,7.291666666666667
41046_marine,96,36,91,7,132,94.79166666666666,7.291666666666667
41047_marine,95,36,90,7,131,94.73684210526315,7.368421052631578
41048_marine,93,36,88,7,129,94.6236559139785,7.526881720430108
41049_marine,92,36,87,7,128,94.56521739130434,7.608695652173914
41050_marine,92,36,87,7,128,94.56521739130434,7.608695652173914
41051_marine,92,35,87,7,127,94.56521739130434,7.608695652173914
41052_marine,93,35,88,7,128,94.6236559139785,7.526881720430108
41053_marine,93,36,88,7,129,94.6236559139785,7.526881720430108
41054_marine,93,36,88,7,129,94.6236559139785,7.526881720430108
41055_marine,93,36,88,7,129,94.6236559139785,7.526881720430108
41056_marine,91,36,86,7,127,94.5054945054945,7.6923076923076925
41057_marine,91,35,86,7,126,94.5054945054945,7.6923076923076925
41058_marine,89,35,84,7,124,94.3820224719101,7.865168539325842
41059_marine,87,35,82,6,122,94.25287356321839,6.896551724137931
41060_marine,86,35,81,6,121,94.18604651162791,6.976744186046512
41061_marine,86,35,81,6,121,94.18604651162791,6.976744186046512
41062_marine,85,34,80,6,119,94.11764705882352,7.0588235294117645
41063_marine,87,33,82,7,120,94.25287356321839,8.045977011494253
41064_marine,89,33,84,9,122,94.3820224719101,10.112359550561797
41065_marine,89,33,84,9,122,94.3820224719101,10.112359550561797
41066_marine,89,34,84,9,123,94.3820224719101,10.112359550561797
41067_marine,88,33,83,8,121,94.31818181818183,9.090909090909092
41068_marine,88,33,83,8,121,94.31818181818183,9.090909090909092
41069_marine,88,33,83,8,121,94.31818181818183,9.090909090909092
41070_marine,343,81,234,208,424,68.22157434402332,60.64139941690962
41071_marine,343,81,234,208,424,68.22157434402332,60.64139941690962
41072_marine,343,85,234,208,428,68.22157434402332,60.64139941690962
41073_marine,343,86,234,208,429,68.22157434402332,60.64139941690962
41074_marine,348,84,239,208,432,68.67816091954023,59.77011494252874
41075_marine,107,47,96,20,154,89.7196261682243,18.69158878504673
41076_marine,94,39,87,12,133,92.5531914893617,12.76595744680851
41077_marine,89,35,84,8,124,94.3820224719101,8.98876404494382
41078_marine,89,34,84,8,123,94.3820224719101,8.98876404494382
41079_marine,89,34,84,8,123,94.3820224719101,8.98876404494382
41080_marine,90,34,85,8,124,94.44444444444444,8.88888888888889
41081_marine,91,34,86,8,125,94.5054945054945,8.791208791208792
41082_marine,93,34,88,8,127,94.6236559139785,8.60215053763441
41083_marine,95,38,90,10,133,94.73684210526315,10.526315789473683
41084_marine,95,36,90,10,131,94.73684210526315,10.526315789473683
41085_marine,350,99,242,208,449,69.14285714285714,59.42857142857143
41086_marine,350,99,242,208,449,69.14285714285714,59.42857142857143
41087_marine,94,37,90,10,131,95.74468085106383,10.638297872340425
41088_marine,92,35,88,8,127,95.65217391304348,8.695652173913043
41089_marine,286,93,204,161,379,71.32867132867133,56.29370629370629
41090_marine,295,94,207,169,389,70.16949152542374,57.28813559322033
41091_marine,296,99,210,167,395,70.94594594594594,56.41891891891891
41092_marine,275,107,206,142,382,74.90909090909092,51.63636363636363
41093_marine,254,90,190,133,344,74.80314960629921,52.362204724409445
41094_marine,89,33,85,9,122,95.50561797752809,10.112359550561797
41095_marine,201,80,161,92,281,80.09950248756219,45.77114427860697
41096_marine,210,88,168,95,298,80,45.23809523809524
41097_marine,199,78,159,91,277,79.89949748743719,45.7286432160804
41098_marine,85,33,81,8,118,95.29411764705881,9.411764705882353
41099_marine,86,33,81,9,119,94.18604651162791,10.465116279069768
41100_marine,84,33,79,9,117,94.04761904761905,10.714285714285714
41101_marine,83,33,78,8,116,93.97590361445783,9.63855421686747
41102_marine,84,33,79,8,117,94.04761904761905,9.523809523809524
41103_marine,83,31,78,8,114,93.97590361445783,9.63855421686747
41104_marine,83,31,78,8,114,93.97590361445783,9.63855421686747
41105_marine,83,33,78,8,116,93.97590361445783,9.63855421686747
41106_marine,83,33,78,8,116,93.97590361445783,9.63855421686747
41107_marine,83,33,78,8,116,93.97590361445783,9.63855421686747
41108_marine,82,33,77,8,115,93.90243902439023,9.75609756097561
41109_marine,82,33,77,8,115,93.90243902439023,9.75609756097561
41110_marine,80,33,75,8,113,93.75,10
41111_marine,78,33,73,8,111,93.58974358974359,10.256410256410255
41112_marine,76,33,71,8,109,93.42105263157895,10.526315789473683
41113_marine,77,34,72,8,111,93.5064935064935,10.38961038961039
41114_marine,76,32,71,7,108,93.42105263157895,9.210526315789473
41115_marine,76,32,71,7,108,93.42105263157895,9.210526315789473
41116_marine,77,32,72,7,109,93.5064935064935,9.090909090909092
41117_marine,77,32,72,7,109,93.5064935064935,9.090909090909092
41118_marine,76,32,72,6,108,94.73684210526315,7.894736842105263
41119_marine,74,32,70,5,106,94.5945945945946,6.756756756756757
41120_marine,74,33,70,5,107,94.5945945945946,6.756756756756757
41121_marine,74,33,70,5,107,94.5945945945946,6.756756756756757
41122_marine,73,39,69,4,112,94.52054794520548,5.47945205479452
41123_marine,72,39,69,3,111,95.83333333333334,4.166666666666666
41124_marine,72,37,69,3,109,95.83333333333334,4.166666666666666
41125_marine,68,35,65,3,103,95.58823529411765,4.411764705882353
41126_marine,68,37,65,3,105,95.58823529411765,4.411764705882353
41127_marine,68,38,65,3,106,95.58823529411765,4.411764705882353
41128_marine,67,40,64,3,107,95.52238805970148,4.477611940298507
41129_marine,65,46,62,3,111,95.38461538461539,4.615384615384616
41130_marine,67,46,64,3,113,95.52238805970148,4.477611940298507
41131_marine,70,44,67,3,114,95.71428571428572,4.285714285714286
41132_marine,70,50,67,3,120,95.71428571428572,4.285714285714286
41133_marine,72,47,69,3,119,95.83333333333334,4.166666666666666
41134_marine,72,45,69,3,117,95.83333333333334,4.166666666666666
41135_marine,72,48,69,3,120,95.83333333333334,4.166666666666666
41136_marine,70,47,67,3,117,95.71428571428572,4.285714285714286
41137_marine,69,48,66,3,117,95.65217391304348,4.3478260869565215
41138_marine,67,48,64,3,115,95.52238805970148,4.477611940298507
41139_marine,68,46,65,3,114,95.58823529411765,4.411764705882353
41140_marine,68,44,65,3,112,95.58823529411765,4.411764705882353
41141_marine,69,42,65,3,111,94.20289855072464,4.3478260869565215
41142_marine,71,41,66,4,112,92.95774647887323,5.633802816901409
41143_marine,70,41,65,4,111,92.85714285714286,5.714285714285714
41144_marine,72,39,67,4,111,93.05555555555556,5.555555555555555
41145_marine,69,38,64,4,107,92.7536231884058,5.797101449275362
41146_marine,73,43,67,4,116,91.78082191780823,5.47945205479452
41147_marine,74,42,68,3,116,91.8918918918919,4.054054054054054
41148_marine,78,45,72,5,123,92.3076923076923,6.41025641025641
41149_marine,122,75,106,16,197,86.88524590163934,13.114754098360656
41150_marine,182,157,134,61,339,73.62637362637363,33.51648351648351
41175_marine,358,238,284,124,596,79.3296089385475,34.63687150837989
41176_marine,328,218,280,91,546,85.36585365853658,27.743902439024392
41177_marine,321,202,272,89,523,84.73520249221184,27.725856697819314
41178_marine,127,88,122,9,215,96.06299212598425,7.086614173228346
41179_marine,122,67,117,8,189,95.90163934426229,6.557377049180328
41180_marine,118,45,113,7,163,95.76271186440678,5.932203389830509
41181_marine,112,39,106,6,151,94.64285714285714,5.357142857142857
41182_marine,108,39,102,4,147,94.44444444444444,3.7037037037037033
41183_marine,102,37,96,4,139,94.11764705882352,3.9215686274509802
41184_marine,98,37,92,4,135,93.87755102040816,4.081632653061225
41185_marine,96,36,92,2,132,95.83333333333334,2.083333333333333
41186_marine,88,35,84,2,123,95.45454545454545,2.272727272727273
41187_marine,89,33,85,3,122,95.50561797752809,3.3707865168539324
41188_marine,88,33,84,3,121,95.45454545454545,3.4090909090909087
41189_marine,88,33,83,4,121,94.31818181818183,4.545454545454546
41190_marine,86,33,81,4,119,94.18604651162791,4.651162790697675
41191_marine,86,33,81,4,119,94.18604651162791,4.651162790697675
41192_marine,86,33,81,4,119,94.18604651162791,4.651162790697675
41193_marine,85,33,80,4,118,94.11764705882352,4.705882352941177
41194_marine,84,33,80,3,117,95.23809523809523,3.571428571428571
41195_marine,86,33,82,3,119,95.34883720930233,3.488372093023256
41196_marine,86,31,82,3,117,95.34883720930233,3.488372093023256
41197_marine,87,33,83,3,120,95.40229885057471,3.4482758620689653
41198_marine,85,33,81,3,118,95.29411764705881,3.5294117647058822
41199_marine,83,32,79,3,115,95.18072289156626,3.614457831325301
41200_marine,81,32,77,3,113,95.06172839506173,3.7037037037037033
41201_marine,80,32,76,3,112,95,3.75
41202_marine,76,32,72,1,108,94.73684210526315,1.3157894736842104
41203_marine,77,32,73,1,109,94.8051948051948,1.2987012987012987
41204_marine,77,32,73,1,109,94.8051948051948,1.2987012987012987
41205_marine,77,32,73,1,109,94.8051948051948,1.2987012987012987
41206_marine,75,31,71,1,106,94.66666666666667,1.3333333333333335
41207_marine,74,31,70,1,105,94.5945945945946,1.3513513513513513
41208_marine,74,31,70,1,105,94.5945945945946,1.3513513513513513
41209_marine,74,29,70,1,103,94.5945945945946,1.3513513513513513
41210_marine,76,29,72,1,105,94.73684210526315,1.3157894736842104
41211_marine,76,29,72,1,105,94.73684210526315,1.3157894736842104
41212_marine,76,29,72,1,105,94.73684210526315,1.3157894736842104
41213_marine,76,29,72,1,105,94.73684210526315,1.3157894736842104
41214_marine,75,29,71,0,104,94.66666666666667,0
41215_marine,75,29,71,0,104,94.66666666666667,0
41216_marine,74,31,70,0,105,94.5945945945946,0
41217_marine,74,31,70,0,105,94.5945945945946,0
41218_marine,74,29,70,0,103,94.5945945945946,0
41219_marine,74,28,70,0,102,94.5945945945946,0
41220_marine,74,28,70,0,102,94.5945945945946,0
41221_marine,74,29,70,0,103,94.5945945945946,0
41222_marine,76,29,72,1,105,94.73684210526315,1.3157894736842104
41223_marine,77,28,73,1,105,94.8051948051948,1.2987012987012987
41224_marine,77,31,73,1,108,94.8051948051948,1.2987012987012987
41225_marine,78,31,73,1,109,93.58974358974359,1.282051282051282
41226_marine,80,37,74,0,117,92.5,0
41227_marine,78,38,72,0,116,92.3076923076923,0
41228_marine,76,38,69,1,114,90.78947368421053,1.3157894736842104
41229_marine,83,40,76,1,123,91.56626506024097,1.2048192771084338
41230_marine,85,40,78,1,125,91.76470588235294,1.1764705882352942
41231_marine,87,42,80,1,129,91.95402298850574,1.1494252873563218
41232_marine,89,42,82,2,131,92.13483146067416,2.247191011235955
41233_marine,101,75,94,4,176,93.06930693069307,3.9603960396039604
41234_marine,147,134,137,9,281,93.19727891156462,6.122448979591836
41257_marine,650,241,449,339,891,69.07692307692308,52.15384615384615
41258_marine,111,39,102,14,150,91.8918918918919,12.612612612612612
41259_marine,107,37,99,11,144,92.5233644859813,10.2803738317757
41260_marine,109,39,101,12,148,92.66055045871559,11.009174311926607
41261_marine,103,40,97,12,143,94.1747572815534,11.650485436893204
41262_marine,104,40,98,10,144,94.23076923076923,9.615384615384617
41263_marine,625,174,432,328,799,69.12,52.480000000000004
41269_marine,608,174,422,316,782,69.4078947368421,51.973684210526315
41270_marine,99,41,94,6,140,94.94949494949495,6.0606060606060606
41271_marine,98,37,93,6,135,94.89795918367348,6.122448979591836
41272_marine,88,33,84,5,121,95.45454545454545,5.681818181818182
41273_marine,86,33,82,5,119,95.34883720930233,5.813953488372093
41274_marine,84,32,80,5,116,95.23809523809523,5.952380952380952
41275_marine,83,33,79,5,116,95.18072289156626,6.024096385542169
41276_marine,79,33,75,5,112,94.9367088607595,6.329113924050633
41277_marine,79,33,75,4,112,94.9367088607595,5.063291139240507
41278_marine,82,30,78,4,112,95.1219512195122,4.878048780487805
41279_marine,77,30,73,4,107,94.8051948051948,5.194805194805195
41280_marine,77,30,73,4,107,94.8051948051948,5.194805194805195
41281_marine,71,30,67,4,101,94.36619718309859,5.633802816901409
41282_marine,69,28,65,4,97,94.20289855072464,5.797101449275362
41283_marine,69,28,65,4,97,94.20289855072464,5.797101449275362
41284_marine,69,28,65,4,97,94.20289855072464,5.797101449275362
41285_marine,69,27,65,4,96,94.20289855072464,5.797101449275362
41286_marine,70,26,66,4,96,94.28571428571428,5.714285714285714
41287_marine,69,28,66,3,97,95.65217391304348,4.3478260869565215
41288_marine,69,26,66,3,95,95.65217391304348,4.3478260869565215
41289_marine,69,26,66,3,95,95.65217391304348,4.3478260869565215
41290_marine,69,26,66,3,95,95.65217391304348,4.3478260869565215
41291_marine,69,26,66,3,95,95.65217391304348,4.3478260869565215
41292_marine,69,26,66,3,95,95.65217391304348,4.3478260869565215
41293_marine,69,24,66,3,93,95.65217391304348,4.3478260869565215
41294_marine,70,25,67,3,95,95.71428571428572,4.285714285714286
41295_marine,72,25,69,3,97,95.83333333333334,4.166666666666666
41296_marine,72,25,69,3,97,95.83333333333334,4.166666666666666
41297_marine,72,25,69,3,97,95.83333333333334,4.166666666666666
41298_marine,72,25,69,3,97,95.83333333333334,4.166666666666666
41299_marine,72,25,69,3,97,95.83333333333334,4.166666666666666
41300_marine,73,27,69,3,100,94.52054794520548,4.10958904109589
41301_marine,73,27,69,3,100,94.52054794520548,4.10958904109589
41302_marine,73,27,69,3,100,94.52054794520548,4.10958904109589
41303_marine,73,27,69,3,100,94.52054794520548,4.10958904109589
41304_marine,72,27,69,3,99,95.83333333333334,4.166666666666666
41305_marine,72,27,69,3,99,95.83333333333334,4.166666666666666
41306_marine,73,27,69,3,100,94.52054794520548,4.10958904109589
41307_marine,75,25,71,3,100,94.66666666666667,4
41308_marine,75,25,71,3,100,94.66666666666667,4
41309_marine,75,26,71,3,101,94.66666666666667,4
41310_marine,77,26,73,3,103,94.8051948051948,3.896103896103896
41311_marine,76,26,72,3,102,94.73684210526315,3.9473684210526314
41312_marine,76,27,72,3,103,94.73684210526315,3.9473684210526314
41313_marine,76,27,72,3,103,94.73684210526315,3.9473684210526314
41314_marine,78,27,74,3,105,94.87179487179486,3.8461538461538463
41315_marine,79,27,75,3,106,94.9367088607595,3.79746835443038
41316_marine,77,26,73,2,103,94.8051948051948,2.5974025974025974
41317_marine,77,26,73,2,103,94.8051948051948,2.5974025974025974
41318_marine,77,27,73,2,104,94.8051948051948,2.5974025974025974
41319_marine,77,25,73,2,102,94.8051948051948,2.5974025974025974
41320_marine,77,27,73,2,104,94.8051948051948,2.5974025974025974
41321_marine,77,27,73,2,104,94.8051948051948,2.5974025974025974
41322_marine,77,28,73,2,105,94.8051948051948,2.5974025974025974
41323_marine,78,27,74,2,105,94.87179487179486,2.564102564102564
41324_marine,78,27,74,2,105,94.87179487179486,2.564102564102564
41325_marine,78,29,74,2,107,94.87179487179486,2.564102564102564
41326_marine,80,29,76,2,109,95,2.5
41327_marine,81,29,77,2,110,95.06172839506173,2.4691358024691357
41328_marine,80,29,76,2,109,95,2.5
41329_marine,85,29,80,2,114,94.11764705882352,2.3529411764705883
41330_marine,89,31,83,4,120,93.25842696629213,4.49438202247191
41331_marine,98,37,92,4,135,93.87755102040816,4.081632653061225
41332_marine,131,94,120,10,225,91.6030534351145,7.633587786259542
41333_marine,501,289,358,231,790,71.45708582834331,46.10778443113773
41334_marine,710,437,433,411,1147,60.985915492957744,57.887323943661976
41374_marine,808,498,478,470,1306,59.15841584158416,58.168316831683164
41375_marine,622,270,405,325,892,65.11254019292605,52.2508038585209
41376_marine,137,60,123,21,197,89.78102189781022,15.328467153284672
41377_marine,117,46,105,15,163,89.74358974358975,12.82051282051282
41378_marine,109,37,99,12,146,90.82568807339449,11.009174311926607
41379_marine,109,41,100,11,150,91.74311926605505,10.091743119266056
41380_marine,118,50,106,20,168,89.83050847457628,16.94915254237288
41381_marine,107,50,100,12,157,93.45794392523365,11.214953271028037
41382_marine,108,50,101,14,158,93.51851851851852,12.962962962962962
41383_marine,119,53,107,23,172,89.91596638655463,19.327731092436977
41384_marine,109,45,101,14,154,92.66055045871559,12.844036697247708
41385_marine,107,40,99,14,147,92.5233644859813,13.084112149532709
41386_marine,109,44,99,13,153,90.82568807339449,11.926605504587156
41387_marine,109,54,98,15,163,89.90825688073394,13.761467889908257
41388_marine,111,70,100,15,181,90.09009009009009,13.513513513513514
41389_marine,105,56,94,14,161,89.52380952380953,13.333333333333334
41390_marine,106,56,95,14,162,89.62264150943396,13.20754716981132
41391_marine,104,47,94,11,151,90.38461538461539,10.576923076923077
41392_marine,101,43,91,11,144,90.0990099009901,10.891089108910892
41393_marine,99,43,91,9,142,91.91919191919192,9.090909090909092
41394_marine,97,43,89,8,140,91.75257731958763,8.24742268041237
41395_marine,96,42,90,8,138,93.75,8.333333333333332
41396_marine,96,42,90,8,138,93.75,8.333333333333332
41397_marine,96,42,90,9,138,93.75,9.375
41398_marine,97,42,90,10,139,92.78350515463917,10.309278350515463
41399_marine,95,38,88,10,133,92.63157894736842,10.526315789473683
41400_marine,96,38,89,10,134,92.70833333333334,10.416666666666668
41401_marine,95,44,91,10,139,95.78947368421052,10.526315789473683
41402_marine,92,41,88,8,133,95.65217391304348,8.695652173913043
41403_marine,91,43,86,7,134,94.5054945054945,7.6923076923076925
41404_marine,91,42,86,7,133,94.5054945054945,7.6923076923076925
41405_marine,91,40,86,7,131,94.5054945054945,7.6923076923076925
41406_marine,92,38,87,7,130,94.56521739130434,7.608695652173914
41407_marine,90,37,85,7,127,94.44444444444444,7.777777777777778
41408_marine,89,37,84,7,126,94.3820224719101,7.865168539325842
41409_marine,88,37,83,7,125,94.31818181818183,7.954545454545454
41410_marine,88,37,83,7,125,94.31818181818183,7.954545454545454
41411_marine,88,37,83,7,125,94.31818181818183,7.954545454545454
41412_marine,88,37,83,7,125,94.31818181818183,7.954545454545454
41413_marine,88,37,83,7,125,94.31818181818183,7.954545454545454
41414_marine,89,38,84,6,127,94.3820224719101,6.741573033707865
41415_marine,89,37,84,6,126,94.3820224719101,6.741573033707865
41416_marine,89,37,84,6,126,94.3820224719101,6.741573033707865
41417_marine,90,36,85,6,126,94.44444444444444,6.666666666666667
41418_marine,88,36,83,6,124,94.31818181818183,6.8181818181818175
41419_marine,86,36,81,6,122,94.18604651162791,6.976744186046512
41420_marine,86,36,81,6,122,94.18604651162791,6.976744186046512
41421_marine,86,37,81,6,123,94.18604651162791,6.976744186046512
41422_marine,86,37,81,6,123,94.18604651162791,6.976744186046512
41423_marine,86,37,81,6,123,94.18604651162791,6.976744186046512
41424_marine,87,37,82,6,124,94.25287356321839,6.896551724137931
41425_marine,87,35,82,6,122,94.25287356321839,6.896551724137931
41426_marine,88,34,83,7,122,94.31818181818183,7.954545454545454
41427_marine,89,35,84,9,124,94.3820224719101,10.112359550561797
41428_marine,89,35,84,9,124,94.3820224719101,10.112359550561797
41429_marine,89,35,84,9,124,94.3820224719101,10.112359550561797
41430_marine,88,35,83,8,123,94.31818181818183,9.090909090909092
41431_marine,88,36,83,8,124,94.31818181818183,9.090909090909092
41432_marine,89,36,84,8,125,94.3820224719101,8.98876404494382
41433_marine,89,36,84,8,125,94.3820224719101,8.98876404494382
41434_marine,89,36,84,8,125,94.3820224719101,8.98876404494382
41435_marine,89,39,84,8,128,94.3820224719101,8.98876404494382
41436_marine,87,37,82,8,124,94.25287356321839,9.195402298850574
41437_marine,87,37,82,8,124,94.25287356321839,9.195402298850574
41438_marine,87,36,82,8,123,94.25287356321839,9.195402298850574
41439_marine,87,36,82,8,123,94.25287356321839,9.195402298850574
41440_marine,87,36,82,8,123,94.25287356321839,9.195402298850574
41441_marine,87,36,82,8,123,94.25287356321839,9.195402298850574
41442_marine,89,36,85,9,125,95.50561797752809,10.112359550561797
41443_marine,91,36,87,11,127,95.6043956043956,12.087912087912088
41444_marine,91,36,87,11,127,95.6043956043956,12.087912087912088
41445_marine,93,37,89,11,130,95.6989247311828,11.827956989247312
41446_marine,93,37,89,11,130,95.6989247311828,11.827956989247312
41447_marine,90,37,86,9,127,95.55555555555556,10
41448_marine,88,36,84,8,124,95.45454545454545,9.090909090909092
41449_marine,278,95,194,159,373,69.7841726618705,57.194244604316545
41450_marine,290,109,201,169,399,69.3103448275862,58.27586206896552
41451_marine,283,101,197,166,384,69.6113074204947,58.657243816254415
41452_marine,254,92,188,136,346,74.01574803149606,53.54330708661418
41453_marine,251,91,187,134,342,74.5019920318725,53.38645418326693
41454_marine,86,35,82,9,121,95.34883720930233,10.465116279069768
41455_marine,198,80,158,91,278,79.7979797979798,45.95959595959596
41456_marine,198,80,158,91,278,79.7979797979798,45.95959595959596
41457_marine,197,80,157,91,277,79.69543147208121,46.192893401015226
41458_marine,83,35,79,8,118,95.18072289156626,9.63855421686747
41459_marine,83,35,79,8,118,95.18072289156626,9.63855421686747
41460_marine,82,33,78,7,115,95.1219512195122,8.536585365853659
41461_marine,82,33,78,7,115,95.1219512195122,8.536585365853659
41462_marine,80,33,76,7,113,95,8.75
41463_marine,80,33,76,7,113,95,8.75
41464_marine,80,33,76,7,113,95,8.75
41465_marine,80,33,76,7,113,95,8.75
41466_marine,78,33,74,7,111,94.87179487179486,8.974358974358974
41467_marine,76,35,72,7,111,94.73684210526315,9.210526315789473
41468_marine,76,35,72,7,111,94.73684210526315,9.210526315789473
41469_marine,76,35,72,7,111,94.73684210526315,9.210526315789473
41470_marine,76,35,72,7,111,94.73684210526315,9.210526315789473
41471_marine,76,35,72,7,111,94.73684210526315,9.210526315789473
41472_marine,77,35,73,7,112,94.8051948051948,9.090909090909092
41473_marine,74,35,70,7,109,94.5945945945946,9.45945945945946
41474_marine,73,38,69,6,111,94.52054794520548,8.21917808219178
41475_marine,73,36,69,6,109,94.52054794520548,8.21917808219178
41476_marine,73,37,69,6,110,94.52054794520548,8.21917808219178
41477_marine,73,37,69,6,110,94.52054794520548,8.21917808219178
41478_marine,72,37,68,6,109,94.44444444444444,8.333333333333332
41479_marine,72,39,68,6,111,94.44444444444444,8.333333333333332
41480_marine,73,40,69,5,113,94.52054794520548,6.8493150684931505
41481_marine,73,44,69,5,117,94.52054794520548,6.8493150684931505
41482_marine,72,46,68,4,118,94.44444444444444,5.555555555555555
41483_marine,71,46,68,3,117,95.77464788732394,4.225352112676056
41484_marine,69,44,66,3,113,95.65217391304348,4.3478260869565215
41485_marine,67,46,64,3,113,95.52238805970148,4.477611940298507
41486_marine,67,48,64,3,115,95.52238805970148,4.477611940298507
41487_marine,68,45,65,3,113,95.58823529411765,4.411764705882353
41488_marine,63,46,60,3,109,95.23809523809523,4.761904761904762
41489_marine,63,50,60,3,113,95.23809523809523,4.761904761904762
41490_marine,66,50,63,3,116,95.45454545454545,4.545454545454546
41491_marine,66,51,63,3,117,95.45454545454545,4.545454545454546
41492_marine,68,53,65,3,121,95.58823529411765,4.411764705882353
41493_marine,69,52,66,3,121,95.65217391304348,4.3478260869565215
41494_marine,69,52,66,3,121,95.65217391304348,4.3478260869565215
41495_marine,68,52,65,3,120,95.58823529411765,4.411764705882353
41496_marine,69,53,66,3,122,95.65217391304348,4.3478260869565215
41497_marine,67,52,64,3,119,95.52238805970148,4.477611940298507
41498_marine,65,54,62,3,119,95.38461538461539,4.615384615384616
41499_marine,66,57,63,3,123,95.45454545454545,4.545454545454546
41500_marine,70,60,65,5,130,92.85714285714286,7.142857142857142
41501_marine,71,59,65,5,130,91.54929577464789,7.042253521126761
41502_marine,69,46,64,4,115,92.7536231884058,5.797101449275362
41503_marine,67,42,62,4,109,92.53731343283582,5.970149253731343
41504_marine,68,42,63,4,110,92.64705882352942,5.88235294117647
41505_marine,67,42,61,4,109,91.04477611940298,5.970149253731343
41506_marine,72,46,66,3,118,91.66666666666666,4.166666666666666
41507_marine,74,47,68,3,121,91.8918918918919,4.054054054054054
41508_marine,73,48,68,5,121,93.15068493150685,6.8493150684931505
41509_marine,118,75,99,18,193,83.89830508474576,15.254237288135593
41510_marine,179,166,124,68,345,69.27374301675978,37.988826815642454
41534_marine,288,212,250,72,500,86.80555555555556,25
41535_marine,295,217,256,69,512,86.77966101694915,23.389830508474578
41536_marine,286,195,247,66,481,86.36363636363636,23.076923076923077
41537_marine,126,59,119,7,185,94.44444444444444,5.555555555555555
41538_marine,115,44,110,6,159,95.65217391304348,5.217391304347826
41539_marine,112,44,107,5,156,95.53571428571429,4.464285714285714
41540_marine,113,40,107,5,153,94.69026548672566,4.424778761061947
41541_marine,110,40,104,6,150,94.54545454545455,5.454545454545454
41542_marine,106,40,100,4,146,94.33962264150944,3.7735849056603774
41543_marine,96,38,90,4,134,93.75,4.166666666666666
41544_marine,94,38,88,4,132,93.61702127659575,4.25531914893617
41545_marine,88,38,84,2,126,95.45454545454545,2.272727272727273
41546_marine,88,35,84,2,123,95.45454545454545,2.272727272727273
41547_marine,88,35,84,2,123,95.45454545454545,2.272727272727273
41548_marine,88,35,84,2,123,95.45454545454545,2.272727272727273
41549_marine,88,35,84,2,123,95.45454545454545,2.272727272727273
41550_marine,85,35,81,2,120,95.29411764705881,2.3529411764705883
41551_marine,85,35,81,2,120,95.29411764705881,2.3529411764705883
41552_marine,85,35,81,2,120,95.29411764705881,2.3529411764705883
41553_marine,84,35,80,2,119,95.23809523809523,2.380952380952381
41554_marine,84,35,80,2,119,95.23809523809523,2.380952380952381
41555_marine,83,35,79,2,118,95.18072289156626,2.4096385542168677
41556_marine,84,35,80,2,119,95.23809523809523,2.380952380952381
41557_marine,82,35,78,2,117,95.1219512195122,2.4390243902439024
41558_marine,80,37,76,2,117,95,2.5
41559_marine,79,37,75,1,116,94.9367088607595,1.2658227848101267
41560_marine,79,37,75,1,116,94.9367088607595,1.2658227848101267
41561_marine,78,37,74,1,115,94.87179487179486,1.282051282051282
41562_marine,77,35,73,0,112,94.8051948051948,0
41563_marine,75,35,71,0,110,94.66666666666667,0
41564_marine,76,33,72,0,109,94.73684210526315,0
41565_marine,74,33,70,0,107,94.5945945945946,0
41566_marine,73,32,69,0,105,94.52054794520548,0
41567_marine,73,32,69,0,105,94.52054794520548,0
41568_marine,73,30,69,0,103,94.52054794520548,0
41569_marine,73,30,69,0,103,94.52054794520548,0
41570_marine,75,30,71,0,105,94.66666666666667,0
41571_marine,75,30,71,0,105,94.66666666666667,0
41572_marine,75,31,71,0,106,94.66666666666667,0
41573_marine,75,31,71,0,106,94.66666666666667,0
41574_marine,75,30,71,0,105,94.66666666666667,0
41575_marine,75,30,71,0,105,94.66666666666667,0
41576_marine,74,29,70,0,103,94.5945945945946,0
41577_marine,74,31,70,0,105,94.5945945945946,0
41578_marine,74,31,70,0,105,94.5945945945946,0
41579_marine,74,31,70,0,105,94.5945945945946,0
41580_marine,74,33,70,0,107,94.5945945945946,0
41581_marine,77,33,73,0,110,94.8051948051948,0
41582_marine,77,33,73,0,110,94.8051948051948,0
41583_marine,75,33,71,0,108,94.66666666666667,0
41584_marine,77,36,73,0,113,94.8051948051948,0
41585_marine,78,36,73,0,114,93.58974358974359,0
41586_marine,81,40,75,0,121,92.5925925925926,0
41587_marine,80,39,74,0,119,92.5,0
41588_marine,78,41,71,1,119,91.02564102564102,1.282051282051282
41589_marine,81,41,74,1,122,91.35802469135803,1.2345679012345678
41590_marine,86,41,79,1,127,91.86046511627907,1.1627906976744187
41591_marine,89,43,82,1,132,92.13483146067416,1.1235955056179776
41592_marine,90,43,83,2,133,92.22222222222223,2.2222222222222223
41593_marine,95,52,88,4,147,92.63157894736842,4.2105263157894735
41594_marine,147,134,137,8,281,93.19727891156462,5.442176870748299
41616_marine,682,307,479,344,989,70.23460410557185,50.43988269794721
41617_marine,458,162,293,281,620,63.97379912663755,61.35371179039302
41618_marine,112,41,103,14,153,91.96428571428571,12.5
41619_marine,109,39,100,11,148,91.74311926605505,10.091743119266056
41620_marine,107,38,98,11,145,91.58878504672897,10.2803738317757
41621_marine,102,40,96,10,142,94.11764705882352,9.803921568627452
41622_marine,102,42,96,10,144,94.11764705882352,9.803921568627452
41623_marine,455,131,299,271,586,65.71428571428571,59.56043956043956
41624_marine,642,189,448,332,831,69.78193146417445,51.71339563862928
41629_marine,597,170,411,313,767,68.84422110552764,52.428810720268004
41630_marine,99,41,95,5,140,95.95959595959596,5.05050505050505
41631_marine,93,35,89,5,128,95.6989247311828,5.376344086021505
41632_marine,86,35,82,5,121,95.34883720930233,5.813953488372093
41633_marine,82,36,78,5,118,95.1219512195122,6.097560975609756
41634_marine,80,33,76,5,113,95,6.25
41635_marine,76,33,72,5,109,94.73684210526315,6.578947368421052
41636_marine,77,33,73,4,110,94.8051948051948,5.194805194805195
41637_marine,77,33,73,4,110,94.8051948051948,5.194805194805195
41638_marine,78,33,74,4,111,94.87179487179486,5.128205128205128
41639_marine,75,33,70,4,108,93.33333333333333,5.333333333333334
41640_marine,73,31,68,4,104,93.15068493150685,5.47945205479452
41641_marine,72,31,67,4,103,93.05555555555556,5.555555555555555
41642_marine,68,31,63,4,99,92.64705882352942,5.88235294117647
41643_marine,71,31,66,4,102,92.95774647887323,5.633802816901409
41644_marine,70,29,66,3,99,94.28571428571428,4.285714285714286
41645_marine,70,29,66,3,99,94.28571428571428,4.285714285714286
41646_marine,70,27,66,3,97,94.28571428571428,4.285714285714286
41647_marine,70,30,66,3,100,94.28571428571428,4.285714285714286
41648_marine,70,30,66,3,100,94.28571428571428,4.285714285714286
41649_marine,70,29,66,3,99,94.28571428571428,4.285714285714286
41650_marine,70,29,66,3,99,94.28571428571428,4.285714285714286
41651_marine,72,29,68,3,101,94.44444444444444,4.166666666666666
41652_marine,72,29,68,3,101,94.44444444444444,4.166666666666666
41653_marine,72,30,68,3,102,94.44444444444444,4.166666666666666
41654_marine,72,30,68,3,102,94.44444444444444,4.166666666666666
41655_marine,73,30,69,3,103,94.52054794520548,4.10958904109589
41656_marine,73,28,69,3,101,94.52054794520548,4.10958904109589
41657_marine,73,28,69,3,101,94.52054794520548,4.10958904109589
41658_marine,75,28,71,3,103,94.66666666666667,4
41659_marine,75,28,71,3,103,94.66666666666667,4
41660_marine,73,28,69,3,101,94.52054794520548,4.10958904109589
41661_marine,73,28,69,3,101,94.52054794520548,4.10958904109589
41662_marine,73,28,69,3,101,94.52054794520548,4.10958904109589
41663_marine,73,28,69,3,101,94.52054794520548,4.10958904109589
41664_marine,75,28,71,3,103,94.66666666666667,4
41665_marine,75,28,71,3,103,94.66666666666667,4
41666_marine,75,28,71,3,103,94.66666666666667,4
41667_marine,74,28,70,2,102,94.5945945945946,2.7027027027027026
41668_marine,74,28,70,2,102,94.5945945945946,2.7027027027027026
41669_marine,74,28,70,2,102,94.5945945945946,2.7027027027027026
41670_marine,75,28,71,2,103,94.66666666666667,2.666666666666667
41671_marine,75,30,71,2,105,94.66666666666667,2.666666666666667
41672_marine,75,30,71,2,105,94.66666666666667,2.666666666666667
41673_marine,75,30,71,2,105,94.66666666666667,2.666666666666667
41674_marine,75,30,71,2,105,94.66666666666667,2.666666666666667
41675_marine,77,30,73,2,107,94.8051948051948,2.5974025974025974
41676_marine,77,30,73,2,107,94.8051948051948,2.5974025974025974
41677_marine,76,30,72,2,106,94.73684210526315,2.631578947368421
41678_marine,76,32,72,2,108,94.73684210526315,2.631578947368421
41679_marine,76,32,72,2,108,94.73684210526315,2.631578947368421
41680_marine,76,31,72,2,107,94.73684210526315,2.631578947368421
41681_marine,76,31,72,2,107,94.73684210526315,2.631578947368421
41682_marine,76,31,72,2,107,94.73684210526315,2.631578947368421
41683_marine,76,31,72,2,107,94.73684210526315,2.631578947368421
41684_marine,77,32,73,2,109,94.8051948051948,2.5974025974025974
41685_marine,78,32,74,2,110,94.87179487179486,2.564102564102564
41686_marine,81,32,77,2,113,95.06172839506173,2.4691358024691357
41687_marine,82,34,78,2,116,95.1219512195122,2.4390243902439024
41688_marine,82,34,78,2,116,95.1219512195122,2.4390243902439024
41689_marine,86,34,81,2,120,94.18604651162791,2.3255813953488373
41690_marine,88,38,83,2,126,94.31818181818183,2.272727272727273
41691_marine,98,42,92,4,140,93.87755102040816,4.081632653061225
41692_marine,130,102,118,10,232,90.76923076923077,7.6923076923076925
41693_marine,576,357,370,297,933,64.23611111111111,51.5625
41694_marine,684,457,410,394,1141,59.94152046783626,57.60233918128655
41695_marine,650,400,381,373,1050,58.61538461538461,57.38461538461539
41735_marine,627,279,410,326,906,65.39074960127593,51.993620414673046
41736_marine,141,66,128,19,207,90.78014184397163,13.47517730496454
41737_marine,116,49,105,16,165,90.51724137931035,13.793103448275861
41738_marine,108,45,100,11,153,92.5925925925926,10.185185185185185
41739_marine,110,44,102,10,154,92.72727272727272,9.090909090909092
41740_marine,115,54,104,18,169,90.43478260869566,15.65217391304348
41741_marine,105,48,99,10,153,94.28571428571428,9.523809523809524
41742_marine,117,52,107,21,169,91.45299145299145,17.94871794871795
41743_marine,119,53,108,22,172,90.75630252100841,18.487394957983195
41744_marine,118,53,107,21,171,90.67796610169492,17.796610169491526
41745_marine,104,43,97,12,147,93.26923076923077,11.538461538461538
41746_marine,103,42,97,11,145,94.1747572815534,10.679611650485436
41747_marine,101,59,96,9,160,95.04950495049505,8.91089108910891
41748_marine,102,65,97,9,167,95.09803921568627,8.823529411764707
41749_marine,99,61,94,9,160,94.94949494949495,9.090909090909092
41750_marine,98,50,93,7,148,94.89795918367348,7.142857142857142
41751_marine,93,44,88,7,137,94.6236559139785,7.526881720430108
41752_marine,93,44,88,7,137,94.6236559139785,7.526881720430108
41753_marine,92,44,87,6,136,94.56521739130434,6.521739130434782
41754_marine,93,44,88,7,137,94.6236559139785,7.526881720430108
41755_marine,93,44,88,7,137,94.6236559139785,7.526881720430108
41756_marine,92,43,87,7,135,94.56521739130434,7.608695652173914
41757_marine,90,43,85,7,133,94.44444444444444,7.777777777777778
41758_marine,88,43,83,7,131,94.31818181818183,7.954545454545454
41759_marine,89,42,84,8,131,94.3820224719101,8.98876404494382
41760_marine,89,43,84,8,132,94.3820224719101,8.98876404494382
41761_marine,89,53,85,6,142,95.50561797752809,6.741573033707865
41762_marine,86,48,82,4,134,95.34883720930233,4.651162790697675
41763_marine,83,47,79,4,130,95.18072289156626,4.819277108433735
41764_marine,83,44,79,4,127,95.18072289156626,4.819277108433735
41765_marine,83,43,79,4,126,95.18072289156626,4.819277108433735
41766_marine,84,40,80,4,124,95.23809523809523,4.761904761904762
41767_marine,83,39,79,4,122,95.18072289156626,4.819277108433735
41768_marine,86,37,82,5,123,95.34883720930233,5.813953488372093
41769_marine,86,37,82,5,123,95.34883720930233,5.813953488372093
41770_marine,86,37,82,5,123,95.34883720930233,5.813953488372093
41771_marine,85,37,81,5,122,95.29411764705881,5.88235294117647
41772_marine,85,37,81,5,122,95.29411764705881,5.88235294117647
41773_marine,85,37,81,5,122,95.29411764705881,5.88235294117647
41774_marine,85,37,81,5,122,95.29411764705881,5.88235294117647
41775_marine,85,37,81,5,122,95.29411764705881,5.88235294117647
41776_marine,85,37,81,5,122,95.29411764705881,5.88235294117647
41777_marine,85,37,80,6,122,94.11764705882352,7.0588235294117645
41778_marine,84,36,79,6,120,94.04761904761905,7.142857142857142
41779_marine,82,36,77,6,118,93.90243902439023,7.317073170731707
41780_marine,82,36,77,6,118,93.90243902439023,7.317073170731707
41781_marine,83,36,78,6,119,93.97590361445783,7.228915662650602
41782_marine,83,36,78,6,119,93.97590361445783,7.228915662650602
41783_marine,83,35,78,6,118,93.97590361445783,7.228915662650602
41784_marine,83,35,78,6,118,93.97590361445783,7.228915662650602
41785_marine,85,36,80,6,121,94.11764705882352,7.0588235294117645
41786_marine,85,35,80,6,120,94.11764705882352,7.0588235294117645
41787_marine,85,36,80,6,121,94.11764705882352,7.0588235294117645
41788_marine,85,36,80,6,121,94.11764705882352,7.0588235294117645
41789_marine,83,36,78,7,119,93.97590361445783,8.433734939759036
41790_marine,85,35,80,9,120,94.11764705882352,10.588235294117647
41791_marine,85,35,80,9,120,94.11764705882352,10.588235294117647
41792_marine,85,36,80,9,121,94.11764705882352,10.588235294117647
41793_marine,86,36,81,8,122,94.18604651162791,9.30232558139535
41794_marine,101,45,92,18,146,91.0891089108911,17.82178217821782
41795_marine,303,96,212,166,399,69.96699669966998,54.78547854785478
41796_marine,300,98,209,166,398,69.66666666666667,55.333333333333336
41797_marine,300,98,209,166,398,69.66666666666667,55.333333333333336
41798_marine,88,39,84,9,127,95.45454545454545,10.227272727272728
41799_marine,87,36,83,9,123,95.40229885057471,10.344827586206897
41800_marine,87,36,83,9,123,95.40229885057471,10.344827586206897
41801_marine,87,36,83,9,123,95.40229885057471,10.344827586206897
41802_marine,87,36,83,9,123,95.40229885057471,10.344827586206897
41803_marine,86,37,82,8,123,95.34883720930233,9.30232558139535
41804_marine,86,37,82,8,123,95.34883720930233,9.30232558139535
41805_marine,85,37,81,8,122,95.29411764705881,9.411764705882353
41806_marine,84,36,80,8,120,95.23809523809523,9.523809523809524
41807_marine,84,36,80,9,120,95.23809523809523,10.714285714285714
41808_marine,86,36,82,9,122,95.34883720930233,10.465116279069768
41809_marine,82,36,78,9,118,95.1219512195122,10.975609756097562
41810_marine,242,84,162,143,326,66.94214876033058,59.09090909090909
41811_marine,242,83,162,143,325,66.94214876033058,59.09090909090909
41812_marine,80,35,76,8,115,95,10
41813_marine,81,35,77,8,116,95.06172839506173,9.876543209876543
41814_marine,83,35,79,8,118,95.18072289156626,9.63855421686747
41815_marine,83,35,79,8,118,95.18072289156626,9.63855421686747
41816_marine,80,34,76,8,114,95,10
41817_marine,80,34,76,8,114,95,10
41818_marine,79,35,75,7,114,94.9367088607595,8.860759493670885
41819_marine,79,33,75,7,112,94.9367088607595,8.860759493670885
41820_marine,79,33,75,7,112,94.9367088607595,8.860759493670885
41821_marine,78,33,74,7,111,94.87179487179486,8.974358974358974
41822_marine,76,33,72,7,109,94.73684210526315,9.210526315789473
41823_marine,76,33,72,7,109,94.73684210526315,9.210526315789473
41824_marine,75,33,71,7,108,94.66666666666667,9.333333333333334
41825_marine,73,33,69,7,106,94.52054794520548,9.58904109589041
41826_marine,73,33,69,7,106,94.52054794520548,9.58904109589041
41827_marine,72,33,68,7,105,94.44444444444444,9.722222222222223
41828_marine,72,33,68,7,105,94.44444444444444,9.722222222222223
41829_marine,72,36,68,7,108,94.44444444444444,9.722222222222223
41830_marine,110,64,86,41,174,78.18181818181819,37.27272727272727
41831_marine,111,64,87,41,175,78.37837837837837,36.93693693693694
41832_marine,113,64,89,41,177,78.76106194690266,36.283185840707965
41833_marine,75,36,71,7,111,94.66666666666667,9.333333333333334
41834_marine,71,38,67,6,109,94.36619718309859,8.450704225352112
41835_marine,71,39,67,6,110,94.36619718309859,8.450704225352112
41836_marine,71,36,67,6,107,94.36619718309859,8.450704225352112
41837_marine,71,36,67,6,107,94.36619718309859,8.450704225352112
41838_marine,70,37,66,6,107,94.28571428571428,8.571428571428571
41839_marine,70,39,66,6,109,94.28571428571428,8.571428571428571
41840_marine,69,39,65,5,108,94.20289855072464,7.246376811594203
41841_marine,69,41,65,5,110,94.20289855072464,7.246376811594203
41842_marine,67,38,64,3,105,95.52238805970148,4.477611940298507
41843_marine,65,42,62,3,107,95.38461538461539,4.615384615384616
41844_marine,65,42,62,3,107,95.38461538461539,4.615384615384616
41845_marine,63,42,60,3,105,95.23809523809523,4.761904761904762
41846_marine,63,42,60,3,105,95.23809523809523,4.761904761904762
41847_marine,60,43,57,3,103,95,5
41848_marine,60,40,57,3,100,95,5
41849_marine,59,44,56,3,103,94.91525423728814,5.084745762711865
41850_marine,62,44,59,3,106,95.16129032258065,4.838709677419355
41851_marine,62,44,59,3,106,95.16129032258065,4.838709677419355
41852_marine,64,44,61,3,108,95.3125,4.6875
41853_marine,64,43,61,3,107,95.3125,4.6875
41854_marine,66,42,63,3,108,95.45454545454545,4.545454545454546
41855_marine,66,43,63,3,109,95.45454545454545,4.545454545454546
41856_marine,66,42,63,3,108,95.45454545454545,4.545454545454546
41857_marine,65,45,62,3,110,95.38461538461539,4.615384615384616
41858_marine,63,47,60,3,110,95.23809523809523,4.761904761904762
41859_marine,70,60,65,5,130,92.85714285714286,7.142857142857142
41860_marine,78,67,70,9,145,89.74358974358975,11.538461538461538
41861_marine,82,66,73,11,148,89.02439024390245,13.414634146341465
41862_marine,75,54,68,6,129,90.66666666666666,8
41863_marine,65,41,60,4,106,92.3076923076923,6.153846153846154
41864_marine,66,42,61,4,108,92.42424242424242,6.0606060606060606
41865_marine,67,42,61,4,109,91.04477611940298,5.970149253731343
41866_marine,70,46,64,3,116,91.42857142857143,4.285714285714286
41867_marine,71,47,65,3,118,91.54929577464789,4.225352112676056
41868_marine,72,49,67,5,121,93.05555555555556,6.944444444444445
41869_marine,115,90,96,19,205,83.47826086956522,16.52173913043478
41870_marine,180,184,121,75,364,67.22222222222223,41.66666666666667
41893_marine,268,218,240,56,486,89.55223880597015,20.8955223880597
41894_marine,252,203,222,46,455,88.09523809523809,18.253968253968253
41895_marine,122,90,115,7,212,94.26229508196722,5.737704918032787
41896_marine,115,62,108,7,177,93.91304347826087,6.086956521739131
41897_marine,110,45,103,6,155,93.63636363636364,5.454545454545454
41898_marine,110,42,105,5,152,95.45454545454545,4.545454545454546
41899_marine,104,42,99,3,146,95.1923076923077,2.8846153846153846
41900_marine,101,48,95,3,149,94.05940594059405,2.9702970297029703
41901_marine,100,46,94,4,146,94,4
41902_marine,96,43,90,4,139,93.75,4.166666666666666
41903_marine,94,38,88,4,132,93.61702127659575,4.25531914893617
41904_marine,92,38,86,4,130,93.47826086956522,4.3478260869565215
41905_marine,90,36,86,2,126,95.55555555555556,2.2222222222222223
41906_marine,90,36,86,2,126,95.55555555555556,2.2222222222222223
41907_marine,90,35,86,2,125,95.55555555555556,2.2222222222222223
41908_marine,90,35,86,2,125,95.55555555555556,2.2222222222222223
41909_marine,90,35,86,2,125,95.55555555555556,2.2222222222222223
41910_marine,88,35,84,2,123,95.45454545454545,2.272727272727273
41911_marine,85,35,81,2,120,95.29411764705881,2.3529411764705883
41912_marine,86,35,82,2,121,95.34883720930233,2.3255813953488373
41913_marine,82,35,78,2,117,95.1219512195122,2.4390243902439024
41914_marine,82,35,78,2,117,95.1219512195122,2.4390243902439024
41915_marine,81,35,77,2,116,95.06172839506173,2.4691358024691357
41916_marine,81,35,77,2,116,95.06172839506173,2.4691358024691357
41917_marine,78,35,74,1,113,94.87179487179486,1.282051282051282
41918_marine,78,35,74,1,113,94.87179487179486,1.282051282051282
41919_marine,77,33,73,1,110,94.8051948051948,1.2987012987012987
41920_marine,77,35,73,1,112,94.8051948051948,1.2987012987012987
41921_marine,75,33,71,0,108,94.66666666666667,0
41922_marine,75,33,71,0,108,94.66666666666667,0
41923_marine,75,33,71,0,108,94.66666666666667,0
41924_marine,73,33,69,0,106,94.52054794520548,0
41925_marine,74,34,70,0,108,94.5945945945946,0
41926_marine,75,32,71,0,107,94.66666666666667,0
41927_marine,73,31,69,0,104,94.52054794520548,0
41928_marine,73,29,69,0,102,94.52054794520548,0
41929_marine,73,30,69,0,103,94.52054794520548,0
41930_marine,75,30,71,0,105,94.66666666666667,0
41931_marine,75,30,71,0,105,94.66666666666667,0
41932_marine,76,31,72,0,107,94.73684210526315,0
41933_marine,76,31,72,0,107,94.73684210526315,0
41934_marine,76,29,72,0,105,94.73684210526315,0
41935_marine,76,29,72,0,105,94.73684210526315,0
41936_marine,76,29,72,0,105,94.73684210526315,0
41937_marine,75,29,71,0,104,94.66666666666667,0
41938_marine,75,31,71,0,106,94.66666666666667,0
41939_marine,75,31,71,0,106,94.66666666666667,0
41940_marine,77,31,73,0,108,94.8051948051948,0
41941_marine,77,32,73,0,109,94.8051948051948,0
41942_marine,77,32,73,0,109,94.8051948051948,0
41943_marine,76,31,72,0,107,94.73684210526315,0
41944_marine,78,32,74,0,110,94.87179487179486,0
41945_marine,77,35,73,0,112,94.8051948051948,0
41946_marine,81,38,75,0,119,92.5925925925926,0
41947_marine,80,39,74,0,119,92.5,0
41948_marine,79,41,72,1,120,91.13924050632912,1.2658227848101267
41949_marine,79,41,72,1,120,91.13924050632912,1.2658227848101267
41950_marine,86,41,79,1,127,91.86046511627907,1.1627906976744187
41951_marine,92,45,85,1,137,92.3913043478261,1.0869565217391304
41952_marine,88,45,81,1,133,92.04545454545455,1.1363636363636365
41953_marine,93,52,86,2,145,92.47311827956989,2.1505376344086025
41954_marine,147,142,137,8,289,93.19727891156462,5.442176870748299
41974_marine,703,343,497,346,1046,70.69701280227596,49.217638691322904
41975_marine,465,209,299,284,674,64.30107526881721,61.0752688172043
41976_marine,121,76,114,13,197,94.21487603305785,10.743801652892563
41977_marine,113,52,103,13,165,91.1504424778761,11.504424778761061
41978_marine,110,45,101,11,155,91.81818181818183,10
41979_marine,107,40,98,10,147,91.58878504672897,9.345794392523365
41980_marine,104,38,95,9,142,91.34615384615384,8.653846153846153
41981_marine,95,38,89,9,133,93.6842105263158,9.473684210526317
41982_marine,97,39,91,9,136,93.81443298969072,9.278350515463918
41983_marine,107,40,101,9,147,94.39252336448598,8.411214953271028
41984_marine,607,171,421,315,778,69.35749588138385,51.894563426688634
41985_marine,632,194,445,317,826,70.41139240506328,50.15822784810127
41986_marine,638,190,451,318,828,70.6896551724138,49.843260188087775
41987_marine,612,171,426,315,783,69.6078431372549,51.470588235294116
41988_marine,598,167,412,308,765,68.89632107023411,51.50501672240802
41989_marine,101,40,96,5,141,95.04950495049505,4.9504950495049505
41990_marine,85,34,81,4,119,95.29411764705881,4.705882352941177
41991_marine,81,34,77,4,115,95.06172839506173,4.938271604938271
41992_marine,82,35,77,4,117,93.90243902439023,4.878048780487805
41993_marine,82,35,77,4,117,93.90243902439023,4.878048780487805
41994_marine,78,35,73,3,113,93.58974358974359,3.8461538461538463
41995_marine,76,35,71,3,111,93.42105263157895,3.9473684210526314
41996_marine,77,35,72,3,112,93.5064935064935,3.896103896103896
41997_marine,76,34,71,3,110,93.42105263157895,3.9473684210526314
41998_marine,74,34,69,3,108,93.24324324324324,4.054054054054054
41999_marine,71,34,67,2,105,94.36619718309859,2.8169014084507045
42000_marine,71,34,67,2,105,94.36619718309859,2.8169014084507045
42001_marine,69,35,65,2,104,94.20289855072464,2.898550724637681
42002_marine,69,37,65,2,106,94.20289855072464,2.898550724637681
42003_marine,69,37,65,2,106,94.20289855072464,2.898550724637681
42004_marine,69,35,65,2,104,94.20289855072464,2.898550724637681
42005_marine,69,33,65,2,102,94.20289855072464,2.898550724637681
42006_marine,69,33,65,2,102,94.20289855072464,2.898550724637681
42007_marine,69,31,65,2,100,94.20289855072464,2.898550724637681
42008_marine,71,31,67,2,102,94.36619718309859,2.8169014084507045
42009_marine,73,31,69,2,104,94.52054794520548,2.73972602739726
42010_marine,73,31,69,2,104,94.52054794520548,2.73972602739726
42011_marine,73,31,69,2,104,94.52054794520548,2.73972602739726
42012_marine,73,31,69,2,104,94.52054794520548,2.73972602739726
42013_marine,73,31,69,2,104,94.52054794520548,2.73972602739726
42014_marine,73,31,69,2,104,94.52054794520548,2.73972602739726
42015_marine,73,30,69,2,103,94.52054794520548,2.73972602739726
42016_marine,73,30,69,2,103,94.52054794520548,2.73972602739726
42017_marine,74,28,70,2,102,94.5945945945946,2.7027027027027026
42018_marine,74,28,70,2,102,94.5945945945946,2.7027027027027026
42019_marine,70,28,66,2,98,94.28571428571428,2.857142857142857
42020_marine,70,28,66,2,98,94.28571428571428,2.857142857142857
42021_marine,70,28,66,2,98,94.28571428571428,2.857142857142857
42022_marine,72,28,68,2,100,94.44444444444444,2.7777777777777777
42023_marine,72,30,68,2,102,94.44444444444444,2.7777777777777777
42024_marine,72,30,68,2,102,94.44444444444444,2.7777777777777777
42025_marine,72,30,68,2,102,94.44444444444444,2.7777777777777777
42026_marine,74,30,70,2,104,94.5945945945946,2.7027027027027026
42027_marine,74,30,70,2,104,94.5945945945946,2.7027027027027026
42028_marine,74,30,70,2,104,94.5945945945946,2.7027027027027026
42029_marine,73,30,69,2,103,94.52054794520548,2.73972602739726
42030_marine,73,29,69,2,102,94.52054794520548,2.73972602739726
42031_marine,73,29,69,2,102,94.52054794520548,2.73972602739726
42032_marine,73,29,69,2,102,94.52054794520548,2.73972602739726
42033_marine,75,29,71,2,104,94.66666666666667,2.666666666666667
42034_marine,75,30,71,2,105,94.66666666666667,2.666666666666667
42035_marine,75,30,71,2,105,94.66666666666667,2.666666666666667
42036_marine,75,32,71,2,107,94.66666666666667,2.666666666666667
42037_marine,77,32,73,2,109,94.8051948051948,2.5974025974025974
42038_marine,76,32,72,2,108,94.73684210526315,2.631578947368421
42039_marine,77,32,73,2,109,94.8051948051948,2.5974025974025974
42040_marine,77,32,73,2,109,94.8051948051948,2.5974025974025974
42041_marine,77,32,73,2,109,94.8051948051948,2.5974025974025974
42042_marine,75,32,71,2,107,94.66666666666667,2.666666666666667
42043_marine,77,32,73,2,109,94.8051948051948,2.5974025974025974
42044_marine,77,32,73,2,109,94.8051948051948,2.5974025974025974
42045_marine,78,32,74,2,110,94.87179487179486,2.564102564102564
42046_marine,78,32,74,2,110,94.87179487179486,2.564102564102564
42047_marine,80,32,76,2,112,95,2.5
42048_marine,81,32,77,2,113,95.06172839506173,2.4691358024691357
42049_marine,83,34,78,2,117,93.97590361445783,2.4096385542168677
42050_marine,86,36,81,2,122,94.18604651162791,2.3255813953488373
42051_marine,102,41,96,4,143,94.11764705882352,3.9215686274509802
42052_marine,131,97,119,11,228,90.83969465648855,8.396946564885496
42053_marine,475,290,339,213,765,71.36842105263158,44.8421052631579
42054_marine,670,446,402,380,1116,60,56.71641791044776
42055_marine,646,398,379,370,1044,58.6687306501548,57.27554179566563
42095_marine,620,299,401,317,919,64.6774193548387,51.12903225806451
42096_marine,144,54,133,17,198,92.36111111111111,11.805555555555555
42097_marine,111,47,104,10,158,93.69369369369369,9.00900900900901
42098_marine,104,46,98,8,150,94.23076923076923,7.6923076923076925
42099_marine,105,48,100,8,153,95.23809523809523,7.6190476190476195
42100_marine,103,48,98,8,151,95.14563106796116,7.766990291262135
42101_marine,103,48,99,8,151,96.11650485436894,7.766990291262135
42102_marine,114,54,106,18,168,92.98245614035088,15.789473684210526
42103_marine,116,55,108,19,171,93.10344827586206,16.379310344827587
42104_marine,101,49,96,9,150,95.04950495049505,8.91089108910891
42105_marine,103,46,98,9,149,95.14563106796116,8.737864077669903
42106_marine,100,45,95,9,145,95,9
42107_marine,102,63,97,10,165,95.09803921568627,9.803921568627452
42108_marine,102,73,93,12,175,91.17647058823529,11.76470588235294
42109_marine,99,64,94,8,163,94.94949494949495,8.080808080808081
42110_marine,96,53,91,7,149,94.79166666666666,7.291666666666667
42111_marine,91,47,86,6,138,94.5054945054945,6.593406593406594
42112_marine,91,47,86,6,138,94.5054945054945,6.593406593406594
42113_marine,89,47,84,5,136,94.3820224719101,5.617977528089887
42114_marine,89,47,84,5,136,94.3820224719101,5.617977528089887
42115_marine,89,47,84,5,136,94.3820224719101,5.617977528089887
42116_marine,90,47,85,5,137,94.44444444444444,5.555555555555555
42117_marine,88,46,83,5,134,94.31818181818183,5.681818181818182
42118_marine,86,46,81,5,132,94.18604651162791,5.813953488372093
42119_marine,86,46,81,5,132,94.18604651162791,5.813953488372093
42120_marine,87,47,82,6,134,94.25287356321839,6.896551724137931
42121_marine,102,60,94,15,162,92.15686274509804,14.705882352941178
42122_marine,87,50,83,3,137,95.40229885057471,3.4482758620689653
42123_marine,87,51,83,3,138,95.40229885057471,3.4482758620689653
42124_marine,84,42,80,3,126,95.23809523809523,3.571428571428571
42125_marine,82,42,78,3,124,95.1219512195122,3.6585365853658534
42126_marine,80,42,76,3,122,95,3.75
42127_marine,79,42,76,3,121,96.20253164556962,3.79746835443038
42128_marine,79,42,76,3,121,96.20253164556962,3.79746835443038
42129_marine,79,42,76,3,121,96.20253164556962,3.79746835443038
42130_marine,79,42,76,3,121,96.20253164556962,3.79746835443038
42131_marine,79,41,76,3,120,96.20253164556962,3.79746835443038
42132_marine,80,40,77,3,120,96.25,3.75
42133_marine,81,39,78,3,120,96.29629629629629,3.7037037037037033
42134_marine,81,40,78,3,121,96.29629629629629,3.7037037037037033
42135_marine,82,40,79,4,122,96.34146341463415,4.878048780487805
42136_marine,82,40,79,5,122,96.34146341463415,6.097560975609756
42137_marine,81,40,78,5,121,96.29629629629629,6.172839506172839
42138_marine,81,38,78,5,119,96.29629629629629,6.172839506172839
42139_marine,79,38,76,5,117,96.20253164556962,6.329113924050633
42140_marine,79,37,76,5,116,96.20253164556962,6.329113924050633
42141_marine,79,37,76,5,116,96.20253164556962,6.329113924050633
42142_marine,79,37,76,5,116,96.20253164556962,6.329113924050633
42143_marine,81,37,77,6,118,95.06172839506173,7.4074074074074066
42144_marine,81,37,77,6,118,95.06172839506173,7.4074074074074066
42145_marine,80,37,76,6,117,95,7.5
42146_marine,81,37,77,6,118,95.06172839506173,7.4074074074074066
42147_marine,81,36,77,6,117,95.06172839506173,7.4074074074074066
42148_marine,81,37,77,6,118,95.06172839506173,7.4074074074074066
42149_marine,81,38,77,6,119,95.06172839506173,7.4074074074074066
42150_marine,80,38,76,6,118,95,7.5
42151_marine,82,38,78,8,120,95.1219512195122,9.75609756097561
42152_marine,81,38,77,9,119,95.06172839506173,11.11111111111111
42153_marine,81,36,77,9,117,95.06172839506173,11.11111111111111
42154_marine,92,45,84,19,137,91.30434782608695,20.652173913043477
42155_marine,294,96,204,167,390,69.38775510204081,56.80272108843537
42156_marine,315,117,222,174,432,70.47619047619048,55.23809523809524
42157_marine,299,105,209,167,404,69.89966555183946,55.852842809364546
42158_marine,83,41,79,9,124,95.18072289156626,10.843373493975903
42159_marine,82,36,78,8,118,95.1219512195122,9.75609756097561
42160_marine,82,37,78,8,119,95.1219512195122,9.75609756097561
42161_marine,81,37,77,8,118,95.06172839506173,9.876543209876543
42162_marine,81,37,77,8,118,95.06172839506173,9.876543209876543
42163_marine,81,37,77,8,118,95.06172839506173,9.876543209876543
42164_marine,82,36,78,8,118,95.1219512195122,9.75609756097561
42165_marine,81,36,77,8,117,95.06172839506173,9.876543209876543
42166_marine,81,36,77,8,117,95.06172839506173,9.876543209876543
42167_marine,79,36,75,8,115,94.9367088607595,10.126582278481013
42168_marine,74,36,70,8,110,94.5945945945946,10.81081081081081
42169_marine,74,35,70,8,109,94.5945945945946,10.81081081081081
42170_marine,74,35,70,8,109,94.5945945945946,10.81081081081081
42171_marine,74,35,70,8,109,94.5945945945946,10.81081081081081
42172_marine,76,35,72,8,111,94.73684210526315,10.526315789473683
42173_marine,77,35,73,8,112,94.8051948051948,10.38961038961039
42174_marine,79,35,75,8,114,94.9367088607595,10.126582278481013
42175_marine,81,35,77,8,116,95.06172839506173,9.876543209876543
42176_marine,79,34,75,7,113,94.9367088607595,8.860759493670885
42177_marine,79,34,75,7,113,94.9367088607595,8.860759493670885
42178_marine,78,32,74,7,110,94.87179487179486,8.974358974358974
42179_marine,78,33,74,7,111,94.87179487179486,8.974358974358974
42180_marine,77,33,73,7,110,94.8051948051948,9.090909090909092
42181_marine,77,33,73,7,110,94.8051948051948,9.090909090909092
42182_marine,76,33,72,7,109,94.73684210526315,9.210526315789473
42183_marine,74,33,70,7,107,94.5945945945946,9.45945945945946
42184_marine,74,33,70,7,107,94.5945945945946,9.45945945945946
42185_marine,74,33,70,7,107,94.5945945945946,9.45945945945946
42186_marine,74,33,70,7,107,94.5945945945946,9.45945945945946
42187_marine,74,33,70,7,107,94.5945945945946,9.45945945945946
42188_marine,75,34,71,7,109,94.66666666666667,9.333333333333334
42189_marine,75,34,71,7,109,94.66666666666667,9.333333333333334
42190_marine,112,64,88,41,176,78.57142857142857,36.607142857142854
42191_marine,122,73,95,46,195,77.8688524590164,37.704918032786885
42192_marine,111,64,87,41,175,78.37837837837837,36.93693693693694
42193_marine,73,36,69,7,109,94.52054794520548,9.58904109589041
42194_marine,70,36,66,6,106,94.28571428571428,8.571428571428571
42195_marine,69,35,65,6,104,94.20289855072464,8.695652173913043
42196_marine,71,35,67,6,106,94.36619718309859,8.450704225352112
42197_marine,70,37,66,6,107,94.28571428571428,8.571428571428571
42198_marine,70,37,66,6,107,94.28571428571428,8.571428571428571
42199_marine,70,37,66,6,107,94.28571428571428,8.571428571428571
42200_marine,69,38,65,5,107,94.20289855072464,7.246376811594203
42201_marine,68,38,65,4,106,95.58823529411765,5.88235294117647
42202_marine,65,38,62,3,103,95.38461538461539,4.615384615384616
42203_marine,61,38,58,3,99,95.08196721311475,4.918032786885246
42204_marine,61,38,58,3,99,95.08196721311475,4.918032786885246
42205_marine,56,38,53,3,94,94.64285714285714,5.357142857142857
42206_marine,56,38,53,3,94,94.64285714285714,5.357142857142857
42207_marine,56,40,53,3,96,94.64285714285714,5.357142857142857
42208_marine,56,40,53,3,96,94.64285714285714,5.357142857142857
42209_marine,57,40,54,3,97,94.73684210526315,5.263157894736842
42210_marine,59,40,56,3,99,94.91525423728814,5.084745762711865
42211_marine,62,40,59,3,102,95.16129032258065,4.838709677419355
42212_marine,62,38,59,3,100,95.16129032258065,4.838709677419355
42213_marine,62,39,59,3,101,95.16129032258065,4.838709677419355
42214_marine,62,38,59,3,100,95.16129032258065,4.838709677419355
42215_marine,60,41,57,3,101,95,5
42216_marine,60,39,57,3,99,95,5
42217_marine,59,41,56,3,100,94.91525423728814,5.084745762711865
42218_marine,60,41,57,3,101,95,5
42219_marine,60,42,57,3,102,95,5
42220_marine,69,57,63,5,126,91.30434782608695,7.246376811594203
42221_marine,71,58,64,6,129,90.14084507042254,8.450704225352112
42222_marine,63,45,58,4,108,92.06349206349206,6.349206349206349
42223_marine,61,42,56,4,103,91.80327868852459,6.557377049180328
42224_marine,63,42,58,3,105,92.06349206349206,4.761904761904762
42225_marine,64,42,58,3,106,90.625,4.6875
42226_marine,68,46,62,3,114,91.17647058823529,4.411764705882353
42227_marine,67,47,61,3,114,91.04477611940298,4.477611940298507
42228_marine,100,83,86,12,183,86,12
42229_marine,183,198,122,80,381,66.66666666666666,43.71584699453552
42230_marine,180,193,119,78,373,66.11111111111111,43.333333333333336
42253_marine,261,220,237,51,481,90.80459770114942,19.54022988505747
42254_marine,247,180,222,43,427,89.87854251012146,17.408906882591094
42255_marine,114,65,107,6,179,93.85964912280701,5.263157894736842
42256_marine,109,47,102,5,156,93.57798165137615,4.587155963302752
42257_marine,103,45,96,3,148,93.20388349514563,2.912621359223301
42258_marine,96,44,91,3,140,94.79166666666666,3.125
42259_marine,95,43,89,3,138,93.6842105263158,3.1578947368421053
42260_marine,93,43,87,3,136,93.54838709677419,3.225806451612903
42261_marine,92,48,86,4,140,93.47826086956522,4.3478260869565215
42262_marine,92,46,86,4,138,93.47826086956522,4.3478260869565215
42263_marine,90,41,84,4,131,93.33333333333333,4.444444444444445
42264_marine,89,39,85,2,128,95.50561797752809,2.247191011235955
42265_marine,88,39,84,2,127,95.45454545454545,2.272727272727273
42266_marine,88,36,84,2,124,95.45454545454545,2.272727272727273
42267_marine,88,36,84,2,124,95.45454545454545,2.272727272727273
42268_marine,88,37,84,2,125,95.45454545454545,2.272727272727273
42269_marine,88,33,84,2,121,95.45454545454545,2.272727272727273
42270_marine,86,33,82,2,119,95.34883720930233,2.3255813953488373
42271_marine,83,33,79,1,116,95.18072289156626,1.2048192771084338
42272_marine,84,33,80,1,117,95.23809523809523,1.1904761904761905
42273_marine,82,31,78,1,113,95.1219512195122,1.2195121951219512
42274_marine,77,29,73,1,106,94.8051948051948,1.2987012987012987
42275_marine,75,27,71,1,102,94.66666666666667,1.3333333333333335
42276_marine,75,25,71,1,100,94.66666666666667,1.3333333333333335
42277_marine,77,25,73,1,102,94.8051948051948,1.2987012987012987
42278_marine,77,25,73,1,102,94.8051948051948,1.2987012987012987
42279_marine,77,25,73,1,102,94.8051948051948,1.2987012987012987
42280_marine,76,26,72,0,102,94.73684210526315,0
42281_marine,75,26,71,0,101,94.66666666666667,0
42282_marine,75,26,71,0,101,94.66666666666667,0
42283_marine,72,28,68,0,100,94.44444444444444,0
42284_marine,72,28,68,0,100,94.44444444444444,0
42285_marine,71,29,67,0,100,94.36619718309859,0
42286_marine,71,29,67,0,100,94.36619718309859,0
42287_marine,73,29,69,0,102,94.52054794520548,0
42288_marine,73,31,69,0,104,94.52054794520548,0
42289_marine,73,32,69,0,105,94.52054794520548,0
42290_marine,73,32,69,0,105,94.52054794520548,0
42291_marine,75,32,71,0,107,94.66666666666667,0
42292_marine,75,30,71,0,105,94.66666666666667,0
42293_marine,75,30,71,0,105,94.66666666666667,0
42294_marine,75,27,71,0,102,94.66666666666667,0
42295_marine,75,27,71,0,102,94.66666666666667,0
42296_marine,75,27,71,0,102,94.66666666666667,0
42297_marine,74,27,70,0,101,94.5945945945946,0
42298_marine,76,27,72,0,103,94.73684210526315,0
42299_marine,76,28,72,0,104,94.73684210526315,0
42300_marine,76,30,72,0,106,94.73684210526315,0
42301_marine,75,30,71,0,105,94.66666666666667,0
42302_marine,75,29,71,0,104,94.66666666666667,0
42303_marine,75,31,71,0,106,94.66666666666667,0
42304_marine,75,34,71,0,109,94.66666666666667,0
42305_marine,77,37,73,0,114,94.8051948051948,0
42306_marine,77,38,73,0,115,94.8051948051948,0
42307_marine,77,41,71,0,118,92.20779220779221,0
42308_marine,79,41,73,0,120,92.40506329113924,0
42309_marine,82,43,75,1,125,91.46341463414635,1.2195121951219512
42310_marine,83,45,76,1,128,91.56626506024097,1.2048192771084338
42311_marine,88,47,81,1,135,92.04545454545455,1.1363636363636365
42312_marine,88,47,81,1,135,92.04545454545455,1.1363636363636365
42313_marine,94,50,87,2,144,92.5531914893617,2.127659574468085
42314_marine,107,104,100,4,211,93.45794392523365,3.7383177570093453
42315_marine,162,170,149,13,332,91.9753086419753,8.024691358024691
42334_marine,662,298,465,325,960,70.2416918429003,49.09365558912387
42335_marine,114,62,108,11,176,94.73684210526315,9.649122807017543
42336_marine,116,56,108,12,172,93.10344827586206,10.344827586206897
42337_marine,116,49,108,10,165,93.10344827586206,8.620689655172415
42338_marine,112,44,104,7,156,92.85714285714286,6.25
42339_marine,107,41,99,6,148,92.5233644859813,5.607476635514018
42340_marine,99,43,91,6,142,91.91919191919192,6.0606060606060606
42341_marine,94,40,89,7,134,94.68085106382979,7.446808510638298
42342_marine,94,41,89,7,135,94.68085106382979,7.446808510638298
42343_marine,99,39,93,7,138,93.93939393939394,7.07070707070707
42344_marine,105,43,99,7,148,94.28571428571428,6.666666666666667
42345_marine,114,42,108,8,156,94.73684210526315,7.017543859649122
42346_marine,118,46,112,7,164,94.91525423728814,5.932203389830509
42347_marine,220,74,166,75,294,75.45454545454545,34.090909090909086
42348_marine,98,46,92,5,144,93.87755102040816,5.1020408163265305
42349_marine,91,40,86,4,131,94.5054945054945,4.395604395604396
42350_marine,91,39,86,4,130,94.5054945054945,4.395604395604396
42351_marine,88,36,83,4,124,94.31818181818183,4.545454545454546
42352_marine,88,36,83,4,124,94.31818181818183,4.545454545454546
42353_marine,84,36,79,3,120,94.04761904761905,3.571428571428571
42354_marine,84,36,79,3,120,94.04761904761905,3.571428571428571
42355_marine,79,36,74,3,115,93.67088607594937,3.79746835443038
42356_marine,76,36,72,2,112,94.73684210526315,2.631578947368421
42357_marine,73,37,69,2,110,94.52054794520548,2.73972602739726
42358_marine,73,37,69,2,110,94.52054794520548,2.73972602739726
42359_marine,73,37,69,2,110,94.52054794520548,2.73972602739726
42360_marine,73,37,69,2,110,94.52054794520548,2.73972602739726
42361_marine,74,35,70,2,109,94.5945945945946,2.7027027027027026
42362_marine,74,37,70,2,111,94.5945945945946,2.7027027027027026
42363_marine,73,35,69,2,108,94.52054794520548,2.73972602739726
42364_marine,73,35,69,2,108,94.52054794520548,2.73972602739726
42365_marine,73,35,69,2,108,94.52054794520548,2.73972602739726
42366_marine,75,35,71,2,110,94.66666666666667,2.666666666666667
42367_marine,75,35,71,2,110,94.66666666666667,2.666666666666667
42368_marine,75,33,71,2,108,94.66666666666667,2.666666666666667
42369_marine,75,33,71,2,108,94.66666666666667,2.666666666666667
42370_marine,74,35,70,2,109,94.5945945945946,2.7027027027027026
42371_marine,74,35,70,2,109,94.5945945945946,2.7027027027027026
42372_marine,74,35,70,2,109,94.5945945945946,2.7027027027027026
42373_marine,74,35,70,2,109,94.5945945945946,2.7027027027027026
42374_marine,74,36,70,2,110,94.5945945945946,2.7027027027027026
42375_marine,74,36,70,2,110,94.5945945945946,2.7027027027027026
42376_marine,74,35,70,2,109,94.5945945945946,2.7027027027027026
42377_marine,72,35,68,2,107,94.44444444444444,2.7777777777777777
42378_marine,71,33,67,2,104,94.36619718309859,2.8169014084507045
42379_marine,71,32,67,2,103,94.36619718309859,2.8169014084507045
42380_marine,72,32,68,2,104,94.44444444444444,2.7777777777777777
42381_marine,72,32,68,2,104,94.44444444444444,2.7777777777777777
42382_marine,72,32,68,2,104,94.44444444444444,2.7777777777777777
42383_marine,72,32,68,2,104,94.44444444444444,2.7777777777777777
42384_marine,72,32,68,2,104,94.44444444444444,2.7777777777777777
42385_marine,72,32,68,2,104,94.44444444444444,2.7777777777777777
42386_marine,72,32,68,2,104,94.44444444444444,2.7777777777777777
42387_marine,74,32,70,2,106,94.5945945945946,2.7027027027027026
42388_marine,76,32,72,2,108,94.73684210526315,2.631578947368421
42389_marine,75,31,71,2,106,94.66666666666667,2.666666666666667
42390_marine,75,31,71,2,106,94.66666666666667,2.666666666666667
42391_marine,75,31,71,2,106,94.66666666666667,2.666666666666667
42392_marine,75,31,71,2,106,94.66666666666667,2.666666666666667
42393_marine,75,31,71,2,106,94.66666666666667,2.666666666666667
42394_marine,75,35,71,2,110,94.66666666666667,2.666666666666667
42395_marine,75,33,71,2,108,94.66666666666667,2.666666666666667
42396_marine,75,35,71,2,110,94.66666666666667,2.666666666666667
42397_marine,77,34,73,2,111,94.8051948051948,2.5974025974025974
42398_marine,76,36,72,2,112,94.73684210526315,2.631578947368421
42399_marine,78,37,74,2,115,94.87179487179486,2.564102564102564
42400_marine,76,37,72,2,113,94.73684210526315,2.631578947368421
42401_marine,76,35,72,2,111,94.73684210526315,2.631578947368421
42402_marine,76,34,72,2,110,94.73684210526315,2.631578947368421
42403_marine,76,34,72,2,110,94.73684210526315,2.631578947368421
42404_marine,78,34,74,2,112,94.87179487179486,2.564102564102564
42405_marine,79,34,75,2,113,94.9367088607595,2.5316455696202533
42406_marine,80,35,76,2,115,95,2.5
42407_marine,82,34,78,2,116,95.1219512195122,2.4390243902439024
42408_marine,83,34,79,2,117,95.18072289156626,2.4096385542168677
42409_marine,85,36,80,2,121,94.11764705882352,2.3529411764705883
42410_marine,85,40,80,2,125,94.11764705882352,2.3529411764705883
42411_marine,103,40,97,4,143,94.1747572815534,3.8834951456310676
42412_marine,126,83,115,8,209,91.26984126984127,6.349206349206349
42413_marine,453,252,319,207,705,70.41942604856513,45.6953642384106
42414_marine,617,399,371,346,1016,60.129659643435986,56.07779578606159
42415_marine,582,376,338,336,958,58.075601374570454,57.73195876288659
42455_marine,598,320,384,304,918,64.21404682274247,50.836120401337794
42456_marine,157,73,141,21,230,89.80891719745223,13.375796178343949
42457_marine,124,56,115,10,180,92.74193548387096,8.064516129032258
42458_marine,109,50,103,8,159,94.4954128440367,7.339449541284404
42459_marine,373,66,242,224,439,64.87935656836461,60.05361930294906
42460_marine,373,65,242,224,438,64.87935656836461,60.05361930294906
42461_marine,102,47,98,7,149,96.07843137254902,6.862745098039216
42462_marine,99,49,95,8,148,95.95959595959596,8.080808080808081
42463_marine,97,50,93,8,147,95.87628865979381,8.24742268041237
42464_marine,97,48,93,8,145,95.87628865979381,8.24742268041237
42465_marine,100,46,95,8,146,95,8
42466_marine,101,48,96,8,149,95.04950495049505,7.920792079207921
42467_marine,102,61,97,8,163,95.09803921568627,7.8431372549019605
42468_marine,199,105,144,90,304,72.36180904522614,45.22613065326633
42469_marine,198,99,143,90,297,72.22222222222221,45.45454545454545
42470_marine,98,54,93,6,152,94.89795918367348,6.122448979591836
42471_marine,96,51,91,6,147,94.79166666666666,6.25
42472_marine,96,49,91,5,145,94.79166666666666,5.208333333333334
42473_marine,94,49,89,5,143,94.68085106382979,5.319148936170213
42474_marine,94,49,89,5,143,94.68085106382979,5.319148936170213
42475_marine,93,49,88,5,142,94.6236559139785,5.376344086021505
42476_marine,93,49,88,5,142,94.6236559139785,5.376344086021505
42477_marine,91,49,86,5,140,94.5054945054945,5.4945054945054945
42478_marine,91,49,86,5,140,94.5054945054945,5.4945054945054945
42479_marine,91,48,86,5,139,94.5054945054945,5.4945054945054945
42480_marine,89,52,85,5,141,95.50561797752809,5.617977528089887
42481_marine,104,58,96,15,162,92.3076923076923,14.423076923076922
42482_marine,152,106,122,51,258,80.26315789473685,33.55263157894737
42483_marine,151,106,122,51,257,80.79470198675497,33.77483443708609
42484_marine,84,52,81,3,136,96.42857142857143,3.571428571428571
42485_marine,81,44,78,3,125,96.29629629629629,3.7037037037037033
42486_marine,80,43,77,3,123,96.25,3.75
42487_marine,80,43,77,3,123,96.25,3.75
42488_marine,79,42,76,3,121,96.20253164556962,3.79746835443038
42489_marine,79,42,76,3,121,96.20253164556962,3.79746835443038
42490_marine,78,42,75,3,120,96.15384615384616,3.8461538461538463
42491_marine,78,41,75,3,119,96.15384615384616,3.8461538461538463
42492_marine,78,41,75,3,119,96.15384615384616,3.8461538461538463
42493_marine,78,41,75,3,119,96.15384615384616,3.8461538461538463
42494_marine,78,42,75,3,120,96.15384615384616,3.8461538461538463
42495_marine,77,43,74,3,120,96.1038961038961,3.896103896103896
42496_marine,77,42,74,3,119,96.1038961038961,3.896103896103896
42497_marine,76,40,73,3,116,96.05263157894737,3.9473684210526314
42498_marine,72,39,69,3,111,95.83333333333334,4.166666666666666
42499_marine,71,39,68,3,110,95.77464788732394,4.225352112676056
42500_marine,71,39,68,3,110,95.77464788732394,4.225352112676056
42501_marine,72,39,69,4,111,95.83333333333334,5.555555555555555
42502_marine,72,38,69,4,110,95.83333333333334,5.555555555555555
42503_marine,74,37,71,4,111,95.94594594594594,5.405405405405405
42504_marine,75,37,72,5,112,96,6.666666666666667
42505_marine,76,37,73,5,113,96.05263157894737,6.578947368421052
42506_marine,76,37,73,5,113,96.05263157894737,6.578947368421052
42507_marine,77,36,73,6,113,94.8051948051948,7.792207792207792
42508_marine,79,37,75,6,116,94.9367088607595,7.59493670886076
42509_marine,79,37,75,6,116,94.9367088607595,7.59493670886076
42510_marine,78,37,74,6,115,94.87179487179486,7.6923076923076925
42511_marine,78,37,74,6,115,94.87179487179486,7.6923076923076925
42512_marine,78,37,74,6,115,94.87179487179486,7.6923076923076925
42513_marine,78,38,74,6,116,94.87179487179486,7.6923076923076925
42514_marine,80,38,76,8,118,95,10
42515_marine,293,99,203,166,392,69.28327645051195,56.655290102389074
42516_marine,294,103,204,166,397,69.38775510204081,56.4625850340136
42517_marine,294,103,204,166,397,69.38775510204081,56.4625850340136
42518_marine,82,42,78,8,124,95.1219512195122,9.75609756097561
42519_marine,82,39,78,8,121,95.1219512195122,9.75609756097561
42520_marine,80,39,76,8,119,95,10
42521_marine,80,38,76,8,118,95,10
42522_marine,80,38,76,8,118,95,10
42523_marine,78,38,74,8,116,94.87179487179486,10.256410256410255
42524_marine,78,38,74,8,116,94.87179487179486,10.256410256410255
42525_marine,78,38,74,8,116,94.87179487179486,10.256410256410255
42526_marine,78,38,74,8,116,94.87179487179486,10.256410256410255
42527_marine,76,37,72,8,113,94.73684210526315,10.526315789473683
42528_marine,74,38,70,8,112,94.5945945945946,10.81081081081081
42529_marine,74,38,70,8,112,94.5945945945946,10.81081081081081
42530_marine,74,36,70,8,110,94.5945945945946,10.81081081081081
42531_marine,73,36,69,8,109,94.52054794520548,10.95890410958904
42532_marine,73,36,69,8,109,94.52054794520548,10.95890410958904
42533_marine,72,36,68,7,108,94.44444444444444,9.722222222222223
42534_marine,73,36,69,7,109,94.52054794520548,9.58904109589041
42535_marine,75,35,71,7,110,94.66666666666667,9.333333333333334
42536_marine,74,35,70,7,109,94.5945945945946,9.45945945945946
42537_marine,74,35,70,7,109,94.5945945945946,9.45945945945946
42538_marine,74,33,70,7,107,94.5945945945946,9.45945945945946
42539_marine,73,33,69,7,106,94.52054794520548,9.58904109589041
42540_marine,73,33,69,7,106,94.52054794520548,9.58904109589041
42541_marine,71,34,67,7,105,94.36619718309859,9.859154929577464
42542_marine,73,34,69,7,107,94.52054794520548,9.58904109589041
42543_marine,73,34,69,7,107,94.52054794520548,9.58904109589041
42544_marine,73,34,69,7,107,94.52054794520548,9.58904109589041
42545_marine,73,35,69,7,108,94.52054794520548,9.58904109589041
42546_marine,73,35,69,6,108,94.52054794520548,8.21917808219178
42547_marine,73,36,69,6,109,94.52054794520548,8.21917808219178
42548_marine,73,36,69,6,109,94.52054794520548,8.21917808219178
42549_marine,74,36,70,6,110,94.5945945945946,8.108108108108109
42550_marine,110,58,86,40,168,78.18181818181819,36.36363636363637
42551_marine,112,64,88,40,176,78.57142857142857,35.714285714285715
42552_marine,110,60,86,40,170,78.18181818181819,36.36363636363637
42553_marine,73,39,69,6,112,94.52054794520548,8.21917808219178
42554_marine,69,39,65,5,108,94.20289855072464,7.246376811594203
42555_marine,63,38,59,5,101,93.65079365079364,7.936507936507936
42556_marine,63,37,59,5,100,93.65079365079364,7.936507936507936
42557_marine,65,39,61,5,104,93.84615384615384,7.6923076923076925
42558_marine,65,39,61,5,104,93.84615384615384,7.6923076923076925
42559_marine,64,39,60,4,103,93.75,6.25
42560_marine,63,36,60,3,99,95.23809523809523,4.761904761904762
42561_marine,61,36,58,3,97,95.08196721311475,4.918032786885246
42562_marine,58,36,55,2,94,94.82758620689656,3.4482758620689653
42563_marine,57,36,54,2,93,94.73684210526315,3.508771929824561
42564_marine,57,36,54,2,93,94.73684210526315,3.508771929824561
42565_marine,55,36,52,2,91,94.54545454545455,3.6363636363636362
42566_marine,55,37,52,2,92,94.54545454545455,3.6363636363636362
42567_marine,55,37,52,2,92,94.54545454545455,3.6363636363636362
42568_marine,56,35,53,2,91,94.64285714285714,3.571428571428571
42569_marine,59,36,56,3,95,94.91525423728814,5.084745762711865
42570_marine,59,36,56,3,95,94.91525423728814,5.084745762711865
42571_marine,61,36,58,3,97,95.08196721311475,4.918032786885246
42572_marine,60,36,57,3,96,95,5
42573_marine,58,38,55,3,96,94.82758620689656,5.172413793103448
42574_marine,58,38,55,3,96,94.82758620689656,5.172413793103448
42575_marine,60,39,57,3,99,95,5
42576_marine,60,41,57,3,101,95,5
42577_marine,60,41,57,3,101,95,5
42578_marine,60,41,57,3,101,95,5
42579_marine,60,41,57,3,101,95,5
42580_marine,62,41,58,3,103,93.54838709677419,4.838709677419355
42581_marine,60,42,55,3,102,91.66666666666666,5
42582_marine,58,42,53,3,100,91.37931034482759,5.172413793103448
42583_marine,59,42,54,3,101,91.52542372881356,5.084745762711865
42584_marine,62,42,56,3,104,90.32258064516128,4.838709677419355
42585_marine,63,40,57,3,103,90.47619047619048,4.761904761904762
42586_marine,60,49,54,3,109,90,5
42587_marine,65,50,59,4,115,90.76923076923077,6.153846153846154
42588_marine,103,84,88,15,187,85.43689320388349,14.563106796116504
42589_marine,191,212,125,88,403,65.44502617801047,46.07329842931937
42613_marine,256,217,232,44,473,90.625,17.1875
42614_marine,120,100,115,5,220,95.83333333333334,4.166666666666666
42615_marine,110,50,103,5,160,93.63636363636364,4.545454545454546
42616_marine,107,48,100,4,155,93.45794392523365,3.7383177570093453
42617_marine,96,48,89,2,144,92.70833333333334,2.083333333333333
42618_marine,96,45,90,2,141,93.75,2.083333333333333
42619_marine,91,44,85,3,135,93.4065934065934,3.296703296703297
42620_marine,91,44,85,3,135,93.4065934065934,3.296703296703297
42621_marine,89,44,83,3,133,93.25842696629213,3.3707865168539324
42622_marine,90,39,84,4,129,93.33333333333333,4.444444444444445
42623_marine,88,41,84,2,129,95.45454545454545,2.272727272727273
42624_marine,88,37,84,2,125,95.45454545454545,2.272727272727273
42625_marine,88,35,84,2,123,95.45454545454545,2.272727272727273
42626_marine,87,35,83,1,122,95.40229885057471,1.1494252873563218
42627_marine,86,35,82,1,121,95.34883720930233,1.1627906976744187
42628_marine,85,33,81,1,118,95.29411764705881,1.1764705882352942
42629_marine,85,34,81,1,119,95.29411764705881,1.1764705882352942
42630_marine,85,30,81,1,115,95.29411764705881,1.1764705882352942
42631_marine,83,28,79,1,111,95.18072289156626,1.2048192771084338
42632_marine,82,28,78,1,110,95.1219512195122,1.2195121951219512
42633_marine,77,28,73,1,105,94.8051948051948,1.2987012987012987
42634_marine,77,28,73,1,105,94.8051948051948,1.2987012987012987
42635_marine,77,28,73,1,105,94.8051948051948,1.2987012987012987
42636_marine,77,27,73,1,104,94.8051948051948,1.2987012987012987
42637_marine,79,27,75,1,106,94.9367088607595,1.2658227848101267
42638_marine,79,27,75,1,106,94.9367088607595,1.2658227848101267
42639_marine,78,27,74,0,105,94.87179487179486,0
42640_marine,78,28,74,0,106,94.87179487179486,0
42641_marine,77,28,73,0,105,94.8051948051948,0
42642_marine,75,29,71,0,104,94.66666666666667,0
42643_marine,75,30,71,0,105,94.66666666666667,0
42644_marine,75,30,71,0,105,94.66666666666667,0
42645_marine,72,30,68,0,102,94.44444444444444,0
42646_marine,72,30,68,0,102,94.44444444444444,0
42647_marine,72,30,68,0,102,94.44444444444444,0
42648_marine,74,29,70,0,103,94.5945945945946,0
42649_marine,74,29,70,0,103,94.5945945945946,0
42650_marine,74,29,70,0,103,94.5945945945946,0
42651_marine,76,29,72,0,105,94.73684210526315,0
42652_marine,75,29,71,0,104,94.66666666666667,0
42653_marine,75,29,71,0,104,94.66666666666667,0
42654_marine,75,31,71,0,106,94.66666666666667,0
42655_marine,77,30,73,0,107,94.8051948051948,0
42656_marine,77,30,73,0,107,94.8051948051948,0
42657_marine,76,30,72,0,106,94.73684210526315,0
42658_marine,75,32,71,0,107,94.66666666666667,0
42659_marine,75,32,71,0,107,94.66666666666667,0
42660_marine,75,30,71,0,105,94.66666666666667,0
42661_marine,75,32,71,0,107,94.66666666666667,0
42662_marine,75,31,71,0,106,94.66666666666667,0
42663_marine,75,32,71,0,107,94.66666666666667,0
42664_marine,75,32,71,0,107,94.66666666666667,0
42665_marine,75,36,71,0,111,94.66666666666667,0
42666_marine,77,38,73,0,115,94.8051948051948,0
42667_marine,79,43,74,0,122,93.67088607594937,0
42668_marine,81,43,75,0,124,92.5925925925926,0
42669_marine,85,45,78,1,130,91.76470588235294,1.1764705882352942
42670_marine,89,47,82,1,136,92.13483146067416,1.1235955056179776
42671_marine,89,47,82,1,136,92.13483146067416,1.1235955056179776
42672_marine,89,47,82,1,136,92.13483146067416,1.1235955056179776
42673_marine,96,50,89,2,146,92.70833333333334,2.083333333333333
42674_marine,104,74,97,2,178,93.26923076923077,1.9230769230769231
42675_marine,160,171,151,7,331,94.375,4.375
42694_marine,629,247,451,293,876,71.70111287758345,46.5818759936407
42695_marine,120,65,111,9,185,92.5,7.5
42696_marine,117,52,108,7,169,92.3076923076923,5.982905982905983
42697_marine,114,49,106,5,163,92.98245614035088,4.385964912280701
42698_marine,110,46,102,5,156,92.72727272727272,4.545454545454546
42699_marine,100,44,92,3,144,92,3
42700_marine,100,45,93,5,145,93,5
42701_marine,100,45,94,6,145,94,6
42702_marine,97,43,91,7,140,93.81443298969072,7.216494845360824
42703_marine,99,41,93,7,140,93.93939393939394,7.07070707070707
42704_marine,98,42,92,7,140,93.87755102040816,7.142857142857142
42705_marine,97,44,91,6,141,93.81443298969072,6.185567010309279
42706_marine,100,45,95,4,145,95,4
42707_marine,101,41,96,4,142,95.04950495049505,3.9603960396039604
42708_marine,99,41,94,4,140,94.94949494949495,4.040404040404041
42709_marine,94,41,89,4,135,94.68085106382979,4.25531914893617
42710_marine,89,39,84,3,128,94.3820224719101,3.3707865168539324
42711_marine,90,37,85,3,127,94.44444444444444,3.3333333333333335
42712_marine,85,37,81,2,122,95.29411764705881,2.3529411764705883
42713_marine,79,37,75,2,116,94.9367088607595,2.5316455696202533
42714_marine,78,38,74,2,116,94.87179487179486,2.564102564102564
42715_marine,78,38,74,2,116,94.87179487179486,2.564102564102564
42716_marine,78,38,74,2,116,94.87179487179486,2.564102564102564
42717_marine,78,37,74,2,115,94.87179487179486,2.564102564102564
42718_marine,78,39,74,2,117,94.87179487179486,2.564102564102564
42719_marine,76,39,72,2,115,94.73684210526315,2.631578947368421
42720_marine,76,39,72,2,115,94.73684210526315,2.631578947368421
42721_marine,75,39,71,2,114,94.66666666666667,2.666666666666667
42722_marine,75,37,71,2,112,94.66666666666667,2.666666666666667
42723_marine,75,37,71,2,112,94.66666666666667,2.666666666666667
42724_marine,76,36,72,2,112,94.73684210526315,2.631578947368421
42725_marine,75,36,71,2,111,94.66666666666667,2.666666666666667
42726_marine,75,36,71,2,111,94.66666666666667,2.666666666666667
42727_marine,75,36,71,2,111,94.66666666666667,2.666666666666667
42728_marine,75,36,71,2,111,94.66666666666667,2.666666666666667
42729_marine,74,34,70,2,108,94.5945945945946,2.7027027027027026
42730_marine,74,36,70,2,110,94.5945945945946,2.7027027027027026
42731_marine,74,36,70,2,110,94.5945945945946,2.7027027027027026
42732_marine,74,36,70,2,110,94.5945945945946,2.7027027027027026
42733_marine,74,36,70,2,110,94.5945945945946,2.7027027027027026
42734_marine,75,36,71,2,111,94.66666666666667,2.666666666666667
42735_marine,73,37,69,2,110,94.52054794520548,2.73972602739726
42736_marine,74,37,70,2,111,94.5945945945946,2.7027027027027026
42737_marine,74,37,70,2,111,94.5945945945946,2.7027027027027026
42738_marine,70,37,66,2,107,94.28571428571428,2.857142857142857
42739_marine,70,35,66,2,105,94.28571428571428,2.857142857142857
42740_marine,71,34,67,2,105,94.36619718309859,2.8169014084507045
42741_marine,71,34,67,2,105,94.36619718309859,2.8169014084507045
42742_marine,71,34,67,2,105,94.36619718309859,2.8169014084507045
42743_marine,70,34,66,2,104,94.28571428571428,2.857142857142857
42744_marine,70,34,66,2,104,94.28571428571428,2.857142857142857
42745_marine,70,34,66,2,104,94.28571428571428,2.857142857142857
42746_marine,70,34,66,2,104,94.28571428571428,2.857142857142857
42747_marine,70,36,66,2,106,94.28571428571428,2.857142857142857
42748_marine,71,35,67,2,106,94.36619718309859,2.8169014084507045
42749_marine,73,35,69,2,108,94.52054794520548,2.73972602739726
42750_marine,73,35,69,2,108,94.52054794520548,2.73972602739726
42751_marine,74,35,70,2,109,94.5945945945946,2.7027027027027026
42752_marine,74,36,70,2,110,94.5945945945946,2.7027027027027026
42753_marine,74,36,70,2,110,94.5945945945946,2.7027027027027026
42754_marine,74,37,70,2,111,94.5945945945946,2.7027027027027026
42755_marine,74,37,70,2,111,94.5945945945946,2.7027027027027026
42756_marine,74,39,70,2,113,94.5945945945946,2.7027027027027026
42757_marine,72,38,68,2,110,94.44444444444444,2.7777777777777777
42758_marine,71,39,67,2,110,94.36619718309859,2.8169014084507045
42759_marine,73,38,69,2,111,94.52054794520548,2.73972602739726
42760_marine,75,38,71,2,113,94.66666666666667,2.666666666666667
42761_marine,77,36,73,2,113,94.8051948051948,2.5974025974025974
42762_marine,77,36,73,2,113,94.8051948051948,2.5974025974025974
42763_marine,77,35,73,2,112,94.8051948051948,2.5974025974025974
42764_marine,77,35,73,2,112,94.8051948051948,2.5974025974025974
42765_marine,79,35,75,2,114,94.9367088607595,2.5316455696202533
42766_marine,79,35,75,2,114,94.9367088607595,2.5316455696202533
42767_marine,81,35,77,2,116,95.06172839506173,2.4691358024691357
42768_marine,83,34,79,2,117,95.18072289156626,2.4096385542168677
42769_marine,85,37,80,2,122,94.11764705882352,2.3529411764705883
42770_marine,85,39,80,2,124,94.11764705882352,2.3529411764705883
42771_marine,104,40,98,4,144,94.23076923076923,3.8461538461538463
42772_marine,113,50,104,6,163,92.03539823008849,5.3097345132743365
42773_marine,369,221,268,150,590,72.62872628726286,40.65040650406504
42774_marine,451,281,304,209,732,67.40576496674058,46.34146341463415
42775_marine,572,364,336,323,936,58.74125874125874,56.46853146853147
42815_marine,610,313,395,307,923,64.75409836065575,50.32786885245901
42816_marine,151,75,135,19,226,89.40397350993378,12.582781456953644
42817_marine,122,60,114,10,182,93.44262295081968,8.19672131147541
42818_marine,116,56,110,14,172,94.82758620689656,12.068965517241379
42819_marine,374,70,243,223,444,64.97326203208557,59.62566844919787
42820_marine,369,73,238,223,442,64.49864498644986,60.43360433604336
42821_marine,100,56,96,9,156,96,9
42822_marine,96,52,92,7,148,95.83333333333334,7.291666666666667
42823_marine,94,52,90,5,146,95.74468085106383,5.319148936170213
42824_marine,94,53,90,6,147,95.74468085106383,6.382978723404255
42825_marine,96,51,92,6,147,95.83333333333334,6.25
42826_marine,96,51,91,6,147,94.79166666666666,6.25
42827_marine,100,58,95,6,158,95,6
42828_marine,234,132,171,107,366,73.07692307692307,45.72649572649573
42829_marine,252,126,187,121,378,74.20634920634922,48.01587301587302
42830_marine,99,58,94,6,157,94.94949494949495,6.0606060606060606
42831_marine,95,52,90,6,147,94.73684210526315,6.315789473684211
42832_marine,97,53,92,6,150,94.84536082474226,6.185567010309279
42833_marine,96,56,91,5,152,94.79166666666666,5.208333333333334
42834_marine,97,56,92,5,153,94.84536082474226,5.154639175257731
42835_marine,97,52,92,5,149,94.84536082474226,5.154639175257731
42836_marine,93,55,88,5,148,94.6236559139785,5.376344086021505
42837_marine,90,51,85,5,141,94.44444444444444,5.555555555555555
42838_marine,92,51,87,5,143,94.56521739130434,5.434782608695652
42839_marine,92,50,87,5,142,94.56521739130434,5.434782608695652
42840_marine,91,53,87,5,144,95.6043956043956,5.4945054945054945
42841_marine,138,107,118,39,245,85.5072463768116,28.26086956521739
42842_marine,148,112,119,51,260,80.4054054054054,34.45945945945946
42843_marine,182,122,146,73,304,80.21978021978022,40.10989010989011
42844_marine,148,101,119,51,249,80.4054054054054,34.45945945945946
42845_marine,83,46,80,3,129,96.3855421686747,3.614457831325301
42846_marine,81,44,78,3,125,96.29629629629629,3.7037037037037033
42847_marine,81,44,78,3,125,96.29629629629629,3.7037037037037033
42848_marine,79,44,76,3,123,96.20253164556962,3.79746835443038
42849_marine,80,43,77,3,123,96.25,3.75
42850_marine,78,43,75,3,121,96.15384615384616,3.8461538461538463
42851_marine,78,43,75,3,121,96.15384615384616,3.8461538461538463
42852_marine,78,43,75,3,121,96.15384615384616,3.8461538461538463
42853_marine,78,43,75,3,121,96.15384615384616,3.8461538461538463
42854_marine,77,41,74,3,118,96.1038961038961,3.896103896103896
42855_marine,77,40,74,3,117,96.1038961038961,3.896103896103896
42856_marine,77,40,74,3,117,96.1038961038961,3.896103896103896
42857_marine,78,40,75,3,118,96.15384615384616,3.8461538461538463
42858_marine,75,40,72,3,115,96,4
42859_marine,74,39,71,3,113,95.94594594594594,4.054054054054054
42860_marine,74,39,71,3,113,95.94594594594594,4.054054054054054
42861_marine,74,39,71,3,113,95.94594594594594,4.054054054054054
42862_marine,74,37,71,3,111,95.94594594594594,4.054054054054054
42863_marine,75,37,72,3,112,96,4
42864_marine,75,37,72,3,112,96,4
42865_marine,75,39,72,3,114,96,4
42866_marine,74,38,71,3,112,95.94594594594594,4.054054054054054
42867_marine,73,38,70,3,111,95.8904109589041,4.10958904109589
42868_marine,74,37,71,3,111,95.94594594594594,4.054054054054054
42869_marine,74,37,71,3,111,95.94594594594594,4.054054054054054
42870_marine,77,38,73,5,115,94.8051948051948,6.493506493506493
42871_marine,78,37,74,6,115,94.87179487179486,7.6923076923076925
42872_marine,78,37,74,6,115,94.87179487179486,7.6923076923076925
42873_marine,80,37,76,6,117,95,7.5
42874_marine,80,37,76,6,117,95,7.5
42875_marine,81,38,77,6,119,95.06172839506173,7.4074074074074066
42876_marine,81,38,77,6,119,95.06172839506173,7.4074074074074066
42877_marine,81,39,77,6,120,95.06172839506173,7.4074074074074066
42878_marine,80,38,76,8,118,95,10
42879_marine,80,38,76,8,118,95,10
42880_marine,80,38,76,8,118,95,10
42881_marine,79,38,75,8,117,94.9367088607595,10.126582278481013
42882_marine,80,38,76,8,118,95,10
42883_marine,77,38,73,8,115,94.8051948051948,10.38961038961039
42884_marine,77,38,73,8,115,94.8051948051948,10.38961038961039
42885_marine,74,37,70,8,111,94.5945945945946,10.81081081081081
42886_marine,75,38,71,8,113,94.66666666666667,10.666666666666668
42887_marine,74,38,70,7,112,94.5945945945946,9.45945945945946
42888_marine,73,36,69,7,109,94.52054794520548,9.58904109589041
42889_marine,72,37,68,7,109,94.44444444444444,9.722222222222223
42890_marine,72,37,68,7,109,94.44444444444444,9.722222222222223
42891_marine,72,37,68,7,109,94.44444444444444,9.722222222222223
42892_marine,72,37,68,7,109,94.44444444444444,9.722222222222223
42893_marine,73,37,69,7,110,94.52054794520548,9.58904109589041
42894_marine,72,36,68,7,108,94.44444444444444,9.722222222222223
42895_marine,75,36,71,7,111,94.66666666666667,9.333333333333334
42896_marine,74,34,70,6,108,94.5945945945946,8.108108108108109
42897_marine,73,34,69,6,107,94.52054794520548,8.21917808219178
42898_marine,70,34,66,6,104,94.28571428571428,8.571428571428571
42899_marine,70,34,66,6,104,94.28571428571428,8.571428571428571
42900_marine,72,32,68,6,104,94.44444444444444,8.333333333333332
42901_marine,72,32,68,6,104,94.44444444444444,8.333333333333332
42902_marine,72,33,68,6,105,94.44444444444444,8.333333333333332
42903_marine,73,33,69,6,106,94.52054794520548,8.21917808219178
42904_marine,73,33,69,6,106,94.52054794520548,8.21917808219178
42905_marine,73,33,69,6,106,94.52054794520548,8.21917808219178
42906_marine,73,31,69,6,104,94.52054794520548,8.21917808219178
42907_marine,73,32,69,6,105,94.52054794520548,8.21917808219178
42908_marine,73,32,69,6,105,94.52054794520548,8.21917808219178
42909_marine,71,32,67,6,103,94.36619718309859,8.450704225352112
42910_marine,71,32,67,6,103,94.36619718309859,8.450704225352112
42911_marine,71,32,67,6,103,94.36619718309859,8.450704225352112
42912_marine,71,33,67,6,104,94.36619718309859,8.450704225352112
42913_marine,70,35,66,5,105,94.28571428571428,7.142857142857142
42914_marine,67,34,63,5,101,94.02985074626866,7.462686567164178
42915_marine,64,34,60,5,98,93.75,7.8125
42916_marine,64,35,60,5,99,93.75,7.8125
42917_marine,62,35,58,5,97,93.54838709677419,8.064516129032258
42918_marine,64,35,60,5,99,93.75,7.8125
42919_marine,62,37,59,3,99,95.16129032258065,4.838709677419355
42920_marine,59,37,56,3,96,94.91525423728814,5.084745762711865
42921_marine,57,37,54,2,94,94.73684210526315,3.508771929824561
42922_marine,57,37,54,2,94,94.73684210526315,3.508771929824561
42923_marine,57,37,54,2,94,94.73684210526315,3.508771929824561
42924_marine,55,35,52,2,90,94.54545454545455,3.6363636363636362
42925_marine,55,36,52,2,91,94.54545454545455,3.6363636363636362
42926_marine,55,36,52,2,91,94.54545454545455,3.6363636363636362
42927_marine,55,36,52,2,91,94.54545454545455,3.6363636363636362
42928_marine,58,36,55,2,94,94.82758620689656,3.4482758620689653
42929_marine,56,36,53,2,92,94.64285714285714,3.571428571428571
42930_marine,56,36,53,2,92,94.64285714285714,3.571428571428571
42931_marine,54,37,51,2,91,94.44444444444444,3.7037037037037033
42932_marine,56,37,53,2,93,94.64285714285714,3.571428571428571
42933_marine,57,37,54,2,94,94.73684210526315,3.508771929824561
42934_marine,57,39,54,2,96,94.73684210526315,3.508771929824561
42935_marine,57,40,54,2,97,94.73684210526315,3.508771929824561
42936_marine,58,41,55,2,99,94.82758620689656,3.4482758620689653
42937_marine,59,41,56,2,100,94.91525423728814,3.389830508474576
42938_marine,59,41,56,2,100,94.91525423728814,3.389830508474576
42939_marine,59,41,56,2,100,94.91525423728814,3.389830508474576
42940_marine,62,43,57,3,105,91.93548387096774,4.838709677419355
42941_marine,62,45,57,3,107,91.93548387096774,4.838709677419355
42942_marine,60,43,55,3,103,91.66666666666666,5
42943_marine,61,42,56,3,103,91.80327868852459,4.918032786885246
42944_marine,60,43,54,3,103,90,5
42945_marine,62,43,56,3,105,90.32258064516128,4.838709677419355
42946_marine,62,50,56,3,112,90.32258064516128,4.838709677419355
42947_marine,69,50,64,5,119,92.7536231884058,7.246376811594203
42948_marine,105,84,89,17,189,84.76190476190476,16.19047619047619
42949_marine,196,233,128,92,429,65.3061224489796,46.93877551020408
42972_marine,242,219,219,38,461,90.49586776859503,15.702479338842975
42973_marine,219,200,200,30,419,91.32420091324201,13.698630136986301
42974_marine,115,70,110,5,185,95.65217391304348,4.3478260869565215
42975_marine,105,52,100,4,157,95.23809523809523,3.8095238095238098
42976_marine,95,50,90,2,145,94.73684210526315,2.1052631578947367
42977_marine,94,50,88,2,144,93.61702127659575,2.127659574468085
42978_marine,92,49,86,2,141,93.47826086956522,2.1739130434782608
42979_marine,91,43,85,2,134,93.4065934065934,2.197802197802198
42980_marine,89,40,83,2,129,93.25842696629213,2.247191011235955
42981_marine,89,40,83,2,129,93.25842696629213,2.247191011235955
42982_marine,87,37,83,1,124,95.40229885057471,1.1494252873563218
42983_marine,85,37,81,1,122,95.29411764705881,1.1764705882352942
42984_marine,87,41,83,1,128,95.40229885057471,1.1494252873563218
42985_marine,85,33,81,1,118,95.29411764705881,1.1764705882352942
42986_marine,85,33,81,1,118,95.29411764705881,1.1764705882352942
42987_marine,85,32,81,1,117,95.29411764705881,1.1764705882352942
42988_marine,83,30,79,1,113,95.18072289156626,1.2048192771084338
42989_marine,82,31,78,1,113,95.1219512195122,1.2195121951219512
42990_marine,80,31,76,1,111,95,1.25
42991_marine,78,29,74,1,107,94.87179487179486,1.282051282051282
42992_marine,76,29,72,1,105,94.73684210526315,1.3157894736842104
42993_marine,74,30,70,1,104,94.5945945945946,1.3513513513513513
42994_marine,73,29,69,1,102,94.52054794520548,1.36986301369863
42995_marine,73,29,69,1,102,94.52054794520548,1.36986301369863
42996_marine,73,29,69,1,102,94.52054794520548,1.36986301369863
42997_marine,75,29,71,1,104,94.66666666666667,1.3333333333333335
42998_marine,74,29,70,0,103,94.5945945945946,0
42999_marine,74,29,70,0,103,94.5945945945946,0
43000_marine,74,29,70,0,103,94.5945945945946,0
43001_marine,73,29,69,0,102,94.52054794520548,0
43002_marine,73,30,69,0,103,94.52054794520548,0
43003_marine,73,28,69,0,101,94.52054794520548,0
43004_marine,72,28,68,0,100,94.44444444444444,0
43005_marine,72,29,68,0,101,94.44444444444444,0
43006_marine,73,29,69,0,102,94.52054794520548,0
43007_marine,73,29,69,0,102,94.52054794520548,0
43008_marine,73,28,69,0,101,94.52054794520548,0
43009_marine,75,30,71,0,105,94.66666666666667,0
43010_marine,75,30,71,0,105,94.66666666666667,0
43011_marine,73,30,69,0,103,94.52054794520548,0
43012_marine,73,32,69,0,105,94.52054794520548,0
43013_marine,75,32,71,0,107,94.66666666666667,0
43014_marine,76,33,72,0,109,94.73684210526315,0
43015_marine,76,33,72,0,109,94.73684210526315,0
43016_marine,76,33,72,0,109,94.73684210526315,0
43017_marine,76,33,72,0,109,94.73684210526315,0
43018_marine,75,32,71,0,107,94.66666666666667,0
43019_marine,75,31,71,0,106,94.66666666666667,0
43020_marine,75,35,71,0,110,94.66666666666667,0
43021_marine,77,37,73,0,114,94.8051948051948,0
43022_marine,77,35,73,0,112,94.8051948051948,0
43023_marine,77,35,73,0,112,94.8051948051948,0
43024_marine,78,37,74,0,115,94.87179487179486,0
43025_marine,78,39,74,0,117,94.87179487179486,0
43026_marine,80,43,76,0,123,95,0
43027_marine,80,42,75,0,122,93.75,0
43028_marine,82,40,76,0,122,92.6829268292683,0
43029_marine,87,42,81,0,129,93.10344827586206,0
43030_marine,90,46,83,1,136,92.22222222222223,1.1111111111111112
43031_marine,92,46,85,1,138,92.3913043478261,1.0869565217391304
43032_marine,91,46,84,1,137,92.3076923076923,1.098901098901099
43033_marine,94,48,86,2,142,91.48936170212765,2.127659574468085
43034_marine,108,72,100,2,180,92.5925925925926,1.8518518518518516
43035_marine,149,168,141,4,317,94.63087248322147,2.684563758389262
43036_marine,154,167,144,8,321,93.5064935064935,5.194805194805195
43053_marine,643,305,471,279,948,73.25038880248833,43.390357698289264
43054_marine,586,212,419,265,798,71.50170648464163,45.22184300341297
43055_marine,116,63,107,7,179,92.24137931034483,6.0344827586206895
43056_marine,116,53,107,7,169,92.24137931034483,6.0344827586206895
43057_marine,109,51,101,5,160,92.66055045871559,4.587155963302752
43058_marine,103,51,95,3,154,92.23300970873787,2.912621359223301
43059_marine,95,49,87,3,144,91.57894736842105,3.1578947368421053
43060_marine,90,49,85,3,139,94.44444444444444,3.3333333333333335
43061_marine,90,48,85,3,138,94.44444444444444,3.3333333333333335
43062_marine,89,46,84,3,135,94.3820224719101,3.3707865168539324
43063_marine,88,46,84,2,134,95.45454545454545,2.272727272727273
43064_marine,87,46,83,1,133,95.40229885057471,1.1494252873563218
43065_marine,89,48,85,1,137,95.50561797752809,1.1235955056179776
43066_marine,89,50,85,1,139,95.50561797752809,1.1235955056179776
43067_marine,90,47,86,1,137,95.55555555555556,1.1111111111111112
43068_marine,88,41,84,1,129,95.45454545454545,1.1363636363636365
43069_marine,84,41,80,2,125,95.23809523809523,2.380952380952381
43070_marine,85,38,81,2,123,95.29411764705881,2.3529411764705883
43071_marine,81,38,77,2,119,95.06172839506173,2.4691358024691357
43072_marine,78,39,74,2,117,94.87179487179486,2.564102564102564
43073_marine,78,39,74,2,117,94.87179487179486,2.564102564102564
43074_marine,78,39,74,2,117,94.87179487179486,2.564102564102564
43075_marine,78,41,74,2,119,94.87179487179486,2.564102564102564
43076_marine,78,41,74,2,119,94.87179487179486,2.564102564102564
43077_marine,78,41,74,2,119,94.87179487179486,2.564102564102564
43078_marine,78,43,74,2,121,94.87179487179486,2.564102564102564
43079_marine,78,41,74,2,119,94.87179487179486,2.564102564102564
43080_marine,78,43,74,2,121,94.87179487179486,2.564102564102564
43081_marine,77,41,73,2,118,94.8051948051948,2.5974025974025974
43082_marine,77,40,73,2,117,94.8051948051948,2.5974025974025974
43083_marine,77,40,73,2,117,94.8051948051948,2.5974025974025974
43084_marine,75,40,71,2,115,94.66666666666667,2.666666666666667
43085_marine,75,40,71,2,115,94.66666666666667,2.666666666666667
43086_marine,75,38,71,2,113,94.66666666666667,2.666666666666667
43087_marine,75,37,71,2,112,94.66666666666667,2.666666666666667
43088_marine,75,35,71,2,110,94.66666666666667,2.666666666666667
43089_marine,74,36,70,2,110,94.5945945945946,2.7027027027027026
43090_marine,72,36,68,2,108,94.44444444444444,2.7777777777777777
43091_marine,72,36,68,2,108,94.44444444444444,2.7777777777777777
43092_marine,71,38,67,2,109,94.36619718309859,2.8169014084507045
43093_marine,71,38,67,2,109,94.36619718309859,2.8169014084507045
43094_marine,69,38,65,2,107,94.20289855072464,2.898550724637681
43095_marine,70,38,66,2,108,94.28571428571428,2.857142857142857
43096_marine,71,38,67,2,109,94.36619718309859,2.8169014084507045
43097_marine,69,38,65,2,107,94.20289855072464,2.898550724637681
43098_marine,69,36,65,2,105,94.20289855072464,2.898550724637681
43099_marine,68,34,64,2,102,94.11764705882352,2.941176470588235
43100_marine,68,34,64,2,102,94.11764705882352,2.941176470588235
43101_marine,68,34,64,2,102,94.11764705882352,2.941176470588235
43102_marine,69,34,65,2,103,94.20289855072464,2.898550724637681
43103_marine,69,34,65,2,103,94.20289855072464,2.898550724637681
43104_marine,69,31,65,2,100,94.20289855072464,2.898550724637681
43105_marine,67,31,63,2,98,94.02985074626866,2.9850746268656714
43106_marine,67,33,63,2,100,94.02985074626866,2.9850746268656714
43107_marine,66,34,62,2,100,93.93939393939394,3.0303030303030303
43108_marine,66,34,62,2,100,93.93939393939394,3.0303030303030303
43109_marine,68,34,64,2,102,94.11764705882352,2.941176470588235
43110_marine,68,34,64,2,102,94.11764705882352,2.941176470588235
43111_marine,70,36,66,2,106,94.28571428571428,2.857142857142857
43112_marine,72,37,68,2,109,94.44444444444444,2.7777777777777777
43113_marine,72,37,68,2,109,94.44444444444444,2.7777777777777777
43114_marine,72,37,68,2,109,94.44444444444444,2.7777777777777777
43115_marine,70,41,66,2,111,94.28571428571428,2.857142857142857
43116_marine,70,41,66,2,111,94.28571428571428,2.857142857142857
43117_marine,70,39,66,2,109,94.28571428571428,2.857142857142857
43118_marine,70,39,66,2,109,94.28571428571428,2.857142857142857
43119_marine,69,38,65,2,107,94.20289855072464,2.898550724637681
43120_marine,69,38,65,2,107,94.20289855072464,2.898550724637681
43121_marine,69,38,65,2,107,94.20289855072464,2.898550724637681
43122_marine,69,35,65,2,104,94.20289855072464,2.898550724637681
43123_marine,71,37,67,2,108,94.36619718309859,2.8169014084507045
43124_marine,73,34,69,2,107,94.52054794520548,2.73972602739726
43125_marine,77,35,73,2,112,94.8051948051948,2.5974025974025974
43126_marine,79,35,75,2,114,94.9367088607595,2.5316455696202533
43127_marine,81,35,77,2,116,95.06172839506173,2.4691358024691357
43128_marine,84,34,79,2,118,94.04761904761905,2.380952380952381
43129_marine,89,39,84,2,128,94.3820224719101,2.247191011235955
43130_marine,88,41,83,2,129,94.31818181818183,2.272727272727273
43131_marine,100,43,95,2,143,95,2
43132_marine,106,45,99,4,151,93.39622641509435,3.7735849056603774
43133_marine,356,201,256,147,557,71.91011235955057,41.29213483146067
43134_marine,391,234,286,156,625,73.1457800511509,39.89769820971867
43135_marine,570,378,343,312,948,60.175438596491226,54.736842105263165
43175_marine,577,281,366,295,858,63.43154246100519,51.12651646447141
43176_marine,134,66,124,12,200,92.53731343283582,8.955223880597014
43177_marine,120,60,112,9,180,93.33333333333333,7.5
43178_marine,111,61,105,9,172,94.5945945945946,8.108108108108109
43179_marine,392,81,261,231,473,66.58163265306123,58.92857142857143
43180_marine,401,85,266,237,486,66.33416458852868,59.10224438902743
43181_marine,101,62,97,9,163,96.03960396039604,8.91089108910891
43182_marine,95,60,91,5,155,95.78947368421052,5.263157894736842
43183_marine,95,58,91,5,153,95.78947368421052,5.263157894736842
43184_marine,93,55,89,5,148,95.6989247311828,5.376344086021505
43185_marine,94,55,90,5,149,95.74468085106383,5.319148936170213
43186_marine,97,54,93,6,151,95.87628865979381,6.185567010309279
43187_marine,98,65,94,6,163,95.91836734693877,6.122448979591836
43188_marine,234,136,172,108,370,73.50427350427351,46.15384615384615
43189_marine,256,137,190,124,393,74.21875,48.4375
43190_marine,102,63,97,6,165,95.09803921568627,5.88235294117647
43191_marine,98,59,93,6,157,94.89795918367348,6.122448979591836
43192_marine,98,56,93,6,154,94.89795918367348,6.122448979591836
43193_marine,98,57,93,6,155,94.89795918367348,6.122448979591836
43194_marine,97,59,92,5,156,94.84536082474226,5.154639175257731
43195_marine,96,54,91,5,150,94.79166666666666,5.208333333333334
43196_marine,96,52,91,5,148,94.79166666666666,5.208333333333334
43197_marine,92,51,87,5,143,94.56521739130434,5.434782608695652
43198_marine,93,51,88,5,144,94.6236559139785,5.376344086021505
43199_marine,91,53,87,5,144,95.6043956043956,5.4945054945054945
43200_marine,91,55,87,5,146,95.6043956043956,5.4945054945054945
43201_marine,140,104,120,39,244,85.71428571428571,27.857142857142858
43202_marine,172,117,135,64,289,78.48837209302324,37.2093023255814
43203_marine,152,102,122,51,254,80.26315789473685,33.55263157894737
43204_marine,87,46,84,3,133,96.55172413793103,3.4482758620689653
43205_marine,84,46,81,3,130,96.42857142857143,3.571428571428571
43206_marine,82,41,79,3,123,96.34146341463415,3.6585365853658534
43207_marine,82,40,79,3,122,96.34146341463415,3.6585365853658534
43208_marine,82,40,79,3,122,96.34146341463415,3.6585365853658534
43209_marine,82,40,79,3,122,96.34146341463415,3.6585365853658534
43210_marine,81,41,78,3,122,96.29629629629629,3.7037037037037033
43211_marine,81,40,78,3,121,96.29629629629629,3.7037037037037033
43212_marine,80,38,77,3,118,96.25,3.75
43213_marine,80,37,77,3,117,96.25,3.75
43214_marine,80,39,77,3,119,96.25,3.75
43215_marine,80,39,77,3,119,96.25,3.75
43216_marine,80,40,77,3,120,96.25,3.75
43217_marine,78,39,75,3,117,96.15384615384616,3.8461538461538463
43218_marine,75,39,72,3,114,96,4
43219_marine,74,39,71,3,113,95.94594594594594,4.054054054054054
43220_marine,74,38,71,3,112,95.94594594594594,4.054054054054054
43221_marine,75,38,72,3,113,96,4
43222_marine,75,38,72,3,113,96,4
43223_marine,75,38,72,3,113,96,4
43224_marine,77,38,74,3,115,96.1038961038961,3.896103896103896
43225_marine,75,38,72,3,113,96,4
43226_marine,74,38,71,3,112,95.94594594594594,4.054054054054054
43227_marine,74,39,71,3,113,95.94594594594594,4.054054054054054
43228_marine,74,37,71,3,111,95.94594594594594,4.054054054054054
43229_marine,74,37,71,3,111,95.94594594594594,4.054054054054054
43230_marine,73,37,70,3,110,95.8904109589041,4.10958904109589
43231_marine,71,37,68,3,108,95.77464788732394,4.225352112676056
43232_marine,71,38,68,3,109,95.77464788732394,4.225352112676056
43233_marine,73,38,69,4,111,94.52054794520548,5.47945205479452
43234_marine,74,38,70,4,112,94.5945945945946,5.405405405405405
43235_marine,75,38,71,5,113,94.66666666666667,6.666666666666667
43236_marine,73,38,69,5,111,94.52054794520548,6.8493150684931505
43237_marine,72,38,68,5,110,94.44444444444444,6.944444444444445
43238_marine,71,38,67,5,109,94.36619718309859,7.042253521126761
43239_marine,71,38,67,5,109,94.36619718309859,7.042253521126761
43240_marine,73,38,69,7,111,94.52054794520548,9.58904109589041
43241_marine,69,38,65,7,107,94.20289855072464,10.144927536231885
43242_marine,69,37,65,7,106,94.20289855072464,10.144927536231885
43243_marine,69,35,65,7,104,94.20289855072464,10.144927536231885
43244_marine,69,35,65,7,104,94.20289855072464,10.144927536231885
43245_marine,69,35,65,7,104,94.20289855072464,10.144927536231885
43246_marine,71,35,67,7,106,94.36619718309859,9.859154929577464
43247_marine,71,35,67,7,106,94.36619718309859,9.859154929577464
43248_marine,69,35,65,6,104,94.20289855072464,8.695652173913043
43249_marine,68,35,64,6,103,94.11764705882352,8.823529411764707
43250_marine,68,35,64,6,103,94.11764705882352,8.823529411764707
43251_marine,66,34,62,6,100,93.93939393939394,9.090909090909092
43252_marine,65,34,61,6,99,93.84615384615384,9.230769230769232
43253_marine,64,34,60,6,98,93.75,9.375
43254_marine,64,34,60,6,98,93.75,9.375
43255_marine,66,33,62,6,99,93.93939393939394,9.090909090909092
43256_marine,67,33,63,6,100,94.02985074626866,8.955223880597014
43257_marine,67,33,63,6,100,94.02985074626866,8.955223880597014
43258_marine,67,33,63,6,100,94.02985074626866,8.955223880597014
43259_marine,67,33,63,6,100,94.02985074626866,8.955223880597014
43260_marine,67,33,63,6,100,94.02985074626866,8.955223880597014
43261_marine,68,33,64,6,101,94.11764705882352,8.823529411764707
43262_marine,68,33,64,6,101,94.11764705882352,8.823529411764707
43263_marine,68,33,64,6,101,94.11764705882352,8.823529411764707
43264_marine,70,33,66,6,103,94.28571428571428,8.571428571428571
43265_marine,71,33,67,6,104,94.36619718309859,8.450704225352112
43266_marine,71,34,67,6,105,94.36619718309859,8.450704225352112
43267_marine,71,34,67,6,105,94.36619718309859,8.450704225352112
43268_marine,71,34,67,6,105,94.36619718309859,8.450704225352112
43269_marine,71,33,67,6,104,94.36619718309859,8.450704225352112
43270_marine,71,33,67,6,104,94.36619718309859,8.450704225352112
43271_marine,71,34,67,6,105,94.36619718309859,8.450704225352112
43272_marine,70,34,66,6,104,94.28571428571428,8.571428571428571
43273_marine,65,36,61,5,101,93.84615384615384,7.6923076923076925
43274_marine,65,36,61,5,101,93.84615384615384,7.6923076923076925
43275_marine,65,38,61,5,103,93.84615384615384,7.6923076923076925
43276_marine,65,37,61,5,102,93.84615384615384,7.6923076923076925
43277_marine,64,37,60,5,101,93.75,7.8125
43278_marine,61,37,58,3,98,95.08196721311475,4.918032786885246
43279_marine,61,37,58,3,98,95.08196721311475,4.918032786885246
43280_marine,61,33,58,3,94,95.08196721311475,4.918032786885246
43281_marine,60,33,57,2,93,95,3.3333333333333335
43282_marine,60,33,57,2,93,95,3.3333333333333335
43283_marine,60,33,57,2,93,95,3.3333333333333335
43284_marine,57,33,54,2,90,94.73684210526315,3.508771929824561
43285_marine,57,35,54,2,92,94.73684210526315,3.508771929824561
43286_marine,57,35,54,2,92,94.73684210526315,3.508771929824561
43287_marine,58,36,55,2,94,94.82758620689656,3.4482758620689653
43288_marine,56,38,53,2,94,94.64285714285714,3.571428571428571
43289_marine,56,38,53,2,94,94.64285714285714,3.571428571428571
43290_marine,56,38,53,2,94,94.64285714285714,3.571428571428571
43291_marine,56,38,53,2,94,94.64285714285714,3.571428571428571
43292_marine,56,37,53,2,93,94.64285714285714,3.571428571428571
43293_marine,57,37,54,2,94,94.73684210526315,3.508771929824561
43294_marine,59,41,56,2,100,94.91525423728814,3.389830508474576
43295_marine,59,42,56,2,101,94.91525423728814,3.389830508474576
43296_marine,61,43,58,2,104,95.08196721311475,3.278688524590164
43297_marine,59,43,56,2,102,94.91525423728814,3.389830508474576
43298_marine,61,43,58,2,104,95.08196721311475,3.278688524590164
43299_marine,61,42,58,2,103,95.08196721311475,3.278688524590164
43300_marine,62,42,57,3,104,91.93548387096774,4.838709677419355
43301_marine,62,45,57,3,107,91.93548387096774,4.838709677419355
43302_marine,59,44,54,3,103,91.52542372881356,5.084745762711865
43303_marine,60,43,55,3,103,91.66666666666666,5
43304_marine,60,43,54,3,103,90,5
43305_marine,62,44,56,3,106,90.32258064516128,4.838709677419355
43306_marine,64,49,58,3,113,90.625,4.6875
43307_marine,69,50,64,5,119,92.7536231884058,7.246376811594203
43308_marine,105,83,88,17,188,83.80952380952381,16.19047619047619
43309_marine,202,241,129,96,443,63.86138613861386,47.524752475247524
43331_marine,239,216,217,32,455,90.7949790794979,13.389121338912133
43332_marine,223,198,206,29,421,92.37668161434978,13.004484304932735
43333_marine,124,109,120,3,233,96.7741935483871,2.4193548387096775
43334_marine,102,53,99,2,155,97.05882352941177,1.9607843137254901
43335_marine,98,49,95,0,147,96.93877551020408,0
43336_marine,92,49,89,0,141,96.73913043478261,0
43337_marine,93,47,89,0,140,95.6989247311828,0
43338_marine,88,43,84,0,131,95.45454545454545,0
43339_marine,86,44,82,0,130,95.34883720930233,0
43340_marine,87,44,83,0,131,95.40229885057471,0
43341_marine,85,41,81,0,126,95.29411764705881,0
43342_marine,85,34,81,0,119,95.29411764705881,0
43343_marine,86,36,82,1,122,95.34883720930233,1.1627906976744187
43344_marine,88,41,84,1,129,95.45454545454545,1.1363636363636365
43345_marine,88,39,84,1,127,95.45454545454545,1.1363636363636365
43346_marine,88,39,84,1,127,95.45454545454545,1.1363636363636365
43347_marine,84,37,80,1,121,95.23809523809523,1.1904761904761905
43348_marine,84,33,80,1,117,95.23809523809523,1.1904761904761905
43349_marine,82,31,78,1,113,95.1219512195122,1.2195121951219512
43350_marine,80,32,76,1,112,95,1.25
43351_marine,74,32,70,1,106,94.5945945945946,1.3513513513513513
43352_marine,74,30,70,1,104,94.5945945945946,1.3513513513513513
43353_marine,74,30,70,1,104,94.5945945945946,1.3513513513513513
43354_marine,72,30,68,1,102,94.44444444444444,1.3888888888888888
43355_marine,72,29,68,1,101,94.44444444444444,1.3888888888888888
43356_marine,72,29,68,1,101,94.44444444444444,1.3888888888888888
43357_marine,73,29,69,0,102,94.52054794520548,0
43358_marine,73,29,69,0,102,94.52054794520548,0
43359_marine,75,29,71,0,104,94.66666666666667,0
43360_marine,75,29,71,0,104,94.66666666666667,0
43361_marine,74,30,70,0,104,94.5945945945946,0
43362_marine,74,30,70,0,104,94.5945945945946,0
43363_marine,73,31,69,0,104,94.52054794520548,0
43364_marine,72,31,68,0,103,94.44444444444444,0
43365_marine,74,31,70,0,105,94.5945945945946,0
43366_marine,74,31,70,0,105,94.5945945945946,0
43367_marine,74,31,70,0,105,94.5945945945946,0
43368_marine,74,31,70,0,105,94.5945945945946,0
43369_marine,74,30,70,0,104,94.5945945945946,0
43370_marine,74,30,70,0,104,94.5945945945946,0
43371_marine,74,31,70,0,105,94.5945945945946,0
43372_marine,76,33,72,0,109,94.73684210526315,0
43373_marine,76,33,72,0,109,94.73684210526315,0
43374_marine,76,35,72,0,111,94.73684210526315,0
43375_marine,79,35,75,0,114,94.9367088607595,0
43376_marine,79,35,75,0,114,94.9367088607595,0
43377_marine,79,35,75,0,114,94.9367088607595,0
43378_marine,79,35,75,0,114,94.9367088607595,0
43379_marine,78,36,74,0,114,94.87179487179486,0
43380_marine,78,35,74,0,113,94.87179487179486,0
43381_marine,78,35,74,0,113,94.87179487179486,0
43382_marine,78,35,74,0,113,94.87179487179486,0
43383_marine,81,33,77,0,114,95.06172839506173,0
43384_marine,81,33,77,0,114,95.06172839506173,0
43385_marine,79,36,75,0,115,94.9367088607595,0
43386_marine,79,39,75,0,118,94.9367088607595,0
43387_marine,82,42,78,0,124,95.1219512195122,0
43388_marine,85,42,80,0,127,94.11764705882352,0
43389_marine,89,45,83,0,134,93.25842696629213,0
43390_marine,90,47,83,1,137,92.22222222222223,1.1111111111111112
43391_marine,95,49,87,1,144,91.57894736842105,1.0526315789473684
43392_marine,96,49,88,1,145,91.66666666666666,1.0416666666666665
43393_marine,96,48,88,2,144,91.66666666666666,2.083333333333333
43394_marine,104,52,96,2,156,92.3076923076923,1.9230769230769231
43395_marine,108,112,100,2,220,92.5925925925926,1.8518518518518516
43396_marine,149,169,141,5,318,94.63087248322147,3.3557046979865772
43397_marine,161,174,144,14,335,89.44099378881988,8.695652173913043
43412_marine,582,295,432,229,877,74.22680412371135,39.34707903780069
43413_marine,351,145,236,180,496,67.23646723646723,51.28205128205128
43414_marine,117,61,109,8,178,93.16239316239316,6.837606837606838
43415_marine,113,59,105,6,172,92.92035398230088,5.3097345132743365
43416_marine,110,53,103,6,163,93.63636363636364,5.454545454545454
43417_marine,102,51,95,4,153,93.13725490196079,3.9215686274509802
43418_marine,94,51,87,2,145,92.5531914893617,2.127659574468085
43419_marine,90,54,85,2,144,94.44444444444444,2.2222222222222223
43420_marine,89,53,85,2,142,95.50561797752809,2.247191011235955
43421_marine,88,51,84,1,139,95.45454545454545,1.1363636363636365
43422_marine,88,51,84,1,139,95.45454545454545,1.1363636363636365
43423_marine,88,55,84,1,143,95.45454545454545,1.1363636363636365
43424_marine,88,54,84,1,142,95.45454545454545,1.1363636363636365
43425_marine,88,52,84,1,140,95.45454545454545,1.1363636363636365
43426_marine,86,58,82,1,144,95.34883720930233,1.1627906976744187
43427_marine,81,56,77,1,137,95.06172839506173,1.2345679012345678
43428_marine,80,47,76,1,127,95,1.25
43429_marine,81,46,77,1,127,95.06172839506173,1.2345679012345678
43430_marine,79,43,75,1,122,94.9367088607595,1.2658227848101267
43431_marine,78,43,74,1,121,94.87179487179486,1.282051282051282
43432_marine,78,43,74,1,121,94.87179487179486,1.282051282051282
43433_marine,77,43,73,1,120,94.8051948051948,1.2987012987012987
43434_marine,76,43,72,1,119,94.73684210526315,1.3157894736842104
43435_marine,76,43,72,1,119,94.73684210526315,1.3157894736842104
43436_marine,77,45,73,2,122,94.8051948051948,2.5974025974025974
43437_marine,77,45,73,2,122,94.8051948051948,2.5974025974025974
43438_marine,77,45,73,2,122,94.8051948051948,2.5974025974025974
43439_marine,77,45,73,2,122,94.8051948051948,2.5974025974025974
43440_marine,76,43,72,2,119,94.73684210526315,2.631578947368421
43441_marine,76,43,72,2,119,94.73684210526315,2.631578947368421
43442_marine,76,43,72,2,119,94.73684210526315,2.631578947368421
43443_marine,76,43,72,2,119,94.73684210526315,2.631578947368421
43444_marine,76,41,72,2,117,94.73684210526315,2.631578947368421
43445_marine,76,41,72,2,117,94.73684210526315,2.631578947368421
43446_marine,74,41,70,2,115,94.5945945945946,2.7027027027027026
43447_marine,74,39,70,2,113,94.5945945945946,2.7027027027027026
43448_marine,73,39,69,2,112,94.52054794520548,2.73972602739726
43449_marine,73,39,69,2,112,94.52054794520548,2.73972602739726
43450_marine,73,38,69,2,111,94.52054794520548,2.73972602739726
43451_marine,73,35,69,2,108,94.52054794520548,2.73972602739726
43452_marine,71,35,67,2,106,94.36619718309859,2.8169014084507045
43453_marine,71,34,67,2,105,94.36619718309859,2.8169014084507045
43454_marine,72,36,68,2,108,94.44444444444444,2.7777777777777777
43455_marine,72,36,68,2,108,94.44444444444444,2.7777777777777777
43456_marine,72,36,68,2,108,94.44444444444444,2.7777777777777777
43457_marine,68,36,64,2,104,94.11764705882352,2.941176470588235
43458_marine,69,36,65,2,105,94.20289855072464,2.898550724637681
43459_marine,69,36,65,2,105,94.20289855072464,2.898550724637681
43460_marine,69,34,65,2,103,94.20289855072464,2.898550724637681
43461_marine,68,34,64,2,102,94.11764705882352,2.941176470588235
43462_marine,68,34,64,2,102,94.11764705882352,2.941176470588235
43463_marine,69,36,65,2,105,94.20289855072464,2.898550724637681
43464_marine,69,36,65,2,105,94.20289855072464,2.898550724637681
43465_marine,69,37,65,2,106,94.20289855072464,2.898550724637681
43466_marine,69,36,65,2,105,94.20289855072464,2.898550724637681
43467_marine,68,36,64,2,104,94.11764705882352,2.941176470588235
43468_marine,69,37,65,2,106,94.20289855072464,2.898550724637681
43469_marine,69,38,65,2,107,94.20289855072464,2.898550724637681
43470_marine,71,38,67,2,109,94.36619718309859,2.8169014084507045
43471_marine,71,38,67,2,109,94.36619718309859,2.8169014084507045
43472_marine,71,38,67,2,109,94.36619718309859,2.8169014084507045
43473_marine,71,38,67,2,109,94.36619718309859,2.8169014084507045
43474_marine,71,40,67,2,111,94.36619718309859,2.8169014084507045
43475_marine,71,42,67,2,113,94.36619718309859,2.8169014084507045
43476_marine,71,42,67,2,113,94.36619718309859,2.8169014084507045
43477_marine,71,42,67,2,113,94.36619718309859,2.8169014084507045
43478_marine,71,38,67,2,109,94.36619718309859,2.8169014084507045
43479_marine,71,37,67,2,108,94.36619718309859,2.8169014084507045
43480_marine,72,39,68,2,111,94.44444444444444,2.7777777777777777
43481_marine,72,39,68,2,111,94.44444444444444,2.7777777777777777
43482_marine,72,39,68,2,111,94.44444444444444,2.7777777777777777
43483_marine,72,37,68,2,109,94.44444444444444,2.7777777777777777
43484_marine,72,36,68,2,108,94.44444444444444,2.7777777777777777
43485_marine,74,35,70,2,109,94.5945945945946,2.7027027027027026
43486_marine,76,35,72,2,111,94.73684210526315,2.631578947368421
43487_marine,77,36,72,2,113,93.5064935064935,2.5974025974025974
43488_marine,81,38,76,2,119,93.82716049382715,2.4691358024691357
43489_marine,82,40,77,2,122,93.90243902439023,2.4390243902439024
43490_marine,85,41,80,2,126,94.11764705882352,2.3529411764705883
43491_marine,94,43,89,2,137,94.68085106382979,2.127659574468085
43492_marine,101,43,94,4,144,93.06930693069307,3.9603960396039604
43493_marine,104,54,95,6,158,91.34615384615384,5.769230769230769
43494_marine,294,180,207,121,474,70.40816326530613,41.156462585034014
43495_marine,566,388,335,304,954,59.187279151943464,53.71024734982333
43496_marine,507,360,306,271,867,60.35502958579882,53.4516765285996
43535_marine,566,283,357,289,849,63.074204946996474,51.060070671378085
43536_marine,130,69,121,12,199,93.07692307692308,9.230769230769232
43537_marine,121,67,111,13,188,91.73553719008265,10.743801652892563
43538_marine,107,63,101,7,170,94.39252336448598,6.5420560747663545
43539_marine,392,149,261,208,541,66.58163265306123,53.06122448979592
43540_marine,389,148,258,207,537,66.32390745501286,53.213367609254504
43541_marine,97,66,93,5,163,95.87628865979381,5.154639175257731
43542_marine,98,62,94,5,160,95.91836734693877,5.1020408163265305
43543_marine,98,60,94,5,158,95.91836734693877,5.1020408163265305
43544_marine,98,59,94,5,157,95.91836734693877,5.1020408163265305
43545_marine,96,59,92,5,155,95.83333333333334,5.208333333333334
43546_marine,95,58,91,5,153,95.78947368421052,5.263157894736842
43547_marine,97,60,93,5,157,95.87628865979381,5.154639175257731
43548_marine,223,123,163,99,346,73.09417040358744,44.39461883408072
43549_marine,222,119,162,100,341,72.97297297297297,45.04504504504504
43550_marine,98,60,94,6,158,95.91836734693877,6.122448979591836
43551_marine,98,60,94,6,158,95.91836734693877,6.122448979591836
43552_marine,99,59,95,6,158,95.95959595959596,6.0606060606060606
43553_marine,99,63,95,6,162,95.95959595959596,6.0606060606060606
43554_marine,97,63,93,6,160,95.87628865979381,6.185567010309279
43555_marine,98,56,94,5,154,95.91836734693877,5.1020408163265305
43556_marine,99,56,95,5,155,95.95959595959596,5.05050505050505
43557_marine,97,52,93,5,149,95.87628865979381,5.154639175257731
43558_marine,92,51,88,5,143,95.65217391304348,5.434782608695652
43559_marine,91,52,87,5,143,95.6043956043956,5.4945054945054945
43560_marine,89,52,85,5,141,95.50561797752809,5.617977528089887
43561_marine,140,107,120,39,247,85.71428571428571,27.857142857142858
43562_marine,138,109,118,38,247,85.5072463768116,27.536231884057973
43563_marine,137,104,117,37,241,85.40145985401459,27.00729927007299
43564_marine,88,48,84,3,136,95.45454545454545,3.4090909090909087
43565_marine,87,47,83,3,134,95.40229885057471,3.4482758620689653
43566_marine,87,43,83,3,130,95.40229885057471,3.4482758620689653
43567_marine,82,41,79,3,123,96.34146341463415,3.6585365853658534
43568_marine,82,40,79,3,122,96.34146341463415,3.6585365853658534
43569_marine,82,38,79,3,120,96.34146341463415,3.6585365853658534
43570_marine,82,38,79,3,120,96.34146341463415,3.6585365853658534
43571_marine,81,38,78,3,119,96.29629629629629,3.7037037037037033
43572_marine,80,38,77,3,118,96.25,3.75
43573_marine,81,37,78,3,118,96.29629629629629,3.7037037037037033
43574_marine,81,37,78,3,118,96.29629629629629,3.7037037037037033
43575_marine,80,36,77,3,116,96.25,3.75
43576_marine,79,37,76,3,116,96.20253164556962,3.79746835443038
43577_marine,78,37,75,3,115,96.15384615384616,3.8461538461538463
43578_marine,77,37,74,3,114,96.1038961038961,3.896103896103896
43579_marine,74,39,71,3,113,95.94594594594594,4.054054054054054
43580_marine,75,38,72,3,113,96,4
43581_marine,75,38,72,3,113,96,4
43582_marine,75,38,72,3,113,96,4
43583_marine,75,38,72,3,113,96,4
43584_marine,75,38,72,3,113,96,4
43585_marine,75,38,72,3,113,96,4
43586_marine,75,38,72,3,113,96,4
43587_marine,75,38,72,3,113,96,4
43588_marine,75,37,72,3,112,96,4
43589_marine,74,37,71,3,111,95.94594594594594,4.054054054054054
43590_marine,73,37,70,3,110,95.8904109589041,4.10958904109589
43591_marine,72,36,69,3,108,95.83333333333334,4.166666666666666
43592_marine,72,36,69,3,108,95.83333333333334,4.166666666666666
43593_marine,72,36,69,3,108,95.83333333333334,4.166666666666666
43594_marine,70,36,67,3,106,95.71428571428572,4.285714285714286
43595_marine,71,36,68,3,107,95.77464788732394,4.225352112676056
43596_marine,70,36,67,3,106,95.71428571428572,4.285714285714286
43597_marine,70,38,67,3,108,95.71428571428572,4.285714285714286
43598_marine,72,36,68,4,108,94.44444444444444,5.555555555555555
43599_marine,68,36,64,4,104,94.11764705882352,5.88235294117647
43600_marine,69,37,65,5,106,94.20289855072464,7.246376811594203
43601_marine,69,37,65,5,106,94.20289855072464,7.246376811594203
43602_marine,68,36,64,4,104,94.11764705882352,5.88235294117647
43603_marine,70,36,66,6,106,94.28571428571428,8.571428571428571
43604_marine,70,36,66,6,106,94.28571428571428,8.571428571428571
43605_marine,69,35,65,6,104,94.20289855072464,8.695652173913043
43606_marine,68,35,64,6,103,94.11764705882352,8.823529411764707
43607_marine,67,35,63,6,102,94.02985074626866,8.955223880597014
43608_marine,67,35,63,6,102,94.02985074626866,8.955223880597014
43609_marine,66,35,62,6,101,93.93939393939394,9.090909090909092
43610_marine,66,35,62,6,101,93.93939393939394,9.090909090909092
43611_marine,65,35,61,6,100,93.84615384615384,9.230769230769232
43612_marine,64,33,60,6,97,93.75,9.375
43613_marine,64,33,60,6,97,93.75,9.375
43614_marine,64,33,60,6,97,93.75,9.375
43615_marine,66,33,62,6,99,93.93939393939394,9.090909090909092
43616_marine,66,32,62,6,98,93.93939393939394,9.090909090909092
43617_marine,68,32,64,6,100,94.11764705882352,8.823529411764707
43618_marine,68,32,64,6,100,94.11764705882352,8.823529411764707
43619_marine,68,32,64,6,100,94.11764705882352,8.823529411764707
43620_marine,67,32,63,6,99,94.02985074626866,8.955223880597014
43621_marine,67,32,63,6,99,94.02985074626866,8.955223880597014
43622_marine,69,31,65,6,100,94.20289855072464,8.695652173913043
43623_marine,69,32,65,6,101,94.20289855072464,8.695652173913043
43624_marine,67,32,63,6,99,94.02985074626866,8.955223880597014
43625_marine,67,33,63,6,100,94.02985074626866,8.955223880597014
43626_marine,67,34,63,6,101,94.02985074626866,8.955223880597014
43627_marine,68,34,64,6,102,94.11764705882352,8.823529411764707
43628_marine,68,34,64,6,102,94.11764705882352,8.823529411764707
43629_marine,66,34,62,6,100,93.93939393939394,9.090909090909092
43630_marine,66,33,62,6,99,93.93939393939394,9.090909090909092
43631_marine,66,35,62,6,101,93.93939393939394,9.090909090909092
43632_marine,66,35,62,6,101,93.93939393939394,9.090909090909092
43633_marine,64,35,60,5,99,93.75,7.8125
43634_marine,64,33,60,5,97,93.75,7.8125
43635_marine,64,33,60,5,97,93.75,7.8125
43636_marine,63,35,60,4,98,95.23809523809523,6.349206349206349
43637_marine,64,35,61,3,99,95.3125,4.6875
43638_marine,62,35,59,3,97,95.16129032258065,4.838709677419355
43639_marine,60,35,57,2,95,95,3.3333333333333335
43640_marine,60,35,57,2,95,95,3.3333333333333335
43641_marine,60,35,57,2,95,95,3.3333333333333335
43642_marine,62,35,59,2,97,95.16129032258065,3.225806451612903
43643_marine,60,35,57,2,95,95,3.3333333333333335
43644_marine,58,35,55,2,93,94.82758620689656,3.4482758620689653
43645_marine,56,36,53,2,92,94.64285714285714,3.571428571428571
43646_marine,57,36,54,2,93,94.73684210526315,3.508771929824561
43647_marine,57,36,54,2,93,94.73684210526315,3.508771929824561
43648_marine,57,38,54,2,95,94.73684210526315,3.508771929824561
43649_marine,57,39,54,2,96,94.73684210526315,3.508771929824561
43650_marine,57,51,54,2,108,94.73684210526315,3.508771929824561
43651_marine,57,50,54,2,107,94.73684210526315,3.508771929824561
43652_marine,57,50,54,2,107,94.73684210526315,3.508771929824561
43653_marine,55,41,52,2,96,94.54545454545455,3.6363636363636362
43654_marine,56,44,53,2,100,94.64285714285714,3.571428571428571
43655_marine,55,45,52,2,100,94.54545454545455,3.6363636363636362
43656_marine,57,44,54,2,101,94.73684210526315,3.508771929824561
43657_marine,59,44,56,2,103,94.91525423728814,3.389830508474576
43658_marine,59,44,56,2,103,94.91525423728814,3.389830508474576
43659_marine,58,43,55,2,101,94.82758620689656,3.4482758620689653
43660_marine,60,45,55,3,105,91.66666666666666,5
43661_marine,61,46,56,3,107,91.80327868852459,4.918032786885246
43662_marine,60,44,55,3,104,91.66666666666666,5
43663_marine,57,44,51,3,101,89.47368421052632,5.263157894736842
43664_marine,60,44,54,3,104,90,5
43665_marine,62,46,56,3,108,90.32258064516128,4.838709677419355
43666_marine,62,47,56,3,109,90.32258064516128,4.838709677419355
43667_marine,69,50,63,7,119,91.30434782608695,10.144927536231885
43668_marine,103,82,84,19,185,81.55339805825243,18.446601941747574
43669_marine,198,251,126,97,449,63.63636363636363,48.98989898989899
43691_marine,218,206,205,22,424,94.03669724770643,10.091743119266056
43692_marine,116,76,112,3,192,96.55172413793103,2.586206896551724
43693_marine,115,65,111,2,180,96.52173913043478,1.7391304347826086
43694_marine,94,49,91,0,143,96.80851063829788,0
43695_marine,90,47,87,0,137,96.66666666666667,0
43696_marine,87,41,83,0,128,95.40229885057471,0
43697_marine,85,41,81,0,126,95.29411764705881,0
43698_marine,85,42,81,0,127,95.29411764705881,0
43699_marine,85,42,81,0,127,95.29411764705881,0
43700_marine,86,40,82,0,126,95.34883720930233,0
43701_marine,87,38,83,0,125,95.40229885057471,0
43702_marine,87,37,83,0,124,95.40229885057471,0
43703_marine,87,39,83,0,126,95.40229885057471,0
43704_marine,84,41,80,1,125,95.23809523809523,1.1904761904761905
43705_marine,84,39,80,1,123,95.23809523809523,1.1904761904761905
43706_marine,84,41,80,1,125,95.23809523809523,1.1904761904761905
43707_marine,80,39,76,1,119,95,1.25
43708_marine,80,39,76,1,119,95,1.25
43709_marine,81,33,77,1,114,95.06172839506173,1.2345679012345678
43710_marine,77,33,73,1,110,94.8051948051948,1.2987012987012987
43711_marine,75,34,71,1,109,94.66666666666667,1.3333333333333335
43712_marine,75,34,71,1,109,94.66666666666667,1.3333333333333335
43713_marine,75,32,71,1,107,94.66666666666667,1.3333333333333335
43714_marine,73,32,69,1,105,94.52054794520548,1.36986301369863
43715_marine,72,32,68,0,104,94.44444444444444,0
43716_marine,72,29,68,0,101,94.44444444444444,0
43717_marine,74,29,70,0,103,94.5945945945946,0
43718_marine,74,29,70,0,103,94.5945945945946,0
43719_marine,74,29,70,0,103,94.5945945945946,0
43720_marine,74,30,70,0,104,94.5945945945946,0
43721_marine,73,30,69,0,103,94.52054794520548,0
43722_marine,72,31,68,0,103,94.44444444444444,0
43723_marine,72,31,68,0,103,94.44444444444444,0
43724_marine,73,31,69,0,104,94.52054794520548,0
43725_marine,75,31,71,0,106,94.66666666666667,0
43726_marine,75,31,71,0,106,94.66666666666667,0
43727_marine,76,33,72,0,109,94.73684210526315,0
43728_marine,76,34,72,0,110,94.73684210526315,0
43729_marine,76,33,72,0,109,94.73684210526315,0
43730_marine,76,33,72,0,109,94.73684210526315,0
43731_marine,76,33,72,0,109,94.73684210526315,0
43732_marine,76,33,72,0,109,94.73684210526315,0
43733_marine,76,33,72,0,109,94.73684210526315,0
43734_marine,76,33,72,0,109,94.73684210526315,0
43735_marine,77,33,73,0,110,94.8051948051948,0
43736_marine,79,35,75,0,114,94.9367088607595,0
43737_marine,81,37,77,0,118,95.06172839506173,0
43738_marine,81,37,77,0,118,95.06172839506173,0
43739_marine,82,38,78,0,120,95.1219512195122,0
43740_marine,81,37,77,0,118,95.06172839506173,0
43741_marine,82,33,78,0,115,95.1219512195122,0
43742_marine,84,33,80,0,117,95.23809523809523,0
43743_marine,85,31,81,0,116,95.29411764705881,0
43744_marine,83,32,79,0,115,95.18072289156626,0
43745_marine,83,35,79,0,118,95.18072289156626,0
43746_marine,82,36,78,0,118,95.1219512195122,0
43747_marine,86,43,82,0,129,95.34883720930233,0
43748_marine,86,45,81,0,131,94.18604651162791,0
43749_marine,90,47,85,0,137,94.44444444444444,0
43750_marine,94,45,86,1,139,91.48936170212765,1.0638297872340425
43751_marine,94,47,86,1,141,91.48936170212765,1.0638297872340425
43752_marine,96,49,88,1,145,91.66666666666666,1.0416666666666665
43753_marine,96,50,88,1,146,91.66666666666666,1.0416666666666665
43754_marine,96,50,88,2,146,91.66666666666666,2.083333333333333
43755_marine,102,68,94,2,170,92.15686274509804,1.9607843137254901
43756_marine,112,121,104,4,233,92.85714285714286,3.571428571428571
43757_marine,161,183,147,11,344,91.30434782608695,6.832298136645963
43772_marine,408,172,332,117,580,81.37254901960785,28.676470588235293
43773_marine,123,62,115,10,185,93.4959349593496,8.130081300813007
43774_marine,115,60,107,6,175,93.04347826086956,5.217391304347826
43775_marine,110,57,103,6,167,93.63636363636364,5.454545454545454
43776_marine,102,54,95,4,156,93.13725490196079,3.9215686274509802
43777_marine,96,53,89,4,149,92.70833333333334,4.166666666666666
43778_marine,92,53,85,2,145,92.3913043478261,2.1739130434782608
43779_marine,89,55,84,1,144,94.3820224719101,1.1235955056179776
43780_marine,88,55,84,1,143,95.45454545454545,1.1363636363636365
43781_marine,86,54,82,1,140,95.34883720930233,1.1627906976744187
43782_marine,84,54,80,1,138,95.23809523809523,1.1904761904761905
43783_marine,84,63,80,1,147,95.23809523809523,1.1904761904761905
43784_marine,82,63,78,1,145,95.1219512195122,1.2195121951219512
43785_marine,78,55,74,1,133,94.87179487179486,1.282051282051282
43786_marine,77,55,73,1,132,94.8051948051948,1.2987012987012987
43787_marine,78,56,74,1,134,94.87179487179486,1.282051282051282
43788_marine,79,54,75,1,133,94.9367088607595,1.2658227848101267
43789_marine,79,53,75,1,132,94.9367088607595,1.2658227848101267
43790_marine,78,51,74,1,129,94.87179487179486,1.282051282051282
43791_marine,78,51,74,1,129,94.87179487179486,1.282051282051282
43792_marine,78,49,74,1,127,94.87179487179486,1.282051282051282
43793_marine,78,45,74,1,123,94.87179487179486,1.282051282051282
43794_marine,78,45,74,1,123,94.87179487179486,1.282051282051282
43795_marine,78,45,74,1,123,94.87179487179486,1.282051282051282
43796_marine,78,45,74,1,123,94.87179487179486,1.282051282051282
43797_marine,80,45,76,1,125,95,1.25
43798_marine,79,44,75,1,123,94.9367088607595,1.2658227848101267
43799_marine,79,42,75,1,121,94.9367088607595,1.2658227848101267
43800_marine,79,42,75,2,121,94.9367088607595,2.5316455696202533
43801_marine,79,42,75,2,121,94.9367088607595,2.5316455696202533
43802_marine,79,42,75,2,121,94.9367088607595,2.5316455696202533
43803_marine,75,40,71,2,115,94.66666666666667,2.666666666666667
43804_marine,75,40,71,2,115,94.66666666666667,2.666666666666667
43805_marine,75,40,71,2,115,94.66666666666667,2.666666666666667
43806_marine,75,40,71,2,115,94.66666666666667,2.666666666666667
43807_marine,74,40,70,2,114,94.5945945945946,2.7027027027027026
43808_marine,74,40,70,2,114,94.5945945945946,2.7027027027027026
43809_marine,74,40,70,2,114,94.5945945945946,2.7027027027027026
43810_marine,72,40,68,2,112,94.44444444444444,2.7777777777777777
43811_marine,70,40,66,2,110,94.28571428571428,2.857142857142857
43812_marine,70,40,66,2,110,94.28571428571428,2.857142857142857
43813_marine,71,40,67,2,111,94.36619718309859,2.8169014084507045
43814_marine,71,40,67,2,111,94.36619718309859,2.8169014084507045
43815_marine,71,40,67,2,111,94.36619718309859,2.8169014084507045
43816_marine,71,39,67,2,110,94.36619718309859,2.8169014084507045
43817_marine,69,39,65,2,108,94.20289855072464,2.898550724637681
43818_marine,69,39,65,2,108,94.20289855072464,2.898550724637681
43819_marine,69,39,65,2,108,94.20289855072464,2.898550724637681
43820_marine,70,39,66,2,109,94.28571428571428,2.857142857142857
43821_marine,70,37,66,2,107,94.28571428571428,2.857142857142857
43822_marine,70,39,66,2,109,94.28571428571428,2.857142857142857
43823_marine,70,39,66,2,109,94.28571428571428,2.857142857142857
43824_marine,71,38,67,2,109,94.36619718309859,2.8169014084507045
43825_marine,71,38,67,2,109,94.36619718309859,2.8169014084507045
43826_marine,70,40,66,2,110,94.28571428571428,2.857142857142857
43827_marine,70,40,66,2,110,94.28571428571428,2.857142857142857
43828_marine,70,40,66,2,110,94.28571428571428,2.857142857142857
43829_marine,70,40,66,2,110,94.28571428571428,2.857142857142857
43830_marine,72,40,68,2,112,94.44444444444444,2.7777777777777777
43831_marine,72,40,68,2,112,94.44444444444444,2.7777777777777777
43832_marine,72,37,68,2,109,94.44444444444444,2.7777777777777777
43833_marine,71,39,67,2,110,94.36619718309859,2.8169014084507045
43834_marine,71,41,67,2,112,94.36619718309859,2.8169014084507045
43835_marine,71,41,67,2,112,94.36619718309859,2.8169014084507045
43836_marine,71,43,67,2,114,94.36619718309859,2.8169014084507045
43837_marine,71,42,67,2,113,94.36619718309859,2.8169014084507045
43838_marine,71,40,67,2,111,94.36619718309859,2.8169014084507045
43839_marine,71,40,67,2,111,94.36619718309859,2.8169014084507045
43840_marine,71,37,67,2,108,94.36619718309859,2.8169014084507045
43841_marine,70,38,66,2,108,94.28571428571428,2.857142857142857
43842_marine,70,38,66,2,108,94.28571428571428,2.857142857142857
43843_marine,70,38,66,2,108,94.28571428571428,2.857142857142857
43844_marine,70,35,66,2,105,94.28571428571428,2.857142857142857
43845_marine,69,36,65,1,105,94.20289855072464,1.4492753623188406
43846_marine,71,38,67,1,109,94.36619718309859,1.4084507042253522
43847_marine,78,38,73,1,116,93.58974358974359,1.282051282051282
43848_marine,81,37,76,2,118,93.82716049382715,2.4691358024691357
43849_marine,82,40,77,2,122,93.90243902439023,2.4390243902439024
43850_marine,83,45,78,2,128,93.97590361445783,2.4096385542168677
43851_marine,85,49,80,2,134,94.11764705882352,2.3529411764705883
43852_marine,97,49,91,2,146,93.81443298969072,2.0618556701030926
43853_marine,101,54,92,4,155,91.0891089108911,3.9603960396039604
43854_marine,124,85,110,11,209,88.70967741935483,8.870967741935484
43855_marine,327,284,250,108,611,76.45259938837921,33.02752293577982
43856_marine,543,446,329,294,989,60.58931860036832,54.14364640883977
43869_marine,262,312,151,114,574,57.63358778625955,43.51145038167939
43870_marine,263,310,154,111,573,58.55513307984791,42.20532319391635
43871_marine,271,306,156,119,577,57.564575645756456,43.91143911439114
43872_marine,290,320,162,139,610,55.86206896551724,47.93103448275862
43873_marine,299,321,164,150,620,54.84949832775919,50.16722408026756
43895_marine,153,119,141,16,272,92.15686274509804,10.457516339869281
43896_marine,125,69,117,11,194,93.60000000000001,8.799999999999999
43897_marine,113,64,107,9,177,94.69026548672566,7.964601769911504
43898_marine,103,63,97,7,166,94.1747572815534,6.796116504854369
43899_marine,381,149,249,204,530,65.35433070866141,53.54330708661418
43900_marine,432,176,285,239,608,65.97222222222221,55.32407407407407
43901_marine,372,146,242,202,518,65.05376344086021,54.3010752688172
43902_marine,94,63,90,5,157,95.74468085106383,5.319148936170213
43903_marine,95,61,91,5,156,95.78947368421052,5.263157894736842
43904_marine,94,61,90,5,155,95.74468085106383,5.319148936170213
43905_marine,97,58,93,5,155,95.87628865979381,5.154639175257731
43906_marine,97,58,93,5,155,95.87628865979381,5.154639175257731
43907_marine,99,66,95,5,165,95.95959595959596,5.05050505050505
43908_marine,101,69,97,5,170,96.03960396039604,4.9504950495049505
43909_marine,99,70,95,5,169,95.95959595959596,5.05050505050505
43910_marine,99,69,95,5,168,95.95959595959596,5.05050505050505
43911_marine,98,65,94,5,163,95.91836734693877,5.1020408163265305
43912_marine,101,59,96,6,160,95.04950495049505,5.9405940594059405
43913_marine,105,63,100,6,168,95.23809523809523,5.714285714285714
43914_marine,106,62,101,6,168,95.28301886792453,5.660377358490567
43915_marine,104,58,99,6,162,95.1923076923077,5.769230769230769
43916_marine,102,57,97,6,159,95.09803921568627,5.88235294117647
43917_marine,99,56,95,5,155,95.95959595959596,5.05050505050505
43918_marine,96,55,92,5,151,95.83333333333334,5.208333333333334
43919_marine,93,52,89,5,145,95.6989247311828,5.376344086021505
43920_marine,93,52,89,5,145,95.6989247311828,5.376344086021505
43921_marine,89,57,85,5,146,95.50561797752809,5.617977528089887
43922_marine,88,51,84,3,139,95.45454545454545,3.4090909090909087
43923_marine,88,47,84,3,135,95.45454545454545,3.4090909090909087
43924_marine,85,47,81,2,132,95.29411764705881,2.3529411764705883
43925_marine,84,46,80,2,130,95.23809523809523,2.380952380952381
43926_marine,84,43,80,2,127,95.23809523809523,2.380952380952381
43927_marine,82,43,78,2,125,95.1219512195122,2.4390243902439024
43928_marine,82,42,78,2,124,95.1219512195122,2.4390243902439024
43929_marine,80,39,76,2,119,95,2.5
43930_marine,79,39,76,2,118,96.20253164556962,2.5316455696202533
43931_marine,77,39,74,2,116,96.1038961038961,2.5974025974025974
43932_marine,76,38,73,2,114,96.05263157894737,2.631578947368421
43933_marine,76,38,73,2,114,96.05263157894737,2.631578947368421
43934_marine,75,38,72,2,113,96,2.666666666666667
43935_marine,75,37,72,2,112,96,2.666666666666667
43936_marine,74,36,71,2,110,95.94594594594594,2.7027027027027026
43937_marine,72,36,69,2,108,95.83333333333334,2.7777777777777777
43938_marine,72,37,69,2,109,95.83333333333334,2.7777777777777777
43939_marine,73,37,70,2,110,95.8904109589041,2.73972602739726
43940_marine,72,37,69,2,109,95.83333333333334,2.7777777777777777
43941_marine,72,36,69,2,108,95.83333333333334,2.7777777777777777
43942_marine,72,36,69,2,108,95.83333333333334,2.7777777777777777
43943_marine,72,36,69,2,108,95.83333333333334,2.7777777777777777
43944_marine,72,36,69,2,108,95.83333333333334,2.7777777777777777
43945_marine,71,36,68,2,107,95.77464788732394,2.8169014084507045
43946_marine,71,36,68,2,107,95.77464788732394,2.8169014084507045
43947_marine,71,38,68,2,109,95.77464788732394,2.8169014084507045
43948_marine,73,40,70,2,113,95.8904109589041,2.73972602739726
43949_marine,73,39,70,2,112,95.8904109589041,2.73972602739726
43950_marine,72,39,69,2,111,95.83333333333334,2.7777777777777777
43951_marine,72,39,69,2,111,95.83333333333334,2.7777777777777777
43952_marine,71,37,68,2,108,95.77464788732394,2.8169014084507045
43953_marine,71,37,68,2,108,95.77464788732394,2.8169014084507045
43954_marine,69,36,66,2,105,95.65217391304348,2.898550724637681
43955_marine,68,37,65,1,105,95.58823529411765,1.4705882352941175
43956_marine,67,37,64,1,104,95.52238805970148,1.4925373134328357
43957_marine,63,37,60,1,100,95.23809523809523,1.5873015873015872
43958_marine,63,37,60,1,100,95.23809523809523,1.5873015873015872
43959_marine,66,36,63,2,102,95.45454545454545,3.0303030303030303
43960_marine,66,36,63,2,102,95.45454545454545,3.0303030303030303
43961_marine,66,36,63,2,102,95.45454545454545,3.0303030303030303
43962_marine,66,36,63,2,102,95.45454545454545,3.0303030303030303
43963_marine,67,34,64,2,101,95.52238805970148,2.9850746268656714
43964_marine,66,34,63,2,100,95.45454545454545,3.0303030303030303
43965_marine,64,34,61,2,98,95.3125,3.125
43966_marine,66,34,63,4,100,95.45454545454545,6.0606060606060606
43967_marine,66,34,62,5,100,93.93939393939394,7.575757575757576
43968_marine,68,34,64,5,102,94.11764705882352,7.352941176470589
43969_marine,67,34,63,5,101,94.02985074626866,7.462686567164178
43970_marine,67,34,63,5,101,94.02985074626866,7.462686567164178
43971_marine,69,34,65,6,103,94.20289855072464,8.695652173913043
43972_marine,69,34,65,6,103,94.20289855072464,8.695652173913043
43973_marine,70,34,66,6,104,94.28571428571428,8.571428571428571
43974_marine,70,34,66,6,104,94.28571428571428,8.571428571428571
43975_marine,72,34,68,6,106,94.44444444444444,8.333333333333332
43976_marine,72,34,68,6,106,94.44444444444444,8.333333333333332
43977_marine,72,34,68,6,106,94.44444444444444,8.333333333333332
43978_marine,73,32,69,6,105,94.52054794520548,8.21917808219178
43979_marine,73,32,69,6,105,94.52054794520548,8.21917808219178
43980_marine,71,32,67,6,103,94.36619718309859,8.450704225352112
43981_marine,69,32,65,6,101,94.20289855072464,8.695652173913043
43982_marine,69,32,65,6,101,94.20289855072464,8.695652173913043
43983_marine,69,32,65,6,101,94.20289855072464,8.695652173913043
43984_marine,68,32,65,5,100,95.58823529411765,7.352941176470589
43985_marine,66,32,63,5,98,95.45454545454545,7.575757575757576
43986_marine,66,33,63,5,99,95.45454545454545,7.575757575757576
43987_marine,66,34,63,5,100,95.45454545454545,7.575757575757576
43988_marine,66,35,63,5,101,95.45454545454545,7.575757575757576
43989_marine,66,33,63,5,99,95.45454545454545,7.575757575757576
43990_marine,66,33,63,5,99,95.45454545454545,7.575757575757576
43991_marine,66,33,63,5,99,95.45454545454545,7.575757575757576
43992_marine,66,35,63,5,101,95.45454545454545,7.575757575757576
43993_marine,66,35,63,4,101,95.45454545454545,6.0606060606060606
43994_marine,63,35,60,4,98,95.23809523809523,6.349206349206349
43995_marine,62,35,59,3,97,95.16129032258065,4.838709677419355
43996_marine,62,35,59,3,97,95.16129032258065,4.838709677419355
43997_marine,60,34,57,3,94,95,5
43998_marine,59,36,56,2,95,94.91525423728814,3.389830508474576
43999_marine,59,36,56,2,95,94.91525423728814,3.389830508474576
44000_marine,59,36,56,2,95,94.91525423728814,3.389830508474576
44001_marine,57,37,54,2,94,94.73684210526315,3.508771929824561
44002_marine,57,39,54,2,96,94.73684210526315,3.508771929824561
44003_marine,59,40,56,2,99,94.91525423728814,3.389830508474576
44004_marine,59,40,56,2,99,94.91525423728814,3.389830508474576
44005_marine,59,40,56,2,99,94.91525423728814,3.389830508474576
44006_marine,59,40,56,2,99,94.91525423728814,3.389830508474576
44007_marine,59,40,56,2,99,94.91525423728814,3.389830508474576
44008_marine,59,40,56,2,99,94.91525423728814,3.389830508474576
44009_marine,59,40,56,2,99,94.91525423728814,3.389830508474576
44010_marine,61,48,58,2,109,95.08196721311475,3.278688524590164
44011_marine,62,48,59,2,110,95.16129032258065,3.225806451612903
44012_marine,61,48,58,2,109,95.08196721311475,3.278688524590164
44013_marine,54,39,51,2,93,94.44444444444444,3.7037037037037033
44014_marine,54,43,51,2,97,94.44444444444444,3.7037037037037033
44015_marine,57,43,54,2,100,94.73684210526315,3.508771929824561
44016_marine,57,43,54,2,100,94.73684210526315,3.508771929824561
44017_marine,59,44,56,2,103,94.91525423728814,3.389830508474576
44018_marine,57,43,54,2,100,94.73684210526315,3.508771929824561
44019_marine,62,56,58,2,118,93.54838709677419,3.225806451612903
44020_marine,63,60,58,3,123,92.06349206349206,4.761904761904762
44021_marine,62,59,57,3,121,91.93548387096774,4.838709677419355
44022_marine,56,58,51,3,114,91.07142857142857,5.357142857142857
44023_marine,55,46,49,3,101,89.0909090909091,5.454545454545454
44024_marine,58,46,52,3,104,89.65517241379311,5.172413793103448
44025_marine,60,50,54,3,110,90,5
44026_marine,63,50,57,4,113,90.47619047619048,6.349206349206349
44027_marine,73,64,67,7,137,91.78082191780823,9.58904109589041
44028_marine,108,88,87,20,196,80.55555555555556,18.51851851851852
44050_marine,227,203,212,24,430,93.3920704845815,10.572687224669604
44051_marine,119,96,115,3,215,96.63865546218487,2.5210084033613445
44052_marine,109,55,105,2,164,96.3302752293578,1.834862385321101
44053_marine,99,49,95,2,148,95.95959595959596,2.0202020202020203
44054_marine,88,47,85,0,135,96.5909090909091,0
44055_marine,89,43,85,0,132,95.50561797752809,0
44056_marine,85,43,81,0,128,95.29411764705881,0
44057_marine,83,43,79,0,126,95.18072289156626,0
44058_marine,81,38,77,0,119,95.06172839506173,0
44059_marine,81,38,77,0,119,95.06172839506173,0
44060_marine,81,36,77,0,117,95.06172839506173,0
44061_marine,81,36,77,0,117,95.06172839506173,0
44062_marine,82,35,78,0,117,95.1219512195122,0
44063_marine,81,35,77,0,116,95.06172839506173,0
44064_marine,81,35,77,0,116,95.06172839506173,0
44065_marine,78,35,74,1,113,94.87179487179486,1.282051282051282
44066_marine,77,33,73,1,110,94.8051948051948,1.2987012987012987
44067_marine,78,33,74,1,111,94.87179487179486,1.282051282051282
44068_marine,76,37,72,1,113,94.73684210526315,1.3157894736842104
44069_marine,72,33,68,1,105,94.44444444444444,1.3888888888888888
44070_marine,71,33,67,1,104,94.36619718309859,1.4084507042253522
44071_marine,71,33,67,1,104,94.36619718309859,1.4084507042253522
44072_marine,71,34,67,1,105,94.36619718309859,1.4084507042253522
44073_marine,71,34,67,0,105,94.36619718309859,0
44074_marine,70,34,66,0,104,94.28571428571428,0
44075_marine,68,32,64,0,100,94.11764705882352,0
44076_marine,68,32,64,0,100,94.11764705882352,0
44077_marine,72,31,68,0,103,94.44444444444444,0
44078_marine,74,31,70,0,105,94.5945945945946,0
44079_marine,75,31,71,0,106,94.66666666666667,0
44080_marine,74,32,70,0,106,94.5945945945946,0
44081_marine,73,33,69,0,106,94.52054794520548,0
44082_marine,73,33,69,0,106,94.52054794520548,0
44083_marine,74,33,70,0,107,94.5945945945946,0
44084_marine,74,33,70,0,107,94.5945945945946,0
44085_marine,75,33,71,0,108,94.66666666666667,0
44086_marine,75,36,71,0,111,94.66666666666667,0
44087_marine,75,36,71,0,111,94.66666666666667,0
44088_marine,75,36,71,0,111,94.66666666666667,0
44089_marine,73,35,69,0,108,94.52054794520548,0
44090_marine,73,35,69,0,108,94.52054794520548,0
44091_marine,75,35,71,0,110,94.66666666666667,0
44092_marine,73,35,69,0,108,94.52054794520548,0
44093_marine,73,35,69,0,108,94.52054794520548,0
44094_marine,73,36,69,0,109,94.52054794520548,0
44095_marine,75,36,71,0,111,94.66666666666667,0
44096_marine,76,36,72,0,112,94.73684210526315,0
44097_marine,76,38,72,0,114,94.73684210526315,0
44098_marine,80,38,76,0,118,95,0
44099_marine,79,34,75,0,113,94.9367088607595,0
44100_marine,81,34,77,0,115,95.06172839506173,0
44101_marine,80,32,76,0,112,95,0
44102_marine,81,30,77,0,111,95.06172839506173,0
44103_marine,83,31,79,0,114,95.18072289156626,0
44104_marine,81,33,77,0,114,95.06172839506173,0
44105_marine,82,33,78,0,115,95.1219512195122,0
44106_marine,81,37,77,0,118,95.06172839506173,0
44107_marine,82,39,78,0,121,95.1219512195122,0
44108_marine,83,41,79,0,124,95.18072289156626,0
44109_marine,84,41,79,0,125,94.04761904761905,0
44110_marine,91,41,84,0,132,92.3076923076923,0
44111_marine,90,47,82,1,137,91.11111111111111,1.1111111111111112
44112_marine,92,47,84,1,139,91.30434782608695,1.0869565217391304
44113_marine,92,52,84,1,144,91.30434782608695,1.0869565217391304
44114_marine,93,54,85,2,147,91.39784946236558,2.1505376344086025
44115_marine,95,54,87,2,149,91.57894736842105,2.1052631578947367
44116_marine,110,102,102,4,212,92.72727272727272,3.6363636363636362
44117_marine,158,197,146,8,355,92.40506329113924,5.063291139240507
44131_marine,379,169,315,102,548,83.11345646437994,26.912928759894463
44132_marine,120,62,112,7,182,93.33333333333333,5.833333333333333
44133_marine,113,57,105,6,170,92.92035398230088,5.3097345132743365
44134_marine,108,58,101,6,166,93.51851851851852,5.555555555555555
44135_marine,102,58,95,4,160,93.13725490196079,3.9215686274509802
44136_marine,96,60,89,4,156,92.70833333333334,4.166666666666666
44137_marine,89,57,82,1,146,92.13483146067416,1.1235955056179776
44138_marine,85,57,80,1,142,94.11764705882352,1.1764705882352942
44139_marine,82,58,78,1,140,95.1219512195122,1.2195121951219512
44140_marine,82,58,78,1,140,95.1219512195122,1.2195121951219512
44141_marine,80,58,76,1,138,95,1.25
44142_marine,80,58,76,1,138,95,1.25
44143_marine,78,63,74,1,141,94.87179487179486,1.282051282051282
44144_marine,80,67,76,1,147,95,1.25
44145_marine,82,67,78,1,149,95.1219512195122,1.2195121951219512
44146_marine,80,65,76,1,145,95,1.25
44147_marine,78,57,74,1,135,94.87179487179486,1.282051282051282
44148_marine,78,55,74,1,133,94.87179487179486,1.282051282051282
44149_marine,78,53,74,1,131,94.87179487179486,1.282051282051282
44150_marine,78,51,74,1,129,94.87179487179486,1.282051282051282
44151_marine,78,51,74,1,129,94.87179487179486,1.282051282051282
44152_marine,78,49,74,1,127,94.87179487179486,1.282051282051282
44153_marine,78,50,74,1,128,94.87179487179486,1.282051282051282
44154_marine,78,50,74,1,128,94.87179487179486,1.282051282051282
44155_marine,78,50,74,1,128,94.87179487179486,1.282051282051282
44156_marine,78,50,74,1,128,94.87179487179486,1.282051282051282
44157_marine,78,48,74,1,126,94.87179487179486,1.282051282051282
44158_marine,78,46,74,1,124,94.87179487179486,1.282051282051282
44159_marine,75,44,71,1,119,94.66666666666667,1.3333333333333335
44160_marine,75,44,71,1,119,94.66666666666667,1.3333333333333335
44161_marine,75,43,71,1,118,94.66666666666667,1.3333333333333335
44162_marine,75,41,71,1,116,94.66666666666667,1.3333333333333335
44163_marine,78,41,74,2,119,94.87179487179486,2.564102564102564
44164_marine,78,41,74,2,119,94.87179487179486,2.564102564102564
44165_marine,77,42,73,1,119,94.8051948051948,1.2987012987012987
44166_marine,74,42,70,1,116,94.5945945945946,1.3513513513513513
44167_marine,73,42,69,1,115,94.52054794520548,1.36986301369863
44168_marine,74,43,70,2,117,94.5945945945946,2.7027027027027026
44169_marine,72,43,68,2,115,94.44444444444444,2.7777777777777777
44170_marine,70,43,66,2,113,94.28571428571428,2.857142857142857
44171_marine,70,41,66,2,111,94.28571428571428,2.857142857142857
44172_marine,71,41,67,2,112,94.36619718309859,2.8169014084507045
44173_marine,71,41,67,2,112,94.36619718309859,2.8169014084507045
44174_marine,71,43,67,2,114,94.36619718309859,2.8169014084507045
44175_marine,71,45,67,2,116,94.36619718309859,2.8169014084507045
44176_marine,71,44,67,2,115,94.36619718309859,2.8169014084507045
44177_marine,69,44,65,2,113,94.20289855072464,2.898550724637681
44178_marine,69,44,65,2,113,94.20289855072464,2.898550724637681
44179_marine,69,41,65,2,110,94.20289855072464,2.898550724637681
44180_marine,67,41,63,2,108,94.02985074626866,2.9850746268656714
44181_marine,67,41,63,2,108,94.02985074626866,2.9850746268656714
44182_marine,67,41,63,2,108,94.02985074626866,2.9850746268656714
44183_marine,67,41,63,2,108,94.02985074626866,2.9850746268656714
44184_marine,67,42,63,2,109,94.02985074626866,2.9850746268656714
44185_marine,68,42,64,2,110,94.11764705882352,2.941176470588235
44186_marine,68,42,64,2,110,94.11764705882352,2.941176470588235
44187_marine,64,42,60,2,106,93.75,3.125
44188_marine,64,42,60,2,106,93.75,3.125
44189_marine,64,42,60,2,106,93.75,3.125
44190_marine,64,42,60,2,106,93.75,3.125
44191_marine,68,40,64,2,108,94.11764705882352,2.941176470588235
44192_marine,68,40,64,2,108,94.11764705882352,2.941176470588235
44193_marine,68,42,64,2,110,94.11764705882352,2.941176470588235
44194_marine,68,42,64,2,110,94.11764705882352,2.941176470588235
44195_marine,70,45,66,2,115,94.28571428571428,2.857142857142857
44196_marine,70,49,66,2,119,94.28571428571428,2.857142857142857
44197_marine,70,49,66,2,119,94.28571428571428,2.857142857142857
44198_marine,70,47,66,2,117,94.28571428571428,2.857142857142857
44199_marine,70,47,66,2,117,94.28571428571428,2.857142857142857
44200_marine,70,47,66,2,117,94.28571428571428,2.857142857142857
44201_marine,70,45,66,2,115,94.28571428571428,2.857142857142857
44202_marine,70,46,66,2,116,94.28571428571428,2.857142857142857
44203_marine,69,47,65,1,116,94.20289855072464,1.4492753623188406
44204_marine,69,45,65,1,114,94.20289855072464,1.4492753623188406
44205_marine,69,46,65,1,115,94.20289855072464,1.4492753623188406
44206_marine,74,46,69,1,120,93.24324324324324,1.3513513513513513
44207_marine,76,47,71,1,123,93.42105263157895,1.3157894736842104
44208_marine,76,49,71,1,125,93.42105263157895,1.3157894736842104
44209_marine,80,52,75,2,132,93.75,2.5
44210_marine,83,52,78,1,135,93.97590361445783,1.2048192771084338
44211_marine,83,57,78,1,140,93.97590361445783,1.2048192771084338
44212_marine,92,57,86,1,149,93.47826086956522,1.0869565217391304
44213_marine,98,61,91,3,159,92.85714285714286,3.061224489795918
44214_marine,125,95,111,8,220,88.8,6.4
44215_marine,329,291,251,110,620,76.29179331306992,33.43465045592705
44216_marine,549,452,331,303,1001,60.29143897996357,55.19125683060109
44225_marine,291,326,159,143,617,54.63917525773196,49.140893470790374
44226_marine,288,318,157,138,606,54.513888888888886,47.91666666666667
44227_marine,302,323,170,145,625,56.29139072847682,48.01324503311258
44228_marine,272,312,156,121,584,57.35294117647059,44.48529411764706
44229_marine,264,301,157,110,565,59.46969696969697,41.66666666666667
44230_marine,172,225,136,31,397,79.06976744186046,18.023255813953487
44231_marine,172,221,137,29,393,79.65116279069767,16.86046511627907
44232_marine,173,225,133,34,398,76.878612716763,19.653179190751445
44233_marine,314,328,172,159,642,54.77707006369427,50.63694267515923
44234_marine,347,366,182,182,713,52.44956772334294,52.44956772334294
44235_marine,356,362,182,194,718,51.12359550561798,54.49438202247191
44254_marine,570,337,373,263,907,65.43859649122807,46.14035087719298
44255_marine,153,113,141,14,266,92.15686274509804,9.15032679738562
44256_marine,125,63,117,11,188,93.60000000000001,8.799999999999999
44257_marine,107,66,101,7,173,94.39252336448598,6.5420560747663545
44258_marine,101,66,96,6,167,95.04950495049505,5.9405940594059405
44259_marine,376,151,245,203,527,65.1595744680851,53.98936170212766
44260_marine,373,151,242,202,524,64.87935656836461,54.15549597855228
44261_marine,94,71,90,5,165,95.74468085106383,5.319148936170213
44262_marine,94,69,90,5,163,95.74468085106383,5.319148936170213
44263_marine,97,64,93,5,161,95.87628865979381,5.154639175257731
44264_marine,97,64,93,5,161,95.87628865979381,5.154639175257731
44265_marine,94,64,90,5,158,95.74468085106383,5.319148936170213
44266_marine,95,64,91,5,159,95.78947368421052,5.263157894736842
44267_marine,99,72,95,5,171,95.95959595959596,5.05050505050505
44268_marine,101,75,97,5,176,96.03960396039604,4.9504950495049505
44269_marine,100,77,96,5,177,96,5
44270_marine,100,71,96,5,171,96,5
44271_marine,101,73,96,5,174,95.04950495049505,4.9504950495049505
44272_marine,111,106,106,5,217,95.4954954954955,4.504504504504505
44273_marine,120,106,115,5,226,95.83333333333334,4.166666666666666
44274_marine,120,105,115,5,225,95.83333333333334,4.166666666666666
44275_marine,112,65,107,5,177,95.53571428571429,4.464285714285714
44276_marine,107,62,102,6,169,95.32710280373831,5.607476635514018
44277_marine,102,60,97,6,162,95.09803921568627,5.88235294117647
44278_marine,102,58,97,5,160,95.09803921568627,4.901960784313726
44279_marine,94,54,90,5,148,95.74468085106383,5.319148936170213
44280_marine,92,54,88,5,146,95.65217391304348,5.434782608695652
44281_marine,89,59,85,4,148,95.50561797752809,4.49438202247191
44282_marine,87,53,83,2,140,95.40229885057471,2.2988505747126435
44283_marine,87,50,83,2,137,95.40229885057471,2.2988505747126435
44284_marine,86,49,82,2,135,95.34883720930233,2.3255813953488373
44285_marine,86,46,82,2,132,95.34883720930233,2.3255813953488373
44286_marine,84,46,80,2,130,95.23809523809523,2.380952380952381
44287_marine,84,45,80,2,129,95.23809523809523,2.380952380952381
44288_marine,82,44,78,2,126,95.1219512195122,2.4390243902439024
44289_marine,82,44,78,2,126,95.1219512195122,2.4390243902439024
44290_marine,82,43,78,2,125,95.1219512195122,2.4390243902439024
44291_marine,79,43,76,2,122,96.20253164556962,2.5316455696202533
44292_marine,77,42,74,2,119,96.1038961038961,2.5974025974025974
44293_marine,77,41,74,2,118,96.1038961038961,2.5974025974025974
44294_marine,77,41,74,2,118,96.1038961038961,2.5974025974025974
44295_marine,77,41,74,2,118,96.1038961038961,2.5974025974025974
44296_marine,77,41,74,2,118,96.1038961038961,2.5974025974025974
44297_marine,74,38,71,2,112,95.94594594594594,2.7027027027027026
44298_marine,75,38,72,2,113,96,2.666666666666667
44299_marine,73,38,70,2,111,95.8904109589041,2.73972602739726
44300_marine,72,39,69,2,111,95.83333333333334,2.7777777777777777
44301_marine,72,39,69,2,111,95.83333333333334,2.7777777777777777
44302_marine,72,38,69,2,110,95.83333333333334,2.7777777777777777
44303_marine,72,38,69,2,110,95.83333333333334,2.7777777777777777
44304_marine,72,38,69,2,110,95.83333333333334,2.7777777777777777
44305_marine,72,37,69,2,109,95.83333333333334,2.7777777777777777
44306_marine,72,37,69,2,109,95.83333333333334,2.7777777777777777
44307_marine,72,35,69,2,107,95.83333333333334,2.7777777777777777
44308_marine,71,35,68,1,106,95.77464788732394,1.4084507042253522
44309_marine,69,34,66,1,103,95.65217391304348,1.4492753623188406
44310_marine,68,34,65,1,102,95.58823529411765,1.4705882352941175
44311_marine,68,34,65,1,102,95.58823529411765,1.4705882352941175
44312_marine,69,34,66,1,103,95.65217391304348,1.4492753623188406
44313_marine,69,34,66,1,103,95.65217391304348,1.4492753623188406
44314_marine,69,34,66,1,103,95.65217391304348,1.4492753623188406
44315_marine,64,34,61,1,98,95.3125,1.5625
44316_marine,64,33,61,1,97,95.3125,1.5625
44317_marine,64,33,61,1,97,95.3125,1.5625
44318_marine,64,33,61,1,97,95.3125,1.5625
44319_marine,65,33,62,1,98,95.38461538461539,1.5384615384615385
44320_marine,65,33,62,1,98,95.38461538461539,1.5384615384615385
44321_marine,65,33,62,1,98,95.38461538461539,1.5384615384615385
44322_marine,65,33,62,1,98,95.38461538461539,1.5384615384615385
44323_marine,65,33,62,1,98,95.38461538461539,1.5384615384615385
44324_marine,65,33,62,1,98,95.38461538461539,1.5384615384615385
44325_marine,64,33,61,1,97,95.3125,1.5625
44326_marine,64,33,61,1,97,95.3125,1.5625
44327_marine,65,33,62,1,98,95.38461538461539,1.5384615384615385
44328_marine,65,33,62,1,98,95.38461538461539,1.5384615384615385
44329_marine,65,33,62,1,98,95.38461538461539,1.5384615384615385
44330_marine,65,33,62,1,98,95.38461538461539,1.5384615384615385
44331_marine,67,34,64,3,101,95.52238805970148,4.477611940298507
44332_marine,67,34,64,3,101,95.52238805970148,4.477611940298507
44333_marine,67,34,64,3,101,95.52238805970148,4.477611940298507
44334_marine,67,34,64,3,101,95.52238805970148,4.477611940298507
44335_marine,69,34,66,3,103,95.65217391304348,4.3478260869565215
44336_marine,69,34,66,4,103,95.65217391304348,5.797101449275362
44337_marine,68,34,65,4,102,95.58823529411765,5.88235294117647
44338_marine,66,34,63,4,100,95.45454545454545,6.0606060606060606
44339_marine,67,32,64,4,99,95.52238805970148,5.970149253731343
44340_marine,68,32,65,5,100,95.58823529411765,7.352941176470589
44341_marine,67,32,64,5,99,95.52238805970148,7.462686567164178
44342_marine,66,32,63,5,98,95.45454545454545,7.575757575757576
44343_marine,66,32,63,5,98,95.45454545454545,7.575757575757576
44344_marine,64,32,61,5,96,95.3125,7.8125
44345_marine,63,32,60,5,95,95.23809523809523,7.936507936507936
44346_marine,63,35,60,5,98,95.23809523809523,7.936507936507936
44347_marine,63,35,60,5,98,95.23809523809523,7.936507936507936
44348_marine,63,35,60,5,98,95.23809523809523,7.936507936507936
44349_marine,63,35,60,5,98,95.23809523809523,7.936507936507936
44350_marine,63,35,60,5,98,95.23809523809523,7.936507936507936
44351_marine,63,36,60,5,99,95.23809523809523,7.936507936507936
44352_marine,63,36,60,5,99,95.23809523809523,7.936507936507936
44353_marine,62,35,59,3,97,95.16129032258065,4.838709677419355
44354_marine,61,35,58,2,96,95.08196721311475,3.278688524590164
44355_marine,61,37,58,2,98,95.08196721311475,3.278688524590164
44356_marine,59,38,56,2,97,94.91525423728814,3.389830508474576
44357_marine,59,38,56,2,97,94.91525423728814,3.389830508474576
44358_marine,57,38,54,2,95,94.73684210526315,3.508771929824561
44359_marine,58,40,55,2,98,94.82758620689656,3.4482758620689653
44360_marine,58,42,55,2,100,94.82758620689656,3.4482758620689653
44361_marine,58,43,55,2,101,94.82758620689656,3.4482758620689653
44362_marine,58,43,55,2,101,94.82758620689656,3.4482758620689653
44363_marine,58,43,55,2,101,94.82758620689656,3.4482758620689653
44364_marine,58,43,55,2,101,94.82758620689656,3.4482758620689653
44365_marine,57,43,54,2,100,94.73684210526315,3.508771929824561
44366_marine,57,42,54,2,99,94.73684210526315,3.508771929824561
44367_marine,57,42,54,2,99,94.73684210526315,3.508771929824561
44368_marine,59,42,56,2,101,94.91525423728814,3.389830508474576
44369_marine,59,42,56,2,101,94.91525423728814,3.389830508474576
44370_marine,59,41,56,2,100,94.91525423728814,3.389830508474576
44371_marine,58,49,55,2,107,94.82758620689656,3.4482758620689653
44372_marine,58,48,55,2,106,94.82758620689656,3.4482758620689653
44373_marine,56,41,53,2,97,94.64285714285714,3.571428571428571
44374_marine,54,45,51,2,99,94.44444444444444,3.7037037037037033
44375_marine,55,45,52,2,100,94.54545454545455,3.6363636363636362
44376_marine,57,45,54,2,102,94.73684210526315,3.508771929824561
44377_marine,53,45,50,2,98,94.33962264150944,3.7735849056603774
44378_marine,56,45,53,2,101,94.64285714285714,3.571428571428571
44379_marine,60,58,56,2,118,93.33333333333333,3.3333333333333335
44380_marine,70,69,64,9,139,91.42857142857143,12.857142857142856
44381_marine,66,68,61,8,134,92.42424242424242,12.121212121212121
44382_marine,68,71,60,12,139,88.23529411764706,17.647058823529413
44383_marine,59,66,53,3,125,89.83050847457628,5.084745762711865
44384_marine,57,50,50,4,107,87.71929824561403,7.017543859649122
44385_marine,60,52,54,3,112,90,5
44386_marine,68,52,62,5,120,91.17647058823529,7.352941176470589
44387_marine,70,59,61,10,129,87.14285714285714,14.285714285714285
44388_marine,117,141,95,22,258,81.19658119658119,18.803418803418804
44409_marine,222,210,208,22,432,93.69369369369369,9.90990990990991
44410_marine,221,191,208,21,412,94.11764705882352,9.502262443438914
44411_marine,115,74,111,2,189,96.52173913043478,1.7391304347826086
44412_marine,99,51,95,2,150,95.95959595959596,2.0202020202020203
44413_marine,92,51,88,0,143,95.65217391304348,0
44414_marine,90,49,86,0,139,95.55555555555556,0
44415_marine,88,47,84,0,135,95.45454545454545,0
44416_marine,82,44,78,0,126,95.1219512195122,0
44417_marine,82,43,78,0,125,95.1219512195122,0
44418_marine,81,42,77,0,123,95.06172839506173,0
44419_marine,81,40,77,0,121,95.06172839506173,0
44420_marine,81,40,77,0,121,95.06172839506173,0
44421_marine,83,37,79,0,120,95.18072289156626,0
44422_marine,82,37,78,0,119,95.1219512195122,0
44423_marine,77,37,73,0,114,94.8051948051948,0
44424_marine,76,37,72,0,113,94.73684210526315,0
44425_marine,74,37,70,0,111,94.5945945945946,0
44426_marine,74,38,70,0,112,94.5945945945946,0
44427_marine,76,38,72,1,114,94.73684210526315,1.3157894736842104
44428_marine,74,36,70,1,110,94.5945945945946,1.3513513513513513
44429_marine,72,38,68,1,110,94.44444444444444,1.3888888888888888
44430_marine,71,36,67,1,107,94.36619718309859,1.4084507042253522
44431_marine,70,36,66,0,106,94.28571428571428,0
44432_marine,70,35,66,0,105,94.28571428571428,0
44433_marine,70,36,66,0,106,94.28571428571428,0
44434_marine,70,36,66,0,106,94.28571428571428,0
44435_marine,69,36,65,0,105,94.20289855072464,0
44436_marine,69,34,65,0,103,94.20289855072464,0
44437_marine,69,34,65,0,103,94.20289855072464,0
44438_marine,71,33,67,0,104,94.36619718309859,0
44439_marine,71,33,67,0,104,94.36619718309859,0
44440_marine,70,35,66,0,105,94.28571428571428,0
44441_marine,70,35,66,0,105,94.28571428571428,0
44442_marine,71,35,67,0,106,94.36619718309859,0
44443_marine,71,36,67,0,107,94.36619718309859,0
44444_marine,74,36,70,0,110,94.5945945945946,0
44445_marine,74,38,70,0,112,94.5945945945946,0
44446_marine,74,38,70,0,112,94.5945945945946,0
44447_marine,74,38,70,0,112,94.5945945945946,0
44448_marine,74,38,70,0,112,94.5945945945946,0
44449_marine,74,39,70,0,113,94.5945945945946,0
44450_marine,74,39,70,0,113,94.5945945945946,0
44451_marine,74,39,70,0,113,94.5945945945946,0
44452_marine,74,37,70,0,111,94.5945945945946,0
44453_marine,74,36,70,0,110,94.5945945945946,0
44454_marine,74,37,70,0,111,94.5945945945946,0
44455_marine,74,37,70,0,111,94.5945945945946,0
44456_marine,79,37,75,0,116,94.9367088607595,0
44457_marine,78,39,74,0,117,94.87179487179486,0
44458_marine,80,41,76,0,121,95,0
44459_marine,78,39,74,0,117,94.87179487179486,0
44460_marine,80,41,76,0,121,95,0
44461_marine,80,35,76,0,115,95,0
44462_marine,80,35,76,0,115,95,0
44463_marine,85,39,81,0,124,95.29411764705881,0
44464_marine,83,41,79,0,124,95.18072289156626,0
44465_marine,83,41,79,0,124,95.18072289156626,0
44466_marine,81,43,77,0,124,95.06172839506173,0
44467_marine,82,43,78,0,125,95.1219512195122,0
44468_marine,82,43,78,0,125,95.1219512195122,0
44469_marine,81,47,77,0,128,95.06172839506173,0
44470_marine,86,47,80,0,133,93.02325581395348,0
44471_marine,89,47,82,0,136,92.13483146067416,0
44472_marine,90,51,82,1,141,91.11111111111111,1.1111111111111112
44473_marine,92,54,84,1,146,91.30434782608695,1.0869565217391304
44474_marine,91,56,83,1,147,91.20879120879121,1.098901098901099
44475_marine,93,57,85,2,150,91.39784946236558,2.1505376344086025
44476_marine,99,61,91,2,160,91.91919191919192,2.0202020202020203
44477_marine,159,195,147,8,354,92.45283018867924,5.031446540880504
44484_marine,257,243,219,52,500,85.21400778210116,20.233463035019454
44489_marine,363,246,307,85,609,84.57300275482093,23.415977961432507
44490_marine,333,169,284,76,502,85.28528528528528,22.822822822822822
44491_marine,117,61,109,4,178,93.16239316239316,3.418803418803419
44492_marine,110,58,102,3,168,92.72727272727272,2.727272727272727
44493_marine,104,58,96,3,162,92.3076923076923,2.8846153846153846
44494_marine,100,57,93,4,157,93,4
44495_marine,93,58,86,3,151,92.47311827956989,3.225806451612903
44496_marine,87,60,80,1,147,91.95402298850574,1.1494252873563218
44497_marine,83,60,78,1,143,93.97590361445783,1.2048192771084338
44498_marine,81,59,76,1,140,93.82716049382715,1.2345679012345678
44499_marine,80,59,76,1,139,95,1.25
44500_marine,80,59,76,1,139,95,1.25
44501_marine,78,59,74,1,137,94.87179487179486,1.282051282051282
44502_marine,78,55,74,1,133,94.87179487179486,1.282051282051282
44503_marine,78,57,74,1,135,94.87179487179486,1.282051282051282
44504_marine,88,66,84,5,154,95.45454545454545,5.681818181818182
44505_marine,88,68,84,5,156,95.45454545454545,5.681818181818182
44506_marine,81,65,77,1,146,95.06172839506173,1.2345679012345678
44507_marine,77,55,73,1,132,94.8051948051948,1.2987012987012987
44508_marine,77,55,73,1,132,94.8051948051948,1.2987012987012987
44509_marine,78,51,74,1,129,94.87179487179486,1.282051282051282
44510_marine,78,53,74,1,131,94.87179487179486,1.282051282051282
44511_marine,78,53,74,1,131,94.87179487179486,1.282051282051282
44512_marine,78,51,74,1,129,94.87179487179486,1.282051282051282
44513_marine,78,53,74,1,131,94.87179487179486,1.282051282051282
44514_marine,76,53,72,1,129,94.73684210526315,1.3157894736842104
44515_marine,74,53,70,1,127,94.5945945945946,1.3513513513513513
44516_marine,74,51,70,1,125,94.5945945945946,1.3513513513513513
44517_marine,74,48,70,1,122,94.5945945945946,1.3513513513513513
44518_marine,74,48,70,1,122,94.5945945945946,1.3513513513513513
44519_marine,73,48,69,1,121,94.52054794520548,1.36986301369863
44520_marine,73,48,69,1,121,94.52054794520548,1.36986301369863
44521_marine,71,46,67,1,117,94.36619718309859,1.4084507042253522
44522_marine,71,45,67,1,116,94.36619718309859,1.4084507042253522
44523_marine,70,45,66,0,115,94.28571428571428,0
44524_marine,70,45,66,0,115,94.28571428571428,0
44525_marine,71,46,67,1,117,94.36619718309859,1.4084507042253522
44526_marine,70,46,66,1,116,94.28571428571428,1.4285714285714286
44527_marine,70,46,66,1,116,94.28571428571428,1.4285714285714286
44528_marine,72,46,68,1,118,94.44444444444444,1.3888888888888888
44529_marine,70,46,66,1,116,94.28571428571428,1.4285714285714286
44530_marine,71,46,67,2,117,94.36619718309859,2.8169014084507045
44531_marine,71,46,67,2,117,94.36619718309859,2.8169014084507045
44532_marine,72,46,68,2,118,94.44444444444444,2.7777777777777777
44533_marine,72,46,68,2,118,94.44444444444444,2.7777777777777777
44534_marine,71,46,67,2,117,94.36619718309859,2.8169014084507045
44535_marine,71,47,67,2,118,94.36619718309859,2.8169014084507045
44536_marine,69,49,65,2,118,94.20289855072464,2.898550724637681
44537_marine,69,49,65,2,118,94.20289855072464,2.898550724637681
44538_marine,69,49,65,2,118,94.20289855072464,2.898550724637681
44539_marine,69,51,65,2,120,94.20289855072464,2.898550724637681
44540_marine,69,50,65,2,119,94.20289855072464,2.898550724637681
44541_marine,69,49,65,2,118,94.20289855072464,2.898550724637681
44542_marine,65,47,61,2,112,93.84615384615384,3.076923076923077
44543_marine,65,48,61,2,113,93.84615384615384,3.076923076923077
44544_marine,65,48,61,2,113,93.84615384615384,3.076923076923077
44545_marine,65,48,61,2,113,93.84615384615384,3.076923076923077
44546_marine,66,48,62,2,114,93.93939393939394,3.0303030303030303
44547_marine,66,49,62,2,115,93.93939393939394,3.0303030303030303
44548_marine,66,49,62,2,115,93.93939393939394,3.0303030303030303
44549_marine,66,49,62,2,115,93.93939393939394,3.0303030303030303
44550_marine,66,45,62,2,111,93.93939393939394,3.0303030303030303
44551_marine,68,45,64,2,113,94.11764705882352,2.941176470588235
44552_marine,68,45,64,2,113,94.11764705882352,2.941176470588235
44553_marine,68,47,64,2,115,94.11764705882352,2.941176470588235
44554_marine,68,47,64,2,115,94.11764705882352,2.941176470588235
44555_marine,68,47,64,2,115,94.11764705882352,2.941176470588235
44556_marine,67,49,63,2,116,94.02985074626866,2.9850746268656714
44557_marine,68,49,64,2,117,94.11764705882352,2.941176470588235
44558_marine,70,47,66,2,117,94.28571428571428,2.857142857142857
44559_marine,70,48,66,2,118,94.28571428571428,2.857142857142857
44560_marine,70,50,66,2,120,94.28571428571428,2.857142857142857
44561_marine,69,52,65,1,121,94.20289855072464,1.4492753623188406
44562_marine,69,51,65,1,120,94.20289855072464,1.4492753623188406
44563_marine,69,51,65,1,120,94.20289855072464,1.4492753623188406
44564_marine,70,50,65,1,120,92.85714285714286,1.4285714285714286
44565_marine,70,50,65,1,120,92.85714285714286,1.4285714285714286
44566_marine,69,50,64,0,119,92.7536231884058,0
44567_marine,69,49,64,0,118,92.7536231884058,0
44568_marine,71,52,66,0,123,92.95774647887323,0
44569_marine,73,52,68,0,125,93.15068493150685,0
44570_marine,78,53,73,1,131,93.58974358974359,1.282051282051282
44571_marine,79,57,74,1,136,93.67088607594937,1.2658227848101267
44572_marine,84,61,78,1,145,92.85714285714286,1.1904761904761905
44573_marine,98,65,89,3,163,90.81632653061224,3.061224489795918
44574_marine,124,102,112,8,226,90.32258064516128,6.451612903225806
44575_marine,400,387,238,188,787,59.5,47
44576_marine,416,384,244,213,800,58.65384615384615,51.20192307692307
44580_marine,339,366,178,182,705,52.50737463126843,53.687315634218294
44581_marine,349,372,186,187,721,53.29512893982808,53.581661891117484
44582_marine,351,368,195,186,719,55.55555555555556,52.991452991452995
44583_marine,341,377,190,180,718,55.718475073313776,52.785923753665685
44584_marine,345,367,190,179,712,55.072463768115945,51.8840579710145
44585_marine,331,366,184,165,697,55.58912386706949,49.848942598187314
44586_marine,183,240,145,33,423,79.23497267759562,18.0327868852459
44587_marine,177,234,141,31,411,79.66101694915254,17.51412429378531
44588_marine,177,234,143,31,411,80.7909604519774,17.51412429378531
44589_marine,178,236,144,29,414,80.89887640449437,16.292134831460675
44590_marine,184,235,148,29,419,80.43478260869566,15.760869565217392
44591_marine,185,235,149,28,420,80.54054054054053,15.135135135135137
44592_marine,187,237,147,34,424,78.6096256684492,18.181818181818183
44593_marine,189,238,147,36,427,77.77777777777779,19.047619047619047
44594_marine,183,244,134,39,427,73.224043715847,21.311475409836063
44595_marine,366,383,186,203,749,50.81967213114754,55.46448087431693
44596_marine,348,349,183,187,697,52.58620689655172,53.735632183908045
44597_marine,377,380,188,213,757,49.86737400530504,56.49867374005305
44613_marine,558,358,360,257,916,64.51612903225806,46.0573476702509
44614_marine,513,303,332,239,816,64.71734892787524,46.588693957115005
44615_marine,126,63,117,11,189,92.85714285714286,8.73015873015873
44616_marine,115,65,107,9,180,93.04347826086956,7.82608695652174
44617_marine,108,69,98,11,177,90.74074074074075,10.185185185185185
44618_marine,100,62,95,6,162,95,6
44619_marine,96,62,91,6,158,94.79166666666666,6.25
44620_marine,95,65,90,5,160,94.73684210526315,5.263157894736842
44621_marine,92,63,88,5,155,95.65217391304348,5.434782608695652
44622_marine,93,61,89,5,154,95.6989247311828,5.376344086021505
44623_marine,97,65,93,5,162,95.87628865979381,5.154639175257731
44624_marine,94,67,90,5,161,95.74468085106383,5.319148936170213
44625_marine,94,70,90,4,164,95.74468085106383,4.25531914893617
44626_marine,92,66,88,4,158,95.65217391304348,4.3478260869565215
44627_marine,95,71,91,4,166,95.78947368421052,4.2105263157894735
44628_marine,97,79,93,4,176,95.87628865979381,4.123711340206185
44629_marine,97,85,93,4,182,95.87628865979381,4.123711340206185
44630_marine,92,87,88,4,179,95.65217391304348,4.3478260869565215
44631_marine,111,124,106,4,235,95.4954954954955,3.6036036036036037
44632_marine,179,215,158,24,394,88.26815642458101,13.40782122905028
44633_marine,205,230,176,41,435,85.85365853658537,20
44634_marine,197,220,169,40,417,85.78680203045685,20.304568527918782
44635_marine,168,206,148,24,374,88.09523809523809,14.285714285714285
44636_marine,110,78,105,6,188,95.45454545454545,5.454545454545454
44637_marine,101,69,96,4,170,95.04950495049505,3.9603960396039604
44638_marine,101,64,96,4,165,95.04950495049505,3.9603960396039604
44639_marine,97,64,92,3,161,94.84536082474226,3.0927835051546393
44640_marine,91,56,86,3,147,94.5054945054945,3.296703296703297
44641_marine,89,62,85,2,151,95.50561797752809,2.247191011235955
44642_marine,85,54,81,1,139,95.29411764705881,1.1764705882352942
44643_marine,84,54,80,1,138,95.23809523809523,1.1904761904761905
44644_marine,83,52,79,1,135,95.18072289156626,1.2048192771084338
44645_marine,83,49,79,1,132,95.18072289156626,1.2048192771084338
44646_marine,83,48,79,1,131,95.18072289156626,1.2048192771084338
44647_marine,83,48,79,2,131,95.18072289156626,2.4096385542168677
44648_marine,81,47,77,2,128,95.06172839506173,2.4691358024691357
44649_marine,81,46,77,2,127,95.06172839506173,2.4691358024691357
44650_marine,81,46,77,2,127,95.06172839506173,2.4691358024691357
44651_marine,80,45,76,2,125,95,2.5
44652_marine,77,43,74,2,120,96.1038961038961,2.5974025974025974
44653_marine,77,42,74,2,119,96.1038961038961,2.5974025974025974
44654_marine,76,41,73,2,117,96.05263157894737,2.631578947368421
44655_marine,76,41,73,2,117,96.05263157894737,2.631578947368421
44656_marine,75,41,72,2,116,96,2.666666666666667
44657_marine,75,40,72,2,115,96,2.666666666666667
44658_marine,74,39,71,2,113,95.94594594594594,2.7027027027027026
44659_marine,74,38,71,2,112,95.94594594594594,2.7027027027027026
44660_marine,73,38,70,2,111,95.8904109589041,2.73972602739726
44661_marine,71,38,68,1,109,95.77464788732394,1.4084507042253522
44662_marine,71,36,68,1,107,95.77464788732394,1.4084507042253522
44663_marine,71,35,68,1,106,95.77464788732394,1.4084507042253522
44664_marine,71,35,68,1,106,95.77464788732394,1.4084507042253522
44665_marine,71,35,68,1,106,95.77464788732394,1.4084507042253522
44666_marine,69,35,66,1,104,95.65217391304348,1.4492753623188406
44667_marine,69,35,66,1,104,95.65217391304348,1.4492753623188406
44668_marine,69,35,66,1,104,95.65217391304348,1.4492753623188406
44669_marine,69,34,66,1,103,95.65217391304348,1.4492753623188406
44670_marine,68,34,65,1,102,95.58823529411765,1.4705882352941175
44671_marine,69,34,66,1,103,95.65217391304348,1.4492753623188406
44672_marine,69,33,66,1,102,95.65217391304348,1.4492753623188406
44673_marine,66,33,63,1,99,95.45454545454545,1.5151515151515151
44674_marine,64,33,61,1,97,95.3125,1.5625
44675_marine,64,33,61,1,97,95.3125,1.5625
44676_marine,64,33,61,1,97,95.3125,1.5625
44677_marine,64,33,61,1,97,95.3125,1.5625
44678_marine,64,33,61,1,97,95.3125,1.5625
44679_marine,64,33,61,1,97,95.3125,1.5625
44680_marine,64,33,61,1,97,95.3125,1.5625
44681_marine,64,33,61,1,97,95.3125,1.5625
44682_marine,64,33,61,1,97,95.3125,1.5625
44683_marine,63,33,60,1,96,95.23809523809523,1.5873015873015872
44684_marine,63,33,60,1,96,95.23809523809523,1.5873015873015872
44685_marine,64,33,61,1,97,95.3125,1.5625
44686_marine,64,33,61,1,97,95.3125,1.5625
44687_marine,64,31,61,1,95,95.3125,1.5625
44688_marine,64,31,61,1,95,95.3125,1.5625
44689_marine,64,31,61,1,95,95.3125,1.5625
44690_marine,64,31,61,1,95,95.3125,1.5625
44691_marine,64,31,61,1,95,95.3125,1.5625
44692_marine,64,31,61,1,95,95.3125,1.5625
44693_marine,64,31,61,1,95,95.3125,1.5625
44694_marine,66,31,63,3,97,95.45454545454545,4.545454545454546
44695_marine,66,31,63,3,97,95.45454545454545,4.545454545454546
44696_marine,66,33,63,3,99,95.45454545454545,4.545454545454546
44697_marine,67,33,64,3,100,95.52238805970148,4.477611940298507
44698_marine,63,33,60,3,96,95.23809523809523,4.761904761904762
44699_marine,63,33,60,3,96,95.23809523809523,4.761904761904762
44700_marine,64,33,61,3,97,95.3125,4.6875
44701_marine,64,33,61,3,97,95.3125,4.6875
44702_marine,63,36,60,3,99,95.23809523809523,4.761904761904762
44703_marine,63,36,60,3,99,95.23809523809523,4.761904761904762
44704_marine,63,37,60,3,100,95.23809523809523,4.761904761904762
44705_marine,63,37,60,3,100,95.23809523809523,4.761904761904762
44706_marine,62,40,59,3,102,95.16129032258065,4.838709677419355
44707_marine,62,40,59,3,102,95.16129032258065,4.838709677419355
44708_marine,61,40,58,3,101,95.08196721311475,4.918032786885246
44709_marine,61,40,58,3,101,95.08196721311475,4.918032786885246
44710_marine,61,41,58,3,102,95.08196721311475,4.918032786885246
44711_marine,61,41,58,3,102,95.08196721311475,4.918032786885246
44712_marine,60,41,57,2,101,95,3.3333333333333335
44713_marine,60,41,57,2,101,95,3.3333333333333335
44714_marine,58,41,55,2,99,94.82758620689656,3.4482758620689653
44715_marine,56,41,53,2,97,94.64285714285714,3.571428571428571
44716_marine,56,40,53,2,96,94.64285714285714,3.571428571428571
44717_marine,56,40,53,2,96,94.64285714285714,3.571428571428571
44718_marine,56,40,53,2,96,94.64285714285714,3.571428571428571
44719_marine,56,41,53,2,97,94.64285714285714,3.571428571428571
44720_marine,56,41,53,2,97,94.64285714285714,3.571428571428571
44721_marine,55,43,52,2,98,94.54545454545455,3.6363636363636362
44722_marine,55,43,52,2,98,94.54545454545455,3.6363636363636362
44723_marine,55,43,52,2,98,94.54545454545455,3.6363636363636362
44724_marine,56,43,53,2,99,94.64285714285714,3.571428571428571
44725_marine,56,43,53,2,99,94.64285714285714,3.571428571428571
44726_marine,56,43,53,2,99,94.64285714285714,3.571428571428571
44727_marine,55,43,52,2,98,94.54545454545455,3.6363636363636362
44728_marine,52,43,49,2,95,94.23076923076923,3.8461538461538463
44729_marine,52,43,49,2,95,94.23076923076923,3.8461538461538463
44730_marine,52,42,49,2,94,94.23076923076923,3.8461538461538463
44731_marine,52,41,49,2,93,94.23076923076923,3.8461538461538463
44732_marine,54,42,51,2,96,94.44444444444444,3.7037037037037033
44733_marine,54,42,51,2,96,94.44444444444444,3.7037037037037033
44734_marine,54,44,51,2,98,94.44444444444444,3.7037037037037033
44735_marine,54,45,51,2,99,94.44444444444444,3.7037037037037033
44736_marine,57,44,54,2,101,94.73684210526315,3.508771929824561
44737_marine,55,44,52,2,99,94.54545454545455,3.6363636363636362
44738_marine,55,44,52,2,99,94.54545454545455,3.6363636363636362
44739_marine,62,59,58,2,121,93.54838709677419,3.225806451612903
44740_marine,60,61,55,3,121,91.66666666666666,5
44741_marine,58,62,53,3,120,91.37931034482759,5.172413793103448
44742_marine,57,63,51,3,120,89.47368421052632,5.263157894736842
44743_marine,58,62,52,3,120,89.65517241379311,5.172413793103448
44744_marine,56,51,50,3,107,89.28571428571429,5.357142857142857
44745_marine,58,54,52,3,112,89.65517241379311,5.172413793103448
44746_marine,69,55,63,6,124,91.30434782608695,8.695652173913043
44747_marine,99,89,81,17,188,81.81818181818183,17.17171717171717
44768_marine,215,204,201,23,419,93.48837209302326,10.69767441860465
44769_marine,218,201,205,23,419,94.03669724770643,10.550458715596331
44770_marine,116,71,111,2,187,95.6896551724138,1.7241379310344827
44771_marine,102,52,97,2,154,95.09803921568627,1.9607843137254901
44772_marine,90,54,86,0,144,95.55555555555556,0
44773_marine,91,48,87,0,139,95.6043956043956,0
44774_marine,91,48,87,0,139,95.6043956043956,0
44775_marine,86,47,82,0,133,95.34883720930233,0
44776_marine,83,47,79,0,130,95.18072289156626,0
44777_marine,83,45,79,0,128,95.18072289156626,0
44778_marine,83,43,79,0,126,95.18072289156626,0
44779_marine,81,44,77,0,125,95.06172839506173,0
44780_marine,81,42,77,0,123,95.06172839506173,0
44781_marine,81,42,77,0,123,95.06172839506173,0
44782_marine,74,41,70,0,115,94.5945945945946,0
44783_marine,71,42,67,0,113,94.36619718309859,0
44784_marine,71,41,67,0,112,94.36619718309859,0
44785_marine,70,41,66,0,111,94.28571428571428,0
44786_marine,68,41,64,0,109,94.11764705882352,0
44787_marine,66,40,62,0,106,93.93939393939394,0
44788_marine,62,38,58,0,100,93.54838709677419,0
44789_marine,62,38,58,0,100,93.54838709677419,0
44790_marine,60,38,56,0,98,93.33333333333333,0
44791_marine,61,36,57,0,97,93.44262295081968,0
44792_marine,61,36,57,0,97,93.44262295081968,0
44793_marine,61,36,57,0,97,93.44262295081968,0
44794_marine,64,37,60,0,101,93.75,0
44795_marine,63,37,59,0,100,93.65079365079364,0
44796_marine,63,37,59,0,100,93.65079365079364,0
44797_marine,63,37,59,0,100,93.65079365079364,0
44798_marine,65,36,61,0,101,93.84615384615384,0
44799_marine,64,37,60,0,101,93.75,0
44800_marine,64,38,60,0,102,93.75,0
44801_marine,64,39,60,0,103,93.75,0
44802_marine,64,39,60,0,103,93.75,0
44803_marine,64,37,60,0,101,93.75,0
44804_marine,64,39,60,0,103,93.75,0
44805_marine,66,39,62,0,105,93.93939393939394,0
44806_marine,66,37,62,0,103,93.93939393939394,0
44807_marine,68,39,64,0,107,94.11764705882352,0
44808_marine,70,39,66,0,109,94.28571428571428,0
44809_marine,72,38,68,0,110,94.44444444444444,0
44810_marine,74,38,70,0,112,94.5945945945946,0
44811_marine,72,38,68,0,110,94.44444444444444,0
44812_marine,75,38,73,0,113,97.33333333333334,0
44813_marine,75,40,73,0,115,97.33333333333334,0
44814_marine,77,40,73,0,117,94.8051948051948,0
44815_marine,79,43,75,0,122,94.9367088607595,0
44816_marine,83,44,79,0,127,95.18072289156626,0
44817_marine,80,44,76,0,124,95,0
44818_marine,78,46,74,0,124,94.87179487179486,0
44819_marine,80,46,76,0,126,95,0
44820_marine,79,47,75,0,126,94.9367088607595,0
44821_marine,81,47,77,0,128,95.06172839506173,0
44822_marine,81,46,77,0,127,95.06172839506173,0
44823_marine,79,45,75,0,124,94.9367088607595,0
44824_marine,78,45,74,0,123,94.87179487179486,0
44825_marine,78,45,74,0,123,94.87179487179486,0
44826_marine,80,47,76,0,127,95,0
44827_marine,80,45,76,0,125,95,0
44828_marine,81,45,77,0,126,95.06172839506173,0
44829_marine,82,45,78,0,127,95.1219512195122,0
44830_marine,82,50,77,0,132,93.90243902439023,0
44831_marine,86,50,80,0,136,93.02325581395348,0
44832_marine,90,52,82,1,142,91.11111111111111,1.1111111111111112
44833_marine,91,53,83,1,144,91.20879120879121,1.098901098901099
44834_marine,93,57,85,1,150,91.39784946236558,1.0752688172043012
44835_marine,94,57,86,2,151,91.48936170212765,2.127659574468085
44836_marine,97,59,89,2,156,91.75257731958763,2.0618556701030926
44837_marine,108,86,98,3,194,90.74074074074075,2.7777777777777777
44838_marine,176,232,160,16,408,90.9090909090909,9.090909090909092
44847_marine,330,272,281,80,602,85.15151515151516,24.242424242424242
44848_marine,307,210,264,71,517,85.99348534201955,23.12703583061889
44849_marine,290,157,248,66,447,85.51724137931035,22.758620689655174
44850_marine,112,61,105,6,173,93.75,5.357142857142857
44851_marine,105,58,96,4,163,91.42857142857143,3.8095238095238098
44852_marine,102,58,94,4,160,92.15686274509804,3.9215686274509802
44853_marine,95,58,87,3,153,91.57894736842105,3.1578947368421053
44854_marine,89,58,82,1,147,92.13483146067416,1.1235955056179776
44855_marine,83,55,76,1,138,91.56626506024097,1.2048192771084338
44856_marine,77,55,72,1,132,93.5064935064935,1.2987012987012987
44857_marine,77,57,72,1,134,93.5064935064935,1.2987012987012987
44858_marine,76,53,72,1,129,94.73684210526315,1.3157894736842104
44859_marine,77,53,73,1,130,94.8051948051948,1.2987012987012987
44860_marine,79,53,75,1,132,94.9367088607595,1.2658227848101267
44861_marine,79,53,75,1,132,94.9367088607595,1.2658227848101267
44862_marine,79,54,75,1,133,94.9367088607595,1.2658227848101267
44863_marine,77,58,73,1,135,94.8051948051948,1.2987012987012987
44864_marine,77,68,73,1,145,94.8051948051948,1.2987012987012987
44865_marine,76,68,72,1,144,94.73684210526315,1.3157894736842104
44866_marine,76,66,72,1,142,94.73684210526315,1.3157894736842104
44867_marine,76,58,72,1,134,94.73684210526315,1.3157894736842104
44868_marine,76,58,72,1,134,94.73684210526315,1.3157894736842104
44869_marine,77,56,73,1,133,94.8051948051948,1.2987012987012987
44870_marine,77,56,73,1,133,94.8051948051948,1.2987012987012987
44871_marine,75,56,71,1,131,94.66666666666667,1.3333333333333335
44872_marine,75,55,71,1,130,94.66666666666667,1.3333333333333335
44873_marine,75,55,71,1,130,94.66666666666667,1.3333333333333335
44874_marine,74,56,70,1,130,94.5945945945946,1.3513513513513513
44875_marine,74,52,70,1,126,94.5945945945946,1.3513513513513513
44876_marine,72,52,68,1,124,94.44444444444444,1.3888888888888888
44877_marine,72,52,68,1,124,94.44444444444444,1.3888888888888888
44878_marine,71,52,67,1,123,94.36619718309859,1.4084507042253522
44879_marine,71,48,67,1,119,94.36619718309859,1.4084507042253522
44880_marine,71,48,67,1,119,94.36619718309859,1.4084507042253522
44881_marine,71,48,67,1,119,94.36619718309859,1.4084507042253522
44882_marine,70,48,66,0,118,94.28571428571428,0
44883_marine,70,48,66,0,118,94.28571428571428,0
44884_marine,70,48,66,0,118,94.28571428571428,0
44885_marine,70,48,66,0,118,94.28571428571428,0
44886_marine,69,46,65,0,115,94.20289855072464,0
44887_marine,70,46,66,1,116,94.28571428571428,1.4285714285714286
44888_marine,68,46,64,1,114,94.11764705882352,1.4705882352941175
44889_marine,68,46,64,1,114,94.11764705882352,1.4705882352941175
44890_marine,68,46,64,1,114,94.11764705882352,1.4705882352941175
44891_marine,69,46,65,1,115,94.20289855072464,1.4492753623188406
44892_marine,70,47,66,2,117,94.28571428571428,2.857142857142857
44893_marine,72,48,68,2,120,94.44444444444444,2.7777777777777777
44894_marine,72,48,68,2,120,94.44444444444444,2.7777777777777777
44895_marine,70,48,66,2,118,94.28571428571428,2.857142857142857
44896_marine,70,50,66,2,120,94.28571428571428,2.857142857142857
44897_marine,70,50,66,2,120,94.28571428571428,2.857142857142857
44898_marine,70,50,66,2,120,94.28571428571428,2.857142857142857
44899_marine,66,50,62,2,116,93.93939393939394,3.0303030303030303
44900_marine,66,48,62,2,114,93.93939393939394,3.0303030303030303
44901_marine,66,48,62,2,114,93.93939393939394,3.0303030303030303
44902_marine,66,49,62,2,115,93.93939393939394,3.0303030303030303
44903_marine,66,51,62,2,117,93.93939393939394,3.0303030303030303
44904_marine,66,51,62,2,117,93.93939393939394,3.0303030303030303
44905_marine,66,51,62,2,117,93.93939393939394,3.0303030303030303
44906_marine,66,49,62,2,115,93.93939393939394,3.0303030303030303
44907_marine,67,49,63,2,116,94.02985074626866,2.9850746268656714
44908_marine,65,49,61,2,114,93.84615384615384,3.076923076923077
44909_marine,65,47,61,2,112,93.84615384615384,3.076923076923077
44910_marine,65,47,61,2,112,93.84615384615384,3.076923076923077
44911_marine,65,47,61,2,112,93.84615384615384,3.076923076923077
44912_marine,66,47,62,2,113,93.93939393939394,3.0303030303030303
44913_marine,66,47,62,2,113,93.93939393939394,3.0303030303030303
44914_marine,66,49,62,2,115,93.93939393939394,3.0303030303030303
44915_marine,66,49,62,2,115,93.93939393939394,3.0303030303030303
44916_marine,66,47,62,2,113,93.93939393939394,3.0303030303030303
44917_marine,66,50,62,2,116,93.93939393939394,3.0303030303030303
44918_marine,67,50,63,2,117,94.02985074626866,2.9850746268656714
44919_marine,67,50,63,2,117,94.02985074626866,2.9850746268656714
44920_marine,66,50,62,1,116,93.93939393939394,1.5151515151515151
44921_marine,66,52,62,1,118,93.93939393939394,1.5151515151515151
44922_marine,67,52,63,0,119,94.02985074626866,0
44923_marine,68,51,63,0,119,92.64705882352942,0
44924_marine,68,51,63,0,119,92.64705882352942,0
44925_marine,68,51,63,0,119,92.64705882352942,0
44926_marine,68,51,63,0,119,92.64705882352942,0
44927_marine,68,54,63,0,122,92.64705882352942,0
44928_marine,70,55,65,0,125,92.85714285714286,0
44929_marine,70,55,65,0,125,92.85714285714286,0
44930_marine,72,54,67,0,126,93.05555555555556,0
44931_marine,71,56,66,0,127,92.95774647887323,0
44932_marine,79,60,73,1,139,92.40506329113924,1.2658227848101267
44933_marine,81,62,73,1,143,90.12345679012346,1.2345679012345678
44934_marine,104,95,92,6,199,88.46153846153845,5.769230769230769
44935_marine,229,262,180,51,491,78.60262008733623,22.270742358078603
44936_marine,381,392,221,191,773,58.00524934383202,50.13123359580053
44937_marine,354,365,199,186,719,56.21468926553672,52.54237288135594
44939_marine,374,411,201,206,785,53.7433155080214,55.080213903743314
44940_marine,376,407,203,202,783,53.98936170212766,53.72340425531915
44941_marine,202,244,155,46,446,76.73267326732673,22.772277227722775
44942_marine,300,299,183,138,599,61,46
44943_marine,348,388,200,174,736,57.47126436781609,50
44944_marine,344,373,200,168,717,58.139534883720934,48.837209302325576
44945_marine,193,248,152,39,441,78.75647668393782,20.207253886010363
44946_marine,177,229,139,30,406,78.53107344632768,16.94915254237288
44947_marine,93,88,84,4,181,90.32258064516128,4.301075268817205
44948_marine,89,87,81,3,176,91.01123595505618,3.3707865168539324
44949_marine,91,87,83,3,178,91.20879120879121,3.296703296703297
44950_marine,98,88,90,3,186,91.83673469387756,3.061224489795918
44951_marine,98,90,88,3,188,89.79591836734694,3.061224489795918
44952_marine,99,96,89,4,195,89.8989898989899,4.040404040404041
44953_marine,187,235,145,36,422,77.54010695187165,19.25133689839572
44954_marine,196,254,147,38,450,75,19.387755102040817
44955_marine,306,299,182,135,605,59.47712418300654,44.11764705882353
44956_marine,385,388,201,205,773,52.2077922077922,53.246753246753244
44973_marine,448,289,291,186,737,64.95535714285714,41.517857142857146
44974_marine,123,70,114,9,193,92.6829268292683,7.317073170731707
44975_marine,114,62,106,9,176,92.98245614035088,7.894736842105263
44976_marine,103,60,97,7,163,94.1747572815534,6.796116504854369
44977_marine,97,59,92,6,156,94.84536082474226,6.185567010309279
44978_marine,97,60,92,6,157,94.84536082474226,6.185567010309279
44979_marine,91,62,86,4,153,94.5054945054945,4.395604395604396
44980_marine,91,63,86,4,154,94.5054945054945,4.395604395604396
44981_marine,88,61,84,4,149,95.45454545454545,4.545454545454546
44982_marine,88,61,84,4,149,95.45454545454545,4.545454545454546
44983_marine,89,64,85,4,153,95.50561797752809,4.49438202247191
44984_marine,90,65,86,4,155,95.55555555555556,4.444444444444445
44985_marine,91,66,87,4,157,95.6043956043956,4.395604395604396
44986_marine,91,69,87,4,160,95.6043956043956,4.395604395604396
44987_marine,91,68,87,4,159,95.6043956043956,4.395604395604396
44988_marine,94,78,90,4,172,95.74468085106383,4.25531914893617
44989_marine,92,84,88,4,176,95.65217391304348,4.3478260869565215
44990_marine,98,94,94,4,192,95.91836734693877,4.081632653061225
44991_marine,109,119,104,4,228,95.41284403669725,3.669724770642202
44992_marine,183,226,162,24,409,88.52459016393442,13.114754098360656
44995_marine,210,241,180,42,451,85.71428571428571,20
44996_marine,197,236,172,36,433,87.30964467005076,18.274111675126903
44997_marine,120,124,115,5,244,95.83333333333334,4.166666666666666
44998_marine,108,76,103,3,184,95.37037037037037,2.7777777777777777
44999_marine,106,75,101,3,181,95.28301886792453,2.8301886792452833
45000_marine,94,71,89,2,165,94.68085106382979,2.127659574468085
45001_marine,88,69,84,2,157,95.45454545454545,2.272727272727273
45002_marine,83,57,79,0,140,95.18072289156626,0
45003_marine,81,57,77,0,138,95.06172839506173,0
45004_marine,81,56,77,0,137,95.06172839506173,0
45005_marine,81,54,77,0,135,95.06172839506173,0
45006_marine,81,53,77,0,134,95.06172839506173,0
45007_marine,81,52,77,0,133,95.06172839506173,0
45008_marine,78,48,74,0,126,94.87179487179486,0
45009_marine,78,47,74,1,125,94.87179487179486,1.282051282051282
45010_marine,77,46,73,1,123,94.8051948051948,1.2987012987012987
45011_marine,79,45,75,1,124,94.9367088607595,1.2658227848101267
45012_marine,76,44,73,1,120,96.05263157894737,1.3157894736842104
45013_marine,76,44,73,1,120,96.05263157894737,1.3157894736842104
45014_marine,76,43,73,1,119,96.05263157894737,1.3157894736842104
45015_marine,75,43,72,1,118,96,1.3333333333333335
45016_marine,74,41,71,1,115,95.94594594594594,1.3513513513513513
45017_marine,74,41,71,1,115,95.94594594594594,1.3513513513513513
45018_marine,74,40,71,1,114,95.94594594594594,1.3513513513513513
45019_marine,74,40,71,1,114,95.94594594594594,1.3513513513513513
45020_marine,74,40,71,1,114,95.94594594594594,1.3513513513513513
45021_marine,74,39,71,1,113,95.94594594594594,1.3513513513513513
45022_marine,72,39,69,1,111,95.83333333333334,1.3888888888888888
45023_marine,70,38,67,1,108,95.71428571428572,1.4285714285714286
45024_marine,69,39,66,1,108,95.65217391304348,1.4492753623188406
45025_marine,69,38,66,1,107,95.65217391304348,1.4492753623188406
45026_marine,69,38,66,1,107,95.65217391304348,1.4492753623188406
45027_marine,69,38,66,1,107,95.65217391304348,1.4492753623188406
45028_marine,69,38,66,1,107,95.65217391304348,1.4492753623188406
45029_marine,69,36,66,1,105,95.65217391304348,1.4492753623188406
45030_marine,70,35,67,1,105,95.71428571428572,1.4285714285714286
45031_marine,68,35,65,1,103,95.58823529411765,1.4705882352941175
45032_marine,65,35,62,1,100,95.38461538461539,1.5384615384615385
45033_marine,64,35,61,1,99,95.3125,1.5625
45034_marine,64,35,61,1,99,95.3125,1.5625
45035_marine,64,35,61,1,99,95.3125,1.5625
45036_marine,64,35,61,1,99,95.3125,1.5625
45037_marine,64,35,61,1,99,95.3125,1.5625
45038_marine,64,35,61,1,99,95.3125,1.5625
45039_marine,64,35,61,1,99,95.3125,1.5625
45040_marine,64,35,61,1,99,95.3125,1.5625
45041_marine,63,35,60,1,98,95.23809523809523,1.5873015873015872
45042_marine,64,35,61,1,99,95.3125,1.5625
45043_marine,64,35,61,1,99,95.3125,1.5625
45044_marine,64,35,61,1,99,95.3125,1.5625
45045_marine,64,35,61,1,99,95.3125,1.5625
45046_marine,64,35,61,1,99,95.3125,1.5625
45047_marine,64,35,61,1,99,95.3125,1.5625
45048_marine,64,35,61,1,99,95.3125,1.5625
45049_marine,64,35,61,1,99,95.3125,1.5625
45050_marine,64,35,61,1,99,95.3125,1.5625
45051_marine,64,35,61,1,99,95.3125,1.5625
45052_marine,62,35,59,1,97,95.16129032258065,1.6129032258064515
45053_marine,62,37,59,1,99,95.16129032258065,1.6129032258064515
45054_marine,58,37,55,1,95,94.82758620689656,1.7241379310344827
45055_marine,58,37,55,1,95,94.82758620689656,1.7241379310344827
45056_marine,60,38,57,1,98,95,1.6666666666666667
45057_marine,60,38,57,1,98,95,1.6666666666666667
45058_marine,62,39,59,3,101,95.16129032258065,4.838709677419355
45059_marine,62,39,59,3,101,95.16129032258065,4.838709677419355
45060_marine,62,39,59,3,101,95.16129032258065,4.838709677419355
45061_marine,62,39,59,3,101,95.16129032258065,4.838709677419355
45062_marine,63,39,60,3,102,95.23809523809523,4.761904761904762
45063_marine,63,39,60,3,102,95.23809523809523,4.761904761904762
45064_marine,62,39,59,3,101,95.16129032258065,4.838709677419355
45065_marine,62,39,59,3,101,95.16129032258065,4.838709677419355
45066_marine,62,40,59,3,102,95.16129032258065,4.838709677419355
45067_marine,62,40,59,3,102,95.16129032258065,4.838709677419355
45068_marine,62,40,59,3,102,95.16129032258065,4.838709677419355
45069_marine,62,40,59,3,102,95.16129032258065,4.838709677419355
45070_marine,59,40,56,2,99,94.91525423728814,3.389830508474576
45071_marine,58,40,55,2,98,94.82758620689656,3.4482758620689653
45072_marine,58,40,55,2,98,94.82758620689656,3.4482758620689653
45073_marine,58,40,55,2,98,94.82758620689656,3.4482758620689653
45074_marine,55,40,52,2,95,94.54545454545455,3.6363636363636362
45075_marine,55,40,52,2,95,94.54545454545455,3.6363636363636362
45076_marine,55,40,52,2,95,94.54545454545455,3.6363636363636362
45077_marine,55,40,52,2,95,94.54545454545455,3.6363636363636362
45078_marine,55,40,52,2,95,94.54545454545455,3.6363636363636362
45079_marine,55,40,52,2,95,94.54545454545455,3.6363636363636362
45080_marine,55,40,52,2,95,94.54545454545455,3.6363636363636362
45081_marine,53,41,50,2,94,94.33962264150944,3.7735849056603774
45082_marine,53,41,50,2,94,94.33962264150944,3.7735849056603774
45083_marine,53,40,50,2,93,94.33962264150944,3.7735849056603774
45084_marine,53,40,50,2,93,94.33962264150944,3.7735849056603774
45085_marine,53,42,50,2,95,94.33962264150944,3.7735849056603774
45086_marine,51,44,48,2,95,94.11764705882352,3.9215686274509802
45087_marine,51,44,48,2,95,94.11764705882352,3.9215686274509802
45088_marine,52,45,49,2,97,94.23076923076923,3.8461538461538463
45089_marine,52,43,49,2,95,94.23076923076923,3.8461538461538463
45090_marine,52,42,49,2,94,94.23076923076923,3.8461538461538463
45091_marine,52,42,49,2,94,94.23076923076923,3.8461538461538463
45092_marine,52,42,49,2,94,94.23076923076923,3.8461538461538463
45093_marine,53,41,50,2,94,94.33962264150944,3.7735849056603774
45094_marine,53,44,50,2,97,94.33962264150944,3.7735849056603774
45095_marine,51,44,48,2,95,94.11764705882352,3.9215686274509802
45096_marine,55,44,52,2,99,94.54545454545455,3.6363636363636362
45097_marine,56,45,53,2,101,94.64285714285714,3.571428571428571
45098_marine,53,46,50,2,99,94.33962264150944,3.7735849056603774
45099_marine,55,49,51,2,104,92.72727272727272,3.6363636363636362
45100_marine,56,50,51,3,106,91.07142857142857,5.357142857142857
45101_marine,56,50,51,3,106,91.07142857142857,5.357142857142857
45102_marine,53,50,47,3,103,88.67924528301887,5.660377358490567
45103_marine,54,50,48,3,104,88.88888888888889,5.555555555555555
45104_marine,56,55,50,3,111,89.28571428571429,5.357142857142857
45105_marine,57,55,53,3,112,92.98245614035088,5.263157894736842
45106_marine,67,55,62,7,122,92.53731343283582,10.44776119402985
45107_marine,108,130,91,20,238,84.25925925925925,18.51851851851852
45124_marine,155,164,139,15,319,89.6774193548387,9.67741935483871
45125_marine,166,181,149,17,347,89.7590361445783,10.240963855421686
45126_marine,193,207,174,28,400,90.15544041450777,14.507772020725387
45127_marine,186,208,174,19,394,93.54838709677419,10.21505376344086
45128_marine,184,196,175,17,380,95.1086956521739,9.239130434782608
45129_marine,109,86,104,2,195,95.41284403669725,1.834862385321101
45130_marine,106,64,101,2,170,95.28301886792453,1.8867924528301887
45131_marine,86,53,81,0,139,94.18604651162791,0
45132_marine,84,48,79,0,132,94.04761904761905,0
45133_marine,80,47,76,0,127,95,0
45134_marine,80,47,77,0,127,96.25,0
45135_marine,80,48,76,0,128,95,0
45136_marine,76,48,72,0,124,94.73684210526315,0
45137_marine,76,46,72,0,122,94.73684210526315,0
45138_marine,75,46,71,0,121,94.66666666666667,0
45139_marine,69,45,65,0,114,94.20289855072464,0
45140_marine,67,45,63,0,112,94.02985074626866,0
45141_marine,67,45,63,0,112,94.02985074626866,0
45142_marine,66,44,62,0,110,93.93939393939394,0
45143_marine,66,43,62,0,109,93.93939393939394,0
45144_marine,66,43,62,0,109,93.93939393939394,0
45145_marine,66,43,62,0,109,93.93939393939394,0
45146_marine,66,43,62,0,109,93.93939393939394,0
45147_marine,63,43,59,0,106,93.65079365079364,0
45148_marine,63,41,59,0,104,93.65079365079364,0
45149_marine,63,41,59,0,104,93.65079365079364,0
45150_marine,63,41,59,0,104,93.65079365079364,0
45151_marine,63,41,59,0,104,93.65079365079364,0
45152_marine,62,41,58,0,103,93.54838709677419,0
45153_marine,65,41,61,0,106,93.84615384615384,0
45154_marine,66,40,62,0,106,93.93939393939394,0
45155_marine,65,40,61,0,105,93.84615384615384,0
45156_marine,65,39,61,0,104,93.84615384615384,0
45157_marine,65,38,61,0,103,93.84615384615384,0
45158_marine,66,39,62,0,105,93.93939393939394,0
45159_marine,66,39,62,0,105,93.93939393939394,0
45160_marine,65,39,61,0,104,93.84615384615384,0
45161_marine,65,38,61,0,103,93.84615384615384,0
45162_marine,67,38,63,0,105,94.02985074626866,0
45163_marine,67,38,63,0,105,94.02985074626866,0
45164_marine,67,40,63,0,107,94.02985074626866,0
45165_marine,68,40,64,0,108,94.11764705882352,0
45166_marine,68,44,64,0,112,94.11764705882352,0
45167_marine,68,45,66,2,113,97.05882352941177,2.941176470588235
45168_marine,69,47,67,2,116,97.10144927536231,2.898550724637681
45169_marine,69,47,67,2,116,97.10144927536231,2.898550724637681
45170_marine,65,47,63,0,112,96.92307692307692,0
45171_marine,65,49,63,0,114,96.92307692307692,0
45172_marine,65,49,63,0,114,96.92307692307692,0
45173_marine,67,49,65,0,116,97.01492537313433,0
45174_marine,67,51,65,0,118,97.01492537313433,0
45175_marine,67,50,65,0,117,97.01492537313433,0
45176_marine,65,50,63,0,115,96.92307692307692,0
45177_marine,67,48,65,0,115,97.01492537313433,0
45178_marine,69,48,67,0,117,97.10144927536231,0
45179_marine,69,46,67,0,115,97.10144927536231,0
45180_marine,75,45,73,0,120,97.33333333333334,0
45181_marine,75,45,73,0,120,97.33333333333334,0
45182_marine,73,46,71,0,119,97.26027397260275,0
45183_marine,72,46,70,0,118,97.22222222222221,0
45184_marine,72,45,70,0,117,97.22222222222221,0
45185_marine,70,45,68,0,115,97.14285714285714,0
45186_marine,70,47,68,0,117,97.14285714285714,0
45187_marine,70,47,68,0,117,97.14285714285714,0
45188_marine,71,48,69,0,119,97.1830985915493,0
45189_marine,72,46,68,0,118,94.44444444444444,0
45190_marine,75,46,70,0,121,93.33333333333333,0
45191_marine,78,48,73,0,126,93.58974358974359,0
45192_marine,81,50,74,0,131,91.35802469135803,0
45193_marine,83,54,75,1,137,90.36144578313254,1.2048192771084338
45194_marine,85,55,77,1,140,90.58823529411765,1.1764705882352942
45195_marine,85,59,77,1,144,90.58823529411765,1.1764705882352942
45196_marine,90,60,82,2,150,91.11111111111111,2.2222222222222223
45197_marine,91,67,83,2,158,91.20879120879121,2.197802197802198
45198_marine,148,155,136,8,303,91.8918918918919,5.405405405405405
45199_marine,194,253,178,16,447,91.75257731958763,8.24742268041237
45200_marine,222,255,200,27,477,90.09009009009009,12.162162162162163
45201_marine,231,222,209,28,453,90.47619047619048,12.121212121212121
45202_marine,227,231,207,28,458,91.18942731277532,12.334801762114537
45203_marine,233,241,208,33,474,89.27038626609442,14.163090128755366
45204_marine,230,233,201,36,463,87.39130434782608,15.65217391304348
45205_marine,242,205,211,38,447,87.19008264462809,15.702479338842975
45206_marine,247,183,212,42,430,85.82995951417004,17.00404858299595
45207_marine,145,93,118,30,238,81.37931034482759,20.689655172413794
45208_marine,109,67,102,7,176,93.57798165137615,6.422018348623854
45209_marine,104,60,97,3,164,93.26923076923077,2.8846153846153846
45210_marine,95,56,88,3,151,92.63157894736842,3.1578947368421053
45211_marine,93,56,87,3,149,93.54838709677419,3.225806451612903
45212_marine,87,56,81,3,143,93.10344827586206,3.4482758620689653
45213_marine,81,52,75,1,133,92.5925925925926,1.2345679012345678
45214_marine,77,52,71,2,129,92.20779220779221,2.5974025974025974
45215_marine,77,52,71,2,129,92.20779220779221,2.5974025974025974
45216_marine,75,52,69,2,127,92,2.666666666666667
45217_marine,74,51,69,2,125,93.24324324324324,2.7027027027027026
45218_marine,74,50,69,2,124,93.24324324324324,2.7027027027027026
45219_marine,71,52,67,1,123,94.36619718309859,1.4084507042253522
45220_marine,71,52,67,1,123,94.36619718309859,1.4084507042253522
45221_marine,73,53,69,1,126,94.52054794520548,1.36986301369863
45222_marine,73,54,69,1,127,94.52054794520548,1.36986301369863
45223_marine,72,58,68,1,130,94.44444444444444,1.3888888888888888
45224_marine,76,62,72,1,138,94.73684210526315,1.3157894736842104
45225_marine,76,70,72,1,146,94.73684210526315,1.3157894736842104
45226_marine,74,58,70,1,132,94.5945945945946,1.3513513513513513
45227_marine,74,58,70,1,132,94.5945945945946,1.3513513513513513
45228_marine,74,56,70,1,130,94.5945945945946,1.3513513513513513
45229_marine,75,56,71,1,131,94.66666666666667,1.3333333333333335
45230_marine,75,56,71,1,131,94.66666666666667,1.3333333333333335
45231_marine,75,56,71,1,131,94.66666666666667,1.3333333333333335
45232_marine,73,56,69,1,129,94.52054794520548,1.36986301369863
45233_marine,73,56,69,1,129,94.52054794520548,1.36986301369863
45234_marine,75,53,71,2,128,94.66666666666667,2.666666666666667
45235_marine,71,52,67,1,123,94.36619718309859,1.4084507042253522
45236_marine,71,52,67,1,123,94.36619718309859,1.4084507042253522
45237_marine,70,52,66,1,122,94.28571428571428,1.4285714285714286
45238_marine,70,50,66,1,120,94.28571428571428,1.4285714285714286
45239_marine,70,50,66,1,120,94.28571428571428,1.4285714285714286
45240_marine,71,50,67,0,121,94.36619718309859,0
45241_marine,71,50,67,0,121,94.36619718309859,0
45242_marine,71,50,67,0,121,94.36619718309859,0
45243_marine,71,50,67,0,121,94.36619718309859,0
45244_marine,71,50,67,0,121,94.36619718309859,0
45245_marine,70,50,66,0,120,94.28571428571428,0
45246_marine,68,50,64,0,118,94.11764705882352,0
45247_marine,65,50,61,0,115,93.84615384615384,0
45248_marine,65,50,61,0,115,93.84615384615384,0
45249_marine,66,50,62,1,116,93.93939393939394,1.5151515151515151
45250_marine,66,49,62,1,115,93.93939393939394,1.5151515151515151
45251_marine,67,49,63,1,116,94.02985074626866,1.4925373134328357
45252_marine,65,50,61,1,115,93.84615384615384,1.5384615384615385
45253_marine,66,50,62,2,116,93.93939393939394,3.0303030303030303
45254_marine,66,50,62,2,116,93.93939393939394,3.0303030303030303
45255_marine,66,50,62,2,116,93.93939393939394,3.0303030303030303
45256_marine,60,52,56,2,112,93.33333333333333,3.3333333333333335
45257_marine,60,52,56,2,112,93.33333333333333,3.3333333333333335
45258_marine,58,50,54,2,108,93.10344827586206,3.4482758620689653
45259_marine,60,50,56,2,110,93.33333333333333,3.3333333333333335
45260_marine,61,50,57,2,111,93.44262295081968,3.278688524590164
45261_marine,59,50,55,2,109,93.22033898305084,3.389830508474576
45262_marine,58,50,54,2,108,93.10344827586206,3.4482758620689653
45263_marine,58,51,54,2,109,93.10344827586206,3.4482758620689653
45264_marine,58,49,54,2,107,93.10344827586206,3.4482758620689653
45265_marine,58,49,54,2,107,93.10344827586206,3.4482758620689653
45266_marine,58,49,54,2,107,93.10344827586206,3.4482758620689653
45267_marine,60,49,56,2,109,93.33333333333333,3.3333333333333335
45268_marine,61,49,57,2,110,93.44262295081968,3.278688524590164
45269_marine,61,51,57,2,112,93.44262295081968,3.278688524590164
45270_marine,63,49,59,2,112,93.65079365079364,3.1746031746031744
45271_marine,62,49,58,2,111,93.54838709677419,3.225806451612903
45272_marine,64,49,60,2,113,93.75,3.125
45273_marine,64,49,60,2,113,93.75,3.125
45274_marine,64,49,60,2,113,93.75,3.125
45275_marine,64,50,60,2,114,93.75,3.125
45276_marine,64,50,60,2,114,93.75,3.125
45277_marine,64,50,60,2,114,93.75,3.125
45278_marine,62,50,58,2,112,93.54838709677419,3.225806451612903
45279_marine,61,50,57,0,111,93.44262295081968,0
45280_marine,61,50,57,0,111,93.44262295081968,0
45281_marine,62,50,57,0,112,91.93548387096774,0
45282_marine,62,51,57,0,113,91.93548387096774,0
45283_marine,64,51,59,0,115,92.1875,0
45284_marine,66,51,61,0,117,92.42424242424242,0
45285_marine,66,52,61,0,118,92.42424242424242,0
45286_marine,66,53,61,0,119,92.42424242424242,0
45287_marine,66,55,61,0,121,92.42424242424242,0
45288_marine,66,55,61,0,121,92.42424242424242,0
45289_marine,67,55,62,0,122,92.53731343283582,0
45290_marine,66,55,61,0,121,92.42424242424242,0
45291_marine,69,54,64,0,123,92.7536231884058,0
45292_marine,71,58,66,0,129,92.95774647887323,0
45293_marine,76,59,70,1,135,92.10526315789474,1.3157894736842104
45294_marine,89,92,78,5,181,87.64044943820225,5.617977528089887
45295_marine,193,240,147,45,433,76.16580310880829,23.316062176165804
45296_marine,207,252,160,49,459,77.29468599033817,23.67149758454106
45297_marine,367,390,206,191,757,56.13079019073569,52.043596730245234
45298_marine,384,389,214,203,773,55.729166666666664,52.864583333333336
45299_marine,378,391,211,200,769,55.82010582010582,52.910052910052904
45300_marine,190,234,147,43,424,77.36842105263158,22.63157894736842
45301_marine,174,218,131,39,392,75.28735632183908,22.413793103448278
45302_marine,171,224,130,36,395,76.0233918128655,21.052631578947366
45303_marine,170,226,129,34,396,75.88235294117646,20
45304_marine,167,226,128,32,393,76.64670658682635,19.16167664670659
45305_marine,166,216,126,33,382,75.90361445783132,19.879518072289155
45306_marine,85,84,74,3,169,87.05882352941177,3.5294117647058822
45307_marine,74,58,68,0,132,91.8918918918919,0
45308_marine,70,58,64,0,128,91.42857142857143,0
45309_marine,70,56,64,0,126,91.42857142857143,0
45310_marine,70,54,64,0,124,91.42857142857143,0
45311_marine,73,60,67,0,133,91.78082191780823,0
45312_marine,75,60,69,0,135,92,0
45313_marine,98,88,88,5,186,89.79591836734694,5.1020408163265305
45314_marine,191,248,146,37,439,76.43979057591623,19.3717277486911
45315_marine,201,259,151,40,460,75.12437810945273,19.900497512437813
45316_marine,386,375,211,197,761,54.66321243523316,51.03626943005182
45332_marine,386,323,261,140,709,67.61658031088082,36.26943005181347
45333_marine,146,114,134,13,260,91.78082191780823,8.904109589041095
45334_marine,116,65,107,8,181,92.24137931034483,6.896551724137931
45335_marine,109,62,101,6,171,92.66055045871559,5.5045871559633035
45336_marine,98,61,92,5,159,93.87755102040816,5.1020408163265305
45337_marine,96,59,91,5,155,94.79166666666666,5.208333333333334
45338_marine,95,60,90,4,155,94.73684210526315,4.2105263157894735
45339_marine,91,62,86,4,153,94.5054945054945,4.395604395604396
45340_marine,91,63,86,4,154,94.5054945054945,4.395604395604396
45341_marine,90,63,86,4,153,95.55555555555556,4.444444444444445
45342_marine,91,66,87,4,157,95.6043956043956,4.395604395604396
45343_marine,89,66,85,4,155,95.50561797752809,4.49438202247191
45344_marine,91,66,87,4,157,95.6043956043956,4.395604395604396
45345_marine,90,69,86,4,159,95.55555555555556,4.444444444444445
45346_marine,90,71,86,4,161,95.55555555555556,4.444444444444445
45347_marine,93,72,89,4,165,95.6989247311828,4.301075268817205
45348_marine,91,79,87,4,170,95.6043956043956,4.395604395604396
45349_marine,96,89,92,4,185,95.83333333333334,4.166666666666666
45350_marine,99,95,95,4,194,95.95959595959596,4.040404040404041
45351_marine,107,86,102,3,193,95.32710280373831,2.803738317757009
45352_marine,175,217,157,22,392,89.71428571428571,12.571428571428573
45353_marine,194,233,170,32,427,87.62886597938144,16.49484536082474
45356_marine,238,268,198,60,506,83.19327731092437,25.210084033613445
45357_marine,200,241,177,32,441,88.5,16
45358_marine,116,86,110,6,202,94.82758620689656,5.172413793103448
45359_marine,112,83,107,5,195,95.53571428571429,4.464285714285714
45360_marine,104,76,99,3,180,95.1923076923077,2.8846153846153846
45361_marine,89,73,85,3,162,95.50561797752809,3.3707865168539324
45362_marine,83,61,79,0,144,95.18072289156626,0
45363_marine,82,59,78,0,141,95.1219512195122,0
45364_marine,81,56,77,0,137,95.06172839506173,0
45365_marine,81,54,77,0,135,95.06172839506173,0
45366_marine,80,54,76,0,134,95,0
45367_marine,80,52,76,0,132,95,0
45368_marine,79,52,75,0,131,94.9367088607595,0
45369_marine,76,51,72,0,127,94.73684210526315,0
45370_marine,76,51,72,0,127,94.73684210526315,0
45371_marine,76,53,72,0,129,94.73684210526315,0
45372_marine,74,44,71,0,118,95.94594594594594,0
45373_marine,73,43,70,0,116,95.8904109589041,0
45374_marine,72,43,69,0,115,95.83333333333334,0
45375_marine,71,41,68,0,112,95.77464788732394,0
45376_marine,71,41,68,0,112,95.77464788732394,0
45377_marine,71,41,68,0,112,95.77464788732394,0
45378_marine,71,41,68,0,112,95.77464788732394,0
45379_marine,69,40,66,0,109,95.65217391304348,0
45380_marine,69,40,66,0,109,95.65217391304348,0
45381_marine,69,40,66,0,109,95.65217391304348,0
45382_marine,69,40,66,1,109,95.65217391304348,1.4492753623188406
45383_marine,69,40,66,1,109,95.65217391304348,1.4492753623188406
45384_marine,71,39,68,1,110,95.77464788732394,1.4084507042253522
45385_marine,71,38,68,1,109,95.77464788732394,1.4084507042253522
45386_marine,71,39,68,1,110,95.77464788732394,1.4084507042253522
45387_marine,68,39,65,1,107,95.58823529411765,1.4705882352941175
45388_marine,68,39,65,1,107,95.58823529411765,1.4705882352941175
45389_marine,67,37,64,1,104,95.52238805970148,1.4925373134328357
45390_marine,66,37,63,1,103,95.45454545454545,1.5151515151515151
45391_marine,66,37,63,1,103,95.45454545454545,1.5151515151515151
45392_marine,65,37,62,1,102,95.38461538461539,1.5384615384615385
45393_marine,65,37,62,1,102,95.38461538461539,1.5384615384615385
45394_marine,65,37,62,1,102,95.38461538461539,1.5384615384615385
45395_marine,65,37,62,1,102,95.38461538461539,1.5384615384615385
45396_marine,65,37,62,1,102,95.38461538461539,1.5384615384615385
45397_marine,65,37,62,1,102,95.38461538461539,1.5384615384615385
45398_marine,65,37,62,1,102,95.38461538461539,1.5384615384615385
45399_marine,64,36,61,1,100,95.3125,1.5625
45400_marine,64,36,61,1,100,95.3125,1.5625
45401_marine,64,38,61,1,102,95.3125,1.5625
45402_marine,64,38,61,1,102,95.3125,1.5625
45403_marine,64,38,61,1,102,95.3125,1.5625
45404_marine,60,38,57,1,98,95,1.6666666666666667
45405_marine,60,38,57,1,98,95,1.6666666666666667
45406_marine,60,38,57,1,98,95,1.6666666666666667
45407_marine,60,38,57,1,98,95,1.6666666666666667
45408_marine,60,38,57,1,98,95,1.6666666666666667
45409_marine,58,38,55,1,96,94.82758620689656,1.7241379310344827
45410_marine,58,39,55,1,97,94.82758620689656,1.7241379310344827
45411_marine,58,39,55,1,97,94.82758620689656,1.7241379310344827
45412_marine,58,39,55,1,97,94.82758620689656,1.7241379310344827
45413_marine,58,39,55,1,97,94.82758620689656,1.7241379310344827
45414_marine,58,39,55,1,97,94.82758620689656,1.7241379310344827
45415_marine,58,39,55,1,97,94.82758620689656,1.7241379310344827
45416_marine,56,39,53,1,95,94.64285714285714,1.7857142857142856
45417_marine,56,39,53,1,95,94.64285714285714,1.7857142857142856
45418_marine,56,39,53,1,95,94.64285714285714,1.7857142857142856
45419_marine,56,39,53,1,95,94.64285714285714,1.7857142857142856
45420_marine,56,39,53,1,95,94.64285714285714,1.7857142857142856
45421_marine,56,39,53,1,95,94.64285714285714,1.7857142857142856
45422_marine,56,39,53,1,95,94.64285714285714,1.7857142857142856
45423_marine,57,39,54,1,96,94.73684210526315,1.7543859649122806
45424_marine,57,39,54,1,96,94.73684210526315,1.7543859649122806
45425_marine,56,39,53,1,95,94.64285714285714,1.7857142857142856
45426_marine,58,40,55,3,98,94.82758620689656,5.172413793103448
45427_marine,58,40,55,3,98,94.82758620689656,5.172413793103448
45428_marine,57,40,54,2,97,94.73684210526315,3.508771929824561
45429_marine,57,40,54,2,97,94.73684210526315,3.508771929824561
45430_marine,57,40,54,2,97,94.73684210526315,3.508771929824561
45431_marine,57,40,54,2,97,94.73684210526315,3.508771929824561
45432_marine,57,40,54,2,97,94.73684210526315,3.508771929824561
45433_marine,57,40,54,2,97,94.73684210526315,3.508771929824561
45434_marine,55,40,52,2,95,94.54545454545455,3.6363636363636362
45435_marine,54,41,51,2,95,94.44444444444444,3.7037037037037033
45436_marine,54,41,51,2,95,94.44444444444444,3.7037037037037033
45437_marine,54,41,51,2,95,94.44444444444444,3.7037037037037033
45438_marine,54,40,51,2,94,94.44444444444444,3.7037037037037033
45439_marine,54,40,51,2,94,94.44444444444444,3.7037037037037033
45440_marine,54,40,51,2,94,94.44444444444444,3.7037037037037033
45441_marine,54,41,51,2,95,94.44444444444444,3.7037037037037033
45442_marine,54,41,51,2,95,94.44444444444444,3.7037037037037033
45443_marine,52,42,49,2,94,94.23076923076923,3.8461538461538463
45444_marine,52,42,49,2,94,94.23076923076923,3.8461538461538463
45445_marine,52,42,49,2,94,94.23076923076923,3.8461538461538463
45446_marine,52,44,49,2,96,94.23076923076923,3.8461538461538463
45447_marine,52,44,49,2,96,94.23076923076923,3.8461538461538463
45448_marine,50,43,47,2,93,94,4
45449_marine,50,42,47,2,92,94,4
45450_marine,50,41,47,2,91,94,4
45451_marine,50,41,47,2,91,94,4
45452_marine,51,41,48,2,92,94.11764705882352,3.9215686274509802
45453_marine,51,41,48,2,92,94.11764705882352,3.9215686274509802
45454_marine,49,44,46,2,93,93.87755102040816,4.081632653061225
45455_marine,49,44,46,2,93,93.87755102040816,4.081632653061225
45456_marine,51,44,48,2,95,94.11764705882352,3.9215686274509802
45457_marine,51,47,48,2,98,94.11764705882352,3.9215686274509802
45458_marine,51,47,48,2,98,94.11764705882352,3.9215686274509802
45459_marine,52,50,48,2,102,92.3076923076923,3.8461538461538463
45460_marine,54,51,49,3,105,90.74074074074075,5.555555555555555
45461_marine,52,51,49,3,103,94.23076923076923,5.769230769230769
45462_marine,51,52,47,3,103,92.15686274509804,5.88235294117647
45463_marine,52,52,48,3,104,92.3076923076923,5.769230769230769
45464_marine,54,56,50,3,110,92.5925925925926,5.555555555555555
45465_marine,57,56,53,4,113,92.98245614035088,7.017543859649122
45466_marine,90,84,81,7,174,90,7.777777777777778
45485_marine,148,194,136,14,342,91.8918918918919,9.45945945945946
45486_marine,156,207,147,13,363,94.23076923076923,8.333333333333332
45487_marine,160,203,151,12,363,94.375,7.5
45488_marine,103,103,98,2,206,95.14563106796116,1.9417475728155338
45489_marine,96,71,91,0,167,94.79166666666666,0
45490_marine,86,59,81,0,145,94.18604651162791,0
45491_marine,82,49,77,0,131,93.90243902439023,0
45492_marine,80,49,75,0,129,93.75,0
45493_marine,78,49,75,0,127,96.15384615384616,0
45494_marine,75,50,72,0,125,96,0
45495_marine,73,48,70,0,121,95.8904109589041,0
45496_marine,72,46,69,0,118,95.83333333333334,0
45497_marine,71,46,68,0,117,95.77464788732394,0
45498_marine,66,46,63,0,112,95.45454545454545,0
45499_marine,65,46,62,0,111,95.38461538461539,0
45500_marine,64,46,61,0,110,95.3125,0
45501_marine,64,46,61,0,110,95.3125,0
45502_marine,64,47,61,0,111,95.3125,0
45503_marine,64,47,61,0,111,95.3125,0
45504_marine,64,45,61,0,109,95.3125,0
45505_marine,64,44,61,0,108,95.3125,0
45506_marine,60,44,57,0,104,95,0
45507_marine,62,44,59,0,106,95.16129032258065,0
45508_marine,62,44,59,0,106,95.16129032258065,0
45509_marine,62,45,59,0,107,95.16129032258065,0
45510_marine,63,45,60,0,108,95.23809523809523,0
45511_marine,64,45,61,0,109,95.3125,0
45512_marine,64,45,61,0,109,95.3125,0
45513_marine,65,45,62,0,110,95.38461538461539,0
45514_marine,64,41,61,0,105,95.3125,0
45515_marine,64,42,61,0,106,95.3125,0
45516_marine,64,42,61,0,106,95.3125,0
45517_marine,62,41,59,0,103,95.16129032258065,0
45518_marine,63,43,60,0,106,95.23809523809523,0
45519_marine,63,42,60,0,105,95.23809523809523,0
45520_marine,63,43,60,0,106,95.23809523809523,0
45521_marine,65,41,62,0,106,95.38461538461539,0
45522_marine,63,41,62,0,104,98.4126984126984,0
45523_marine,63,44,62,0,107,98.4126984126984,0
45524_marine,63,46,62,0,109,98.4126984126984,0
45525_marine,63,50,62,0,113,98.4126984126984,0
45526_marine,61,51,60,0,112,98.36065573770492,0
45527_marine,64,59,63,2,123,98.4375,3.125
45528_marine,62,59,61,2,121,98.38709677419355,3.225806451612903
45529_marine,62,59,61,2,121,98.38709677419355,3.225806451612903
45530_marine,64,50,63,2,114,98.4375,3.125
45531_marine,62,49,61,0,111,98.38709677419355,0
45532_marine,62,49,61,0,111,98.38709677419355,0
45533_marine,64,52,63,0,116,98.4375,0
45534_marine,62,50,61,0,112,98.38709677419355,0
45535_marine,63,50,61,0,113,96.82539682539682,0
45536_marine,63,49,61,0,112,96.82539682539682,0
45537_marine,63,49,61,0,112,96.82539682539682,0
45538_marine,63,48,61,0,111,96.82539682539682,0
45539_marine,63,47,61,0,110,96.82539682539682,0
45540_marine,65,47,63,0,112,96.92307692307692,0
45541_marine,64,49,62,0,113,96.875,0
45542_marine,64,48,62,0,112,96.875,0
45543_marine,64,48,62,0,112,96.875,0
45544_marine,62,48,60,0,110,96.7741935483871,0
45545_marine,64,49,62,0,113,96.875,0
45546_marine,66,50,64,0,116,96.96969696969697,0
45547_marine,66,48,64,0,114,96.96969696969697,0
45548_marine,67,48,65,0,115,97.01492537313433,0
45549_marine,62,48,60,0,110,96.7741935483871,0
45550_marine,62,49,59,0,111,95.16129032258065,0
45551_marine,65,50,62,0,115,95.38461538461539,0
45552_marine,67,50,64,0,117,95.52238805970148,0
45553_marine,70,55,66,0,125,94.28571428571428,0
45554_marine,71,55,66,0,126,92.95774647887323,0
45555_marine,71,56,65,1,127,91.54929577464789,1.4084507042253522
45556_marine,75,59,67,1,134,89.33333333333333,1.3333333333333335
45557_marine,76,59,67,2,135,88.1578947368421,2.631578947368421
45558_marine,77,68,69,2,145,89.6103896103896,2.5974025974025974
45559_marine,89,86,79,2,175,88.76404494382022,2.247191011235955
45560_marine,179,226,163,13,405,91.06145251396647,7.262569832402235
45561_marine,197,234,179,17,431,90.86294416243655,8.629441624365482
45562_marine,196,229,178,17,425,90.81632653061224,8.673469387755102
45563_marine,99,126,90,7,225,90.9090909090909,7.07070707070707
45564_marine,93,84,86,5,177,92.47311827956989,5.376344086021505
45565_marine,91,64,84,5,155,92.3076923076923,5.4945054945054945
45566_marine,94,62,87,3,156,92.5531914893617,3.1914893617021276
45567_marine,91,54,84,3,145,92.3076923076923,3.296703296703297
45568_marine,89,52,82,3,141,92.13483146067416,3.3707865168539324
45569_marine,86,52,79,3,138,91.86046511627907,3.488372093023256
45570_marine,81,52,75,3,133,92.5925925925926,3.7037037037037033
45571_marine,78,52,72,1,130,92.3076923076923,1.282051282051282
45572_marine,70,52,64,1,122,91.42857142857143,1.4285714285714286
45573_marine,70,52,64,1,122,91.42857142857143,1.4285714285714286
45574_marine,68,52,62,1,120,91.17647058823529,1.4705882352941175
45575_marine,69,52,63,2,121,91.30434782608695,2.898550724637681
45576_marine,68,52,63,2,120,92.64705882352942,2.941176470588235
45577_marine,66,52,61,2,118,92.42424242424242,3.0303030303030303
45578_marine,64,52,59,2,116,92.1875,3.125
45579_marine,64,50,59,2,114,92.1875,3.125
45580_marine,64,53,59,2,117,92.1875,3.125
45581_marine,64,53,59,2,117,92.1875,3.125
45582_marine,63,53,58,2,116,92.06349206349206,3.1746031746031744
45583_marine,63,53,58,2,116,92.06349206349206,3.1746031746031744
45584_marine,62,55,58,1,117,93.54838709677419,1.6129032258064515
45585_marine,62,56,58,1,118,93.54838709677419,1.6129032258064515
45586_marine,62,56,58,1,118,93.54838709677419,1.6129032258064515
45587_marine,60,56,56,1,116,93.33333333333333,1.6666666666666667
45588_marine,62,56,58,1,118,93.54838709677419,1.6129032258064515
45589_marine,62,56,58,1,118,93.54838709677419,1.6129032258064515
45590_marine,63,56,59,1,119,93.65079365079364,1.5873015873015872
45591_marine,63,56,59,1,119,93.65079365079364,1.5873015873015872
45592_marine,61,52,57,1,113,93.44262295081968,1.639344262295082
45593_marine,61,54,57,1,115,93.44262295081968,1.639344262295082
45594_marine,61,52,57,1,113,93.44262295081968,1.639344262295082
45595_marine,61,52,57,1,113,93.44262295081968,1.639344262295082
45596_marine,60,52,56,1,112,93.33333333333333,1.6666666666666667
45597_marine,60,50,56,1,110,93.33333333333333,1.6666666666666667
45598_marine,61,50,57,0,111,93.44262295081968,0
45599_marine,61,50,57,0,111,93.44262295081968,0
45600_marine,59,50,55,0,109,93.22033898305084,0
45601_marine,59,50,55,0,109,93.22033898305084,0
45602_marine,61,50,57,0,111,93.44262295081968,0
45603_marine,61,50,57,0,111,93.44262295081968,0
45604_marine,61,49,57,0,110,93.44262295081968,0
45605_marine,60,49,56,0,109,93.33333333333333,0
45606_marine,58,49,54,0,107,93.10344827586206,0
45607_marine,58,50,54,0,108,93.10344827586206,0
45608_marine,58,51,54,0,109,93.10344827586206,0
45609_marine,58,51,54,0,109,93.10344827586206,0
45610_marine,59,51,55,1,110,93.22033898305084,1.694915254237288
45611_marine,60,51,56,1,111,93.33333333333333,1.6666666666666667
45612_marine,60,54,56,1,114,93.33333333333333,1.6666666666666667
45613_marine,56,54,52,1,110,92.85714285714286,1.7857142857142856
45614_marine,53,54,49,1,107,92.45283018867924,1.8867924528301887
45615_marine,54,54,50,2,108,92.5925925925926,3.7037037037037033
45616_marine,55,54,51,2,109,92.72727272727272,3.6363636363636362
45617_marine,56,57,52,2,113,92.85714285714286,3.571428571428571
45618_marine,58,67,54,2,125,93.10344827586206,3.4482758620689653
45619_marine,56,61,52,2,117,92.85714285714286,3.571428571428571
45620_marine,55,56,51,2,111,92.72727272727272,3.6363636363636362
45621_marine,55,56,51,2,111,92.72727272727272,3.6363636363636362
45622_marine,54,56,50,2,110,92.5925925925926,3.7037037037037033
45623_marine,54,56,50,2,110,92.5925925925926,3.7037037037037033
45624_marine,56,54,52,2,110,92.85714285714286,3.571428571428571
45625_marine,56,53,52,2,109,92.85714285714286,3.571428571428571
45626_marine,56,53,52,2,109,92.85714285714286,3.571428571428571
45627_marine,56,53,52,2,109,92.85714285714286,3.571428571428571
45628_marine,56,53,52,2,109,92.85714285714286,3.571428571428571
45629_marine,57,53,53,2,110,92.98245614035088,3.508771929824561
45630_marine,56,53,52,2,109,92.85714285714286,3.571428571428571
45631_marine,56,53,52,2,109,92.85714285714286,3.571428571428571
45632_marine,58,53,54,2,111,93.10344827586206,3.4482758620689653
45633_marine,62,54,58,2,116,93.54838709677419,3.225806451612903
45634_marine,62,54,58,2,116,93.54838709677419,3.225806451612903
45635_marine,60,54,56,2,114,93.33333333333333,3.3333333333333335
45636_marine,59,52,55,1,111,93.22033898305084,1.694915254237288
45637_marine,58,52,54,0,110,93.10344827586206,0
45638_marine,58,52,54,0,110,93.10344827586206,0
45639_marine,60,52,55,0,112,91.66666666666666,0
45640_marine,60,53,55,0,113,91.66666666666666,0
45641_marine,60,55,55,0,115,91.66666666666666,0
45642_marine,60,56,55,0,116,91.66666666666666,0
45643_marine,60,54,55,0,114,91.66666666666666,0
45644_marine,60,54,55,0,114,91.66666666666666,0
45645_marine,62,54,57,0,116,91.93548387096774,0
45646_marine,62,53,57,0,115,91.93548387096774,0
45647_marine,64,55,59,0,119,92.1875,0
45648_marine,61,57,56,0,118,91.80327868852459,0
45649_marine,61,57,56,0,118,91.80327868852459,0
45650_marine,64,57,59,0,121,92.1875,0
45651_marine,69,55,64,0,124,92.7536231884058,0
45652_marine,70,57,65,0,127,92.85714285714286,0
45653_marine,71,59,65,0,130,91.54929577464789,0
45654_marine,76,59,68,0,135,89.47368421052632,0
45655_marine,84,74,73,4,158,86.90476190476191,4.761904761904762
45656_marine,89,88,78,5,177,87.64044943820225,5.617977528089887
45657_marine,146,179,115,27,325,78.76712328767124,18.493150684931507
45658_marine,180,223,137,42,403,76.11111111111111,23.333333333333332
45659_marine,177,223,134,42,400,75.70621468926554,23.728813559322035
45660_marine,90,86,79,4,176,87.77777777777777,4.444444444444445
45661_marine,77,60,70,1,137,90.9090909090909,1.2987012987012987
45662_marine,75,58,69,0,133,92,0
45663_marine,75,56,69,0,131,92,0
45664_marine,74,56,68,0,130,91.8918918918919,0
45665_marine,68,56,62,0,124,91.17647058823529,0
45666_marine,66,55,60,0,121,90.9090909090909,0
45667_marine,65,53,60,0,118,92.3076923076923,0
45668_marine,65,53,60,0,118,92.3076923076923,0
45669_marine,61,53,56,0,114,91.80327868852459,0
45670_marine,54,52,50,0,106,92.5925925925926,0
45671_marine,54,54,50,0,108,92.5925925925926,0
45672_marine,63,54,57,0,117,90.47619047619048,0
45673_marine,67,53,61,0,120,91.04477611940298,0
45674_marine,88,73,78,5,161,88.63636363636364,5.681818181818182
45675_marine,96,89,86,6,185,89.58333333333334,6.25
45676_marine,205,263,149,42,468,72.6829268292683,20.48780487804878
45677_marine,355,360,196,169,715,55.21126760563381,47.6056338028169
45678_marine,349,353,197,161,702,56.446991404011456,46.13180515759313
45679_marine,200,262,145,44,462,72.5,22
45692_marine,318,262,227,95,580,71.38364779874213,29.874213836477985
45693_marine,121,74,112,9,195,92.56198347107438,7.43801652892562
45694_marine,115,68,106,7,183,92.17391304347827,6.086956521739131
45695_marine,103,68,97,6,171,94.1747572815534,5.825242718446602
45696_marine,95,66,90,5,161,94.73684210526315,5.263157894736842
45697_marine,92,65,87,4,157,94.56521739130434,4.3478260869565215
45698_marine,93,66,88,4,159,94.6236559139785,4.301075268817205
45699_marine,88,66,83,4,154,94.31818181818183,4.545454545454546
45700_marine,90,65,85,4,155,94.44444444444444,4.444444444444445
45701_marine,89,66,85,4,155,95.50561797752809,4.49438202247191
45702_marine,88,66,84,4,154,95.45454545454545,4.545454545454546
45703_marine,86,66,82,4,152,95.34883720930233,4.651162790697675
45704_marine,89,69,85,4,158,95.50561797752809,4.49438202247191
45705_marine,91,71,87,4,162,95.6043956043956,4.395604395604396
45706_marine,89,74,85,4,163,95.50561797752809,4.49438202247191
45707_marine,94,74,90,3,168,95.74468085106383,3.1914893617021276
45708_marine,96,76,92,3,172,95.83333333333334,3.125
45709_marine,101,78,97,3,179,96.03960396039604,2.9702970297029703
45710_marine,97,82,93,3,179,95.87628865979381,3.0927835051546393
45711_marine,102,83,98,3,185,96.07843137254902,2.941176470588235
45712_marine,106,83,101,3,189,95.28301886792453,2.8301886792452833
45713_marine,171,222,156,18,393,91.22807017543859,10.526315789473683
45717_marine,238,268,200,60,506,84.03361344537815,25.210084033613445
45718_marine,184,227,163,25,411,88.58695652173914,13.586956521739129
45719_marine,177,225,156,25,402,88.13559322033898,14.124293785310735
45720_marine,163,211,148,19,374,90.79754601226993,11.65644171779141
45721_marine,87,75,83,3,162,95.40229885057471,3.4482758620689653
45722_marine,82,63,78,0,145,95.1219512195122,0
45723_marine,81,61,77,0,142,95.06172839506173,0
45724_marine,81,61,77,0,142,95.06172839506173,0
45725_marine,80,59,76,0,139,95,0
45726_marine,80,59,76,0,139,95,0
45727_marine,79,56,75,0,135,94.9367088607595,0
45728_marine,79,53,75,0,132,94.9367088607595,0
45729_marine,76,52,72,0,128,94.73684210526315,0
45730_marine,76,52,72,0,128,94.73684210526315,0
45731_marine,75,51,72,0,126,96,0
45732_marine,74,52,71,0,126,95.94594594594594,0
45733_marine,72,50,69,0,122,95.83333333333334,0
45734_marine,71,50,68,0,121,95.77464788732394,0
45735_marine,71,46,68,0,117,95.77464788732394,0
45736_marine,69,46,66,0,115,95.65217391304348,0
45737_marine,69,45,66,0,114,95.65217391304348,0
45738_marine,67,44,64,0,111,95.52238805970148,0
45739_marine,67,43,64,0,110,95.52238805970148,0
45740_marine,67,43,64,0,110,95.52238805970148,0
45741_marine,67,42,64,0,109,95.52238805970148,0
45742_marine,67,41,64,0,108,95.52238805970148,0
45743_marine,67,41,64,0,108,95.52238805970148,0
45744_marine,66,41,63,0,107,95.45454545454545,0
45745_marine,66,41,63,0,107,95.45454545454545,0
45746_marine,65,41,62,0,106,95.38461538461539,0
45747_marine,65,40,62,0,105,95.38461538461539,0
45748_marine,65,40,62,0,105,95.38461538461539,0
45749_marine,65,41,62,0,106,95.38461538461539,0
45750_marine,64,40,61,0,104,95.3125,0
45751_marine,64,40,61,1,104,95.3125,1.5625
45752_marine,64,40,61,1,104,95.3125,1.5625
45753_marine,64,40,61,1,104,95.3125,1.5625
45754_marine,63,40,60,1,103,95.23809523809523,1.5873015873015872
45755_marine,63,39,60,1,102,95.23809523809523,1.5873015873015872
45756_marine,63,39,60,1,102,95.23809523809523,1.5873015873015872
45757_marine,58,39,55,1,97,94.82758620689656,1.7241379310344827
45758_marine,58,39,55,1,97,94.82758620689656,1.7241379310344827
45759_marine,58,39,55,1,97,94.82758620689656,1.7241379310344827
45760_marine,60,39,57,1,99,95,1.6666666666666667
45761_marine,58,39,55,1,97,94.82758620689656,1.7241379310344827
45762_marine,58,39,55,1,97,94.82758620689656,1.7241379310344827
45763_marine,58,39,55,1,97,94.82758620689656,1.7241379310344827
45764_marine,58,39,55,1,97,94.82758620689656,1.7241379310344827
45765_marine,58,39,55,1,97,94.82758620689656,1.7241379310344827
45766_marine,56,39,53,1,95,94.64285714285714,1.7857142857142856
45767_marine,56,39,53,1,95,94.64285714285714,1.7857142857142856
45768_marine,56,39,53,1,95,94.64285714285714,1.7857142857142856
45769_marine,56,39,53,1,95,94.64285714285714,1.7857142857142856
45770_marine,56,39,53,1,95,94.64285714285714,1.7857142857142856
45771_marine,56,39,53,1,95,94.64285714285714,1.7857142857142856
45772_marine,56,39,53,1,95,94.64285714285714,1.7857142857142856
45773_marine,56,39,53,1,95,94.64285714285714,1.7857142857142856
45774_marine,56,39,53,1,95,94.64285714285714,1.7857142857142856
45775_marine,56,39,53,1,95,94.64285714285714,1.7857142857142856
45776_marine,56,39,53,1,95,94.64285714285714,1.7857142857142856
45777_marine,56,39,53,1,95,94.64285714285714,1.7857142857142856
45778_marine,56,39,53,1,95,94.64285714285714,1.7857142857142856
45779_marine,56,39,53,1,95,94.64285714285714,1.7857142857142856
45780_marine,56,39,53,1,95,94.64285714285714,1.7857142857142856
45781_marine,56,39,53,1,95,94.64285714285714,1.7857142857142856
45782_marine,56,39,53,1,95,94.64285714285714,1.7857142857142856
45783_marine,56,39,53,1,95,94.64285714285714,1.7857142857142856
45784_marine,56,39,53,1,95,94.64285714285714,1.7857142857142856
45785_marine,56,39,53,0,95,94.64285714285714,0
45786_marine,56,40,53,0,96,94.64285714285714,0
45787_marine,53,40,50,0,93,94.33962264150944,0
45788_marine,51,40,48,0,91,94.11764705882352,0
45789_marine,53,40,50,0,93,94.33962264150944,0
45790_marine,53,40,50,0,93,94.33962264150944,0
45791_marine,51,41,48,0,92,94.11764705882352,0
45792_marine,51,42,48,0,93,94.11764705882352,0
45793_marine,51,42,48,0,93,94.11764705882352,0
45794_marine,51,42,48,0,93,94.11764705882352,0
45795_marine,51,42,48,0,93,94.11764705882352,0
45796_marine,53,42,50,2,95,94.33962264150944,3.7735849056603774
45797_marine,53,43,50,2,96,94.33962264150944,3.7735849056603774
45798_marine,52,42,49,2,94,94.23076923076923,3.8461538461538463
45799_marine,50,42,47,2,92,94,4
45800_marine,50,42,47,2,92,94,4
45801_marine,50,42,47,2,92,94,4
45802_marine,50,42,47,2,92,94,4
45803_marine,50,42,47,2,92,94,4
45804_marine,50,42,47,2,92,94,4
45805_marine,50,42,47,2,92,94,4
45806_marine,50,44,47,2,94,94,4
45807_marine,50,43,47,2,93,94,4
45808_marine,50,44,47,2,94,94,4
45809_marine,50,40,47,2,90,94,4
45810_marine,50,40,47,2,90,94,4
45811_marine,50,40,47,2,90,94,4
45812_marine,50,42,47,2,92,94,4
45813_marine,48,42,45,2,90,93.75,4.166666666666666
45814_marine,47,45,44,2,92,93.61702127659575,4.25531914893617
45815_marine,47,48,44,2,95,93.61702127659575,4.25531914893617
45816_marine,45,49,42,2,94,93.33333333333333,4.444444444444445
45817_marine,45,49,44,2,94,97.77777777777777,4.444444444444445
45818_marine,47,50,46,2,97,97.87234042553192,4.25531914893617
45819_marine,46,51,44,2,97,95.65217391304348,4.3478260869565215
45820_marine,48,51,45,3,99,93.75,6.25
45821_marine,51,52,48,3,103,94.11764705882352,5.88235294117647
45822_marine,50,52,46,3,102,92,6
45823_marine,51,56,47,3,107,92.15686274509804,5.88235294117647
45824_marine,50,56,46,3,106,92,6
45825_marine,57,60,53,4,117,92.98245614035088,7.017543859649122
45826_marine,95,114,84,13,209,88.42105263157895,13.684210526315791
45845_marine,135,197,126,12,332,93.33333333333333,8.88888888888889
45846_marine,138,191,129,10,329,93.47826086956522,7.246376811594203
45847_marine,93,97,88,0,190,94.6236559139785,0
45848_marine,92,70,87,0,162,94.56521739130434,0
45849_marine,85,56,80,0,141,94.11764705882352,0
45850_marine,81,54,76,0,135,93.82716049382715,0
45851_marine,77,50,72,0,127,93.5064935064935,0
45852_marine,77,50,72,0,127,93.5064935064935,0
45853_marine,71,50,68,0,121,95.77464788732394,0
45854_marine,72,48,69,0,120,95.83333333333334,0
45855_marine,68,48,65,0,116,95.58823529411765,0
45856_marine,66,48,63,0,114,95.45454545454545,0
45857_marine,66,48,63,0,114,95.45454545454545,0
45858_marine,67,48,64,0,115,95.52238805970148,0
45859_marine,67,49,64,0,116,95.52238805970148,0
45860_marine,65,48,62,0,113,95.38461538461539,0
45861_marine,65,47,62,0,112,95.38461538461539,0
45862_marine,65,48,62,0,113,95.38461538461539,0
45863_marine,64,48,61,0,112,95.3125,0
45864_marine,62,48,59,0,110,95.16129032258065,0
45865_marine,60,48,57,0,108,95,0
45866_marine,60,48,57,0,108,95,0
45867_marine,60,48,57,0,108,95,0
45868_marine,60,46,57,0,106,95,0
45869_marine,60,46,57,0,106,95,0
45870_marine,60,46,57,0,106,95,0
45871_marine,61,46,58,0,107,95.08196721311475,0
45872_marine,61,46,58,0,107,95.08196721311475,0
45873_marine,62,46,59,0,108,95.16129032258065,0
45874_marine,61,46,58,0,107,95.08196721311475,0
45875_marine,61,47,58,0,108,95.08196721311475,0
45876_marine,60,48,57,0,108,95,0
45877_marine,60,48,57,0,108,95,0
45878_marine,56,48,55,0,104,98.21428571428571,0
45879_marine,56,46,55,0,102,98.21428571428571,0
45880_marine,56,47,55,0,103,98.21428571428571,0
45881_marine,56,48,55,0,104,98.21428571428571,0
45882_marine,56,48,55,0,104,98.21428571428571,0
45883_marine,56,47,55,0,103,98.21428571428571,0
45884_marine,56,50,55,0,106,98.21428571428571,0
45885_marine,57,50,56,0,107,98.24561403508771,0
45886_marine,59,52,58,2,111,98.30508474576271,3.389830508474576
45887_marine,60,61,59,2,121,98.33333333333333,3.3333333333333335
45888_marine,71,83,70,2,154,98.59154929577466,2.8169014084507045
45889_marine,61,61,60,2,122,98.36065573770492,3.278688524590164
45890_marine,61,52,60,2,113,98.36065573770492,3.278688524590164
45891_marine,59,51,58,0,110,98.30508474576271,0
45892_marine,61,51,60,0,112,98.36065573770492,0
45893_marine,59,51,58,0,110,98.30508474576271,0
45894_marine,60,51,59,0,111,98.33333333333333,0
45895_marine,57,51,55,0,108,96.49122807017544,0
45896_marine,59,50,57,0,109,96.61016949152543,0
45897_marine,59,52,57,0,111,96.61016949152543,0
45898_marine,59,52,57,0,111,96.61016949152543,0
45899_marine,56,49,54,0,105,96.42857142857143,0
45900_marine,56,49,54,0,105,96.42857142857143,0
45901_marine,56,51,54,0,107,96.42857142857143,0
45902_marine,52,51,50,0,103,96.15384615384616,0
45903_marine,53,50,51,0,103,96.22641509433963,0
45904_marine,52,50,50,0,102,96.15384615384616,0
45905_marine,54,51,52,0,105,96.29629629629629,0
45906_marine,54,52,52,0,106,96.29629629629629,0
45907_marine,54,51,52,0,105,96.29629629629629,0
45908_marine,52,51,50,0,103,96.15384615384616,0
45909_marine,53,51,51,0,104,96.22641509433963,0
45910_marine,53,52,51,0,105,96.22641509433963,0
45911_marine,62,52,59,0,114,95.16129032258065,0
45912_marine,62,52,59,0,114,95.16129032258065,0
45913_marine,62,54,59,0,116,95.16129032258065,0
45914_marine,63,57,59,0,120,93.65079365079364,0
45915_marine,65,57,61,0,122,93.84615384615384,0
45916_marine,65,57,59,1,122,90.76923076923077,1.5384615384615385
45917_marine,67,57,61,1,124,91.04477611940298,1.4925373134328357
45918_marine,69,59,63,1,128,91.30434782608695,1.4492753623188406
45919_marine,72,60,66,1,132,91.66666666666666,1.3888888888888888
45920_marine,75,70,70,1,145,93.33333333333333,1.3333333333333335
45921_marine,81,94,76,1,175,93.82716049382715,1.2345679012345678
45922_marine,78,71,73,3,149,93.58974358974359,3.8461538461538463
45923_marine,82,67,77,3,149,93.90243902439023,3.6585365853658534
45924_marine,80,59,75,3,139,93.75,3.75
45925_marine,81,59,76,3,140,93.82716049382715,3.7037037037037033
45926_marine,81,57,76,3,138,93.82716049382715,3.7037037037037033
45927_marine,80,55,75,3,135,93.75,3.75
45928_marine,74,53,70,1,127,94.5945945945946,1.3513513513513513
45929_marine,74,54,70,1,128,94.5945945945946,1.3513513513513513
45930_marine,69,54,65,1,123,94.20289855072464,1.4492753623188406
45931_marine,64,54,60,1,118,93.75,1.5625
45932_marine,64,54,60,1,118,93.75,1.5625
45933_marine,62,54,58,1,116,93.54838709677419,1.6129032258064515
45934_marine,62,54,58,1,116,93.54838709677419,1.6129032258064515
45935_marine,62,54,59,2,116,95.16129032258065,3.225806451612903
45936_marine,62,54,59,2,116,95.16129032258065,3.225806451612903
45937_marine,60,54,57,2,114,95,3.3333333333333335
45938_marine,60,54,57,2,114,95,3.3333333333333335
45939_marine,58,54,55,2,112,94.82758620689656,3.4482758620689653
45940_marine,58,54,55,2,112,94.82758620689656,3.4482758620689653
45941_marine,57,53,54,2,110,94.73684210526315,3.508771929824561
45942_marine,57,55,54,2,112,94.73684210526315,3.508771929824561
45943_marine,55,57,52,2,112,94.54545454545455,3.6363636363636362
45944_marine,54,56,51,2,110,94.44444444444444,3.7037037037037033
45945_marine,54,56,51,2,110,94.44444444444444,3.7037037037037033
45946_marine,54,56,51,2,110,94.44444444444444,3.7037037037037033
45947_marine,54,54,51,2,108,94.44444444444444,3.7037037037037033
45948_marine,51,54,49,1,105,96.07843137254902,1.9607843137254901
45949_marine,51,54,49,1,105,96.07843137254902,1.9607843137254901
45950_marine,52,54,50,1,106,96.15384615384616,1.9230769230769231
45951_marine,56,51,54,1,107,96.42857142857143,1.7857142857142856
45952_marine,56,51,54,1,107,96.42857142857143,1.7857142857142856
45953_marine,56,51,54,1,107,96.42857142857143,1.7857142857142856
45954_marine,55,51,53,1,106,96.36363636363636,1.8181818181818181
45955_marine,53,51,51,1,104,96.22641509433963,1.8867924528301887
45956_marine,53,49,51,1,102,96.22641509433963,1.8867924528301887
45957_marine,52,49,50,0,101,96.15384615384616,0
45958_marine,52,51,50,0,103,96.15384615384616,0
45959_marine,52,51,50,0,103,96.15384615384616,0
45960_marine,52,51,50,0,103,96.15384615384616,0
45961_marine,52,51,50,0,103,96.15384615384616,0
45962_marine,52,51,50,0,103,96.15384615384616,0
45963_marine,52,51,50,0,103,96.15384615384616,0
45964_marine,52,51,50,0,103,96.15384615384616,0
45965_marine,51,50,49,0,101,96.07843137254902,0
45966_marine,49,51,47,0,100,95.91836734693877,0
45967_marine,51,51,49,0,102,96.07843137254902,0
45968_marine,49,52,47,0,101,95.91836734693877,0
45969_marine,49,54,47,0,103,95.91836734693877,0
45970_marine,45,54,43,0,99,95.55555555555556,0
45971_marine,46,54,44,0,100,95.65217391304348,0
45972_marine,47,55,45,1,102,95.74468085106383,2.127659574468085
45973_marine,47,55,45,1,102,95.74468085106383,2.127659574468085
45974_marine,50,55,48,1,105,96,2
45975_marine,50,55,48,1,105,96,2
45976_marine,50,56,48,1,106,96,2
45977_marine,53,68,51,1,121,96.22641509433963,1.8867924528301887
45978_marine,61,80,58,3,141,95.08196721311475,4.918032786885246
45979_marine,52,68,50,1,120,96.15384615384616,1.9230769230769231
45980_marine,50,58,48,1,108,96,2
45981_marine,50,57,48,1,107,96,2
45982_marine,47,57,45,1,104,95.74468085106383,2.127659574468085
45983_marine,47,58,45,1,105,95.74468085106383,2.127659574468085
45984_marine,45,54,43,1,99,95.55555555555556,2.2222222222222223
45985_marine,46,53,44,2,99,95.65217391304348,4.3478260869565215
45986_marine,46,53,44,2,99,95.65217391304348,4.3478260869565215
45987_marine,46,53,44,2,99,95.65217391304348,4.3478260869565215
45988_marine,46,53,44,2,99,95.65217391304348,4.3478260869565215
45989_marine,47,53,45,2,100,95.74468085106383,4.25531914893617
45990_marine,50,53,48,2,103,96,4
45991_marine,50,53,48,2,103,96,4
45992_marine,48,54,46,2,102,95.83333333333334,4.166666666666666
45993_marine,47,54,45,1,101,95.74468085106383,2.127659574468085
45994_marine,51,54,49,1,105,96.07843137254902,1.9607843137254901
45995_marine,50,55,48,0,105,96,0
45996_marine,52,55,50,0,107,96.15384615384616,0
45997_marine,53,55,50,0,108,94.33962264150944,0
45998_marine,53,55,50,0,108,94.33962264150944,0
45999_marine,54,55,51,0,109,94.44444444444444,0
46000_marine,54,55,51,0,109,94.44444444444444,0
46001_marine,54,56,51,0,110,94.44444444444444,0
46002_marine,54,56,51,0,110,94.44444444444444,0
46003_marine,54,54,51,0,108,94.44444444444444,0
46004_marine,56,54,51,0,110,91.07142857142857,0
46005_marine,56,54,51,0,110,91.07142857142857,0
46006_marine,56,53,51,0,109,91.07142857142857,0
46007_marine,55,55,50,0,110,90.9090909090909,0
46008_marine,55,55,50,0,110,90.9090909090909,0
46009_marine,57,55,52,0,112,91.22807017543859,0
46010_marine,60,55,55,0,115,91.66666666666666,0
46011_marine,61,55,56,0,116,91.80327868852459,0
46012_marine,63,56,58,0,119,92.06349206349206,0
46013_marine,65,60,60,0,125,92.3076923076923,0
46014_marine,65,60,59,0,125,90.76923076923077,0
46015_marine,67,60,61,0,127,91.04477611940298,0
46016_marine,69,60,63,0,129,91.30434782608695,0
46017_marine,69,60,63,0,129,91.30434782608695,0
46018_marine,66,58,62,0,124,93.93939393939394,0
46019_marine,72,58,68,0,130,94.44444444444444,0
46020_marine,72,58,68,0,130,94.44444444444444,0
46021_marine,70,58,64,0,128,91.42857142857143,0
46022_marine,68,58,62,0,126,91.17647058823529,0
46023_marine,68,57,62,0,125,91.17647058823529,0
46024_marine,66,55,60,0,121,90.9090909090909,0
46025_marine,66,55,61,0,121,92.42424242424242,0
46026_marine,62,55,57,0,117,91.93548387096774,0
46027_marine,60,55,55,0,115,91.66666666666666,0
46028_marine,55,55,51,0,110,92.72727272727272,0
46029_marine,55,55,51,0,110,92.72727272727272,0
46030_marine,55,54,51,0,109,92.72727272727272,0
46031_marine,55,54,51,0,109,92.72727272727272,0
46032_marine,55,54,51,0,109,92.72727272727272,0
46033_marine,58,54,53,0,112,91.37931034482759,0
46034_marine,65,57,59,0,122,90.76923076923077,0
46035_marine,72,59,66,1,131,91.66666666666666,1.3888888888888888
46036_marine,96,86,86,5,182,89.58333333333334,5.208333333333334
46037_marine,145,198,111,19,343,76.55172413793103,13.10344827586207
46038_marine,201,261,151,34,462,75.12437810945273,16.91542288557214
46039_marine,205,260,154,38,465,75.1219512195122,18.536585365853657
46045_marine,195,260,148,39,455,75.8974358974359,20
46048_marine,209,252,158,45,461,75.5980861244019,21.5311004784689
46052_marine,137,118,127,10,255,92.7007299270073,7.2992700729927
46053_marine,110,70,103,7,180,93.63636363636364,6.363636363636363
46054_marine,100,68,94,5,168,94,5
46055_marine,92,69,87,4,161,94.56521739130434,4.3478260869565215
46056_marine,89,70,84,3,159,94.3820224719101,3.3707865168539324
46057_marine,91,67,86,3,158,94.5054945054945,3.296703296703297
46058_marine,87,65,82,3,152,94.25287356321839,3.4482758620689653
46059_marine,88,66,83,3,154,94.31818181818183,3.4090909090909087
46060_marine,90,68,85,3,158,94.44444444444444,3.3333333333333335
46061_marine,87,68,83,3,155,95.40229885057471,3.4482758620689653
46062_marine,88,68,84,3,156,95.45454545454545,3.4090909090909087
46063_marine,84,68,80,3,152,95.23809523809523,3.571428571428571
46064_marine,84,69,80,3,153,95.23809523809523,3.571428571428571
46065_marine,85,72,81,3,157,95.29411764705881,3.5294117647058822
46066_marine,86,74,82,3,160,95.34883720930233,3.488372093023256
46067_marine,94,90,90,3,184,95.74468085106383,3.1914893617021276
46068_marine,102,97,98,3,199,96.07843137254902,2.941176470588235
46069_marine,100,97,96,3,197,96,3
46070_marine,102,102,98,3,204,96.07843137254902,2.941176470588235
46071_marine,108,103,104,3,211,96.29629629629629,2.7777777777777777
46072_marine,114,105,109,3,219,95.6140350877193,2.631578947368421
46073_marine,125,126,119,4,251,95.19999999999999,3.2
46074_marine,171,220,160,16,391,93.56725146198829,9.35672514619883
46080_marine,174,228,155,22,402,89.08045977011494,12.643678160919542
46081_marine,87,73,83,3,160,95.40229885057471,3.4482758620689653
46082_marine,82,65,78,0,147,95.1219512195122,0
46083_marine,79,61,75,0,140,94.9367088607595,0
46084_marine,79,59,75,0,138,94.9367088607595,0
46085_marine,79,57,75,0,136,94.9367088607595,0
46086_marine,77,57,73,0,134,94.8051948051948,0
46087_marine,77,56,73,0,133,94.8051948051948,0
46088_marine,77,55,73,0,132,94.8051948051948,0
46089_marine,75,54,71,0,129,94.66666666666667,0
46090_marine,75,52,71,0,127,94.66666666666667,0
46091_marine,74,52,71,0,126,95.94594594594594,0
46092_marine,71,53,68,0,124,95.77464788732394,0
46093_marine,69,53,66,0,122,95.65217391304348,0
46094_marine,69,51,66,0,120,95.65217391304348,0
46095_marine,69,51,66,0,120,95.65217391304348,0
46096_marine,67,50,64,0,117,95.52238805970148,0
46097_marine,67,50,64,0,117,95.52238805970148,0
46098_marine,67,49,64,0,116,95.52238805970148,0
46099_marine,67,49,64,0,116,95.52238805970148,0
46100_marine,67,45,64,0,112,95.52238805970148,0
46101_marine,67,45,64,0,112,95.52238805970148,0
46102_marine,65,45,62,0,110,95.38461538461539,0
46103_marine,65,45,62,0,110,95.38461538461539,0
46104_marine,64,45,61,0,109,95.3125,0
46105_marine,64,45,61,0,109,95.3125,0
46106_marine,64,44,61,0,108,95.3125,0
46107_marine,63,44,60,0,107,95.23809523809523,0
46108_marine,63,44,60,0,107,95.23809523809523,0
46109_marine,62,44,59,0,106,95.16129032258065,0
46110_marine,62,42,59,0,104,95.16129032258065,0
46111_marine,59,42,56,0,101,94.91525423728814,0
46112_marine,57,42,54,0,99,94.73684210526315,0
46113_marine,57,42,54,0,99,94.73684210526315,0
46114_marine,57,42,54,0,99,94.73684210526315,0
46115_marine,56,42,53,0,98,94.64285714285714,0
46116_marine,56,41,53,0,97,94.64285714285714,0
46117_marine,56,41,53,0,97,94.64285714285714,0
46118_marine,56,41,53,0,97,94.64285714285714,0
46119_marine,53,41,50,0,94,94.33962264150944,0
46120_marine,53,41,50,0,94,94.33962264150944,0
46121_marine,54,40,51,1,94,94.44444444444444,1.8518518518518516
46122_marine,52,40,49,1,92,94.23076923076923,1.9230769230769231
46123_marine,52,40,49,1,92,94.23076923076923,1.9230769230769231
46124_marine,52,40,49,1,92,94.23076923076923,1.9230769230769231
46125_marine,52,40,49,1,92,94.23076923076923,1.9230769230769231
46126_marine,52,40,49,1,92,94.23076923076923,1.9230769230769231
46127_marine,52,41,49,1,93,94.23076923076923,1.9230769230769231
46128_marine,52,41,49,1,93,94.23076923076923,1.9230769230769231
46129_marine,52,41,49,1,93,94.23076923076923,1.9230769230769231
46130_marine,52,41,49,1,93,94.23076923076923,1.9230769230769231
46131_marine,52,41,49,1,93,94.23076923076923,1.9230769230769231
46132_marine,52,41,49,1,93,94.23076923076923,1.9230769230769231
46133_marine,52,41,49,1,93,94.23076923076923,1.9230769230769231
46134_marine,52,41,49,1,93,94.23076923076923,1.9230769230769231
46135_marine,52,41,49,1,93,94.23076923076923,1.9230769230769231
46136_marine,52,41,49,1,93,94.23076923076923,1.9230769230769231
46137_marine,51,41,48,0,92,94.11764705882352,0
46138_marine,51,42,48,0,93,94.11764705882352,0
46139_marine,51,41,48,0,92,94.11764705882352,0
46140_marine,51,41,48,0,92,94.11764705882352,0
46141_marine,49,40,46,0,89,93.87755102040816,0
46142_marine,49,40,46,0,89,93.87755102040816,0
46143_marine,49,40,46,0,89,93.87755102040816,0
46144_marine,47,40,44,0,87,93.61702127659575,0
46145_marine,47,40,44,0,87,93.61702127659575,0
46146_marine,47,41,44,0,88,93.61702127659575,0
46147_marine,48,41,45,0,89,93.75,0
46148_marine,48,42,45,0,90,93.75,0
46149_marine,47,43,44,0,90,93.61702127659575,0
46150_marine,45,43,42,0,88,93.33333333333333,0
46151_marine,45,43,42,0,88,93.33333333333333,0
46152_marine,45,44,42,0,89,93.33333333333333,0
46153_marine,45,44,42,0,89,93.33333333333333,0
46154_marine,45,44,42,0,89,93.33333333333333,0
46155_marine,45,44,42,0,89,93.33333333333333,0
46156_marine,45,44,42,0,89,93.33333333333333,0
46157_marine,45,44,42,0,89,93.33333333333333,0
46158_marine,45,43,42,0,88,93.33333333333333,0
46159_marine,45,43,42,0,88,93.33333333333333,0
46160_marine,47,44,44,2,91,93.61702127659575,4.25531914893617
46161_marine,46,44,43,2,90,93.47826086956522,4.3478260869565215
46162_marine,46,44,43,2,90,93.47826086956522,4.3478260869565215
46163_marine,46,44,43,2,90,93.47826086956522,4.3478260869565215
46164_marine,46,44,43,2,90,93.47826086956522,4.3478260869565215
46165_marine,46,43,43,2,89,93.47826086956522,4.3478260869565215
46166_marine,46,42,43,2,88,93.47826086956522,4.3478260869565215
46167_marine,49,43,46,2,92,93.87755102040816,4.081632653061225
46168_marine,49,44,46,2,93,93.87755102040816,4.081632653061225
46169_marine,49,45,46,2,94,93.87755102040816,4.081632653061225
46170_marine,49,46,46,2,95,93.87755102040816,4.081632653061225
46171_marine,47,46,44,2,93,93.61702127659575,4.25531914893617
46172_marine,43,46,42,2,89,97.67441860465115,4.651162790697675
46173_marine,43,45,42,2,88,97.67441860465115,4.651162790697675
46174_marine,41,47,40,2,88,97.5609756097561,4.878048780487805
46175_marine,39,48,38,2,87,97.43589743589743,5.128205128205128
46176_marine,40,50,39,2,90,97.5,5
46177_marine,40,50,39,2,90,97.5,5
46178_marine,38,51,37,2,89,97.36842105263158,5.263157894736842
46179_marine,40,53,37,3,93,92.5,7.5
46180_marine,41,52,38,3,93,92.6829268292683,7.317073170731707
46181_marine,43,52,39,3,95,90.69767441860465,6.976744186046512
46182_marine,44,54,40,3,98,90.9090909090909,6.8181818181818175
46183_marine,44,57,40,3,101,90.9090909090909,6.8181818181818175
46184_marine,48,57,44,3,105,91.66666666666666,6.25
46185_marine,56,61,52,4,117,92.85714285714286,7.142857142857142
46186_marine,92,136,80,14,228,86.95652173913044,15.217391304347828
46204_marine,122,185,109,12,307,89.34426229508196,9.836065573770492
46205_marine,116,192,107,7,308,92.24137931034483,6.0344827586206895
46206_marine,84,98,79,1,182,94.04761904761905,1.1904761904761905
46207_marine,81,75,76,0,156,93.82716049382715,0
46208_marine,80,59,75,0,139,93.75,0
46209_marine,79,55,74,0,134,93.67088607594937,0
46210_marine,81,55,76,0,136,93.82716049382715,0
46211_marine,77,52,72,0,129,93.5064935064935,0
46212_marine,71,53,68,0,124,95.77464788732394,0
46213_marine,68,51,65,0,119,95.58823529411765,0
46214_marine,64,50,61,0,114,95.3125,0
46215_marine,64,50,61,0,114,95.3125,0
46216_marine,64,50,61,0,114,95.3125,0
46217_marine,64,50,61,0,114,95.3125,0
46218_marine,64,50,61,0,114,95.3125,0
46219_marine,64,50,61,0,114,95.3125,0
46220_marine,64,51,61,0,115,95.3125,0
46221_marine,63,49,60,0,112,95.23809523809523,0
46222_marine,61,50,58,0,111,95.08196721311475,0
46223_marine,61,49,58,0,110,95.08196721311475,0
46224_marine,59,49,56,0,108,94.91525423728814,0
46225_marine,59,49,56,0,108,94.91525423728814,0
46226_marine,59,49,56,0,108,94.91525423728814,0
46227_marine,59,49,56,0,108,94.91525423728814,0
46228_marine,59,47,56,0,106,94.91525423728814,0
46229_marine,59,47,56,0,106,94.91525423728814,0
46230_marine,60,47,57,0,107,95,0
46231_marine,60,47,57,0,107,95,0
46232_marine,59,47,56,0,106,94.91525423728814,0
46233_marine,59,48,56,0,107,94.91525423728814,0
46234_marine,56,47,55,0,103,98.21428571428571,0
46235_marine,56,47,55,0,103,98.21428571428571,0
46236_marine,55,47,54,0,102,98.18181818181819,0
46237_marine,55,48,54,0,103,98.18181818181819,0
46238_marine,55,49,54,0,104,98.18181818181819,0
46239_marine,55,50,54,0,105,98.18181818181819,0
46240_marine,54,50,53,0,104,98.14814814814815,0
46241_marine,54,50,53,0,104,98.14814814814815,0
46242_marine,54,48,53,0,102,98.14814814814815,0
46243_marine,54,48,53,0,102,98.14814814814815,0
46244_marine,52,48,51,0,100,98.07692307692307,0
46245_marine,52,50,51,0,102,98.07692307692307,0
46246_marine,52,52,51,0,104,98.07692307692307,0
46247_marine,55,61,54,2,116,98.18181818181819,3.6363636363636362
46248_marine,54,61,53,2,115,98.14814814814815,3.7037037037037033
46249_marine,56,63,55,2,119,98.21428571428571,3.571428571428571
46250_marine,56,56,55,2,112,98.21428571428571,3.571428571428571
46251_marine,52,52,51,0,104,98.07692307692307,0
46252_marine,52,53,51,0,105,98.07692307692307,0
46253_marine,52,51,51,0,103,98.07692307692307,0
46254_marine,52,51,51,0,103,98.07692307692307,0
46255_marine,53,53,52,0,106,98.11320754716981,0
46256_marine,52,50,50,0,102,96.15384615384616,0
46257_marine,52,51,50,0,103,96.15384615384616,0
46258_marine,52,51,50,0,103,96.15384615384616,0
46259_marine,52,50,50,0,102,96.15384615384616,0
46260_marine,52,52,50,0,104,96.15384615384616,0
46261_marine,52,51,50,0,103,96.15384615384616,0
46262_marine,52,51,50,0,103,96.15384615384616,0
46263_marine,52,52,50,0,104,96.15384615384616,0
46264_marine,52,51,50,0,103,96.15384615384616,0
46265_marine,52,51,50,0,103,96.15384615384616,0
46266_marine,52,52,50,0,104,96.15384615384616,0
46267_marine,52,52,50,0,104,96.15384615384616,0
46268_marine,50,51,48,0,101,96,0
46269_marine,50,51,48,0,101,96,0
46270_marine,54,52,52,0,106,96.29629629629629,0
46271_marine,55,51,52,0,106,94.54545454545455,0
46272_marine,59,51,56,0,110,94.91525423728814,0
46273_marine,59,51,56,0,110,94.91525423728814,0
46274_marine,63,55,58,1,118,92.06349206349206,1.5873015873015872
46275_marine,63,60,58,1,123,92.06349206349206,1.5873015873015872
46276_marine,63,58,58,1,121,92.06349206349206,1.5873015873015872
46277_marine,64,58,58,1,122,90.625,1.5625
46278_marine,64,58,58,1,122,90.625,1.5625
46279_marine,64,59,58,1,123,90.625,1.5625
46280_marine,65,58,60,1,123,92.3076923076923,1.5384615384615385
46281_marine,69,61,64,1,130,92.7536231884058,1.4492753623188406
46282_marine,70,62,65,1,132,92.85714285714286,1.4285714285714286
46283_marine,69,59,64,1,128,92.7536231884058,1.4492753623188406
46284_marine,71,59,66,1,130,92.95774647887323,1.4084507042253522
46285_marine,68,59,64,1,127,94.11764705882352,1.4705882352941175
46286_marine,65,58,61,1,123,93.84615384615384,1.5384615384615385
46287_marine,67,58,63,1,125,94.02985074626866,1.4925373134328357
46288_marine,66,56,62,1,122,93.93939393939394,1.5151515151515151
46289_marine,64,56,60,1,120,93.75,1.5625
46290_marine,61,56,57,1,117,93.44262295081968,1.639344262295082
46291_marine,60,56,56,1,116,93.33333333333333,1.6666666666666667
46292_marine,58,56,54,1,114,93.10344827586206,1.7241379310344827
46293_marine,58,56,54,1,114,93.10344827586206,1.7241379310344827
46294_marine,57,56,54,1,113,94.73684210526315,1.7543859649122806
46295_marine,55,56,52,1,111,94.54545454545455,1.8181818181818181
46296_marine,56,56,53,2,112,94.64285714285714,3.571428571428571
46297_marine,55,56,52,2,111,94.54545454545455,3.6363636363636362
46298_marine,56,56,53,2,112,94.64285714285714,3.571428571428571
46299_marine,54,57,51,2,111,94.44444444444444,3.7037037037037033
46300_marine,55,58,52,2,113,94.54545454545455,3.6363636363636362
46301_marine,55,58,52,2,113,94.54545454545455,3.6363636363636362
46302_marine,53,55,50,2,108,94.33962264150944,3.7735849056603774
46303_marine,53,55,50,2,108,94.33962264150944,3.7735849056603774
46304_marine,53,55,50,2,108,94.33962264150944,3.7735849056603774
46305_marine,53,53,50,2,106,94.33962264150944,3.7735849056603774
46306_marine,53,53,50,2,106,94.33962264150944,3.7735849056603774
46307_marine,53,55,50,2,108,94.33962264150944,3.7735849056603774
46308_marine,53,55,50,2,108,94.33962264150944,3.7735849056603774
46309_marine,53,54,50,2,107,94.33962264150944,3.7735849056603774
46310_marine,53,52,50,2,105,94.33962264150944,3.7735849056603774
46311_marine,53,51,50,2,104,94.33962264150944,3.7735849056603774
46312_marine,52,51,50,1,103,96.15384615384616,1.9230769230769231
46313_marine,51,51,49,1,102,96.07843137254902,1.9607843137254901
46314_marine,49,51,47,1,100,95.91836734693877,2.0408163265306123
46315_marine,48,49,46,0,97,95.83333333333334,0
46316_marine,48,49,46,0,97,95.83333333333334,0
46317_marine,48,49,46,0,97,95.83333333333334,0
46318_marine,52,49,50,0,101,96.15384615384616,0
46319_marine,50,49,48,0,99,96,0
46320_marine,50,49,48,0,99,96,0
46321_marine,50,49,48,0,99,96,0
46322_marine,48,50,46,0,98,95.83333333333334,0
46323_marine,46,50,44,0,96,95.65217391304348,0
46324_marine,45,50,43,0,95,95.55555555555556,0
46325_marine,43,51,41,0,94,95.34883720930233,0
46326_marine,39,51,37,0,90,94.87179487179486,0
46327_marine,39,53,37,0,92,94.87179487179486,0
46328_marine,41,53,39,0,94,95.1219512195122,0
46329_marine,41,53,39,0,94,95.1219512195122,0
46330_marine,41,53,39,0,94,95.1219512195122,0
46331_marine,42,53,40,0,95,95.23809523809523,0
46332_marine,42,54,40,0,96,95.23809523809523,0
46333_marine,42,54,40,0,96,95.23809523809523,0
46334_marine,44,54,42,1,98,95.45454545454545,2.272727272727273
46335_marine,44,54,42,1,98,95.45454545454545,2.272727272727273
46336_marine,45,55,43,1,100,95.55555555555556,2.2222222222222223
46337_marine,49,67,47,1,116,95.91836734693877,2.0408163265306123
46338_marine,57,78,54,4,135,94.73684210526315,7.017543859649122
46339_marine,49,66,47,1,115,95.91836734693877,2.0408163265306123
46340_marine,47,56,45,1,103,95.74468085106383,2.127659574468085
46341_marine,47,55,45,1,102,95.74468085106383,2.127659574468085
46342_marine,46,55,44,1,101,95.65217391304348,2.1739130434782608
46343_marine,45,55,43,1,100,95.55555555555556,2.2222222222222223
46344_marine,44,54,42,1,98,95.45454545454545,2.272727272727273
46345_marine,44,53,42,1,97,95.45454545454545,2.272727272727273
46346_marine,44,51,42,1,95,95.45454545454545,2.272727272727273
46347_marine,45,53,43,2,98,95.55555555555556,4.444444444444445
46348_marine,45,53,43,2,98,95.55555555555556,4.444444444444445
46349_marine,42,53,40,2,95,95.23809523809523,4.761904761904762
46350_marine,41,56,39,1,97,95.1219512195122,2.4390243902439024
46351_marine,41,55,39,1,96,95.1219512195122,2.4390243902439024
46352_marine,41,55,39,0,96,95.1219512195122,0
46353_marine,41,55,39,0,96,95.1219512195122,0
46354_marine,43,55,41,0,98,95.34883720930233,0
46355_marine,46,55,43,0,101,93.47826086956522,0
46356_marine,48,55,45,0,103,93.75,0
46357_marine,47,55,44,0,102,93.61702127659575,0
46358_marine,47,55,44,0,102,93.61702127659575,0
46359_marine,47,55,44,0,102,93.61702127659575,0
46360_marine,48,55,45,0,103,93.75,0
46361_marine,48,56,45,0,104,93.75,0
46362_marine,48,54,45,0,102,93.75,0
46363_marine,48,52,45,0,100,93.75,0
46364_marine,51,52,48,0,103,94.11764705882352,0
46365_marine,53,51,50,0,104,94.33962264150944,0
46366_marine,50,53,47,0,103,94,0
46367_marine,50,55,47,0,105,94,0
46368_marine,51,55,48,0,106,94.11764705882352,0
46369_marine,51,55,48,0,106,94.11764705882352,0
46370_marine,53,55,50,0,108,94.33962264150944,0
46371_marine,59,55,56,0,114,94.91525423728814,0
46372_marine,59,56,56,0,115,94.91525423728814,0
46373_marine,59,56,56,0,115,94.91525423728814,0
46374_marine,60,58,57,0,118,95,0
46375_marine,62,60,59,0,122,95.16129032258065,0
46376_marine,65,60,61,0,125,93.84615384615384,0
46377_marine,65,56,61,0,121,93.84615384615384,0
46378_marine,65,56,61,0,121,93.84615384615384,0
46379_marine,63,56,59,0,119,93.65079365079364,0
46380_marine,62,56,59,0,118,95.16129032258065,0
46381_marine,66,55,63,0,121,95.45454545454545,0
46382_marine,60,55,57,0,115,95,0
46383_marine,57,55,55,0,112,96.49122807017544,0
46384_marine,53,55,51,0,108,96.22641509433963,0
46385_marine,55,55,53,0,110,96.36363636363636,0
46386_marine,55,55,53,0,110,96.36363636363636,0
46387_marine,53,55,51,0,108,96.22641509433963,0
46388_marine,54,55,52,0,109,96.29629629629629,0
46389_marine,54,55,52,0,109,96.29629629629629,0
46390_marine,52,54,50,0,106,96.15384615384616,0
46391_marine,53,54,51,0,107,96.22641509433963,0
46392_marine,55,54,51,0,109,92.72727272727272,0
46393_marine,55,54,51,0,109,92.72727272727272,0
46394_marine,58,55,53,0,113,91.37931034482759,0
46395_marine,64,55,58,1,119,90.625,1.5625
46396_marine,66,57,60,1,123,90.9090909090909,1.5151515151515151
46397_marine,74,60,68,1,134,91.8918918918919,1.3513513513513513
46398_marine,86,78,76,3,164,88.37209302325581,3.488372093023256
46399_marine,97,99,87,6,196,89.69072164948454,6.185567010309279
46400_marine,207,265,158,36,472,76.32850241545893,17.391304347826086
46409_marine,250,293,196,46,543,78.4,18.4
46410_marine,247,287,194,43,534,78.54251012145748,17.408906882591094
46411_marine,252,285,199,42,537,78.96825396825396,16.666666666666664
46412_marine,130,104,120,8,234,92.3076923076923,6.153846153846154
46413_marine,101,68,94,5,169,93.06930693069307,4.9504950495049505
46414_marine,93,68,87,5,161,93.54838709677419,5.376344086021505
46415_marine,87,68,82,3,155,94.25287356321839,3.4482758620689653
46416_marine,88,70,83,3,158,94.31818181818183,3.4090909090909087
46417_marine,87,65,82,3,152,94.25287356321839,3.4482758620689653
46418_marine,84,65,79,3,149,94.04761904761905,3.571428571428571
46419_marine,85,67,80,3,152,94.11764705882352,3.5294117647058822
46420_marine,86,67,81,3,153,94.18604651162791,3.488372093023256
46421_marine,85,67,81,3,152,95.29411764705881,3.5294117647058822
46422_marine,83,67,79,3,150,95.18072289156626,3.614457831325301
46423_marine,83,69,79,3,152,95.18072289156626,3.614457831325301
46424_marine,85,69,81,3,154,95.29411764705881,3.5294117647058822
46425_marine,85,71,81,3,156,95.29411764705881,3.5294117647058822
46426_marine,85,73,81,3,158,95.29411764705881,3.5294117647058822
46427_marine,94,75,90,3,169,95.74468085106383,3.1914893617021276
46428_marine,100,98,96,3,198,96,3
46429_marine,100,99,96,3,199,96,3
46430_marine,104,100,100,3,204,96.15384615384616,2.8846153846153846
46431_marine,107,104,102,3,211,95.32710280373831,2.803738317757009
46432_marine,113,130,108,3,243,95.57522123893806,2.6548672566371683
46433_marine,156,206,143,13,362,91.66666666666666,8.333333333333332
46434_marine,167,217,153,18,384,91.61676646706587,10.778443113772456
46440_marine,170,226,151,22,396,88.8235294117647,12.941176470588237
46441_marine,79,73,75,3,152,94.9367088607595,3.79746835443038
46442_marine,76,66,72,0,142,94.73684210526315,0
46443_marine,76,61,72,0,137,94.73684210526315,0
46444_marine,75,62,71,0,137,94.66666666666667,0
46445_marine,74,57,70,0,131,94.5945945945946,0
46446_marine,74,57,70,0,131,94.5945945945946,0
46447_marine,73,57,69,0,130,94.52054794520548,0
46448_marine,72,55,68,0,127,94.44444444444444,0
46449_marine,72,54,68,0,126,94.44444444444444,0
46450_marine,66,54,63,0,120,95.45454545454545,0
46451_marine,65,54,62,0,119,95.38461538461539,0
46452_marine,65,52,62,0,117,95.38461538461539,0
46453_marine,63,50,60,0,113,95.23809523809523,0
46454_marine,63,50,60,0,113,95.23809523809523,0
46455_marine,61,50,58,0,111,95.08196721311475,0
46456_marine,61,49,58,0,110,95.08196721311475,0
46457_marine,61,49,58,0,110,95.08196721311475,0
46458_marine,61,49,58,0,110,95.08196721311475,0
46459_marine,61,49,58,0,110,95.08196721311475,0
46460_marine,59,48,56,0,107,94.91525423728814,0
46461_marine,59,48,56,0,107,94.91525423728814,0
46462_marine,58,48,55,0,106,94.82758620689656,0
46463_marine,56,48,53,0,104,94.64285714285714,0
46464_marine,56,46,53,0,102,94.64285714285714,0
46465_marine,55,46,52,0,101,94.54545454545455,0
46466_marine,54,46,51,0,100,94.44444444444444,0
46467_marine,54,46,51,0,100,94.44444444444444,0
46468_marine,52,46,49,0,98,94.23076923076923,0
46469_marine,52,46,49,0,98,94.23076923076923,0
46470_marine,52,45,49,0,97,94.23076923076923,0
46471_marine,51,45,48,0,96,94.11764705882352,0
46472_marine,50,45,47,0,95,94,0
46473_marine,50,45,47,0,95,94,0
46474_marine,50,45,47,0,95,94,0
46475_marine,50,45,47,0,95,94,0
46476_marine,50,44,47,0,94,94,0
46477_marine,50,44,47,0,94,94,0
46478_marine,50,44,47,0,94,94,0
46479_marine,50,44,47,0,94,94,0
46480_marine,50,44,47,0,94,94,0
46481_marine,50,44,47,0,94,94,0
46482_marine,50,44,47,0,94,94,0
46483_marine,50,44,47,0,94,94,0
46484_marine,49,44,46,0,93,93.87755102040816,0
46485_marine,49,44,46,0,93,93.87755102040816,0
46486_marine,49,44,46,0,93,93.87755102040816,0
46487_marine,49,44,46,0,93,93.87755102040816,0
46488_marine,49,44,46,0,93,93.87755102040816,0
46489_marine,49,44,46,0,93,93.87755102040816,0
46490_marine,49,44,46,0,93,93.87755102040816,0
46491_marine,49,44,46,0,93,93.87755102040816,0
46492_marine,49,44,46,0,93,93.87755102040816,0
46493_marine,47,44,44,0,91,93.61702127659575,0
46494_marine,47,44,44,0,91,93.61702127659575,0
46495_marine,47,44,44,0,91,93.61702127659575,0
46496_marine,47,44,44,0,91,93.61702127659575,0
46497_marine,47,44,44,0,91,93.61702127659575,0
46498_marine,47,44,44,0,91,93.61702127659575,0
46499_marine,47,44,44,0,91,93.61702127659575,0
46500_marine,47,44,44,0,91,93.61702127659575,0
46501_marine,47,44,44,0,91,93.61702127659575,0
46502_marine,47,44,44,0,91,93.61702127659575,0
46503_marine,47,44,44,0,91,93.61702127659575,0
46504_marine,47,44,44,0,91,93.61702127659575,0
46505_marine,47,44,44,0,91,93.61702127659575,0
46506_marine,47,45,44,0,92,93.61702127659575,0
46507_marine,47,46,44,0,93,93.61702127659575,0
46508_marine,45,46,42,0,91,93.33333333333333,0
46509_marine,45,46,42,0,91,93.33333333333333,0
46510_marine,46,46,43,0,92,93.47826086956522,0
46511_marine,46,46,43,0,92,93.47826086956522,0
46512_marine,45,45,42,0,90,93.33333333333333,0
46513_marine,45,45,42,0,90,93.33333333333333,0
46514_marine,43,45,40,0,88,93.02325581395348,0
46515_marine,44,46,41,0,90,93.18181818181817,0
46516_marine,44,46,41,0,90,93.18181818181817,0
46517_marine,44,46,41,0,90,93.18181818181817,0
46518_marine,44,45,41,0,89,93.18181818181817,0
46519_marine,44,45,41,0,89,93.18181818181817,0
46520_marine,44,48,41,0,92,93.18181818181817,0
46521_marine,44,48,41,0,92,93.18181818181817,0
46522_marine,44,47,41,0,91,93.18181818181817,0
46523_marine,43,47,40,0,90,93.02325581395348,0
46524_marine,41,47,38,0,88,92.6829268292683,0
46525_marine,41,45,38,0,86,92.6829268292683,0
46526_marine,43,44,40,2,87,93.02325581395348,4.651162790697675
46527_marine,41,43,40,2,84,97.5609756097561,4.878048780487805
46528_marine,39,43,38,2,82,97.43589743589743,5.128205128205128
46529_marine,39,43,38,2,82,97.43589743589743,5.128205128205128
46530_marine,39,43,38,2,82,97.43589743589743,5.128205128205128
46531_marine,37,44,36,2,81,97.2972972972973,5.405405405405405
46532_marine,37,44,36,2,81,97.2972972972973,5.405405405405405
46533_marine,35,44,34,2,79,97.14285714285714,5.714285714285714
46534_marine,35,48,34,2,83,97.14285714285714,5.714285714285714
46535_marine,36,49,35,2,85,97.22222222222221,5.555555555555555
46536_marine,36,48,35,2,84,97.22222222222221,5.555555555555555
46537_marine,36,47,35,2,83,97.22222222222221,5.555555555555555
46538_marine,36,47,35,2,83,97.22222222222221,5.555555555555555
46539_marine,38,50,35,3,88,92.10526315789474,7.894736842105263
46540_marine,38,48,35,3,86,92.10526315789474,7.894736842105263
46541_marine,41,48,37,3,89,90.2439024390244,7.317073170731707
46542_marine,43,54,39,3,97,90.69767441860465,6.976744186046512
46543_marine,43,54,39,3,97,90.69767441860465,6.976744186046512
46544_marine,47,56,43,3,103,91.48936170212765,6.382978723404255
46545_marine,54,59,49,5,113,90.74074074074075,9.25925925925926
46546_marine,86,126,75,13,212,87.20930232558139,15.11627906976744
46560_marine,107,162,90,14,269,84.11214953271028,13.084112149532709
46561_marine,105,169,88,14,274,83.80952380952381,13.333333333333334
46562_marine,105,172,90,12,277,85.71428571428571,11.428571428571429
46563_marine,101,176,90,12,277,89.10891089108911,11.881188118811881
46564_marine,99,179,90,8,278,90.9090909090909,8.080808080808081
46565_marine,93,165,84,6,258,90.32258064516128,6.451612903225806
46566_marine,66,90,61,1,156,92.42424242424242,1.5151515151515151
46567_marine,64,57,59,1,121,92.1875,1.5625
46568_marine,65,53,60,0,118,92.3076923076923,0
46569_marine,69,53,64,0,122,92.7536231884058,0
46570_marine,69,55,64,0,124,92.7536231884058,0
46571_marine,65,55,62,0,120,95.38461538461539,0
46572_marine,65,52,62,0,117,95.38461538461539,0
46573_marine,62,52,59,0,114,95.16129032258065,0
46574_marine,62,52,59,0,114,95.16129032258065,0
46575_marine,62,51,59,0,113,95.16129032258065,0
46576_marine,62,51,59,0,113,95.16129032258065,0
46577_marine,62,50,59,0,112,95.16129032258065,0
46578_marine,61,50,58,0,111,95.08196721311475,0
46579_marine,59,51,56,0,110,94.91525423728814,0
46580_marine,60,51,57,0,111,95,0
46581_marine,59,51,56,0,110,94.91525423728814,0
46582_marine,59,52,56,0,111,94.91525423728814,0
46583_marine,57,52,54,0,109,94.73684210526315,0
46584_marine,57,52,54,0,109,94.73684210526315,0
46585_marine,57,50,54,0,107,94.73684210526315,0
46586_marine,57,49,54,0,106,94.73684210526315,0
46587_marine,57,50,54,0,107,94.73684210526315,0
46588_marine,57,50,54,0,107,94.73684210526315,0
46589_marine,57,51,54,0,108,94.73684210526315,0
46590_marine,56,48,53,0,104,94.64285714285714,0
46591_marine,57,48,54,0,105,94.73684210526315,0
46592_marine,57,48,54,0,105,94.73684210526315,0
46593_marine,54,48,53,0,102,98.14814814814815,0
46594_marine,54,46,53,0,100,98.14814814814815,0
46595_marine,53,47,52,0,100,98.11320754716981,0
46596_marine,53,48,52,0,101,98.11320754716981,0
46597_marine,51,48,50,0,99,98.0392156862745,0
46598_marine,51,51,50,0,102,98.0392156862745,0
46599_marine,51,51,50,0,102,98.0392156862745,0
46600_marine,51,51,50,0,102,98.0392156862745,0
46601_marine,51,51,50,0,102,98.0392156862745,0
46602_marine,51,51,50,0,102,98.0392156862745,0
46603_marine,49,51,48,0,100,97.95918367346938,0
46604_marine,49,51,48,0,100,97.95918367346938,0
46605_marine,49,51,48,0,100,97.95918367346938,0
46606_marine,49,52,48,0,101,97.95918367346938,0
46607_marine,51,52,50,0,103,98.0392156862745,0
46608_marine,54,52,53,2,106,98.14814814814815,3.7037037037037033
46609_marine,50,53,49,0,103,98,0
46610_marine,50,58,49,0,108,98,0
46611_marine,54,60,53,0,114,98.14814814814815,0
46612_marine,52,58,51,0,110,98.07692307692307,0
46613_marine,52,54,51,0,106,98.07692307692307,0
46614_marine,52,54,51,0,106,98.07692307692307,0
46615_marine,51,55,50,0,106,98.0392156862745,0
46616_marine,49,52,48,0,101,97.95918367346938,0
46617_marine,48,52,47,0,100,97.91666666666666,0
46618_marine,49,51,47,0,100,95.91836734693877,0
46619_marine,49,53,47,0,102,95.91836734693877,0
46620_marine,49,53,47,0,102,95.91836734693877,0
46621_marine,51,52,49,0,103,96.07843137254902,0
46622_marine,51,53,49,0,104,96.07843137254902,0
46623_marine,51,52,49,0,103,96.07843137254902,0
46624_marine,51,52,49,0,103,96.07843137254902,0
46625_marine,51,53,49,0,104,96.07843137254902,0
46626_marine,49,54,47,0,103,95.91836734693877,0
46627_marine,51,54,49,0,105,96.07843137254902,0
46628_marine,51,54,49,0,105,96.07843137254902,0
46629_marine,51,54,49,0,105,96.07843137254902,0
46630_marine,51,54,49,0,105,96.07843137254902,0
46631_marine,52,55,50,0,107,96.15384615384616,0
46632_marine,56,55,53,0,111,94.64285714285714,0
46633_marine,57,54,53,1,111,92.98245614035088,1.7543859649122806
46634_marine,55,54,51,1,109,92.72727272727272,1.8181818181818181
46635_marine,55,57,50,1,112,90.9090909090909,1.8181818181818181
46636_marine,55,57,50,1,112,90.9090909090909,1.8181818181818181
46637_marine,55,57,50,1,112,90.9090909090909,1.8181818181818181
46638_marine,55,57,49,1,112,89.0909090909091,1.8181818181818181
46639_marine,57,57,51,1,114,89.47368421052632,1.7543859649122806
46640_marine,56,58,51,1,114,91.07142857142857,1.7857142857142856
46641_marine,57,57,53,1,114,92.98245614035088,1.7543859649122806
46642_marine,58,57,54,1,115,93.10344827586206,1.7241379310344827
46643_marine,58,57,54,1,115,93.10344827586206,1.7241379310344827
46644_marine,56,57,52,1,113,92.85714285714286,1.7857142857142856
46645_marine,58,57,54,1,115,93.10344827586206,1.7241379310344827
46646_marine,58,57,54,1,115,93.10344827586206,1.7241379310344827
46647_marine,58,57,54,1,115,93.10344827586206,1.7241379310344827
46648_marine,59,53,55,1,112,93.22033898305084,1.694915254237288
46649_marine,59,55,55,1,114,93.22033898305084,1.694915254237288
46650_marine,57,55,53,1,112,92.98245614035088,1.7543859649122806
46651_marine,57,55,53,1,112,92.98245614035088,1.7543859649122806
46652_marine,56,55,53,1,111,94.64285714285714,1.7857142857142856
46653_marine,56,55,53,1,111,94.64285714285714,1.7857142857142856
46654_marine,54,55,51,1,109,94.44444444444444,1.8518518518518516
46655_marine,53,54,50,1,107,94.33962264150944,1.8867924528301887
46656_marine,53,54,50,2,107,94.33962264150944,3.7735849056603774
46657_marine,52,54,49,2,106,94.23076923076923,3.8461538461538463
46658_marine,52,53,49,2,105,94.23076923076923,3.8461538461538463
46659_marine,51,55,48,2,106,94.11764705882352,3.9215686274509802
46660_marine,49,55,46,2,104,93.87755102040816,4.081632653061225
46661_marine,49,55,46,2,104,93.87755102040816,4.081632653061225
46662_marine,49,55,46,2,104,93.87755102040816,4.081632653061225
46663_marine,51,59,48,2,110,94.11764705882352,3.9215686274509802
46664_marine,51,60,48,2,111,94.11764705882352,3.9215686274509802
46665_marine,51,58,48,2,109,94.11764705882352,3.9215686274509802
46666_marine,51,56,48,2,107,94.11764705882352,3.9215686274509802
46667_marine,51,58,48,2,109,94.11764705882352,3.9215686274509802
46668_marine,49,56,46,2,105,93.87755102040816,4.081632653061225
46669_marine,49,56,46,2,105,93.87755102040816,4.081632653061225
46670_marine,49,56,46,2,105,93.87755102040816,4.081632653061225
46671_marine,49,56,46,2,105,93.87755102040816,4.081632653061225
46672_marine,47,56,44,2,103,93.61702127659575,4.25531914893617
46673_marine,47,54,44,2,101,93.61702127659575,4.25531914893617
46674_marine,46,54,43,1,100,93.47826086956522,2.1739130434782608
46675_marine,44,53,41,1,97,93.18181818181817,2.272727272727273
46676_marine,43,51,41,0,94,95.34883720930233,0
46677_marine,42,51,40,0,93,95.23809523809523,0
46678_marine,42,51,40,0,93,95.23809523809523,0
46679_marine,42,51,40,0,93,95.23809523809523,0
46680_marine,42,50,40,0,92,95.23809523809523,0
46681_marine,42,50,40,0,92,95.23809523809523,0
46682_marine,41,51,39,0,92,95.1219512195122,0
46683_marine,40,51,38,0,91,95,0
46684_marine,38,53,36,0,91,94.73684210526315,0
46685_marine,38,55,36,0,93,94.73684210526315,0
46686_marine,38,55,36,0,93,94.73684210526315,0
46687_marine,38,55,36,0,93,94.73684210526315,0
46688_marine,38,55,36,0,93,94.73684210526315,0
46689_marine,38,55,36,0,93,94.73684210526315,0
46690_marine,39,55,37,0,94,94.87179487179486,0
46691_marine,40,55,38,0,95,95,0
46692_marine,42,56,40,0,98,95.23809523809523,0
46693_marine,43,56,41,0,99,95.34883720930233,0
46694_marine,43,56,41,0,99,95.34883720930233,0
46695_marine,44,56,42,1,100,95.45454545454545,2.272727272727273
46696_marine,45,57,43,1,102,95.55555555555556,2.2222222222222223
46697_marine,47,69,45,1,116,95.74468085106383,2.127659574468085
46698_marine,47,67,45,1,114,95.74468085106383,2.127659574468085
46699_marine,47,67,45,1,114,95.74468085106383,2.127659574468085
46700_marine,45,57,43,1,102,95.55555555555556,2.2222222222222223
46701_marine,45,56,43,1,101,95.55555555555556,2.2222222222222223
46702_marine,44,54,42,1,98,95.45454545454545,2.272727272727273
46703_marine,43,54,41,1,97,95.34883720930233,2.3255813953488373
46704_marine,43,56,41,1,99,95.34883720930233,2.3255813953488373
46705_marine,43,56,41,1,99,95.34883720930233,2.3255813953488373
46706_marine,40,54,38,0,94,95,0
46707_marine,41,52,39,0,93,95.1219512195122,0
46708_marine,41,52,39,0,93,95.1219512195122,0
46709_marine,41,52,39,0,93,95.1219512195122,0
46710_marine,41,52,39,0,93,95.1219512195122,0
46711_marine,41,53,39,0,94,95.1219512195122,0
46712_marine,41,55,39,0,96,95.1219512195122,0
46713_marine,41,55,39,0,96,95.1219512195122,0
46714_marine,42,53,39,0,95,92.85714285714286,0
46715_marine,44,53,41,0,97,93.18181818181817,0
46716_marine,44,53,41,0,97,93.18181818181817,0
46717_marine,46,53,43,0,99,93.47826086956522,0
46718_marine,46,53,43,0,99,93.47826086956522,0
46719_marine,46,53,43,0,99,93.47826086956522,0
46720_marine,46,53,43,0,99,93.47826086956522,0
46721_marine,47,56,44,0,103,93.61702127659575,0
46722_marine,49,54,46,0,103,93.87755102040816,0
46723_marine,49,54,46,0,103,93.87755102040816,0
46724_marine,49,54,46,0,103,93.87755102040816,0
46725_marine,48,53,45,0,101,93.75,0
46726_marine,48,53,45,0,101,93.75,0
46727_marine,48,55,45,0,103,93.75,0
46728_marine,49,55,46,0,104,93.87755102040816,0
46729_marine,49,55,46,0,104,93.87755102040816,0
46730_marine,49,55,46,0,104,93.87755102040816,0
46731_marine,51,55,48,0,106,94.11764705882352,0
46732_marine,55,55,52,0,110,94.54545454545455,0
46733_marine,59,56,56,0,115,94.91525423728814,0
46734_marine,60,52,57,0,112,95,0
46735_marine,60,52,57,0,112,95,0
46736_marine,62,52,59,0,114,95.16129032258065,0
46737_marine,62,54,59,0,116,95.16129032258065,0
46738_marine,62,54,59,0,116,95.16129032258065,0
46739_marine,62,54,59,0,116,95.16129032258065,0
46740_marine,62,56,59,0,118,95.16129032258065,0
46741_marine,58,56,55,0,114,94.82758620689656,0
46742_marine,55,56,53,0,111,96.36363636363636,0
46743_marine,53,56,51,0,109,96.22641509433963,0
46744_marine,53,56,51,0,109,96.22641509433963,0
46745_marine,51,56,49,0,107,96.07843137254902,0
46746_marine,52,55,50,0,107,96.15384615384616,0
46747_marine,52,55,50,0,107,96.15384615384616,0
46748_marine,50,55,48,0,105,96,0
46749_marine,50,54,48,0,104,96,0
46750_marine,50,54,48,0,104,96,0
46751_marine,50,54,48,0,104,96,0
46752_marine,50,54,48,0,104,96,0
46753_marine,52,55,50,0,107,96.15384615384616,0
46754_marine,54,55,52,0,109,96.29629629629629,0
46755_marine,57,55,52,0,112,91.22807017543859,0
46756_marine,59,55,53,1,114,89.83050847457628,1.694915254237288
46757_marine,64,55,58,1,119,90.625,1.5625
46758_marine,68,62,62,1,130,91.17647058823529,1.4705882352941175
46759_marine,74,62,68,1,136,91.8918918918919,1.3513513513513513
46760_marine,95,89,82,9,184,86.31578947368422,9.473684210526317
46761_marine,196,256,148,34,452,75.51020408163265,17.346938775510203
46762_marine,207,258,159,34,465,76.81159420289855,16.425120772946862
46763_marine,221,279,169,35,500,76.47058823529412,15.837104072398189
46766_marine,209,260,158,38,469,75.5980861244019,18.181818181818183
46770_marine,217,226,172,41,443,79.26267281105991,18.89400921658986
46771_marine,119,94,109,8,213,91.59663865546219,6.722689075630252
46772_marine,96,68,89,4,164,92.70833333333334,4.166666666666666
46773_marine,95,66,89,4,161,93.6842105263158,4.2105263157894735
46774_marine,87,68,81,3,155,93.10344827586206,3.4482758620689653
46775_marine,84,67,79,3,151,94.04761904761905,3.571428571428571
46776_marine,86,67,81,3,153,94.18604651162791,3.488372093023256
46777_marine,83,65,78,3,148,93.97590361445783,3.614457831325301
46778_marine,83,66,78,3,149,93.97590361445783,3.614457831325301
46779_marine,83,67,78,3,150,93.97590361445783,3.614457831325301
46780_marine,84,67,79,3,151,94.04761904761905,3.571428571428571
46781_marine,83,67,79,3,150,95.18072289156626,3.614457831325301
46782_marine,84,68,80,3,152,95.23809523809523,3.571428571428571
46783_marine,83,68,79,3,151,95.18072289156626,3.614457831325301
46784_marine,78,68,74,3,146,94.87179487179486,3.8461538461538463
46785_marine,78,70,74,3,148,94.87179487179486,3.8461538461538463
46786_marine,79,72,75,3,151,94.9367088607595,3.79746835443038
46787_marine,83,75,79,3,158,95.18072289156626,3.614457831325301
46788_marine,93,99,89,3,192,95.6989247311828,3.225806451612903
46789_marine,91,100,87,3,191,95.6043956043956,3.296703296703297
46790_marine,94,104,89,3,198,94.68085106382979,3.1914893617021276
46791_marine,103,124,98,3,227,95.14563106796116,2.912621359223301
46792_marine,143,208,133,12,351,93.00699300699301,8.391608391608392
46793_marine,155,217,140,16,372,90.32258064516128,10.32258064516129
46797_marine,159,207,142,22,366,89.30817610062893,13.836477987421384
46799_marine,184,242,164,31,426,89.13043478260869,16.847826086956523
46800_marine,147,211,132,20,358,89.79591836734694,13.60544217687075
46801_marine,76,68,73,3,144,96.05263157894737,3.9473684210526314
46802_marine,73,64,69,0,137,94.52054794520548,0
46803_marine,71,61,67,0,132,94.36619718309859,0
46804_marine,71,61,67,0,132,94.36619718309859,0
46805_marine,70,59,66,0,129,94.28571428571428,0
46806_marine,68,59,64,0,127,94.11764705882352,0
46807_marine,65,56,61,0,121,93.84615384615384,0
46808_marine,67,55,63,0,122,94.02985074626866,0
46809_marine,64,53,61,0,117,95.3125,0
46810_marine,63,53,60,0,116,95.23809523809523,0
46811_marine,63,52,60,0,115,95.23809523809523,0
46812_marine,63,52,60,0,115,95.23809523809523,0
46813_marine,59,52,56,0,111,94.91525423728814,0
46814_marine,57,52,54,0,109,94.73684210526315,0
46815_marine,55,52,52,0,107,94.54545454545455,0
46816_marine,55,49,52,0,104,94.54545454545455,0
46817_marine,55,49,52,0,104,94.54545454545455,0
46818_marine,55,49,52,0,104,94.54545454545455,0
46819_marine,55,49,52,0,104,94.54545454545455,0
46820_marine,54,48,51,0,102,94.44444444444444,0
46821_marine,54,48,51,0,102,94.44444444444444,0
46822_marine,56,48,53,0,104,94.64285714285714,0
46823_marine,55,48,52,0,103,94.54545454545455,0
46824_marine,52,48,49,0,100,94.23076923076923,0
46825_marine,52,48,49,0,100,94.23076923076923,0
46826_marine,51,48,48,0,99,94.11764705882352,0
46827_marine,51,48,48,0,99,94.11764705882352,0
46828_marine,51,46,48,0,97,94.11764705882352,0
46829_marine,50,46,47,0,96,94,0
46830_marine,50,45,47,0,95,94,0
46831_marine,49,45,46,0,94,93.87755102040816,0
46832_marine,49,45,46,0,94,93.87755102040816,0
46833_marine,49,45,46,0,94,93.87755102040816,0
46834_marine,49,45,46,0,94,93.87755102040816,0
46835_marine,49,46,46,0,95,93.87755102040816,0
46836_marine,49,46,46,0,95,93.87755102040816,0
46837_marine,49,46,46,0,95,93.87755102040816,0
46838_marine,49,46,46,0,95,93.87755102040816,0
46839_marine,49,46,46,0,95,93.87755102040816,0
46840_marine,51,45,48,0,96,94.11764705882352,0
46841_marine,51,45,48,0,96,94.11764705882352,0
46842_marine,51,45,48,0,96,94.11764705882352,0
46843_marine,51,45,48,0,96,94.11764705882352,0
46844_marine,51,45,48,0,96,94.11764705882352,0
46845_marine,51,46,48,0,97,94.11764705882352,0
46846_marine,49,46,46,0,95,93.87755102040816,0
46847_marine,49,46,46,0,95,93.87755102040816,0
46848_marine,49,45,46,0,94,93.87755102040816,0
46849_marine,49,45,46,0,94,93.87755102040816,0
46850_marine,48,45,45,0,93,93.75,0
46851_marine,48,44,45,0,92,93.75,0
46852_marine,48,44,45,0,92,93.75,0
46853_marine,46,44,43,0,90,93.47826086956522,0
46854_marine,46,44,43,0,90,93.47826086956522,0
46855_marine,46,44,43,0,90,93.47826086956522,0
46856_marine,46,44,43,0,90,93.47826086956522,0
46857_marine,46,45,43,0,91,93.47826086956522,0
46858_marine,46,45,43,0,91,93.47826086956522,0
46859_marine,46,45,43,0,91,93.47826086956522,0
46860_marine,46,45,43,0,91,93.47826086956522,0
46861_marine,46,45,43,0,91,93.47826086956522,0
46862_marine,46,45,43,0,91,93.47826086956522,0
46863_marine,46,45,43,0,91,93.47826086956522,0
46864_marine,46,46,43,0,92,93.47826086956522,0
46865_marine,46,46,43,0,92,93.47826086956522,0
46866_marine,46,47,43,0,93,93.47826086956522,0
46867_marine,44,47,41,0,91,93.18181818181817,0
46868_marine,44,47,41,0,91,93.18181818181817,0
46869_marine,44,47,41,0,91,93.18181818181817,0
46870_marine,44,47,41,0,91,93.18181818181817,0
46871_marine,44,47,41,0,91,93.18181818181817,0
46872_marine,44,49,41,0,93,93.18181818181817,0
46873_marine,44,49,41,0,93,93.18181818181817,0
46874_marine,44,49,41,0,93,93.18181818181817,0
46875_marine,43,49,40,0,92,93.02325581395348,0
46876_marine,44,49,41,0,93,93.18181818181817,0
46877_marine,42,49,39,0,91,92.85714285714286,0
46878_marine,42,45,39,0,87,92.85714285714286,0
46879_marine,40,45,37,0,85,92.5,0
46880_marine,40,45,37,0,85,92.5,0
46881_marine,40,45,37,0,85,92.5,0
46882_marine,38,45,37,0,83,97.36842105263158,0
46883_marine,38,45,37,0,83,97.36842105263158,0
46884_marine,38,44,37,0,82,97.36842105263158,0
46885_marine,37,44,36,0,81,97.2972972972973,0
46886_marine,37,43,36,0,80,97.2972972972973,0
46887_marine,37,43,36,0,80,97.2972972972973,0
46888_marine,35,43,34,0,78,97.14285714285714,0
46889_marine,35,43,34,0,78,97.14285714285714,0
46890_marine,33,41,32,0,74,96.96969696969697,0
46891_marine,35,42,34,2,77,97.14285714285714,5.714285714285714
46892_marine,35,42,34,2,77,97.14285714285714,5.714285714285714
46893_marine,35,46,34,2,81,97.14285714285714,5.714285714285714
46894_marine,35,48,34,2,83,97.14285714285714,5.714285714285714
46895_marine,36,48,35,2,84,97.22222222222221,5.555555555555555
46896_marine,36,49,35,2,85,97.22222222222221,5.555555555555555
46897_marine,36,49,35,2,85,97.22222222222221,5.555555555555555
46898_marine,34,49,33,2,83,97.05882352941177,5.88235294117647
46899_marine,36,50,33,3,86,91.66666666666666,8.333333333333332
46900_marine,36,48,33,3,84,91.66666666666666,8.333333333333332
46901_marine,40,48,36,3,88,90,7.5
46902_marine,41,52,37,3,93,90.2439024390244,7.317073170731707
46903_marine,42,52,38,3,94,90.47619047619048,7.142857142857142
46904_marine,44,52,40,3,96,90.9090909090909,6.8181818181818175
46905_marine,51,61,46,5,112,90.19607843137256,9.803921568627452
46906_marine,83,113,68,15,196,81.92771084337349,18.072289156626507
46919_marine,100,150,83,13,250,83,13
46920_marine,96,167,85,10,263,88.54166666666666,10.416666666666668
46921_marine,96,165,85,10,261,88.54166666666666,10.416666666666668
46922_marine,95,169,86,10,264,90.52631578947368,10.526315789473683
46923_marine,91,163,82,6,254,90.10989010989012,6.593406593406594
46924_marine,85,161,76,5,246,89.41176470588236,5.88235294117647
46925_marine,60,92,55,1,152,91.66666666666666,1.6666666666666667
46926_marine,58,61,53,1,119,91.37931034482759,1.7241379310344827
46927_marine,58,53,53,1,111,91.37931034482759,1.7241379310344827
46928_marine,58,53,53,1,111,91.37931034482759,1.7241379310344827
46929_marine,61,54,56,0,115,91.80327868852459,0
46930_marine,58,54,54,0,112,93.10344827586206,0
46931_marine,61,51,58,0,112,95.08196721311475,0
46932_marine,59,51,56,0,110,94.91525423728814,0
46933_marine,60,50,57,0,110,95,0
46934_marine,58,50,55,0,108,94.82758620689656,0
46935_marine,58,50,55,0,108,94.82758620689656,0
46936_marine,58,50,55,0,108,94.82758620689656,0
46937_marine,57,51,54,0,108,94.73684210526315,0
46938_marine,57,51,54,0,108,94.73684210526315,0
46939_marine,57,52,54,0,109,94.73684210526315,0
46940_marine,58,52,55,0,110,94.82758620689656,0
46941_marine,55,50,52,0,105,94.54545454545455,0
46942_marine,53,50,50,0,103,94.33962264150944,0
46943_marine,53,51,50,0,104,94.33962264150944,0
46944_marine,53,52,50,0,105,94.33962264150944,0
46945_marine,55,51,52,0,106,94.54545454545455,0
46946_marine,53,51,50,0,104,94.33962264150944,0
46947_marine,53,51,50,0,104,94.33962264150944,0
46948_marine,51,50,48,0,101,94.11764705882352,0
46949_marine,50,50,47,0,100,94,0
46950_marine,53,50,50,0,103,94.33962264150944,0
46951_marine,50,51,49,0,101,98,0
46952_marine,49,52,48,0,101,97.95918367346938,0
46953_marine,51,52,50,0,103,98.0392156862745,0
46954_marine,51,52,50,0,103,98.0392156862745,0
46955_marine,50,50,49,0,100,98,0
46956_marine,50,50,49,0,100,98,0
46957_marine,50,50,49,0,100,98,0
46958_marine,50,50,49,0,100,98,0
46959_marine,50,51,49,0,101,98,0
46960_marine,48,52,47,0,100,97.91666666666666,0
46961_marine,48,52,47,0,100,97.91666666666666,0
46962_marine,48,52,47,0,100,97.91666666666666,0
46963_marine,48,52,47,0,100,97.91666666666666,0
46964_marine,48,51,47,0,99,97.91666666666666,0
46965_marine,48,51,47,0,99,97.91666666666666,0
46966_marine,48,54,47,0,102,97.91666666666666,0
46967_marine,50,54,49,0,104,98,0
46968_marine,50,52,49,0,102,98,0
46969_marine,50,54,49,0,104,98,0
46970_marine,62,74,61,0,136,98.38709677419355,0
46971_marine,64,75,63,0,139,98.4375,0
46972_marine,52,61,51,0,113,98.07692307692307,0
46973_marine,50,53,49,0,103,98,0
46974_marine,52,55,51,0,107,98.07692307692307,0
46975_marine,51,56,50,0,107,98.0392156862745,0
46976_marine,49,53,48,0,102,97.95918367346938,0
46977_marine,48,53,47,0,101,97.91666666666666,0
46978_marine,48,51,47,0,99,97.91666666666666,0
46979_marine,48,53,47,0,101,97.91666666666666,0
46980_marine,48,53,47,0,101,97.91666666666666,0
46981_marine,47,54,45,0,101,95.74468085106383,0
46982_marine,47,52,45,0,99,95.74468085106383,0
46983_marine,47,53,45,0,100,95.74468085106383,0
46984_marine,47,53,45,0,100,95.74468085106383,0
46985_marine,49,54,47,0,103,95.91836734693877,0
46986_marine,49,54,47,0,103,95.91836734693877,0
46987_marine,49,54,47,0,103,95.91836734693877,0
46988_marine,49,53,47,0,102,95.91836734693877,0
46989_marine,49,53,47,0,102,95.91836734693877,0
46990_marine,49,53,47,0,102,95.91836734693877,0
46991_marine,49,53,46,1,102,93.87755102040816,2.0408163265306123
46992_marine,51,53,47,1,104,92.15686274509804,1.9607843137254901
46993_marine,51,54,47,1,105,92.15686274509804,1.9607843137254901
46994_marine,52,55,48,1,107,92.3076923076923,1.9230769230769231
46995_marine,52,55,48,1,107,92.3076923076923,1.9230769230769231
46996_marine,52,57,48,1,109,92.3076923076923,1.9230769230769231
46997_marine,52,57,48,1,109,92.3076923076923,1.9230769230769231
46998_marine,51,57,47,1,108,92.15686274509804,1.9607843137254901
46999_marine,50,57,47,1,107,94,2
47000_marine,52,57,49,1,109,94.23076923076923,1.9230769230769231
47001_marine,52,57,49,1,109,94.23076923076923,1.9230769230769231
47002_marine,51,56,48,1,107,94.11764705882352,1.9607843137254901
47003_marine,51,57,48,1,108,94.11764705882352,1.9607843137254901
47004_marine,53,57,50,1,110,94.33962264150944,1.8867924528301887
47005_marine,53,57,50,1,110,94.33962264150944,1.8867924528301887
47006_marine,53,57,50,1,110,94.33962264150944,1.8867924528301887
47007_marine,53,55,50,1,108,94.33962264150944,1.8867924528301887
47008_marine,53,55,50,1,108,94.33962264150944,1.8867924528301887
47009_marine,54,55,51,1,109,94.44444444444444,1.8518518518518516
47010_marine,50,55,47,1,105,94,2
47011_marine,50,56,47,1,106,94,2
47012_marine,50,56,47,1,106,94,2
47013_marine,48,56,45,1,104,93.75,2.083333333333333
47014_marine,48,55,45,1,103,93.75,2.083333333333333
47015_marine,45,55,42,1,100,93.33333333333333,2.2222222222222223
47016_marine,45,55,42,1,100,93.33333333333333,2.2222222222222223
47017_marine,47,56,44,2,103,93.61702127659575,4.25531914893617
47018_marine,46,56,43,2,102,93.47826086956522,4.3478260869565215
47019_marine,46,56,43,2,102,93.47826086956522,4.3478260869565215
47020_marine,46,56,43,2,102,93.47826086956522,4.3478260869565215
47021_marine,46,56,43,2,102,93.47826086956522,4.3478260869565215
47022_marine,47,58,44,2,105,93.61702127659575,4.25531914893617
47023_marine,47,60,44,2,107,93.61702127659575,4.25531914893617
47024_marine,47,58,44,2,105,93.61702127659575,4.25531914893617
47025_marine,47,58,44,2,105,93.61702127659575,4.25531914893617
47026_marine,47,60,44,2,107,93.61702127659575,4.25531914893617
47027_marine,47,58,44,2,105,93.61702127659575,4.25531914893617
47028_marine,47,58,44,2,105,93.61702127659575,4.25531914893617
47029_marine,47,57,43,3,104,91.48936170212765,6.382978723404255
47030_marine,47,56,43,3,103,91.48936170212765,6.382978723404255
47031_marine,45,54,41,3,99,91.11111111111111,6.666666666666667
47032_marine,45,54,41,2,99,91.11111111111111,4.444444444444445
47033_marine,46,54,42,3,100,91.30434782608695,6.521739130434782
47034_marine,46,56,42,3,102,91.30434782608695,6.521739130434782
47035_marine,46,56,42,3,102,91.30434782608695,6.521739130434782
47036_marine,45,56,41,3,101,91.11111111111111,6.666666666666667
47037_marine,45,56,41,3,101,91.11111111111111,6.666666666666667
47038_marine,45,56,41,3,101,91.11111111111111,6.666666666666667
47039_marine,45,56,41,3,101,91.11111111111111,6.666666666666667
47040_marine,44,56,41,2,100,93.18181818181817,4.545454545454546
47041_marine,44,59,41,2,103,93.18181818181817,4.545454545454546
47042_marine,44,59,41,2,103,93.18181818181817,4.545454545454546
47043_marine,41,59,38,2,100,92.6829268292683,4.878048780487805
47044_marine,41,59,38,2,100,92.6829268292683,4.878048780487805
47045_marine,41,58,38,2,99,92.6829268292683,4.878048780487805
47046_marine,41,58,38,2,99,92.6829268292683,4.878048780487805
47047_marine,40,58,38,1,98,95,2.5
47048_marine,40,57,38,1,97,95,2.5
47049_marine,40,57,38,1,97,95,2.5
47050_marine,40,57,38,1,97,95,2.5
47051_marine,41,57,39,1,98,95.1219512195122,2.4390243902439024
47052_marine,41,57,39,0,98,95.1219512195122,0
47053_marine,42,58,40,0,100,95.23809523809523,0
47054_marine,42,58,40,0,100,95.23809523809523,0
47055_marine,40,58,38,0,98,95,0
47056_marine,40,58,38,0,98,95,0
47057_marine,41,60,39,0,101,95.1219512195122,0
47058_marine,41,62,39,0,103,95.1219512195122,0
47059_marine,43,62,41,0,105,95.34883720930233,0
47060_marine,42,61,40,0,103,95.23809523809523,0
47061_marine,44,59,42,0,103,95.45454545454545,0
47062_marine,41,59,39,0,100,95.1219512195122,0
47063_marine,41,59,39,0,100,95.1219512195122,0
47064_marine,41,59,39,0,100,95.1219512195122,0
47065_marine,41,60,39,0,101,95.1219512195122,0
47066_marine,40,58,38,0,98,95,0
47067_marine,40,56,38,0,96,95,0
47068_marine,40,55,38,0,95,95,0
47069_marine,40,55,38,0,95,95,0
47070_marine,40,56,38,0,96,95,0
47071_marine,40,56,38,0,96,95,0
47072_marine,41,56,38,0,97,92.6829268292683,0
47073_marine,41,58,38,0,99,92.6829268292683,0
47074_marine,41,60,38,0,101,92.6829268292683,0
47075_marine,41,60,38,0,101,92.6829268292683,0
47076_marine,43,59,40,0,102,93.02325581395348,0
47077_marine,45,57,42,0,102,93.33333333333333,0
47078_marine,48,57,45,0,105,93.75,0
47079_marine,49,55,46,0,104,93.87755102040816,0
47080_marine,49,55,46,0,104,93.87755102040816,0
47081_marine,49,54,46,0,103,93.87755102040816,0
47082_marine,50,54,47,0,104,94,0
47083_marine,50,54,47,0,104,94,0
47084_marine,49,53,46,0,102,93.87755102040816,0
47085_marine,47,53,44,0,100,93.61702127659575,0
47086_marine,47,53,44,0,100,93.61702127659575,0
47087_marine,47,53,44,0,100,93.61702127659575,0
47088_marine,45,53,42,0,98,93.33333333333333,0
47089_marine,47,53,44,0,100,93.61702127659575,0
47090_marine,47,53,44,0,100,93.61702127659575,0
47091_marine,47,53,44,0,100,93.61702127659575,0
47092_marine,47,53,44,0,100,93.61702127659575,0
47093_marine,49,54,46,0,103,93.87755102040816,0
47094_marine,49,54,46,0,103,93.87755102040816,0
47095_marine,51,54,48,0,105,94.11764705882352,0
47096_marine,54,54,51,0,108,94.44444444444444,0
47097_marine,54,54,51,0,108,94.44444444444444,0
47098_marine,56,54,53,0,110,94.64285714285714,0
47099_marine,51,54,48,0,105,94.11764705882352,0
47100_marine,51,56,48,0,107,94.11764705882352,0
47101_marine,52,56,50,0,108,96.15384615384616,0
47102_marine,52,56,50,0,108,96.15384615384616,0
47103_marine,50,54,48,0,104,96,0
47104_marine,50,56,48,0,106,96,0
47105_marine,50,56,48,0,106,96,0
47106_marine,50,56,48,0,106,96,0
47107_marine,51,56,49,0,107,96.07843137254902,0
47108_marine,51,56,49,0,107,96.07843137254902,0
47109_marine,51,55,49,0,106,96.07843137254902,0
47110_marine,51,55,49,0,106,96.07843137254902,0
47111_marine,51,54,49,0,105,96.07843137254902,0
47112_marine,49,54,47,0,103,95.91836734693877,0
47113_marine,51,55,49,0,106,96.07843137254902,0
47114_marine,51,55,49,0,106,96.07843137254902,0
47115_marine,52,55,50,0,107,96.15384615384616,0
47116_marine,53,55,50,0,108,94.33962264150944,0
47117_marine,55,56,51,1,111,92.72727272727272,1.8181818181818181
47118_marine,62,58,56,1,120,90.32258064516128,1.6129032258064515
47119_marine,68,61,62,1,129,91.17647058823529,1.4705882352941175
47120_marine,72,63,66,1,135,91.66666666666666,1.3888888888888888
47121_marine,85,64,77,6,149,90.58823529411765,7.0588235294117645
47122_marine,86,70,77,6,156,89.53488372093024,6.976744186046512
47123_marine,181,227,144,32,408,79.55801104972376,17.67955801104972
47130_marine,213,226,168,42,439,78.87323943661971,19.718309859154928
47131_marine,96,75,87,6,171,90.625,6.25
47132_marine,87,69,80,4,156,91.95402298850574,4.597701149425287
47133_marine,86,66,80,4,152,93.02325581395348,4.651162790697675
47134_marine,79,65,74,3,144,93.67088607594937,3.79746835443038
47135_marine,80,65,75,3,145,93.75,3.75
47136_marine,80,66,75,3,146,93.75,3.75
47137_marine,78,66,73,3,144,93.58974358974359,3.8461538461538463
47138_marine,78,66,73,3,144,93.58974358974359,3.8461538461538463
47139_marine,77,67,72,3,144,93.5064935064935,3.896103896103896
47140_marine,79,68,74,3,147,93.67088607594937,3.79746835443038
47141_marine,78,69,74,3,147,94.87179487179486,3.8461538461538463
47142_marine,78,69,74,3,147,94.87179487179486,3.8461538461538463
47143_marine,77,69,73,3,146,94.8051948051948,3.896103896103896
47144_marine,77,69,73,3,146,94.8051948051948,3.896103896103896
47145_marine,79,71,75,3,150,94.9367088607595,3.79746835443038
47146_marine,83,74,79,3,157,95.18072289156626,3.614457831325301
47147_marine,85,75,81,3,160,95.29411764705881,3.5294117647058822
47148_marine,89,98,85,3,187,95.50561797752809,3.3707865168539324
47149_marine,92,102,87,3,194,94.56521739130434,3.260869565217391
47150_marine,102,116,94,4,218,92.15686274509804,3.9215686274509802
47151_marine,143,204,130,13,347,90.9090909090909,9.090909090909092
47152_marine,150,215,136,16,365,90.66666666666666,10.666666666666668
47158_marine,166,233,147,22,399,88.55421686746988,13.253012048192772
47159_marine,161,221,145,19,382,90.06211180124224,11.801242236024844
47160_marine,92,74,88,5,166,95.65217391304348,5.434782608695652
47161_marine,73,67,70,3,140,95.8904109589041,4.10958904109589
47162_marine,67,64,64,0,131,95.52238805970148,0
47163_marine,67,61,64,0,128,95.52238805970148,0
47164_marine,65,59,62,0,124,95.38461538461539,0
47165_marine,65,59,62,0,124,95.38461538461539,0
47166_marine,64,60,61,0,124,95.3125,0
47167_marine,62,59,59,0,121,95.16129032258065,0
47168_marine,63,56,60,0,119,95.23809523809523,0
47169_marine,59,53,56,0,112,94.91525423728814,0
47170_marine,56,53,53,0,109,94.64285714285714,0
47171_marine,56,52,53,0,108,94.64285714285714,0
47172_marine,55,52,52,0,107,94.54545454545455,0
47173_marine,52,52,49,0,104,94.23076923076923,0
47174_marine,50,52,47,0,102,94,0
47175_marine,50,52,47,0,102,94,0
47176_marine,50,51,47,0,101,94,0
47177_marine,50,51,47,0,101,94,0
47178_marine,50,49,47,0,99,94,0
47179_marine,50,49,47,0,99,94,0
47180_marine,50,48,47,0,98,94,0
47181_marine,50,48,47,0,98,94,0
47182_marine,48,48,45,0,96,93.75,0
47183_marine,48,48,45,0,96,93.75,0
47184_marine,48,48,45,0,96,93.75,0
47185_marine,48,48,45,0,96,93.75,0
47186_marine,47,48,44,0,95,93.61702127659575,0
47187_marine,47,48,44,0,95,93.61702127659575,0
47188_marine,47,48,44,0,95,93.61702127659575,0
47189_marine,47,48,44,0,95,93.61702127659575,0
47190_marine,47,47,44,0,94,93.61702127659575,0
47191_marine,46,47,43,0,93,93.47826086956522,0
47192_marine,46,47,43,0,93,93.47826086956522,0
47193_marine,46,45,43,0,91,93.47826086956522,0
47194_marine,46,45,43,0,91,93.47826086956522,0
47195_marine,46,45,43,0,91,93.47826086956522,0
47196_marine,46,46,43,0,92,93.47826086956522,0
47197_marine,46,46,43,0,92,93.47826086956522,0
47198_marine,46,46,43,0,92,93.47826086956522,0
47199_marine,44,46,41,0,90,93.18181818181817,0
47200_marine,43,46,40,0,89,93.02325581395348,0
47201_marine,43,46,40,0,89,93.02325581395348,0
47202_marine,43,46,40,0,89,93.02325581395348,0
47203_marine,43,46,40,0,89,93.02325581395348,0
47204_marine,43,46,40,0,89,93.02325581395348,0
47205_marine,43,47,40,0,90,93.02325581395348,0
47206_marine,43,47,40,0,90,93.02325581395348,0
47207_marine,43,47,40,0,90,93.02325581395348,0
47208_marine,45,46,42,0,91,93.33333333333333,0
47209_marine,45,46,42,0,91,93.33333333333333,0
47210_marine,45,46,42,0,91,93.33333333333333,0
47211_marine,45,46,42,0,91,93.33333333333333,0
47212_marine,45,46,42,0,91,93.33333333333333,0
47213_marine,45,46,42,0,91,93.33333333333333,0
47214_marine,45,46,42,0,91,93.33333333333333,0
47215_marine,45,46,42,0,91,93.33333333333333,0
47216_marine,45,46,42,0,91,93.33333333333333,0
47217_marine,45,46,42,0,91,93.33333333333333,0
47218_marine,44,45,41,0,89,93.18181818181817,0
47219_marine,44,45,41,0,89,93.18181818181817,0
47220_marine,44,47,41,0,91,93.18181818181817,0
47221_marine,44,48,41,0,92,93.18181818181817,0
47222_marine,44,48,41,0,92,93.18181818181817,0
47223_marine,44,48,41,0,92,93.18181818181817,0
47224_marine,44,48,41,0,92,93.18181818181817,0
47225_marine,44,48,41,0,92,93.18181818181817,0
47226_marine,42,48,39,0,90,92.85714285714286,0
47227_marine,42,49,39,0,91,92.85714285714286,0
47228_marine,42,49,39,0,91,92.85714285714286,0
47229_marine,42,49,39,0,91,92.85714285714286,0
47230_marine,40,49,37,0,89,92.5,0
47231_marine,38,49,35,0,87,92.10526315789474,0
47232_marine,38,49,35,0,87,92.10526315789474,0
47233_marine,38,47,35,0,85,92.10526315789474,0
47234_marine,38,47,35,0,85,92.10526315789474,0
47235_marine,38,46,35,0,84,92.10526315789474,0
47236_marine,38,46,35,0,84,92.10526315789474,0
47237_marine,36,46,35,0,82,97.22222222222221,0
47238_marine,36,45,35,0,81,97.22222222222221,0
47239_marine,35,45,34,0,80,97.14285714285714,0
47240_marine,35,45,34,0,80,97.14285714285714,0
47241_marine,35,45,34,0,80,97.14285714285714,0
47242_marine,35,43,34,0,78,97.14285714285714,0
47243_marine,33,42,32,0,75,96.96969696969697,0
47244_marine,33,42,32,0,75,96.96969696969697,0
47245_marine,33,41,32,0,74,96.96969696969697,0
47246_marine,35,41,34,0,76,97.14285714285714,0
47247_marine,32,42,31,0,74,96.875,0
47248_marine,32,44,31,0,76,96.875,0
47249_marine,32,44,31,0,76,96.875,0
47250_marine,32,44,31,0,76,96.875,0
47251_marine,32,44,31,0,76,96.875,0
47252_marine,30,45,29,0,75,96.66666666666667,0
47253_marine,30,45,29,0,75,96.66666666666667,0
47254_marine,30,46,29,0,76,96.66666666666667,0
47255_marine,31,48,30,0,79,96.7741935483871,0
47256_marine,31,49,30,2,80,96.7741935483871,6.451612903225806
47257_marine,31,49,30,2,80,96.7741935483871,6.451612903225806
47258_marine,31,49,30,2,80,96.7741935483871,6.451612903225806
47259_marine,33,49,30,3,82,90.9090909090909,9.090909090909092
47260_marine,37,51,34,3,88,91.8918918918919,8.108108108108109
47261_marine,40,50,36,3,90,90,7.5
47262_marine,40,54,36,3,94,90,7.5
47263_marine,40,54,36,3,94,90,7.5
47264_marine,44,56,40,4,100,90.9090909090909,9.090909090909092
47265_marine,57,75,53,5,132,92.98245614035088,8.771929824561402
47266_marine,154,213,96,80,367,62.33766233766234,51.94805194805194
47267_marine,173,238,101,94,411,58.38150289017341,54.33526011560693
47279_marine,100,165,84,12,265,84,12
47280_marine,92,161,81,8,253,88.04347826086956,8.695652173913043
47281_marine,92,159,83,8,251,90.21739130434783,8.695652173913043
47282_marine,87,163,78,5,250,89.65517241379311,5.747126436781609
47283_marine,87,156,76,7,243,87.356321839080465,8.045977011494253
47284_marine,59,90,54,1,149,91.52542372881356,1.694915254237288
47285_marine,55,65,50,1,120,90.9090909090909,1.8181818181818181
47286_marine,54,52,49,1,106,90.74074074074075,1.8518518518518516
47287_marine,54,52,49,1,106,90.74074074074075,1.8518518518518516
47288_marine,56,54,51,1,110,91.07142857142857,1.7857142857142856
47289_marine,54,54,50,0,108,92.5925925925926,0
47290_marine,54,52,51,0,106,94.44444444444444,0
47291_marine,55,51,52,0,106,94.54545454545455,0
47292_marine,55,51,52,0,106,94.54545454545455,0
47293_marine,56,51,53,0,107,94.64285714285714,0
47294_marine,56,50,53,0,106,94.64285714285714,0
47295_marine,56,48,53,0,104,94.64285714285714,0
47296_marine,56,48,53,0,104,94.64285714285714,0
47297_marine,55,48,52,0,103,94.54545454545455,0
47298_marine,54,47,51,0,101,94.44444444444444,0
47299_marine,55,47,52,0,102,94.54545454545455,0
47300_marine,54,48,51,0,102,94.44444444444444,0
47301_marine,51,49,48,0,100,94.11764705882352,0
47302_marine,51,49,48,0,100,94.11764705882352,0
47303_marine,51,49,48,0,100,94.11764705882352,0
47304_marine,51,50,48,0,101,94.11764705882352,0
47305_marine,51,50,48,0,101,94.11764705882352,0
47306_marine,49,50,46,0,99,93.87755102040816,0
47307_marine,50,52,47,0,102,94,0
47308_marine,50,52,47,0,102,94,0
47309_marine,51,53,48,0,104,94.11764705882352,0
47310_marine,49,53,48,0,102,97.95918367346938,0
47311_marine,48,53,47,0,101,97.91666666666666,0
47312_marine,48,53,47,0,101,97.91666666666666,0
47313_marine,48,53,47,0,101,97.91666666666666,0
47314_marine,47,53,46,0,100,97.87234042553192,0
47315_marine,47,53,46,0,100,97.87234042553192,0
47316_marine,45,53,44,0,98,97.77777777777777,0
47317_marine,45,53,44,0,98,97.77777777777777,0
47318_marine,45,53,44,0,98,97.77777777777777,0
47319_marine,45,53,44,0,98,97.77777777777777,0
47320_marine,45,53,44,0,98,97.77777777777777,0
47321_marine,45,53,44,0,98,97.77777777777777,0
47322_marine,45,53,44,0,98,97.77777777777777,0
47323_marine,45,53,44,0,98,97.77777777777777,0
47324_marine,45,53,44,0,98,97.77777777777777,0
47325_marine,45,54,44,0,99,97.77777777777777,0
47326_marine,45,54,44,0,99,97.77777777777777,0
47327_marine,45,54,44,0,99,97.77777777777777,0
47328_marine,46,56,45,0,102,97.82608695652173,0
47329_marine,48,58,47,0,106,97.91666666666666,0
47330_marine,50,63,49,0,113,98,0
47331_marine,49,61,48,0,110,97.95918367346938,0
47332_marine,49,56,48,0,105,97.95918367346938,0
47333_marine,47,55,46,0,102,97.87234042553192,0
47334_marine,46,55,45,0,101,97.82608695652173,0
47335_marine,47,53,46,0,100,97.87234042553192,0
47336_marine,45,53,44,0,98,97.77777777777777,0
47337_marine,45,54,44,0,99,97.77777777777777,0
47338_marine,45,56,44,0,101,97.77777777777777,0
47339_marine,45,57,44,0,102,97.77777777777777,0
47340_marine,48,56,47,0,104,97.91666666666666,0
47341_marine,48,56,47,0,104,97.91666666666666,0
47342_marine,48,53,47,0,101,97.91666666666666,0
47343_marine,48,53,47,0,101,97.91666666666666,0
47344_marine,46,53,45,0,99,97.82608695652173,0
47345_marine,46,52,45,0,98,97.82608695652173,0
47346_marine,47,52,45,0,99,95.74468085106383,0
47347_marine,46,52,44,0,98,95.65217391304348,0
47348_marine,46,52,44,0,98,95.65217391304348,0
47349_marine,46,52,44,0,98,95.65217391304348,0
47350_marine,45,52,42,1,97,93.33333333333333,2.2222222222222223
47351_marine,44,52,41,1,96,93.18181818181817,2.272727272727273
47352_marine,46,52,43,1,98,93.47826086956522,2.1739130434782608
47353_marine,49,53,45,1,102,91.83673469387756,2.0408163265306123
47354_marine,49,53,45,1,102,91.83673469387756,2.0408163265306123
47355_marine,52,53,48,1,105,92.3076923076923,1.9230769230769231
47356_marine,52,53,48,1,105,92.3076923076923,1.9230769230769231
47357_marine,52,53,48,1,105,92.3076923076923,1.9230769230769231
47358_marine,51,55,47,1,106,92.15686274509804,1.9607843137254901
47359_marine,48,55,45,1,103,93.75,2.083333333333333
47360_marine,48,55,45,1,103,93.75,2.083333333333333
47361_marine,48,56,45,1,104,93.75,2.083333333333333
47362_marine,47,55,44,1,102,93.61702127659575,2.127659574468085
47363_marine,49,56,46,1,105,93.87755102040816,2.0408163265306123
47364_marine,49,57,46,1,106,93.87755102040816,2.0408163265306123
47365_marine,49,57,46,1,106,93.87755102040816,2.0408163265306123
47366_marine,49,57,46,1,106,93.87755102040816,2.0408163265306123
47367_marine,49,55,46,1,104,93.87755102040816,2.0408163265306123
47368_marine,49,55,46,1,104,93.87755102040816,2.0408163265306123
47369_marine,48,56,45,1,104,93.75,2.083333333333333
47370_marine,47,56,44,1,103,93.61702127659575,2.127659574468085
47371_marine,45,56,42,1,101,93.33333333333333,2.2222222222222223
47372_marine,46,56,43,1,102,93.47826086956522,2.1739130434782608
47373_marine,46,57,43,1,103,93.47826086956522,2.1739130434782608
47374_marine,45,57,42,1,102,93.33333333333333,2.2222222222222223
47375_marine,45,57,42,1,102,93.33333333333333,2.2222222222222223
47376_marine,46,57,43,1,103,93.47826086956522,2.1739130434782608
47377_marine,47,58,44,2,105,93.61702127659575,4.25531914893617
47378_marine,46,58,43,2,104,93.47826086956522,4.3478260869565215
47379_marine,46,59,43,2,105,93.47826086956522,4.3478260869565215
47380_marine,47,59,43,3,106,91.48936170212765,6.382978723404255
47381_marine,48,59,44,4,107,91.66666666666666,8.333333333333332
47382_marine,48,61,44,4,109,91.66666666666666,8.333333333333332
47383_marine,48,63,44,4,111,91.66666666666666,8.333333333333332
47384_marine,48,61,44,4,109,91.66666666666666,8.333333333333332
47385_marine,48,59,44,4,107,91.66666666666666,8.333333333333332
47386_marine,46,59,42,4,105,91.30434782608695,8.695652173913043
47387_marine,45,59,41,4,104,91.11111111111111,8.88888888888889
47388_marine,46,59,42,4,105,91.30434782608695,8.695652173913043
47389_marine,46,59,42,4,105,91.30434782608695,8.695652173913043
47390_marine,46,57,42,4,103,91.30434782608695,8.695652173913043
47391_marine,45,57,41,3,102,91.11111111111111,6.666666666666667
47392_marine,45,56,41,3,101,91.11111111111111,6.666666666666667
47393_marine,45,56,41,3,101,91.11111111111111,6.666666666666667
47394_marine,46,56,42,3,102,91.30434782608695,6.521739130434782
47395_marine,45,56,41,3,101,91.11111111111111,6.666666666666667
47396_marine,45,56,41,3,101,91.11111111111111,6.666666666666667
47397_marine,45,58,41,3,103,91.11111111111111,6.666666666666667
47398_marine,45,58,41,3,103,91.11111111111111,6.666666666666667
47399_marine,45,57,41,3,102,91.11111111111111,6.666666666666667
47400_marine,45,57,41,3,102,91.11111111111111,6.666666666666667
47401_marine,45,57,41,3,102,91.11111111111111,6.666666666666667
47402_marine,42,57,38,3,99,90.47619047619048,7.142857142857142
47403_marine,42,57,38,3,99,90.47619047619048,7.142857142857142
47404_marine,41,57,38,2,98,92.6829268292683,4.878048780487805
47405_marine,41,58,38,2,99,92.6829268292683,4.878048780487805
47406_marine,41,58,38,2,99,92.6829268292683,4.878048780487805
47407_marine,41,58,38,2,99,92.6829268292683,4.878048780487805
47408_marine,39,59,36,2,98,92.3076923076923,5.128205128205128
47409_marine,39,59,36,2,98,92.3076923076923,5.128205128205128
47410_marine,39,59,36,2,98,92.3076923076923,5.128205128205128
47411_marine,40,59,37,2,99,92.5,5
47412_marine,39,58,37,1,97,94.87179487179486,2.564102564102564
47413_marine,40,58,38,1,98,95,2.5
47414_marine,41,58,39,1,99,95.1219512195122,2.4390243902439024
47415_marine,41,59,39,1,100,95.1219512195122,2.4390243902439024
47416_marine,41,59,39,1,100,95.1219512195122,2.4390243902439024
47417_marine,40,59,38,0,99,95,0
47418_marine,40,59,38,0,99,95,0
47419_marine,40,59,38,0,99,95,0
47420_marine,40,59,38,0,99,95,0
47421_marine,39,59,37,0,98,94.87179487179486,0
47422_marine,38,59,36,0,97,94.73684210526315,0
47423_marine,38,59,36,0,97,94.73684210526315,0
47424_marine,38,59,36,0,97,94.73684210526315,0
47425_marine,38,58,36,0,96,94.73684210526315,0
47426_marine,38,58,36,0,96,94.73684210526315,0
47427_marine,40,58,38,0,98,95,0
47428_marine,40,57,38,0,97,95,0
47429_marine,40,57,38,0,97,95,0
47430_marine,40,57,38,0,97,95,0
47431_marine,40,58,38,0,98,95,0
47432_marine,41,58,38,0,99,92.6829268292683,0
47433_marine,41,58,38,0,99,92.6829268292683,0
47434_marine,41,60,38,0,101,92.6829268292683,0
47435_marine,41,60,38,0,101,92.6829268292683,0
47436_marine,41,60,38,0,101,92.6829268292683,0
47437_marine,45,60,42,0,105,93.33333333333333,0
47438_marine,45,62,42,0,107,93.33333333333333,0
47439_marine,47,60,44,0,107,93.61702127659575,0
47440_marine,47,57,44,0,104,93.61702127659575,0
47441_marine,48,55,45,0,103,93.75,0
47442_marine,48,55,45,0,103,93.75,0
47443_marine,48,54,45,0,102,93.75,0
47444_marine,48,52,45,0,100,93.75,0
47445_marine,44,52,41,0,96,93.18181818181817,0
47446_marine,44,51,41,0,95,93.18181818181817,0
47447_marine,44,51,41,0,95,93.18181818181817,0
47448_marine,46,51,43,0,97,93.47826086956522,0
47449_marine,45,53,42,0,98,93.33333333333333,0
47450_marine,45,53,42,0,98,93.33333333333333,0
47451_marine,45,53,42,0,98,93.33333333333333,0
47452_marine,45,53,42,0,98,93.33333333333333,0
47453_marine,45,53,42,0,98,93.33333333333333,0
47454_marine,45,53,42,0,98,93.33333333333333,0
47455_marine,47,53,44,0,100,93.61702127659575,0
47456_marine,47,53,44,0,100,93.61702127659575,0
47457_marine,47,54,44,0,101,93.61702127659575,0
47458_marine,47,54,44,0,101,93.61702127659575,0
47459_marine,47,54,44,0,101,93.61702127659575,0
47460_marine,50,54,48,0,104,96,0
47461_marine,48,54,46,0,102,95.83333333333334,0
47462_marine,48,54,46,0,102,95.83333333333334,0
47463_marine,48,54,46,0,102,95.83333333333334,0
47464_marine,48,54,46,0,102,95.83333333333334,0
47465_marine,48,54,46,0,102,95.83333333333334,0
47466_marine,48,54,46,0,102,95.83333333333334,0
47467_marine,50,56,48,0,106,96,0
47468_marine,50,56,48,0,106,96,0
47469_marine,51,55,49,0,106,96.07843137254902,0
47470_marine,51,55,49,0,106,96.07843137254902,0
47471_marine,51,55,49,0,106,96.07843137254902,0
47472_marine,53,55,51,0,108,96.22641509433963,0
47473_marine,53,56,51,0,109,96.22641509433963,0
47474_marine,53,54,51,0,107,96.22641509433963,0
47475_marine,53,53,51,0,106,96.22641509433963,0
47476_marine,53,53,51,0,106,96.22641509433963,0
47477_marine,56,54,53,0,110,94.64285714285714,0
47478_marine,58,56,54,1,114,93.10344827586206,1.7241379310344827
47479_marine,58,57,54,1,115,93.10344827586206,1.7241379310344827
47480_marine,70,59,64,1,129,91.42857142857143,1.4285714285714286
47481_marine,73,60,66,2,133,90.41095890410958,2.73972602739726
47482_marine,79,64,71,4,143,89.87341772151899,5.063291139240507
47483_marine,106,102,95,8,208,89.62264150943396,7.547169811320755
47484_marine,194,232,156,34,426,80.41237113402062,17.525773195876287
47490_marine,200,220,160,35,420,80,17.5
47491_marine,91,73,82,4,164,90.10989010989012,4.395604395604396
47492_marine,82,67,75,3,149,91.46341463414635,3.6585365853658534
47493_marine,80,66,74,1,146,92.5,1.25
47494_marine,75,66,70,1,141,93.33333333333333,1.3333333333333335
47495_marine,78,67,73,3,145,93.58974358974359,3.8461538461538463
47496_marine,77,65,72,3,142,93.5064935064935,3.896103896103896
47497_marine,73,65,68,3,138,93.15068493150685,4.10958904109589
47498_marine,73,67,68,3,140,93.15068493150685,4.10958904109589
47499_marine,73,68,68,3,141,93.15068493150685,4.10958904109589
47500_marine,73,70,68,3,143,93.15068493150685,4.10958904109589
47501_marine,72,70,68,3,142,94.44444444444444,4.166666666666666
47502_marine,72,70,68,3,142,94.44444444444444,4.166666666666666
47503_marine,71,70,67,3,141,94.36619718309859,4.225352112676056
47504_marine,71,70,67,3,141,94.36619718309859,4.225352112676056
47505_marine,71,70,67,3,141,94.36619718309859,4.225352112676056
47506_marine,78,70,73,3,148,93.58974358974359,3.8461538461538463
47507_marine,82,76,77,3,158,93.90243902439023,3.6585365853658534
47508_marine,82,78,77,3,160,93.90243902439023,3.6585365853658534
47509_marine,93,98,87,4,191,93.54838709677419,4.301075268817205
47510_marine,115,187,106,5,302,92.17391304347827,4.3478260869565215
47511_marine,140,207,127,14,347,90.71428571428571,10
47518_marine,150,224,134,17,374,89.33333333333333,11.333333333333332
47519_marine,86,78,82,3,164,95.34883720930233,3.488372093023256
47520_marine,81,72,78,3,153,96.29629629629629,3.7037037037037033
47521_marine,76,101,73,2,177,96.05263157894737,2.631578947368421
47522_marine,75,91,72,0,166,96,0
47523_marine,83,144,80,0,227,96.3855421686747,0
47524_marine,86,144,83,0,230,96.51162790697676,0
47525_marine,87,142,84,0,229,96.55172413793103,0
47526_marine,73,85,70,0,158,95.8904109589041,0
47527_marine,62,60,59,0,122,95.16129032258065,0
47528_marine,60,56,57,0,116,95,0
47529_marine,58,54,55,0,112,94.82758620689656,0
47530_marine,57,53,54,0,110,94.73684210526315,0
47531_marine,55,52,52,0,107,94.54545454545455,0
47532_marine,53,52,50,0,105,94.33962264150944,0
47533_marine,51,52,48,0,103,94.11764705882352,0
47534_marine,51,52,48,0,103,94.11764705882352,0
47535_marine,51,52,48,0,103,94.11764705882352,0
47536_marine,51,51,48,0,102,94.11764705882352,0
47537_marine,50,51,47,0,101,94,0
47538_marine,50,51,47,0,101,94,0
47539_marine,50,51,47,0,101,94,0
47540_marine,48,51,45,0,99,93.75,0
47541_marine,48,48,45,0,96,93.75,0
47542_marine,48,48,45,0,96,93.75,0
47543_marine,47,48,44,0,95,93.61702127659575,0
47544_marine,47,48,44,0,95,93.61702127659575,0
47545_marine,47,48,44,0,95,93.61702127659575,0
47546_marine,47,48,44,0,95,93.61702127659575,0
47547_marine,47,48,44,0,95,93.61702127659575,0
47548_marine,47,48,44,0,95,93.61702127659575,0
47549_marine,47,50,44,0,97,93.61702127659575,0
47550_marine,47,49,44,0,96,93.61702127659575,0
47551_marine,46,49,43,0,95,93.47826086956522,0
47552_marine,46,49,43,0,95,93.47826086956522,0
47553_marine,44,49,41,0,93,93.18181818181817,0
47554_marine,44,49,41,0,93,93.18181818181817,0
47555_marine,44,49,41,0,93,93.18181818181817,0
47556_marine,44,49,41,0,93,93.18181818181817,0
47557_marine,44,47,41,0,91,93.18181818181817,0
47558_marine,44,48,41,0,92,93.18181818181817,0
47559_marine,44,48,41,0,92,93.18181818181817,0
47560_marine,44,48,41,0,92,93.18181818181817,0
47561_marine,44,48,41,0,92,93.18181818181817,0
47562_marine,44,48,41,0,92,93.18181818181817,0
47563_marine,44,48,41,0,92,93.18181818181817,0
47564_marine,44,49,41,0,93,93.18181818181817,0
47565_marine,44,49,41,0,93,93.18181818181817,0
47566_marine,44,49,41,0,93,93.18181818181817,0
47567_marine,44,49,41,0,93,93.18181818181817,0
47568_marine,44,49,41,0,93,93.18181818181817,0
47569_marine,44,49,41,0,93,93.18181818181817,0
47570_marine,44,49,41,0,93,93.18181818181817,0
47571_marine,44,49,41,0,93,93.18181818181817,0
47572_marine,46,49,43,0,95,93.47826086956522,0
47573_marine,46,49,43,0,95,93.47826086956522,0
47574_marine,45,49,42,0,94,93.33333333333333,0
47575_marine,45,49,42,0,94,93.33333333333333,0
47576_marine,45,49,42,0,94,93.33333333333333,0
47577_marine,45,50,42,0,95,93.33333333333333,0
47578_marine,45,50,42,0,95,93.33333333333333,0
47579_marine,45,49,42,0,94,93.33333333333333,0
47580_marine,45,49,42,0,94,93.33333333333333,0
47581_marine,43,49,40,0,92,93.02325581395348,0
47582_marine,43,49,40,0,92,93.02325581395348,0
47583_marine,43,49,40,0,92,93.02325581395348,0
47584_marine,39,49,36,0,88,92.3076923076923,0
47585_marine,39,49,36,0,88,92.3076923076923,0
47586_marine,39,48,36,0,87,92.3076923076923,0
47587_marine,38,49,35,0,87,92.10526315789474,0
47588_marine,38,49,35,0,87,92.10526315789474,0
47589_marine,38,47,35,0,85,92.10526315789474,0
47590_marine,38,47,35,0,85,92.10526315789474,0
47591_marine,36,47,35,0,83,97.22222222222221,0
47592_marine,36,46,35,0,82,97.22222222222221,0
47593_marine,36,44,35,0,80,97.22222222222221,0
47594_marine,36,44,35,0,80,97.22222222222221,0
47595_marine,36,44,35,0,80,97.22222222222221,0
47596_marine,36,45,35,0,81,97.22222222222221,0
47597_marine,34,45,33,0,79,97.05882352941177,0
47598_marine,34,44,33,0,78,97.05882352941177,0
47599_marine,34,44,33,0,78,97.05882352941177,0
47600_marine,34,44,33,0,78,97.05882352941177,0
47601_marine,34,43,33,0,77,97.05882352941177,0
47602_marine,33,43,32,0,76,96.96969696969697,0
47603_marine,33,45,32,0,78,96.96969696969697,0
47604_marine,33,44,32,0,77,96.96969696969697,0
47605_marine,31,44,30,0,75,96.7741935483871,0
47606_marine,31,44,30,0,75,96.7741935483871,0
47607_marine,31,44,30,0,75,96.7741935483871,0
47608_marine,31,44,30,0,75,96.7741935483871,0
47609_marine,31,44,30,0,75,96.7741935483871,0
47610_marine,31,44,30,0,75,96.7741935483871,0
47611_marine,31,44,30,0,75,96.7741935483871,0
47612_marine,31,45,30,0,76,96.7741935483871,0
47613_marine,30,45,29,0,75,96.66666666666667,0
47614_marine,31,47,30,0,78,96.7741935483871,0
47615_marine,31,49,30,0,80,96.7741935483871,0
47616_marine,31,50,30,0,81,96.7741935483871,0
47617_marine,31,51,30,0,82,96.7741935483871,0
47618_marine,29,51,28,0,80,96.55172413793103,0
47619_marine,33,52,30,1,85,90.9090909090909,3.0303030303030303
47620_marine,34,52,31,1,86,91.17647058823529,2.941176470588235
47621_marine,37,53,33,1,90,89.1891891891892,2.7027027027027026
47622_marine,38,54,34,3,92,89.47368421052632,7.894736842105263
47623_marine,38,54,34,3,92,89.47368421052632,7.894736842105263
47624_marine,42,55,38,4,97,90.47619047619048,9.523809523809524
47625_marine,69,99,58,10,168,84.05797101449275,14.492753623188406
47626_marine,150,212,94,81,362,62.66666666666667,54
47627_marine,143,210,88,77,353,61.53846153846154,53.84615384615385
47628_marine,150,219,89,78,369,59.333333333333336,52
47635_marine,131,153,92,53,284,70.22900763358778,40.458015267175576
47637_marine,198,243,125,97,441,63.13131313131313,48.98989898989899
47638_marine,90,150,79,10,240,87.77777777777777,11.11111111111111
47639_marine,83,153,72,8,236,86.74698795180723,9.63855421686747
47640_marine,84,154,73,8,238,86.90476190476191,9.523809523809524
47641_marine,84,152,75,6,236,89.28571428571429,7.142857142857142
47642_marine,81,146,72,5,227,88.88888888888889,6.172839506172839
47643_marine,59,88,54,1,147,91.52542372881356,1.694915254237288
47644_marine,53,64,48,1,117,90.56603773584906,1.8867924528301887
47645_marine,51,53,46,1,104,90.19607843137256,1.9607843137254901
47646_marine,52,52,47,1,104,90.38461538461539,1.9230769230769231
47647_marine,51,53,47,1,104,92.15686274509804,1.9607843137254901
47648_marine,49,49,45,1,98,91.83673469387756,2.0408163265306123
47649_marine,51,49,47,1,100,92.15686274509804,1.9607843137254901
47650_marine,49,49,46,0,98,93.87755102040816,0
47651_marine,50,49,47,0,99,94,0
47652_marine,50,48,47,0,98,94,0
47653_marine,51,48,48,0,99,94.11764705882352,0
47654_marine,51,48,48,0,99,94.11764705882352,0
47655_marine,52,47,49,0,99,94.23076923076923,0
47656_marine,51,47,48,0,98,94.11764705882352,0
47657_marine,51,47,48,0,98,94.11764705882352,0
47658_marine,51,47,48,0,98,94.11764705882352,0
47659_marine,51,47,48,0,98,94.11764705882352,0
47660_marine,50,48,47,0,98,94,0
47661_marine,50,48,47,0,98,94,0
47662_marine,50,49,47,0,99,94,0
47663_marine,51,49,48,1,100,94.11764705882352,1.9607843137254901
47664_marine,51,49,48,1,100,94.11764705882352,1.9607843137254901
47665_marine,51,48,48,1,99,94.11764705882352,1.9607843137254901
47666_marine,51,49,48,1,100,94.11764705882352,1.9607843137254901
47667_marine,51,50,48,1,101,94.11764705882352,1.9607843137254901
47668_marine,47,50,46,0,97,97.87234042553192,0
47669_marine,48,50,47,0,98,97.91666666666666,0
47670_marine,48,50,47,0,98,97.91666666666666,0
47671_marine,48,50,47,0,98,97.91666666666666,0
47672_marine,48,50,47,0,98,97.91666666666666,0
47673_marine,45,50,44,0,95,97.77777777777777,0
47674_marine,45,50,44,0,95,97.77777777777777,0
47675_marine,45,50,44,0,95,97.77777777777777,0
47676_marine,45,51,44,0,96,97.77777777777777,0
47677_marine,45,51,44,0,96,97.77777777777777,0
47678_marine,45,51,44,0,96,97.77777777777777,0
47679_marine,45,52,44,0,97,97.77777777777777,0
47680_marine,45,53,44,0,98,97.77777777777777,0
47681_marine,45,54,44,0,99,97.77777777777777,0
47682_marine,45,54,44,0,99,97.77777777777777,0
47683_marine,45,54,44,0,99,97.77777777777777,0
47684_marine,45,54,44,0,99,97.77777777777777,0
47685_marine,45,54,44,0,99,97.77777777777777,0
47686_marine,45,57,44,0,102,97.77777777777777,0
47687_marine,45,56,44,0,101,97.77777777777777,0
47688_marine,45,56,44,0,101,97.77777777777777,0
47689_marine,44,55,43,0,99,97.72727272727273,0
47690_marine,44,57,43,0,101,97.72727272727273,0
47691_marine,45,59,44,0,104,97.77777777777777,0
47692_marine,45,58,44,0,103,97.77777777777777,0
47693_marine,47,58,46,0,105,97.87234042553192,0
47694_marine,45,56,44,0,101,97.77777777777777,0
47695_marine,45,55,44,0,100,97.77777777777777,0
47696_marine,45,53,44,0,98,97.77777777777777,0
47697_marine,45,53,44,0,98,97.77777777777777,0
47698_marine,47,54,46,0,101,97.87234042553192,0
47699_marine,47,54,46,0,101,97.87234042553192,0
47700_marine,47,54,46,0,101,97.87234042553192,0
47701_marine,47,54,46,0,101,97.87234042553192,0
47702_marine,47,52,46,0,99,97.87234042553192,0
47703_marine,47,51,46,0,98,97.87234042553192,0
47704_marine,44,52,43,0,96,97.72727272727273,0
47705_marine,44,52,43,0,96,97.72727272727273,0
47706_marine,44,52,43,0,96,97.72727272727273,0
47707_marine,43,52,42,0,95,97.67441860465115,0
47708_marine,43,52,42,0,95,97.67441860465115,0
47709_marine,44,52,42,1,96,95.45454545454545,2.272727272727273
47710_marine,43,52,41,1,95,95.34883720930233,2.3255813953488373
47711_marine,44,52,41,1,96,93.18181818181817,2.272727272727273
47712_marine,44,54,41,1,98,93.18181818181817,2.272727272727273
47713_marine,44,54,41,1,98,93.18181818181817,2.272727272727273
47714_marine,46,55,43,1,101,93.47826086956522,2.1739130434782608
47715_marine,45,55,41,1,100,91.11111111111111,2.2222222222222223
47716_marine,47,55,43,1,102,91.48936170212765,2.127659574468085
47717_marine,46,55,42,1,101,91.30434782608695,2.1739130434782608
47718_marine,45,55,41,1,100,91.11111111111111,2.2222222222222223
47719_marine,46,57,43,1,103,93.47826086956522,2.1739130434782608
47720_marine,46,57,43,1,103,93.47826086956522,2.1739130434782608
47721_marine,45,57,42,1,102,93.33333333333333,2.2222222222222223
47722_marine,45,57,42,1,102,93.33333333333333,2.2222222222222223
47723_marine,47,58,44,1,105,93.61702127659575,2.127659574468085
47724_marine,49,57,46,1,106,93.87755102040816,2.0408163265306123
47725_marine,49,58,46,1,107,93.87755102040816,2.0408163265306123
47726_marine,49,56,46,1,105,93.87755102040816,2.0408163265306123
47727_marine,49,57,46,1,106,93.87755102040816,2.0408163265306123
47728_marine,48,57,45,1,105,93.75,2.083333333333333
47729_marine,48,57,45,1,105,93.75,2.083333333333333
47730_marine,45,57,42,1,102,93.33333333333333,2.2222222222222223
47731_marine,45,57,42,1,102,93.33333333333333,2.2222222222222223
47732_marine,45,58,42,1,103,93.33333333333333,2.2222222222222223
47733_marine,45,58,41,2,103,91.11111111111111,4.444444444444445
47734_marine,45,59,41,2,104,91.11111111111111,4.444444444444445
47735_marine,46,60,42,2,106,91.30434782608695,4.3478260869565215
47736_marine,46,61,42,2,107,91.30434782608695,4.3478260869565215
47737_marine,46,61,42,2,107,91.30434782608695,4.3478260869565215
47738_marine,46,61,42,4,107,91.30434782608695,8.695652173913043
47739_marine,46,61,42,4,107,91.30434782608695,8.695652173913043
47740_marine,47,60,43,4,107,91.48936170212765,8.51063829787234
47741_marine,45,60,41,4,105,91.11111111111111,8.88888888888889
47742_marine,45,64,41,4,109,91.11111111111111,8.88888888888889
47743_marine,45,64,41,4,109,91.11111111111111,8.88888888888889
47744_marine,45,62,41,4,107,91.11111111111111,8.88888888888889
47745_marine,44,62,40,5,106,90.9090909090909,11.363636363636363
47746_marine,44,62,40,5,106,90.9090909090909,11.363636363636363
47747_marine,44,62,40,5,106,90.9090909090909,11.363636363636363
47748_marine,44,62,40,5,106,90.9090909090909,11.363636363636363
47749_marine,42,60,39,4,102,92.85714285714286,9.523809523809524
47750_marine,44,60,41,4,104,93.18181818181817,9.090909090909092
47751_marine,44,60,41,4,104,93.18181818181817,9.090909090909092
47752_marine,45,61,42,4,106,93.33333333333333,8.88888888888889
47753_marine,45,61,42,4,106,93.33333333333333,8.88888888888889
47754_marine,43,61,40,3,104,93.02325581395348,6.976744186046512
47755_marine,43,61,40,3,104,93.02325581395348,6.976744186046512
47756_marine,44,61,41,3,105,93.18181818181817,6.8181818181818175
47757_marine,44,60,41,3,104,93.18181818181817,6.8181818181818175
47758_marine,44,60,41,3,104,93.18181818181817,6.8181818181818175
47759_marine,44,60,41,3,104,93.18181818181817,6.8181818181818175
47760_marine,43,60,40,3,103,93.02325581395348,6.976744186046512
47761_marine,41,61,38,3,102,92.6829268292683,7.317073170731707
47762_marine,41,61,38,3,102,92.6829268292683,7.317073170731707
47763_marine,39,60,36,3,99,92.3076923076923,7.6923076923076925
47764_marine,39,60,36,3,99,92.3076923076923,7.6923076923076925
47765_marine,39,60,36,3,99,92.3076923076923,7.6923076923076925
47766_marine,39,60,36,3,99,92.3076923076923,7.6923076923076925
47767_marine,39,60,36,3,99,92.3076923076923,7.6923076923076925
47768_marine,38,60,36,2,98,94.73684210526315,5.263157894736842
47769_marine,38,60,36,2,98,94.73684210526315,5.263157894736842
47770_marine,38,60,36,2,98,94.73684210526315,5.263157894736842
47771_marine,39,59,37,2,98,94.87179487179486,5.128205128205128
47772_marine,39,59,37,2,98,94.87179487179486,5.128205128205128
47773_marine,39,59,37,2,98,94.87179487179486,5.128205128205128
47774_marine,40,59,38,2,99,95,5
47775_marine,40,59,38,2,99,95,5
47776_marine,40,59,38,2,99,95,5
47777_marine,40,59,38,2,99,95,5
47778_marine,40,59,38,2,99,95,5
47779_marine,40,59,38,2,99,95,5
47780_marine,38,59,37,1,97,97.36842105263158,2.631578947368421
47781_marine,37,59,36,0,96,97.2972972972973,0
47782_marine,37,59,36,0,96,97.2972972972973,0
47783_marine,37,59,36,0,96,97.2972972972973,0
47784_marine,37,59,36,0,96,97.2972972972973,0
47785_marine,37,58,36,0,95,97.2972972972973,0
47786_marine,37,56,36,0,93,97.2972972972973,0
47787_marine,37,57,36,0,94,97.2972972972973,0
47788_marine,38,57,36,0,95,94.73684210526315,0
47789_marine,38,59,36,0,97,94.73684210526315,0
47790_marine,38,59,36,0,97,94.73684210526315,0
47791_marine,39,60,36,0,99,92.3076923076923,0
47792_marine,41,60,38,0,101,92.6829268292683,0
47793_marine,41,60,38,0,101,92.6829268292683,0
47794_marine,41,62,38,0,103,92.6829268292683,0
47795_marine,42,62,39,0,104,92.85714285714286,0
47796_marine,43,62,40,0,105,93.02325581395348,0
47797_marine,43,60,40,0,103,93.02325581395348,0
47798_marine,43,60,40,0,103,93.02325581395348,0
47799_marine,45,60,42,0,105,93.33333333333333,0
47800_marine,45,61,42,0,106,93.33333333333333,0
47801_marine,45,59,42,0,104,93.33333333333333,0
47802_marine,45,58,42,0,103,93.33333333333333,0
47803_marine,46,58,43,0,104,93.47826086956522,0
47804_marine,44,56,41,0,100,93.18181818181817,0
47805_marine,44,56,41,0,100,93.18181818181817,0
47806_marine,44,56,41,0,100,93.18181818181817,0
47807_marine,44,56,41,0,100,93.18181818181817,0
47808_marine,44,56,41,0,100,93.18181818181817,0
47809_marine,44,56,41,0,100,93.18181818181817,0
47810_marine,44,58,41,0,102,93.18181818181817,0
47811_marine,44,58,41,0,102,93.18181818181817,0
47812_marine,44,58,41,0,102,93.18181818181817,0
47813_marine,46,58,43,0,104,93.47826086956522,0
47814_marine,46,57,43,0,103,93.47826086956522,0
47815_marine,46,57,43,0,103,93.47826086956522,0
47816_marine,46,57,43,0,103,93.47826086956522,0
47817_marine,46,55,43,0,101,93.47826086956522,0
47818_marine,46,56,43,0,102,93.47826086956522,0
47819_marine,46,56,43,0,102,93.47826086956522,0
47820_marine,45,56,43,0,101,95.55555555555556,0
47821_marine,45,56,43,0,101,95.55555555555556,0
47822_marine,45,56,43,0,101,95.55555555555556,0
47823_marine,49,56,47,0,105,95.91836734693877,0
47824_marine,49,56,47,0,105,95.91836734693877,0
47825_marine,49,56,47,0,105,95.91836734693877,0
47826_marine,49,56,47,0,105,95.91836734693877,0
47827_marine,49,55,47,0,104,95.91836734693877,0
47828_marine,49,55,47,0,104,95.91836734693877,0
47829_marine,49,57,47,0,106,95.91836734693877,0
47830_marine,50,57,48,0,107,96,0
47831_marine,50,57,48,0,107,96,0
47832_marine,52,57,50,0,109,96.15384615384616,0
47833_marine,54,58,52,0,112,96.29629629629629,0
47834_marine,54,58,52,0,112,96.29629629629629,0
47835_marine,54,58,52,0,112,96.29629629629629,0
47836_marine,54,58,52,0,112,96.29629629629629,0
47837_marine,54,59,52,0,113,96.29629629629629,0
47838_marine,55,60,52,0,115,94.54545454545455,0
47839_marine,58,60,54,1,118,93.10344827586206,1.7241379310344827
47840_marine,58,59,54,1,117,93.10344827586206,1.7241379310344827
47841_marine,70,61,66,1,131,94.28571428571428,1.4285714285714286
47842_marine,73,64,66,2,137,90.41095890410958,2.73972602739726
47843_marine,73,70,65,4,143,89.04109589041096,5.47945205479452
47844_marine,132,173,110,17,305,83.33333333333334,12.878787878787879
47845_marine,189,215,152,33,404,80.42328042328042,17.46031746031746
47850_marine,187,212,149,29,399,79.67914438502673,15.508021390374333
47851_marine,86,73,78,3,159,90.69767441860465,3.488372093023256
47852_marine,80,66,73,2,146,91.25,2.5
47853_marine,78,68,72,2,146,92.3076923076923,2.564102564102564
47854_marine,74,67,68,2,141,91.8918918918919,2.7027027027027026
47855_marine,71,65,66,1,136,92.95774647887323,1.4084507042253522
47856_marine,70,65,65,1,135,92.85714285714286,1.4285714285714286
47857_marine,72,65,67,3,137,93.05555555555556,4.166666666666666
47858_marine,71,65,66,3,136,92.95774647887323,4.225352112676056
47859_marine,70,66,65,3,136,92.85714285714286,4.285714285714286
47860_marine,70,67,65,3,137,92.85714285714286,4.285714285714286
47861_marine,69,69,65,3,138,94.20289855072464,4.3478260869565215
47862_marine,68,70,64,3,138,94.11764705882352,4.411764705882353
47863_marine,68,70,64,3,138,94.11764705882352,4.411764705882353
47864_marine,68,70,64,3,138,94.11764705882352,4.411764705882353
47865_marine,73,72,68,3,145,93.15068493150685,4.10958904109589
47866_marine,79,75,74,3,154,93.67088607594937,3.79746835443038
47867_marine,79,76,74,3,155,93.67088607594937,3.79746835443038
47868_marine,99,161,92,5,260,92.92929292929293,5.05050505050505
47869_marine,127,191,116,11,318,91.33858267716536,8.661417322834646
47870_marine,130,205,119,12,335,91.53846153846153,9.230769230769232
47875_marine,152,248,133,21,400,87.5,13.815789473684212
47876_marine,152,240,134,20,392,88.1578947368421,13.157894736842104
47877_marine,146,233,133,16,379,91.0958904109589,10.95890410958904
47878_marine,103,133,99,3,236,96.11650485436894,2.912621359223301
47879_marine,96,129,93,3,225,96.875,3.125
47880_marine,85,113,82,3,198,96.47058823529412,3.5294117647058822
47881_marine,76,102,73,2,178,96.05263157894737,2.631578947368421
47882_marine,73,92,70,0,165,95.8904109589041,0
47883_marine,89,146,83,4,235,93.25842696629213,4.49438202247191
47884_marine,134,171,116,40,305,86.56716417910447,29.850746268656714
47885_marine,113,162,98,25,275,86.72566371681415,22.123893805309734
47886_marine,83,142,80,0,225,96.3855421686747,0
47887_marine,64,68,61,0,132,95.3125,0
47888_marine,58,58,55,0,116,94.82758620689656,0
47889_marine,58,55,55,0,113,94.82758620689656,0
47890_marine,54,55,51,0,109,94.44444444444444,0
47891_marine,54,55,51,0,109,94.44444444444444,0
47892_marine,51,55,48,0,106,94.11764705882352,0
47893_marine,51,55,48,0,106,94.11764705882352,0
47894_marine,51,54,48,0,105,94.11764705882352,0
47895_marine,51,54,48,0,105,94.11764705882352,0
47896_marine,51,53,48,0,104,94.11764705882352,0
47897_marine,51,53,48,0,104,94.11764705882352,0
47898_marine,50,53,47,0,103,94,0
47899_marine,48,53,45,0,101,93.75,0
47900_marine,47,53,44,0,100,93.61702127659575,0
47901_marine,47,52,44,0,99,93.61702127659575,0
47902_marine,47,52,44,0,99,93.61702127659575,0
47903_marine,47,52,44,0,99,93.61702127659575,0
47904_marine,47,52,44,0,99,93.61702127659575,0
47905_marine,47,50,44,0,97,93.61702127659575,0
47906_marine,47,50,44,0,97,93.61702127659575,0
47907_marine,45,50,42,0,95,93.33333333333333,0
47908_marine,45,50,42,0,95,93.33333333333333,0
47909_marine,45,50,42,0,95,93.33333333333333,0
47910_marine,45,50,42,0,95,93.33333333333333,0
47911_marine,44,49,41,0,93,93.18181818181817,0
47912_marine,44,49,41,0,93,93.18181818181817,0
47913_marine,44,49,41,0,93,93.18181818181817,0
47914_marine,44,49,41,0,93,93.18181818181817,0
47915_marine,44,49,41,0,93,93.18181818181817,0
47916_marine,44,49,41,0,93,93.18181818181817,0
47917_marine,44,49,41,0,93,93.18181818181817,0
47918_marine,44,49,41,0,93,93.18181818181817,0
47919_marine,44,49,41,0,93,93.18181818181817,0
47920_marine,44,50,41,0,94,93.18181818181817,0
47921_marine,44,50,41,0,94,93.18181818181817,0
47922_marine,44,50,41,0,94,93.18181818181817,0
47923_marine,44,50,41,0,94,93.18181818181817,0
47924_marine,44,51,41,0,95,93.18181818181817,0
47925_marine,44,51,41,0,95,93.18181818181817,0
47926_marine,44,51,41,0,95,93.18181818181817,0
47927_marine,44,51,41,0,95,93.18181818181817,0
47928_marine,44,49,41,0,93,93.18181818181817,0
47929_marine,44,49,41,0,93,93.18181818181817,0
47930_marine,44,49,41,0,93,93.18181818181817,0
47931_marine,42,49,39,0,91,92.85714285714286,0
47932_marine,42,49,39,0,91,92.85714285714286,0
47933_marine,42,49,39,0,91,92.85714285714286,0
47934_marine,40,50,37,0,90,92.5,0
47935_marine,42,50,39,0,92,92.85714285714286,0
47936_marine,42,50,39,0,92,92.85714285714286,0
47937_marine,42,50,39,0,92,92.85714285714286,0
47938_marine,42,48,39,0,90,92.85714285714286,0
47939_marine,42,48,39,0,90,92.85714285714286,0
47940_marine,42,48,39,0,90,92.85714285714286,0
47941_marine,42,48,39,0,90,92.85714285714286,0
47942_marine,40,48,37,0,88,92.5,0
47943_marine,40,48,37,0,88,92.5,0
47944_marine,40,48,37,0,88,92.5,0
47945_marine,38,48,37,0,86,97.36842105263158,0
47946_marine,38,48,37,0,86,97.36842105263158,0
47947_marine,38,47,37,0,85,97.36842105263158,0
47948_marine,38,47,37,0,85,97.36842105263158,0
47949_marine,37,46,36,0,83,97.2972972972973,0
47950_marine,37,46,36,0,83,97.2972972972973,0
47951_marine,35,46,34,0,81,97.14285714285714,0
47952_marine,35,46,34,0,81,97.14285714285714,0
47953_marine,35,46,34,0,81,97.14285714285714,0
47954_marine,35,46,34,0,81,97.14285714285714,0
47955_marine,35,45,34,0,80,97.14285714285714,0
47956_marine,35,45,34,0,80,97.14285714285714,0
47957_marine,35,45,34,0,80,97.14285714285714,0
47958_marine,33,46,32,0,79,96.96969696969697,0
47959_marine,33,45,32,0,78,96.96969696969697,0
47960_marine,33,45,32,0,78,96.96969696969697,0
47961_marine,33,45,32,0,78,96.96969696969697,0
47962_marine,33,45,32,0,78,96.96969696969697,0
47963_marine,33,44,32,0,77,96.96969696969697,0
47964_marine,33,44,32,0,77,96.96969696969697,0
47965_marine,32,44,31,0,76,96.875,0
47966_marine,32,44,31,0,76,96.875,0
47967_marine,32,44,31,0,76,96.875,0
47968_marine,32,46,31,0,78,96.875,0
47969_marine,32,46,31,0,78,96.875,0
47970_marine,32,48,31,0,80,96.875,0
47971_marine,32,49,31,0,81,96.875,0
47972_marine,32,49,31,0,81,96.875,0
47973_marine,32,49,31,0,81,96.875,0
47974_marine,33,49,32,0,82,96.96969696969697,0
47975_marine,33,49,32,0,82,96.96969696969697,0
47976_marine,34,52,33,0,86,97.05882352941177,0
47977_marine,34,54,33,0,88,97.05882352941177,0
47978_marine,32,54,31,0,86,96.875,0
47979_marine,34,53,31,1,87,91.17647058823529,2.941176470588235
47980_marine,34,53,31,1,87,91.17647058823529,2.941176470588235
47981_marine,34,55,30,1,89,88.23529411764706,2.941176470588235
47982_marine,36,54,32,1,90,88.88888888888889,2.7777777777777777
47983_marine,36,54,32,1,90,88.88888888888889,2.7777777777777777
47984_marine,40,55,36,2,95,90,5
47985_marine,73,115,61,12,188,83.56164383561644,16.43835616438356
47986_marine,145,214,87,76,359,60,52.41379310344828
47987_marine,153,222,90,81,375,58.82352941176471,52.94117647058824
47988_marine,139,204,85,69,343,61.15107913669065,49.64028776978417
47997_marine,93,137,76,15,230,81.72043010752688,16.129032258064516
47998_marine,84,135,73,10,219,86.90476190476191,11.904761904761903
47999_marine,85,134,74,10,219,87.05882352941177,11.76470588235294
48000_marine,83,136,72,8,219,86.74698795180723,9.63855421686747
48001_marine,77,138,68,7,215,88.31168831168831,9.090909090909092
48002_marine,54,80,49,2,134,90.74074074074075,3.7037037037037033
48003_marine,52,60,47,2,112,90.38461538461539,3.8461538461538463
48004_marine,52,50,47,2,102,90.38461538461539,3.8461538461538463
48005_marine,52,52,47,2,104,90.38461538461539,3.8461538461538463
48006_marine,50,52,46,1,102,92,2
48007_marine,48,49,44,1,97,91.66666666666666,2.083333333333333
48008_marine,49,49,45,1,98,91.83673469387756,2.0408163265306123
48009_marine,51,49,47,1,100,92.15686274509804,1.9607843137254901
48010_marine,50,49,47,0,99,94,0
48011_marine,50,49,47,0,99,94,0
48012_marine,51,48,48,0,99,94.11764705882352,0
48013_marine,53,48,50,0,101,94.33962264150944,0
48014_marine,53,48,50,0,101,94.33962264150944,0
48015_marine,52,48,49,0,100,94.23076923076923,0
48016_marine,52,48,49,0,100,94.23076923076923,0
48017_marine,50,49,47,0,99,94,0
48018_marine,50,49,47,0,99,94,0
48019_marine,51,49,48,1,100,94.11764705882352,1.9607843137254901
48020_marine,52,50,49,1,102,94.23076923076923,1.9230769230769231
48021_marine,51,49,48,1,100,94.11764705882352,1.9607843137254901
48022_marine,50,49,47,1,99,94,2
48023_marine,50,49,47,1,99,94,2
48024_marine,50,48,47,1,98,94,2
48025_marine,50,49,47,1,99,94,2
48026_marine,50,49,47,1,99,94,2
48027_marine,48,49,47,1,97,97.91666666666666,2.083333333333333
48028_marine,48,49,47,1,97,97.91666666666666,2.083333333333333
48029_marine,49,50,48,1,99,97.95918367346938,2.0408163265306123
48030_marine,47,50,46,1,97,97.87234042553192,2.127659574468085
48031_marine,47,50,46,1,97,97.87234042553192,2.127659574468085
48032_marine,47,50,46,1,97,97.87234042553192,2.127659574468085
48033_marine,45,50,44,0,95,97.77777777777777,0
48034_marine,45,50,44,0,95,97.77777777777777,0
48035_marine,45,51,44,0,96,97.77777777777777,0
48036_marine,45,51,44,0,96,97.77777777777777,0
48037_marine,45,51,44,0,96,97.77777777777777,0
48038_marine,45,52,44,0,97,97.77777777777777,0
48039_marine,45,52,44,0,97,97.77777777777777,0
48040_marine,45,53,44,0,98,97.77777777777777,0
48041_marine,45,52,44,0,97,97.77777777777777,0
48042_marine,45,54,44,0,99,97.77777777777777,0
48043_marine,45,55,44,0,100,97.77777777777777,0
48044_marine,45,55,44,0,100,97.77777777777777,0
48045_marine,44,55,43,0,99,97.72727272727273,0
48046_marine,44,55,43,0,99,97.72727272727273,0
48047_marine,44,54,43,0,98,97.72727272727273,0
48048_marine,44,54,43,0,98,97.72727272727273,0
48049_marine,44,55,43,0,99,97.72727272727273,0
48050_marine,44,54,43,0,98,97.72727272727273,0
48051_marine,44,54,43,0,98,97.72727272727273,0
48052_marine,44,54,43,0,98,97.72727272727273,0
48053_marine,44,52,43,0,96,97.72727272727273,0
48054_marine,45,53,44,0,98,97.77777777777777,0
48055_marine,47,53,46,0,100,97.87234042553192,0
48056_marine,47,53,46,0,100,97.87234042553192,0
48057_marine,45,52,44,0,97,97.77777777777777,0
48058_marine,45,56,44,0,101,97.77777777777777,0
48059_marine,45,56,44,0,101,97.77777777777777,0
48060_marine,43,56,42,0,99,97.67441860465115,0
48061_marine,43,56,42,0,99,97.67441860465115,0
48062_marine,45,54,44,0,99,97.77777777777777,0
48063_marine,44,53,43,0,97,97.72727272727273,0
48064_marine,42,54,41,0,96,97.61904761904762,0
48065_marine,42,54,41,0,96,97.61904761904762,0
48066_marine,42,54,41,0,96,97.61904761904762,0
48067_marine,42,54,41,0,96,97.61904761904762,0
48068_marine,43,54,41,1,97,95.34883720930233,2.3255813953488373
48069_marine,43,54,41,1,97,95.34883720930233,2.3255813953488373
48070_marine,43,54,41,1,97,95.34883720930233,2.3255813953488373
48071_marine,43,54,41,1,97,95.34883720930233,2.3255813953488373
48072_marine,41,54,39,1,95,95.1219512195122,2.4390243902439024
48073_marine,41,54,39,1,95,95.1219512195122,2.4390243902439024
48074_marine,42,54,40,1,96,95.23809523809523,2.380952380952381
48075_marine,42,54,40,1,96,95.23809523809523,2.380952380952381
48076_marine,44,55,41,1,99,93.18181818181817,2.272727272727273
48077_marine,46,55,43,1,101,93.47826086956522,2.1739130434782608
48078_marine,45,55,42,1,100,93.33333333333333,2.2222222222222223
48079_marine,44,55,41,1,99,93.18181818181817,2.272727272727273
48080_marine,43,55,40,1,98,93.02325581395348,2.3255813953488373
48081_marine,43,55,40,1,98,93.02325581395348,2.3255813953488373
48082_marine,43,55,40,1,98,93.02325581395348,2.3255813953488373
48083_marine,43,55,40,1,98,93.02325581395348,2.3255813953488373
48084_marine,45,56,42,1,101,93.33333333333333,2.2222222222222223
48085_marine,45,57,42,1,102,93.33333333333333,2.2222222222222223
48086_marine,45,58,42,1,103,93.33333333333333,2.2222222222222223
48087_marine,47,58,44,1,105,93.61702127659575,2.127659574468085
48088_marine,47,57,43,2,104,91.48936170212765,4.25531914893617
48089_marine,44,57,40,2,101,90.9090909090909,4.545454545454546
48090_marine,44,57,40,2,101,90.9090909090909,4.545454545454546
48091_marine,44,58,40,2,102,90.9090909090909,4.545454545454546
48092_marine,43,58,39,2,101,90.69767441860465,4.651162790697675
48093_marine,44,59,40,2,103,90.9090909090909,4.545454545454546
48094_marine,44,59,40,2,103,90.9090909090909,4.545454545454546
48095_marine,42,59,38,2,101,90.47619047619048,4.761904761904762
48096_marine,41,60,37,2,101,90.2439024390244,4.878048780487805
48097_marine,42,60,38,3,102,90.47619047619048,7.142857142857142
48098_marine,42,60,38,3,102,90.47619047619048,7.142857142857142
48099_marine,44,62,40,4,106,90.9090909090909,9.090909090909092
48100_marine,45,62,41,4,107,91.11111111111111,8.88888888888889
48101_marine,46,64,42,5,110,91.30434782608695,10.869565217391305
48102_marine,45,66,42,5,111,93.33333333333333,11.11111111111111
48103_marine,45,64,42,5,109,93.33333333333333,11.11111111111111
48104_marine,45,62,42,5,107,93.33333333333333,11.11111111111111
48105_marine,46,62,43,6,108,93.47826086956522,13.043478260869565
48106_marine,46,62,43,6,108,93.47826086956522,13.043478260869565
48107_marine,44,62,41,6,106,93.18181818181817,13.636363636363635
48108_marine,43,62,40,5,105,93.02325581395348,11.627906976744185
48109_marine,43,62,40,5,105,93.02325581395348,11.627906976744185
48110_marine,43,60,40,5,103,93.02325581395348,11.627906976744185
48111_marine,43,60,40,5,103,93.02325581395348,11.627906976744185
48112_marine,43,60,40,5,103,93.02325581395348,11.627906976744185
48113_marine,41,60,38,4,101,92.6829268292683,9.75609756097561
48114_marine,41,60,38,4,101,92.6829268292683,9.75609756097561
48115_marine,41,60,38,4,101,92.6829268292683,9.75609756097561
48116_marine,39,60,36,4,99,92.3076923076923,10.256410256410255
48117_marine,39,60,36,3,99,92.3076923076923,7.6923076923076925
48118_marine,39,60,36,3,99,92.3076923076923,7.6923076923076925
48119_marine,41,60,38,3,101,92.6829268292683,7.317073170731707
48120_marine,39,59,36,3,98,92.3076923076923,7.6923076923076925
48121_marine,39,60,36,3,99,92.3076923076923,7.6923076923076925
48122_marine,39,61,36,3,100,92.3076923076923,7.6923076923076925
48123_marine,39,61,36,3,100,92.3076923076923,7.6923076923076925
48124_marine,39,61,36,3,100,92.3076923076923,7.6923076923076925
48125_marine,39,61,36,3,100,92.3076923076923,7.6923076923076925
48126_marine,39,61,36,3,100,92.3076923076923,7.6923076923076925
48127_marine,39,60,36,3,99,92.3076923076923,7.6923076923076925
48128_marine,39,60,36,3,99,92.3076923076923,7.6923076923076925
48129_marine,39,60,36,3,99,92.3076923076923,7.6923076923076925
48130_marine,39,60,36,3,99,92.3076923076923,7.6923076923076925
48131_marine,39,60,36,3,99,92.3076923076923,7.6923076923076925
48132_marine,40,60,37,3,100,92.5,7.5
48133_marine,39,60,37,2,99,94.87179487179486,5.128205128205128
48134_marine,39,59,37,2,98,94.87179487179486,5.128205128205128
48135_marine,39,59,37,2,98,94.87179487179486,5.128205128205128
48136_marine,39,59,37,2,98,94.87179487179486,5.128205128205128
48137_marine,39,59,37,2,98,94.87179487179486,5.128205128205128
48138_marine,39,59,37,2,98,94.87179487179486,5.128205128205128
48139_marine,39,59,37,2,98,94.87179487179486,5.128205128205128
48140_marine,39,59,37,2,98,94.87179487179486,5.128205128205128
48141_marine,39,59,37,2,98,94.87179487179486,5.128205128205128
48142_marine,39,59,37,2,98,94.87179487179486,5.128205128205128
48143_marine,39,59,37,2,98,94.87179487179486,5.128205128205128
48144_marine,38,58,37,1,96,97.36842105263158,2.631578947368421
48145_marine,37,57,36,0,94,97.2972972972973,0
48146_marine,37,56,36,0,93,97.2972972972973,0
48147_marine,37,55,36,0,92,97.2972972972973,0
48148_marine,37,55,36,0,92,97.2972972972973,0
48149_marine,37,55,36,0,92,97.2972972972973,0
48150_marine,38,55,36,0,93,94.73684210526315,0
48151_marine,39,56,36,0,95,92.3076923076923,0
48152_marine,39,56,36,0,95,92.3076923076923,0
48153_marine,40,56,37,0,96,92.5,0
48154_marine,40,58,37,0,98,92.5,0
48155_marine,41,58,38,0,99,92.6829268292683,0
48156_marine,43,58,40,0,101,93.02325581395348,0
48157_marine,43,58,40,0,101,93.02325581395348,0
48158_marine,43,58,40,0,101,93.02325581395348,0
48159_marine,43,58,40,0,101,93.02325581395348,0
48160_marine,45,58,42,0,103,93.33333333333333,0
48161_marine,45,56,42,0,101,93.33333333333333,0
48162_marine,45,56,42,0,101,93.33333333333333,0
48163_marine,45,56,42,0,101,93.33333333333333,0
48164_marine,43,56,40,0,99,93.02325581395348,0
48165_marine,43,58,40,0,101,93.02325581395348,0
48166_marine,44,58,41,0,102,93.18181818181817,0
48167_marine,44,58,41,0,102,93.18181818181817,0
48168_marine,44,58,41,0,102,93.18181818181817,0
48169_marine,44,56,41,0,100,93.18181818181817,0
48170_marine,44,58,41,0,102,93.18181818181817,0
48171_marine,44,58,41,0,102,93.18181818181817,0
48172_marine,44,58,41,0,102,93.18181818181817,0
48173_marine,44,58,41,0,102,93.18181818181817,0
48174_marine,44,56,41,0,100,93.18181818181817,0
48175_marine,44,57,41,0,101,93.18181818181817,0
48176_marine,44,57,41,0,101,93.18181818181817,0
48177_marine,46,57,43,0,103,93.47826086956522,0
48178_marine,46,57,43,0,103,93.47826086956522,0
48179_marine,45,57,43,0,102,95.55555555555556,0
48180_marine,45,57,43,0,102,95.55555555555556,0
48181_marine,45,56,43,0,101,95.55555555555556,0
48182_marine,45,56,43,0,101,95.55555555555556,0
48183_marine,45,56,43,0,101,95.55555555555556,0
48184_marine,45,56,43,0,101,95.55555555555556,0
48185_marine,47,56,45,0,103,95.74468085106383,0
48186_marine,49,56,47,0,105,95.91836734693877,0
48187_marine,49,56,47,0,105,95.91836734693877,0
48188_marine,49,56,47,0,105,95.91836734693877,0
48189_marine,49,56,47,0,105,95.91836734693877,0
48190_marine,49,57,47,0,106,95.91836734693877,0
48191_marine,51,59,49,0,110,96.07843137254902,0
48192_marine,52,59,50,0,111,96.15384615384616,0
48193_marine,52,60,50,0,112,96.15384615384616,0
48194_marine,52,60,50,0,112,96.15384615384616,0
48195_marine,52,60,50,0,112,96.15384615384616,0
48196_marine,52,60,50,0,112,96.15384615384616,0
48197_marine,52,60,50,0,112,96.15384615384616,0
48198_marine,54,63,52,0,117,96.29629629629629,0
48199_marine,55,64,53,1,119,96.36363636363636,1.8181818181818181
48200_marine,57,64,53,1,121,92.98245614035088,1.7543859649122806
48201_marine,60,64,56,1,124,93.33333333333333,1.6666666666666667
48202_marine,66,64,62,1,130,93.93939393939394,1.5151515151515151
48203_marine,69,67,64,2,136,92.7536231884058,2.898550724637681
48204_marine,77,72,69,4,149,89.6103896103896,5.194805194805195
48205_marine,181,198,146,29,379,80.66298342541437,16.022099447513813
48210_marine,141,180,118,14,321,83.68794326241135,9.929078014184398
48211_marine,85,76,78,3,161,91.76470588235294,3.5294117647058822
48212_marine,80,68,73,2,148,91.25,2.5
48213_marine,73,69,67,2,142,91.78082191780823,2.73972602739726
48214_marine,67,67,61,2,134,91.04477611940298,2.9850746268656714
48215_marine,65,67,59,2,132,90.76923076923077,3.076923076923077
48216_marine,63,67,57,2,130,90.47619047619048,3.1746031746031744
48217_marine,61,67,56,1,128,91.80327868852459,1.639344262295082
48218_marine,62,69,57,1,131,91.93548387096774,1.6129032258064515
48219_marine,62,69,57,1,131,91.93548387096774,1.6129032258064515
48220_marine,62,69,58,1,131,93.54838709677419,1.6129032258064515
48221_marine,66,69,62,3,135,93.93939393939394,4.545454545454546
48222_marine,66,69,62,3,135,93.93939393939394,4.545454545454546
48223_marine,67,70,63,3,137,94.02985074626866,4.477611940298507
48224_marine,69,70,64,3,139,92.7536231884058,4.3478260869565215
48225_marine,75,75,70,3,150,93.33333333333333,4
48226_marine,79,79,74,3,158,93.67088607594937,3.79746835443038
48227_marine,119,183,110,11,302,92.43697478991596,9.243697478991598
48228_marine,125,189,116,12,314,92.80000000000001,9.6
48235_marine,140,237,124,16,377,88.57142857142857,11.428571428571429
48236_marine,107,154,103,3,261,96.26168224299066,2.803738317757009
48237_marine,104,140,100,3,244,96.15384615384616,2.8846153846153846
48238_marine,97,133,94,3,230,96.90721649484536,3.0927835051546393
48239_marine,92,131,89,3,223,96.73913043478261,3.260869565217391
48240_marine,80,116,77,3,196,96.25,3.75
48241_marine,70,99,67,0,169,95.71428571428572,0
48242_marine,72,91,69,0,163,95.83333333333334,0
48243_marine,85,146,80,3,231,94.11764705882352,3.5294117647058822
48244_marine,139,176,121,41,315,87.05035971223022,29.496402877697843
48245_marine,112,163,100,22,275,89.28571428571429,19.642857142857142
48246_marine,83,144,80,0,227,96.3855421686747,0
48247_marine,63,59,60,0,122,95.23809523809523,0
48248_marine,57,57,54,0,114,94.73684210526315,0
48249_marine,56,56,53,0,112,94.64285714285714,0
48250_marine,54,55,51,0,109,94.44444444444444,0
48251_marine,51,55,48,0,106,94.11764705882352,0
48252_marine,51,55,48,0,106,94.11764705882352,0
48253_marine,51,55,48,0,106,94.11764705882352,0
48254_marine,51,55,48,0,106,94.11764705882352,0
48255_marine,51,55,48,0,106,94.11764705882352,0
48256_marine,51,54,48,0,105,94.11764705882352,0
48257_marine,48,54,45,0,102,93.75,0
48258_marine,48,53,45,0,101,93.75,0
48259_marine,48,53,45,0,101,93.75,0
48260_marine,47,53,44,0,100,93.61702127659575,0
48261_marine,47,52,44,0,99,93.61702127659575,0
48262_marine,47,52,44,0,99,93.61702127659575,0
48263_marine,45,52,42,0,97,93.33333333333333,0
48264_marine,43,52,40,0,95,93.02325581395348,0
48265_marine,43,52,40,0,95,93.02325581395348,0
48266_marine,43,52,40,0,95,93.02325581395348,0
48267_marine,43,52,40,0,95,93.02325581395348,0
48268_marine,43,52,40,0,95,93.02325581395348,0
48269_marine,43,52,40,0,95,93.02325581395348,0
48270_marine,43,50,40,0,93,93.02325581395348,0
48271_marine,42,49,39,0,91,92.85714285714286,0
48272_marine,42,49,39,0,91,92.85714285714286,0
48273_marine,42,47,39,0,89,92.85714285714286,0
48274_marine,42,47,39,0,89,92.85714285714286,0
48275_marine,42,47,39,0,89,92.85714285714286,0
48276_marine,42,47,39,0,89,92.85714285714286,0
48277_marine,42,47,39,0,89,92.85714285714286,0
48278_marine,44,47,41,0,91,93.18181818181817,0
48279_marine,44,47,41,0,91,93.18181818181817,0
48280_marine,42,47,39,0,89,92.85714285714286,0
48281_marine,42,47,39,0,89,92.85714285714286,0
48282_marine,42,48,39,0,90,92.85714285714286,0
48283_marine,40,48,37,0,88,92.5,0
48284_marine,40,49,37,0,89,92.5,0
48285_marine,40,49,37,0,89,92.5,0
48286_marine,40,49,37,0,89,92.5,0
48287_marine,40,49,37,0,89,92.5,0
48288_marine,40,49,37,0,89,92.5,0
48289_marine,40,49,37,0,89,92.5,0
48290_marine,40,50,37,0,90,92.5,0
48291_marine,40,50,37,0,90,92.5,0
48292_marine,40,50,37,0,90,92.5,0
48293_marine,40,50,37,0,90,92.5,0
48294_marine,40,50,37,0,90,92.5,0
48295_marine,40,50,37,0,90,92.5,0
48296_marine,40,50,37,0,90,92.5,0
48297_marine,40,50,37,0,90,92.5,0
48298_marine,42,50,39,0,92,92.85714285714286,0
48299_marine,38,50,37,0,88,97.36842105263158,0
48300_marine,38,50,37,0,88,97.36842105263158,0
48301_marine,38,50,37,0,88,97.36842105263158,0
48302_marine,38,50,37,0,88,97.36842105263158,0
48303_marine,38,50,37,0,88,97.36842105263158,0
48304_marine,38,48,37,0,86,97.36842105263158,0
48305_marine,36,47,35,0,83,97.22222222222221,0
48306_marine,36,47,35,0,83,97.22222222222221,0
48307_marine,36,47,35,0,83,97.22222222222221,0
48308_marine,36,48,35,0,84,97.22222222222221,0
48309_marine,36,48,35,0,84,97.22222222222221,0
48310_marine,34,48,33,0,82,97.05882352941177,0
48311_marine,34,48,33,0,82,97.05882352941177,0
48312_marine,34,48,33,0,82,97.05882352941177,0
48313_marine,34,50,33,0,84,97.05882352941177,0
48314_marine,34,50,33,0,84,97.05882352941177,0
48315_marine,34,50,33,0,84,97.05882352941177,0
48316_marine,34,50,33,0,84,97.05882352941177,0
48317_marine,34,49,33,0,83,97.05882352941177,0
48318_marine,34,48,33,0,82,97.05882352941177,0
48319_marine,34,48,33,0,82,97.05882352941177,0
48320_marine,34,48,33,0,82,97.05882352941177,0
48321_marine,34,48,33,0,82,97.05882352941177,0
48322_marine,34,49,33,0,83,97.05882352941177,0
48323_marine,34,49,33,0,83,97.05882352941177,0
48324_marine,34,49,33,0,83,97.05882352941177,0
48325_marine,34,49,33,0,83,97.05882352941177,0
48326_marine,34,49,33,0,83,97.05882352941177,0
48327_marine,34,49,33,0,83,97.05882352941177,0
48328_marine,33,49,32,0,82,96.96969696969697,0
48329_marine,33,49,32,0,82,96.96969696969697,0
48330_marine,33,50,32,0,83,96.96969696969697,0
48331_marine,33,50,32,0,83,96.96969696969697,0
48332_marine,33,50,32,0,83,96.96969696969697,0
48333_marine,33,50,32,0,83,96.96969696969697,0
48334_marine,34,50,33,0,84,97.05882352941177,0
48335_marine,32,50,31,0,82,96.875,0
48336_marine,32,50,31,0,82,96.875,0
48337_marine,32,53,31,0,85,96.875,0
48338_marine,32,54,31,0,86,96.875,0
48339_marine,34,53,31,1,87,91.17647058823529,2.941176470588235
48340_marine,32,53,28,1,85,87.5,3.125
48341_marine,32,55,28,1,87,87.5,3.125
48342_marine,34,55,30,1,89,88.23529411764706,2.941176470588235
48343_marine,34,54,30,1,88,88.23529411764706,2.941176470588235
48344_marine,48,69,44,2,117,91.66666666666666,4.166666666666666
48345_marine,101,154,73,40,255,72.27722772277228,39.603960396039604
48346_marine,112,167,74,47,279,66.07142857142857,41.964285714285715
48347_marine,129,199,80,61,328,62.01550387596899,47.286821705426355
48348_marine,123,193,78,59,316,63.41463414634146,47.96747967479675
48354_marine,157,173,97,79,330,61.78343949044586,50.318471337579616
48355_marine,175,214,110,85,389,62.857142857142854,48.57142857142857
48356_marine,84,132,68,13,216,80.95238095238095,15.476190476190476
48357_marine,76,130,66,9,206,86.8421052631579,11.842105263157894
48358_marine,76,129,67,8,205,88.1578947368421,10.526315789473683
48359_marine,76,128,67,8,204,88.1578947368421,10.526315789473683
48360_marine,73,124,64,6,197,87.67123287671232,8.21917808219178
48361_marine,70,118,63,6,188,90,8.571428571428571
48362_marine,53,60,48,4,113,90.56603773584906,7.547169811320755
48363_marine,50,51,45,2,101,90,4
48364_marine,51,51,46,2,102,90.19607843137256,3.9215686274509802
48365_marine,48,52,44,2,100,91.66666666666666,4.166666666666666
48366_marine,48,50,44,2,98,91.66666666666666,4.166666666666666
48367_marine,47,49,43,1,96,91.48936170212765,2.127659574468085
48368_marine,49,49,45,1,98,91.83673469387756,2.0408163265306123
48369_marine,49,49,45,1,98,91.83673469387756,2.0408163265306123
48370_marine,49,49,46,0,98,93.87755102040816,0
48371_marine,49,50,46,0,99,93.87755102040816,0
48372_marine,47,49,44,0,96,93.61702127659575,0
48373_marine,49,49,46,0,98,93.87755102040816,0
48374_marine,49,49,46,0,98,93.87755102040816,0
48375_marine,49,50,46,0,99,93.87755102040816,0
48376_marine,50,50,47,1,100,94,2
48377_marine,50,50,47,1,100,94,2
48378_marine,50,50,47,1,100,94,2
48379_marine,51,49,48,1,100,94.11764705882352,1.9607843137254901
48380_marine,51,49,48,1,100,94.11764705882352,1.9607843137254901
48381_marine,50,50,47,1,100,94,2
48382_marine,50,51,47,1,101,94,2
48383_marine,50,50,47,1,100,94,2
48384_marine,50,50,47,1,100,94,2
48385_marine,48,49,47,1,97,97.91666666666666,2.083333333333333
48386_marine,48,49,47,1,97,97.91666666666666,2.083333333333333
48387_marine,46,49,45,1,95,97.82608695652173,2.1739130434782608
48388_marine,46,49,45,1,95,97.82608695652173,2.1739130434782608
48389_marine,47,49,46,1,96,97.87234042553192,2.127659574468085
48390_marine,47,49,46,1,96,97.87234042553192,2.127659574468085
48391_marine,47,49,46,1,96,97.87234042553192,2.127659574468085
48392_marine,46,50,45,1,96,97.82608695652173,2.1739130434782608
48393_marine,46,50,45,1,96,97.82608695652173,2.1739130434782608
48394_marine,46,50,45,1,96,97.82608695652173,2.1739130434782608
48395_marine,45,50,44,0,95,97.77777777777777,0
48396_marine,45,50,44,0,95,97.77777777777777,0
48397_marine,45,51,44,0,96,97.77777777777777,0
48398_marine,45,51,44,0,96,97.77777777777777,0
48399_marine,45,52,44,0,97,97.77777777777777,0
48400_marine,45,51,44,0,96,97.77777777777777,0
48401_marine,45,51,44,0,96,97.77777777777777,0
48402_marine,45,51,44,0,96,97.77777777777777,0
48403_marine,45,51,44,0,96,97.77777777777777,0
48404_marine,42,53,41,0,95,97.61904761904762,0
48405_marine,42,53,41,0,95,97.61904761904762,0
48406_marine,42,53,41,0,95,97.61904761904762,0
48407_marine,42,53,41,0,95,97.61904761904762,0
48408_marine,42,53,41,0,95,97.61904761904762,0
48409_marine,42,53,41,0,95,97.61904761904762,0
48410_marine,42,53,41,0,95,97.61904761904762,0
48411_marine,42,53,41,0,95,97.61904761904762,0
48412_marine,42,53,41,0,95,97.61904761904762,0
48413_marine,42,53,41,0,95,97.61904761904762,0
48414_marine,42,53,41,0,95,97.61904761904762,0
48415_marine,42,53,41,0,95,97.61904761904762,0
48416_marine,43,52,42,0,95,97.67441860465115,0
48417_marine,43,52,42,0,95,97.67441860465115,0
48418_marine,43,52,42,0,95,97.67441860465115,0
48419_marine,45,54,44,0,99,97.77777777777777,0
48420_marine,43,54,42,0,97,97.67441860465115,0
48421_marine,43,54,42,0,97,97.67441860465115,0
48422_marine,42,52,41,0,94,97.61904761904762,0
48423_marine,42,52,41,0,94,97.61904761904762,0
48424_marine,42,52,41,0,94,97.61904761904762,0
48425_marine,44,52,43,0,96,97.72727272727273,0
48426_marine,43,52,41,1,95,95.34883720930233,2.3255813953488373
48427_marine,40,52,38,1,92,95,2.5
48428_marine,40,52,38,1,92,95,2.5
48429_marine,40,54,38,1,94,95,2.5
48430_marine,40,54,38,1,94,95,2.5
48431_marine,41,54,39,1,95,95.1219512195122,2.4390243902439024
48432_marine,41,54,39,1,95,95.1219512195122,2.4390243902439024
48433_marine,41,54,39,1,95,95.1219512195122,2.4390243902439024
48434_marine,41,54,39,1,95,95.1219512195122,2.4390243902439024
48435_marine,42,53,40,1,95,95.23809523809523,2.380952380952381
48436_marine,42,54,39,1,96,92.85714285714286,2.380952380952381
48437_marine,42,55,39,1,97,92.85714285714286,2.380952380952381
48438_marine,42,55,39,1,97,92.85714285714286,2.380952380952381
48439_marine,44,55,41,1,99,93.18181818181817,2.272727272727273
48440_marine,44,55,41,1,99,93.18181818181817,2.272727272727273
48441_marine,44,55,41,1,99,93.18181818181817,2.272727272727273
48442_marine,44,55,41,1,99,93.18181818181817,2.272727272727273
48443_marine,44,55,40,2,99,90.9090909090909,4.545454545454546
48444_marine,44,55,40,2,99,90.9090909090909,4.545454545454546
48445_marine,46,56,42,2,102,91.30434782608695,4.3478260869565215
48446_marine,46,57,42,2,103,91.30434782608695,4.3478260869565215
48447_marine,43,58,39,2,101,90.69767441860465,4.651162790697675
48448_marine,43,58,39,2,101,90.69767441860465,4.651162790697675
48449_marine,42,58,38,2,100,90.47619047619048,4.761904761904762
48450_marine,42,58,38,2,100,90.47619047619048,4.761904761904762
48451_marine,42,60,38,2,102,90.47619047619048,4.761904761904762
48452_marine,42,60,38,2,102,90.47619047619048,4.761904761904762
48453_marine,42,60,38,2,102,90.47619047619048,4.761904761904762
48454_marine,41,59,37,2,100,90.2439024390244,4.878048780487805
48455_marine,41,59,37,2,100,90.2439024390244,4.878048780487805
48456_marine,42,62,38,3,104,90.47619047619048,7.142857142857142
48457_marine,42,64,38,3,106,90.47619047619048,7.142857142857142
48458_marine,42,66,38,3,108,90.47619047619048,7.142857142857142
48459_marine,43,66,40,4,109,93.02325581395348,9.30232558139535
48460_marine,45,63,42,6,108,93.33333333333333,13.333333333333334
48461_marine,45,63,42,6,108,93.33333333333333,13.333333333333334
48462_marine,45,67,42,6,112,93.33333333333333,13.333333333333334
48463_marine,45,67,42,6,112,93.33333333333333,13.333333333333334
48464_marine,46,69,43,6,115,93.47826086956522,13.043478260869565
48465_marine,46,67,43,6,113,93.47826086956522,13.043478260869565
48466_marine,45,65,42,5,110,93.33333333333333,11.11111111111111
48467_marine,44,65,41,5,109,93.18181818181817,11.363636363636363
48468_marine,43,65,40,5,108,93.02325581395348,11.627906976744185
48469_marine,43,66,40,5,109,93.02325581395348,11.627906976744185
48470_marine,40,64,37,5,104,92.5,12.5
48471_marine,40,64,37,5,104,92.5,12.5
48472_marine,40,64,37,5,104,92.5,12.5
48473_marine,40,64,37,5,104,92.5,12.5
48474_marine,40,64,37,5,104,92.5,12.5
48475_marine,40,63,37,5,103,92.5,12.5
48476_marine,40,63,37,5,103,92.5,12.5
48477_marine,40,63,37,5,103,92.5,12.5
48478_marine,39,63,36,4,102,92.3076923076923,10.256410256410255
48479_marine,37,59,34,4,96,91.8918918918919,10.81081081081081
48480_marine,36,59,33,3,95,91.66666666666666,8.333333333333332
48481_marine,37,59,34,3,96,91.8918918918919,8.108108108108109
48482_marine,37,59,34,3,96,91.8918918918919,8.108108108108109
48483_marine,37,58,34,3,95,91.8918918918919,8.108108108108109
48484_marine,37,58,34,3,95,91.8918918918919,8.108108108108109
48485_marine,37,58,34,3,95,91.8918918918919,8.108108108108109
48486_marine,37,58,34,3,95,91.8918918918919,8.108108108108109
48487_marine,37,60,34,3,97,91.8918918918919,8.108108108108109
48488_marine,37,62,34,3,99,91.8918918918919,8.108108108108109
48489_marine,37,61,34,3,98,91.8918918918919,8.108108108108109
48490_marine,37,59,34,3,96,91.8918918918919,8.108108108108109
48491_marine,37,59,34,3,96,91.8918918918919,8.108108108108109
48492_marine,38,59,35,3,97,92.10526315789474,7.894736842105263
48493_marine,38,59,35,3,97,92.10526315789474,7.894736842105263
48494_marine,40,59,37,3,99,92.5,7.5
48495_marine,40,58,37,3,98,92.5,7.5
48496_marine,40,58,37,3,98,92.5,7.5
48497_marine,39,57,37,2,96,94.87179487179486,5.128205128205128
48498_marine,39,58,37,2,97,94.87179487179486,5.128205128205128
48499_marine,39,58,37,2,97,94.87179487179486,5.128205128205128
48500_marine,39,58,37,2,97,94.87179487179486,5.128205128205128
48501_marine,39,57,37,2,96,94.87179487179486,5.128205128205128
48502_marine,39,57,37,2,96,94.87179487179486,5.128205128205128
48503_marine,39,56,37,2,95,94.87179487179486,5.128205128205128
48504_marine,39,55,37,2,94,94.87179487179486,5.128205128205128
48505_marine,39,55,37,2,94,94.87179487179486,5.128205128205128
48506_marine,38,54,37,1,92,97.36842105263158,2.631578947368421
48507_marine,37,54,36,0,91,97.2972972972973,0
48508_marine,37,54,36,0,91,97.2972972972973,0
48509_marine,37,54,36,0,91,97.2972972972973,0
48510_marine,37,54,36,0,91,97.2972972972973,0
48511_marine,39,54,37,0,93,94.87179487179486,0
48512_marine,40,55,37,0,95,92.5,0
48513_marine,40,55,37,0,95,92.5,0
48514_marine,41,57,38,0,98,92.6829268292683,0
48515_marine,41,57,38,0,98,92.6829268292683,0
48516_marine,41,56,38,0,97,92.6829268292683,0
48517_marine,41,56,38,0,97,92.6829268292683,0
48518_marine,41,56,38,0,97,92.6829268292683,0
48519_marine,41,56,38,0,97,92.6829268292683,0
48520_marine,43,57,40,0,100,93.02325581395348,0
48521_marine,43,55,40,0,98,93.02325581395348,0
48522_marine,43,55,40,0,98,93.02325581395348,0
48523_marine,43,55,40,0,98,93.02325581395348,0
48524_marine,43,55,40,0,98,93.02325581395348,0
48525_marine,43,55,40,0,98,93.02325581395348,0
48526_marine,43,55,40,0,98,93.02325581395348,0
48527_marine,43,55,40,0,98,93.02325581395348,0
48528_marine,43,55,40,0,98,93.02325581395348,0
48529_marine,43,56,40,0,99,93.02325581395348,0
48530_marine,43,56,40,0,99,93.02325581395348,0
48531_marine,43,56,40,0,99,93.02325581395348,0
48532_marine,44,56,41,0,100,93.18181818181817,0
48533_marine,44,56,41,0,100,93.18181818181817,0
48534_marine,44,54,41,0,98,93.18181818181817,0
48535_marine,44,54,41,0,98,93.18181818181817,0
48536_marine,44,52,41,0,96,93.18181818181817,0
48537_marine,43,52,41,0,95,95.34883720930233,0
48538_marine,43,52,41,0,95,95.34883720930233,0
48539_marine,43,52,41,0,95,95.34883720930233,0
48540_marine,43,54,41,0,97,95.34883720930233,0
48541_marine,42,54,40,0,96,95.23809523809523,0
48542_marine,42,55,40,0,97,95.23809523809523,0
48543_marine,44,55,42,0,99,95.45454545454545,0
48544_marine,44,55,42,0,99,95.45454545454545,0
48545_marine,45,57,43,0,102,95.55555555555556,0
48546_marine,45,56,43,0,101,95.55555555555556,0
48547_marine,45,56,43,0,101,95.55555555555556,0
48548_marine,47,56,45,0,103,95.74468085106383,0
48549_marine,47,56,45,0,103,95.74468085106383,0
48550_marine,47,56,45,0,103,95.74468085106383,0
48551_marine,51,56,49,0,107,96.07843137254902,0
48552_marine,51,58,49,0,109,96.07843137254902,0
48553_marine,52,59,50,0,111,96.15384615384616,0
48554_marine,52,60,50,0,112,96.15384615384616,0
48555_marine,52,60,50,0,112,96.15384615384616,0
48556_marine,52,60,50,0,112,96.15384615384616,0
48557_marine,52,60,50,0,112,96.15384615384616,0
48558_marine,52,63,50,0,115,96.15384615384616,0
48559_marine,52,64,50,0,116,96.15384615384616,0
48560_marine,53,64,51,1,117,96.22641509433963,1.8867924528301887
48561_marine,57,66,53,1,123,92.98245614035088,1.7543859649122806
48562_marine,58,68,54,1,126,93.10344827586206,1.7241379310344827
48563_marine,64,68,60,1,132,93.75,1.5625
48564_marine,64,73,60,1,137,93.75,1.5625
48565_marine,109,156,92,13,265,84.40366972477065,11.926605504587156
48566_marine,172,201,140,27,373,81.3953488372093,15.69767441860465
48567_marine,183,224,150,30,407,81.9672131147541,16.39344262295082
48568_marine,189,233,152,30,422,80.42328042328042,15.873015873015872
48569_marine,170,209,137,27,379,80.58823529411765,15.88235294117647
48570_marine,78,74,70,3,152,89.74358974358975,3.8461538461538463
48571_marine,77,73,70,2,150,90.9090909090909,2.5974025974025974
48572_marine,71,67,65,2,138,91.54929577464789,2.8169014084507045
48573_marine,64,67,58,2,131,90.625,3.125
48574_marine,62,67,56,2,129,90.32258064516128,3.225806451612903
48575_marine,62,67,56,2,129,90.32258064516128,3.225806451612903
48576_marine,62,67,56,2,129,90.32258064516128,3.225806451612903
48577_marine,62,67,56,2,129,90.32258064516128,3.225806451612903
48578_marine,62,68,56,2,130,90.32258064516128,3.225806451612903
48579_marine,61,69,56,1,130,91.80327868852459,1.639344262295082
48580_marine,61,69,57,1,130,93.44262295081968,1.639344262295082
48581_marine,64,69,60,1,133,93.75,1.5625
48582_marine,64,69,60,1,133,93.75,1.5625
48583_marine,67,67,63,3,134,94.02985074626866,4.477611940298507
48584_marine,69,66,64,3,135,92.7536231884058,4.3478260869565215
48585_marine,73,71,68,3,144,93.15068493150685,4.10958904109589
48586_marine,116,178,108,10,294,93.10344827586206,8.620689655172415
48587_marine,127,187,117,14,314,92.1259842519685,11.023622047244094
48593_marine,134,233,121,17,367,90.29850746268657,12.686567164179104
48594_marine,135,237,120,19,372,88.88888888888889,14.074074074074074
48595_marine,124,229,112,15,353,90.32258064516128,12.096774193548388
48596_marine,95,142,91,3,237,95.78947368421052,3.1578947368421053
48597_marine,93,132,90,3,225,96.7741935483871,3.225806451612903
48598_marine,90,129,87,3,219,96.66666666666667,3.3333333333333335
48599_marine,84,122,81,3,206,96.42857142857143,3.571428571428571
48600_marine,78,112,75,2,190,96.15384615384616,2.564102564102564
48601_marine,58,62,55,0,120,94.82758620689656,0
48602_marine,60,61,57,0,121,95,0
48603_marine,72,130,69,0,202,95.83333333333334,0
48604_marine,74,134,71,0,208,95.94594594594594,0
48605_marine,72,134,69,0,206,95.83333333333334,0
48606_marine,64,77,61,0,141,95.3125,0
48607_marine,56,57,53,0,113,94.64285714285714,0
48608_marine,54,55,51,0,109,94.44444444444444,0
48609_marine,54,53,51,0,107,94.44444444444444,0
48610_marine,51,54,48,0,105,94.11764705882352,0
48611_marine,50,54,47,0,104,94,0
48612_marine,49,53,46,0,102,93.87755102040816,0
48613_marine,49,53,46,0,102,93.87755102040816,0
48614_marine,47,53,44,0,100,93.61702127659575,0
48615_marine,46,53,43,0,99,93.47826086956522,0
48616_marine,46,52,43,0,98,93.47826086956522,0
48617_marine,44,52,41,0,96,93.18181818181817,0
48618_marine,42,52,39,0,94,92.85714285714286,0
48619_marine,42,52,39,0,94,92.85714285714286,0
48620_marine,42,52,39,0,94,92.85714285714286,0
48621_marine,41,51,38,0,92,92.6829268292683,0
48622_marine,41,50,38,0,91,92.6829268292683,0
48623_marine,41,50,38,0,91,92.6829268292683,0
48624_marine,41,50,38,0,91,92.6829268292683,0
48625_marine,41,50,38,0,91,92.6829268292683,0
48626_marine,41,50,38,0,91,92.6829268292683,0
48627_marine,41,50,38,0,91,92.6829268292683,0
48628_marine,41,50,38,0,91,92.6829268292683,0
48629_marine,41,50,38,0,91,92.6829268292683,0
48630_marine,38,50,35,0,88,92.10526315789474,0
48631_marine,38,49,35,0,87,92.10526315789474,0
48632_marine,38,49,35,0,87,92.10526315789474,0
48633_marine,38,49,35,0,87,92.10526315789474,0
48634_marine,38,49,35,0,87,92.10526315789474,0
48635_marine,38,49,35,0,87,92.10526315789474,0
48636_marine,38,49,35,0,87,92.10526315789474,0
48637_marine,38,49,35,0,87,92.10526315789474,0
48638_marine,38,49,35,0,87,92.10526315789474,0
48639_marine,38,49,35,0,87,92.10526315789474,0
48640_marine,38,47,35,0,85,92.10526315789474,0
48641_marine,38,47,35,0,85,92.10526315789474,0
48642_marine,38,47,35,0,85,92.10526315789474,0
48643_marine,38,47,35,0,85,92.10526315789474,0
48644_marine,40,48,37,0,88,92.5,0
48645_marine,40,49,37,0,89,92.5,0
48646_marine,40,50,37,0,90,92.5,0
48647_marine,40,50,37,0,90,92.5,0
48648_marine,40,50,37,0,90,92.5,0
48649_marine,40,50,37,0,90,92.5,0
48650_marine,40,50,37,0,90,92.5,0
48651_marine,40,50,37,0,90,92.5,0
48652_marine,38,50,37,0,88,97.36842105263158,0
48653_marine,38,50,37,0,88,97.36842105263158,0
48654_marine,38,50,37,0,88,97.36842105263158,0
48655_marine,38,50,37,0,88,97.36842105263158,0
48656_marine,36,50,35,0,86,97.22222222222221,0
48657_marine,36,50,35,0,86,97.22222222222221,0
48658_marine,36,50,35,0,86,97.22222222222221,0
48659_marine,34,50,33,0,84,97.05882352941177,0
48660_marine,34,49,33,0,83,97.05882352941177,0
48661_marine,34,49,33,0,83,97.05882352941177,0
48662_marine,32,47,31,0,79,96.875,0
48663_marine,32,47,31,0,79,96.875,0
48664_marine,32,47,31,0,79,96.875,0
48665_marine,32,47,31,0,79,96.875,0
48666_marine,32,47,31,0,79,96.875,0
48667_marine,32,47,31,0,79,96.875,0
48668_marine,32,50,31,0,82,96.875,0
48669_marine,32,50,31,0,82,96.875,0
48670_marine,32,50,31,0,82,96.875,0
48671_marine,32,50,31,0,82,96.875,0
48672_marine,32,50,31,0,82,96.875,0
48673_marine,32,50,31,0,82,96.875,0
48674_marine,32,50,31,0,82,96.875,0
48675_marine,32,49,31,0,81,96.875,0
48676_marine,32,49,31,0,81,96.875,0
48677_marine,32,50,31,0,82,96.875,0
48678_marine,32,50,31,0,82,96.875,0
48679_marine,32,50,31,0,82,96.875,0
48680_marine,32,50,31,0,82,96.875,0
48681_marine,32,49,31,0,81,96.875,0
48682_marine,32,49,31,0,81,96.875,0
48683_marine,32,49,31,0,81,96.875,0
48684_marine,32,49,31,0,81,96.875,0
48685_marine,32,49,31,0,81,96.875,0
48686_marine,32,49,31,0,81,96.875,0
48687_marine,32,49,31,0,81,96.875,0
48688_marine,32,49,31,0,81,96.875,0
48689_marine,32,49,31,0,81,96.875,0
48690_marine,31,50,30,0,81,96.7741935483871,0
48691_marine,31,50,30,0,81,96.7741935483871,0
48692_marine,31,50,30,0,81,96.7741935483871,0
48693_marine,31,50,30,0,81,96.7741935483871,0
48694_marine,32,50,31,0,82,96.875,0
48695_marine,32,50,31,0,82,96.875,0
48696_marine,32,50,31,0,82,96.875,0
48697_marine,32,50,31,0,82,96.875,0
48698_marine,32,51,31,0,83,96.875,0
48699_marine,31,53,28,1,84,90.32258064516128,3.225806451612903
48700_marine,32,53,28,1,85,87.5,3.125
48701_marine,32,53,28,1,85,87.5,3.125
48702_marine,34,55,30,1,89,88.23529411764706,2.941176470588235
48703_marine,35,53,31,2,88,88.57142857142857,5.714285714285714
48704_marine,52,66,46,5,118,88.46153846153845,9.615384615384617
48705_marine,118,171,75,51,289,63.559322033898304,43.22033898305085
48706_marine,119,190,75,52,309,63.02521008403361,43.69747899159664
48707_marine,124,188,78,59,312,62.903225806451616,47.58064516129033
48708_marine,116,155,73,55,271,62.93103448275862,47.41379310344828
48713_marine,161,198,102,78,359,63.35403726708074,48.4472049689441
48714_marine,166,199,104,81,365,62.65060240963856,48.795180722891565
48715_marine,170,204,109,80,374,64.11764705882354,47.05882352941176
48716_marine,79,123,68,11,202,86.07594936708861,13.924050632911392
48717_marine,75,125,66,8,200,88,10.666666666666668
48718_marine,75,120,66,8,195,88,10.666666666666668
48719_marine,69,122,60,6,191,86.95652173913044,8.695652173913043
48720_marine,67,122,58,6,189,86.56716417910447,8.955223880597014
48721_marine,66,114,57,6,180,86.36363636363636,9.090909090909092
48722_marine,48,53,43,4,101,89.58333333333334,8.333333333333332
48723_marine,48,51,44,4,99,91.66666666666666,8.333333333333332
48724_marine,48,50,44,4,98,91.66666666666666,8.333333333333332
48725_marine,47,50,43,2,97,91.48936170212765,4.25531914893617
48726_marine,47,51,43,2,98,91.48936170212765,4.25531914893617
48727_marine,47,51,43,2,98,91.48936170212765,4.25531914893617
48728_marine,47,49,43,2,96,91.48936170212765,4.25531914893617
48729_marine,47,49,43,1,96,91.48936170212765,2.127659574468085
48730_marine,46,49,42,0,95,91.30434782608695,0
48731_marine,47,49,44,0,96,93.61702127659575,0
48732_marine,45,48,42,0,93,93.33333333333333,0
48733_marine,47,48,44,1,95,93.61702127659575,2.127659574468085
48734_marine,47,49,44,1,96,93.61702127659575,2.127659574468085
48735_marine,48,49,45,1,97,93.75,2.083333333333333
48736_marine,48,49,45,1,97,93.75,2.083333333333333
48737_marine,48,49,45,1,97,93.75,2.083333333333333
48738_marine,49,49,45,2,98,91.83673469387756,4.081632653061225
48739_marine,50,50,46,2,100,92,4
48740_marine,49,50,45,2,99,91.83673469387756,4.081632653061225
48741_marine,49,49,45,2,98,91.83673469387756,4.081632653061225
48742_marine,49,48,45,2,97,91.83673469387756,4.081632653061225
48743_marine,49,50,45,2,99,91.83673469387756,4.081632653061225
48744_marine,43,50,41,2,93,95.34883720930233,4.651162790697675
48745_marine,43,50,41,2,93,95.34883720930233,4.651162790697675
48746_marine,42,50,41,1,92,97.61904761904762,2.380952380952381
48747_marine,42,50,41,1,92,97.61904761904762,2.380952380952381
48748_marine,42,50,41,1,92,97.61904761904762,2.380952380952381
48749_marine,42,51,41,1,93,97.61904761904762,2.380952380952381
48750_marine,42,51,41,1,93,97.61904761904762,2.380952380952381
48751_marine,42,51,41,1,93,97.61904761904762,2.380952380952381
48752_marine,42,51,41,1,93,97.61904761904762,2.380952380952381
48753_marine,42,51,41,1,93,97.61904761904762,2.380952380952381
48754_marine,42,51,41,1,93,97.61904761904762,2.380952380952381
48755_marine,42,51,41,1,93,97.61904761904762,2.380952380952381
48756_marine,41,51,40,0,92,97.5609756097561,0
48757_marine,41,51,40,0,92,97.5609756097561,0
48758_marine,41,51,40,0,92,97.5609756097561,0
48759_marine,41,51,40,0,92,97.5609756097561,0
48760_marine,41,51,40,0,92,97.5609756097561,0
48761_marine,40,51,39,0,91,97.5,0
48762_marine,40,51,39,0,91,97.5,0
48763_marine,40,51,39,0,91,97.5,0
48764_marine,40,52,39,0,92,97.5,0
48765_marine,40,53,39,0,93,97.5,0
48766_marine,40,53,39,0,93,97.5,0
48767_marine,44,53,43,0,97,97.72727272727273,0
48768_marine,42,53,41,0,95,97.61904761904762,0
48769_marine,42,54,41,0,96,97.61904761904762,0
48770_marine,42,54,41,0,96,97.61904761904762,0
48771_marine,42,54,41,0,96,97.61904761904762,0
48772_marine,42,54,41,0,96,97.61904761904762,0
48773_marine,42,53,41,0,95,97.61904761904762,0
48774_marine,42,53,41,0,95,97.61904761904762,0
48775_marine,42,53,41,0,95,97.61904761904762,0
48776_marine,42,52,41,0,94,97.61904761904762,0
48777_marine,42,52,41,0,94,97.61904761904762,0
48778_marine,42,52,41,0,94,97.61904761904762,0
48779_marine,42,52,41,0,94,97.61904761904762,0
48780_marine,43,52,42,0,95,97.67441860465115,0
48781_marine,41,52,40,0,93,97.5609756097561,0
48782_marine,40,53,39,0,93,97.5,0
48783_marine,39,52,38,0,91,97.43589743589743,0
48784_marine,39,52,38,0,91,97.43589743589743,0
48785_marine,39,52,37,1,91,94.87179487179486,2.564102564102564
48786_marine,39,52,37,1,91,94.87179487179486,2.564102564102564
48787_marine,39,52,37,1,91,94.87179487179486,2.564102564102564
48788_marine,39,52,37,1,91,94.87179487179486,2.564102564102564
48789_marine,39,52,37,1,91,94.87179487179486,2.564102564102564
48790_marine,39,52,37,1,91,94.87179487179486,2.564102564102564
48791_marine,39,52,37,1,91,94.87179487179486,2.564102564102564
48792_marine,39,52,37,1,91,94.87179487179486,2.564102564102564
48793_marine,40,52,38,1,92,95,2.5
48794_marine,40,51,38,1,91,95,2.5
48795_marine,40,51,38,1,91,95,2.5
48796_marine,40,54,38,1,94,95,2.5
48797_marine,41,54,38,1,95,92.6829268292683,2.4390243902439024
48798_marine,42,55,38,2,97,90.47619047619048,4.761904761904762
48799_marine,42,55,38,2,97,90.47619047619048,4.761904761904762
48800_marine,42,55,38,2,97,90.47619047619048,4.761904761904762
48801_marine,42,55,38,2,97,90.47619047619048,4.761904761904762
48802_marine,45,55,41,2,100,91.11111111111111,4.444444444444445
48803_marine,45,55,41,2,100,91.11111111111111,4.444444444444445
48804_marine,45,55,41,2,100,91.11111111111111,4.444444444444445
48805_marine,43,56,39,2,99,90.69767441860465,4.651162790697675
48806_marine,44,56,40,2,100,90.9090909090909,4.545454545454546
48807_marine,44,56,40,2,100,90.9090909090909,4.545454545454546
48808_marine,43,58,39,2,101,90.69767441860465,4.651162790697675
48809_marine,42,58,38,2,100,90.47619047619048,4.761904761904762
48810_marine,42,59,38,2,101,90.47619047619048,4.761904761904762
48811_marine,41,60,37,2,101,90.2439024390244,4.878048780487805
48812_marine,41,60,37,2,101,90.2439024390244,4.878048780487805
48813_marine,38,60,34,2,98,89.47368421052632,5.263157894736842
48814_marine,38,63,34,2,101,89.47368421052632,5.263157894736842
48815_marine,38,63,34,2,101,89.47368421052632,5.263157894736842
48816_marine,39,66,35,3,105,89.74358974358975,7.6923076923076925
48817_marine,39,67,36,3,106,92.3076923076923,7.6923076923076925
48818_marine,42,65,39,5,107,92.85714285714286,11.904761904761903
48819_marine,42,67,39,5,109,92.85714285714286,11.904761904761903
48820_marine,42,67,39,5,109,92.85714285714286,11.904761904761903
48821_marine,42,62,39,5,104,92.85714285714286,11.904761904761903
48822_marine,42,67,39,5,109,92.85714285714286,11.904761904761903
48823_marine,42,67,39,5,109,92.85714285714286,11.904761904761903
48824_marine,42,67,39,5,109,92.85714285714286,11.904761904761903
48825_marine,42,65,39,5,107,92.85714285714286,11.904761904761903
48826_marine,42,63,39,5,105,92.85714285714286,11.904761904761903
48827_marine,41,65,38,5,106,92.6829268292683,12.195121951219512
48828_marine,40,63,37,5,103,92.5,12.5
48829_marine,40,64,37,5,104,92.5,12.5
48830_marine,42,63,38,6,105,90.47619047619048,14.285714285714285
48831_marine,54,80,48,12,134,88.88888888888889,22.22222222222222
48832_marine,40,63,37,5,103,92.5,12.5
48833_marine,40,60,37,5,100,92.5,12.5
48834_marine,40,61,37,5,101,92.5,12.5
48835_marine,40,60,37,5,100,92.5,12.5
48836_marine,40,60,37,5,100,92.5,12.5
48837_marine,38,60,35,5,98,92.10526315789474,13.157894736842104
48838_marine,38,60,35,5,98,92.10526315789474,13.157894736842104
48839_marine,38,60,35,5,98,92.10526315789474,13.157894736842104
48840_marine,38,60,35,5,98,92.10526315789474,13.157894736842104
48841_marine,37,60,34,4,97,91.8918918918919,10.81081081081081
48842_marine,37,60,34,4,97,91.8918918918919,10.81081081081081
48843_marine,36,60,33,3,96,91.66666666666666,8.333333333333332
48844_marine,36,62,33,3,98,91.66666666666666,8.333333333333332
48845_marine,36,59,33,3,95,91.66666666666666,8.333333333333332
48846_marine,37,61,34,3,98,91.8918918918919,8.108108108108109
48847_marine,37,61,34,3,98,91.8918918918919,8.108108108108109
48848_marine,37,61,34,3,98,91.8918918918919,8.108108108108109
48849_marine,37,59,34,3,96,91.8918918918919,8.108108108108109
48850_marine,37,59,34,3,96,91.8918918918919,8.108108108108109
48851_marine,37,59,34,3,96,91.8918918918919,8.108108108108109
48852_marine,38,58,35,4,96,92.10526315789474,10.526315789473683
48853_marine,39,58,36,4,97,92.3076923076923,10.256410256410255
48854_marine,39,58,36,4,97,92.3076923076923,10.256410256410255
48855_marine,39,58,36,4,97,92.3076923076923,10.256410256410255
48856_marine,39,57,36,4,96,92.3076923076923,10.256410256410255
48857_marine,39,57,36,4,96,92.3076923076923,10.256410256410255
48858_marine,39,57,36,4,96,92.3076923076923,10.256410256410255
48859_marine,38,55,35,3,93,92.10526315789474,7.894736842105263
48860_marine,38,54,35,3,92,92.10526315789474,7.894736842105263
48861_marine,38,54,35,3,92,92.10526315789474,7.894736842105263
48862_marine,37,54,35,2,91,94.5945945945946,5.405405405405405
48863_marine,37,53,35,2,90,94.5945945945946,5.405405405405405
48864_marine,37,52,35,2,89,94.5945945945946,5.405405405405405
48865_marine,37,51,35,2,88,94.5945945945946,5.405405405405405
48866_marine,37,51,35,2,88,94.5945945945946,5.405405405405405
48867_marine,39,51,37,2,90,94.87179487179486,5.128205128205128
48868_marine,38,51,36,1,89,94.73684210526315,2.631578947368421
48869_marine,37,51,36,0,88,97.2972972972973,0
48870_marine,38,51,37,0,89,97.36842105263158,0
48871_marine,38,51,37,0,89,97.36842105263158,0
48872_marine,39,51,37,0,90,94.87179487179486,0
48873_marine,41,52,38,0,93,92.6829268292683,0
48874_marine,41,54,38,0,95,92.6829268292683,0
48875_marine,42,54,38,1,96,90.47619047619048,2.380952380952381
48876_marine,42,54,38,1,96,90.47619047619048,2.380952380952381
48877_marine,42,54,38,1,96,90.47619047619048,2.380952380952381
48878_marine,42,56,38,1,98,90.47619047619048,2.380952380952381
48879_marine,42,56,38,1,98,90.47619047619048,2.380952380952381
48880_marine,42,57,38,1,99,90.47619047619048,2.380952380952381
48881_marine,42,55,38,1,97,90.47619047619048,2.380952380952381
48882_marine,42,55,38,1,97,90.47619047619048,2.380952380952381
48883_marine,42,55,38,1,97,90.47619047619048,2.380952380952381
48884_marine,44,55,40,1,99,90.9090909090909,2.272727272727273
48885_marine,44,55,40,1,99,90.9090909090909,2.272727272727273
48886_marine,44,54,40,1,98,90.9090909090909,2.272727272727273
48887_marine,44,54,40,1,98,90.9090909090909,2.272727272727273
48888_marine,44,54,40,1,98,90.9090909090909,2.272727272727273
48889_marine,43,56,39,1,99,90.69767441860465,2.3255813953488373
48890_marine,43,57,39,1,100,90.69767441860465,2.3255813953488373
48891_marine,43,57,39,1,100,90.69767441860465,2.3255813953488373
48892_marine,43,57,39,1,100,90.69767441860465,2.3255813953488373
48893_marine,43,57,39,1,100,90.69767441860465,2.3255813953488373
48894_marine,42,57,39,0,99,92.85714285714286,0
48895_marine,41,57,39,0,98,95.1219512195122,0
48896_marine,42,55,40,0,97,95.23809523809523,0
48897_marine,42,55,40,0,97,95.23809523809523,0
48898_marine,42,55,40,0,97,95.23809523809523,0
48899_marine,42,55,40,0,97,95.23809523809523,0
48900_marine,42,53,40,0,95,95.23809523809523,0
48901_marine,42,52,40,0,94,95.23809523809523,0
48902_marine,42,52,40,0,94,95.23809523809523,0
48903_marine,42,53,40,0,95,95.23809523809523,0
48904_marine,42,53,40,0,95,95.23809523809523,0
48905_marine,42,53,40,0,95,95.23809523809523,0
48906_marine,42,53,40,0,95,95.23809523809523,0
48907_marine,42,53,40,0,95,95.23809523809523,0
48908_marine,42,53,40,0,95,95.23809523809523,0
48909_marine,44,53,42,0,97,95.45454545454545,0
48910_marine,44,53,42,0,97,95.45454545454545,0
48911_marine,46,55,44,0,101,95.65217391304348,0
48912_marine,48,55,46,0,103,95.83333333333334,0
48913_marine,48,57,46,0,105,95.83333333333334,0
48914_marine,49,57,47,0,106,95.91836734693877,0
48915_marine,49,59,47,0,108,95.91836734693877,0
48916_marine,49,59,47,0,108,95.91836734693877,0
48917_marine,49,59,47,0,108,95.91836734693877,0
48918_marine,49,62,47,0,111,95.91836734693877,0
48919_marine,51,63,49,0,114,96.07843137254902,0
48920_marine,51,64,49,0,115,96.07843137254902,0
48921_marine,52,68,50,1,120,96.15384615384616,1.9230769230769231
48922_marine,53,68,50,1,121,94.33962264150944,1.8867924528301887
48923_marine,56,68,52,1,124,92.85714285714286,1.7857142857142856
48924_marine,61,68,57,1,129,93.44262295081968,1.639344262295082
48925_marine,61,73,57,1,134,93.44262295081968,1.639344262295082
48926_marine,75,93,69,3,168,92,4
48927_marine,80,93,74,3,173,92.5,3.75
48928_marine,80,93,73,4,173,91.25,5
48929_marine,82,91,75,4,173,91.46341463414635,4.878048780487805
48930_marine,70,65,65,2,135,92.85714285714286,2.857142857142857
48931_marine,64,66,60,2,130,93.75,3.125
48932_marine,60,66,56,2,126,93.33333333333333,3.3333333333333335
48933_marine,62,66,56,2,128,90.32258064516128,3.225806451612903
48934_marine,62,66,56,2,128,90.32258064516128,3.225806451612903
48935_marine,62,66,56,2,128,90.32258064516128,3.225806451612903
48936_marine,62,67,56,2,129,90.32258064516128,3.225806451612903
48937_marine,62,67,56,2,129,90.32258064516128,3.225806451612903
48938_marine,62,68,56,2,130,90.32258064516128,3.225806451612903
48939_marine,62,69,56,2,131,90.32258064516128,3.225806451612903
48940_marine,61,69,56,2,130,91.80327868852459,3.278688524590164
48941_marine,61,69,56,2,130,91.80327868852459,3.278688524590164
48942_marine,63,69,58,2,132,92.06349206349206,3.1746031746031744
48943_marine,68,68,62,4,136,91.17647058823529,5.88235294117647
48944_marine,70,68,64,4,138,91.42857142857143,5.714285714285714
48945_marine,73,72,67,4,145,91.78082191780823,5.47945205479452
48946_marine,124,183,115,12,307,92.74193548387096,9.67741935483871
48952_marine,132,221,118,19,353,89.39393939393939,14.393939393939394
48953_marine,122,219,110,11,341,90.1639344262295,9.01639344262295
48954_marine,100,199,96,1,299,96,1
48955_marine,88,130,84,1,218,95.45454545454545,1.1363636363636365
48956_marine,82,118,79,1,200,96.34146341463415,1.2195121951219512
48957_marine,82,118,79,1,200,96.34146341463415,1.2195121951219512
48958_marine,66,72,63,1,138,95.45454545454545,1.5151515151515151
48959_marine,66,77,63,0,143,95.45454545454545,0
48960_marine,64,73,61,0,137,95.3125,0
48961_marine,60,71,56,1,131,93.33333333333333,1.6666666666666667
48962_marine,59,64,55,1,123,93.22033898305084,1.694915254237288
48963_marine,59,59,55,1,118,93.22033898305084,1.694915254237288
48964_marine,59,59,55,1,118,93.22033898305084,1.694915254237288
48965_marine,59,59,55,1,118,93.22033898305084,1.694915254237288
48966_marine,55,58,51,1,113,92.72727272727272,1.8181818181818181
48967_marine,54,57,51,0,111,94.44444444444444,0
48968_marine,49,55,46,0,104,93.87755102040816,0
48969_marine,48,53,45,0,101,93.75,0
48970_marine,47,53,44,0,100,93.61702127659575,0
48971_marine,47,53,44,0,100,93.61702127659575,0
48972_marine,44,54,41,0,98,93.18181818181817,0
48973_marine,43,54,40,0,97,93.02325581395348,0
48974_marine,42,53,39,0,95,92.85714285714286,0
48975_marine,42,53,39,0,95,92.85714285714286,0
48976_marine,42,52,39,0,94,92.85714285714286,0
48977_marine,42,52,39,0,94,92.85714285714286,0
48978_marine,42,52,39,0,94,92.85714285714286,0
48979_marine,40,52,37,0,92,92.5,0
48980_marine,40,52,37,0,92,92.5,0
48981_marine,40,51,37,0,91,92.5,0
48982_marine,39,51,36,0,90,92.3076923076923,0
48983_marine,39,51,36,0,90,92.3076923076923,0
48984_marine,39,51,36,0,90,92.3076923076923,0
48985_marine,39,51,36,0,90,92.3076923076923,0
48986_marine,39,50,36,0,89,92.3076923076923,0
48987_marine,39,50,36,0,89,92.3076923076923,0
48988_marine,39,50,36,0,89,92.3076923076923,0
48989_marine,39,50,36,0,89,92.3076923076923,0
48990_marine,38,50,35,0,88,92.10526315789474,0
48991_marine,38,49,35,0,87,92.10526315789474,0
48992_marine,38,49,35,0,87,92.10526315789474,0
48993_marine,38,49,35,0,87,92.10526315789474,0
48994_marine,38,49,35,0,87,92.10526315789474,0
48995_marine,38,49,35,0,87,92.10526315789474,0
48996_marine,38,49,35,0,87,92.10526315789474,0
48997_marine,38,49,35,0,87,92.10526315789474,0
48998_marine,38,49,35,0,87,92.10526315789474,0
48999_marine,38,49,35,0,87,92.10526315789474,0
49000_marine,38,49,35,0,87,92.10526315789474,0
49001_marine,38,50,35,0,88,92.10526315789474,0
49002_marine,38,50,35,0,88,92.10526315789474,0
49003_marine,38,50,35,0,88,92.10526315789474,0
49004_marine,38,51,35,0,89,92.10526315789474,0
49005_marine,36,51,35,0,87,97.22222222222221,0
49006_marine,36,51,35,0,87,97.22222222222221,0
49007_marine,36,51,35,0,87,97.22222222222221,0
49008_marine,36,51,35,0,87,97.22222222222221,0
49009_marine,36,52,35,0,88,97.22222222222221,0
49010_marine,36,52,35,0,88,97.22222222222221,0
49011_marine,36,52,35,0,88,97.22222222222221,0
49012_marine,36,52,35,0,88,97.22222222222221,0
49013_marine,34,52,33,0,86,97.05882352941177,0
49014_marine,34,52,33,0,86,97.05882352941177,0
49015_marine,34,51,33,0,85,97.05882352941177,0
49016_marine,34,51,33,0,85,97.05882352941177,0
49017_marine,34,51,33,0,85,97.05882352941177,0
49018_marine,34,51,33,0,85,97.05882352941177,0
49019_marine,34,49,33,0,83,97.05882352941177,0
49020_marine,32,49,31,0,81,96.875,0
49021_marine,32,49,31,0,81,96.875,0
49022_marine,32,49,31,0,81,96.875,0
49023_marine,32,49,31,0,81,96.875,0
49024_marine,32,49,31,0,81,96.875,0
49025_marine,32,49,31,0,81,96.875,0
49026_marine,32,49,31,0,81,96.875,0
49027_marine,32,49,31,0,81,96.875,0
49028_marine,32,50,31,0,82,96.875,0
49029_marine,32,50,31,0,82,96.875,0
49030_marine,32,52,31,0,84,96.875,0
49031_marine,32,52,31,0,84,96.875,0
49032_marine,32,51,31,0,83,96.875,0
49033_marine,32,51,31,0,83,96.875,0
49034_marine,32,51,31,0,83,96.875,0
49035_marine,32,51,31,0,83,96.875,0
49036_marine,32,51,31,0,83,96.875,0
49037_marine,32,50,31,0,82,96.875,0
49038_marine,32,50,31,0,82,96.875,0
49039_marine,32,50,31,0,82,96.875,0
49040_marine,32,50,31,0,82,96.875,0
49041_marine,32,49,31,0,81,96.875,0
49042_marine,32,49,31,0,81,96.875,0
49043_marine,32,49,31,0,81,96.875,0
49044_marine,32,49,31,0,81,96.875,0
49045_marine,32,49,31,0,81,96.875,0
49046_marine,32,49,31,0,81,96.875,0
49047_marine,32,49,31,0,81,96.875,0
49048_marine,32,49,31,0,81,96.875,0
49049_marine,32,50,31,0,82,96.875,0
49050_marine,32,50,31,0,82,96.875,0
49051_marine,32,50,31,0,82,96.875,0
49052_marine,32,50,31,0,82,96.875,0
49053_marine,31,50,30,0,81,96.7741935483871,0
49054_marine,32,50,31,0,82,96.875,0
49055_marine,32,50,31,0,82,96.875,0
49056_marine,32,50,31,0,82,96.875,0
49057_marine,32,50,31,0,82,96.875,0
49058_marine,30,49,29,0,79,96.66666666666667,0
49059_marine,31,50,28,1,81,90.32258064516128,3.225806451612903
49060_marine,32,50,28,1,82,87.5,3.125
49061_marine,33,51,28,2,84,84.84848484848484,6.0606060606060606
49062_marine,35,53,30,2,88,85.71428571428571,5.714285714285714
49063_marine,39,54,34,3,93,87.17948717948718,7.6923076923076925
49064_marine,59,67,48,8,126,81.35593220338984,13.559322033898304
49065_marine,121,183,75,54,304,61.98347107438017,44.62809917355372
49066_marine,120,174,75,54,294,62.5,45
49067_marine,119,173,75,54,292,63.02521008403361,45.378151260504204
49073_marine,160,196,100,77,356,62.5,48.125
49074_marine,157,194,100,77,351,63.69426751592356,49.044585987261144
49075_marine,75,120,63,12,195,84,16
49076_marine,69,120,60,8,189,86.95652173913044,11.594202898550725
49077_marine,69,120,60,8,189,86.95652173913044,11.594202898550725
49078_marine,66,118,57,8,184,86.36363636363636,12.121212121212121
49079_marine,64,123,55,8,187,85.9375,12.5
49080_marine,60,117,51,6,177,85,10
49081_marine,49,73,42,4,122,85.71428571428571,8.16326530612245
49082_marine,46,55,40,4,101,86.95652173913044,8.695652173913043
49083_marine,44,51,40,4,95,90.9090909090909,9.090909090909092
49084_marine,44,50,40,4,94,90.9090909090909,9.090909090909092
49085_marine,46,50,42,4,96,91.30434782608695,8.695652173913043
49086_marine,45,50,41,3,95,91.11111111111111,6.666666666666667
49087_marine,47,50,43,3,97,91.48936170212765,6.382978723404255
49088_marine,46,50,42,2,96,91.30434782608695,4.3478260869565215
49089_marine,46,49,42,2,95,91.30434782608695,4.3478260869565215
49090_marine,44,49,40,2,93,90.9090909090909,4.545454545454546
49091_marine,42,49,39,1,91,92.85714285714286,2.380952380952381
49092_marine,42,50,39,1,92,92.85714285714286,2.380952380952381
49093_marine,42,49,39,1,91,92.85714285714286,2.380952380952381
49094_marine,45,49,42,1,94,93.33333333333333,2.2222222222222223
49095_marine,45,49,42,1,94,93.33333333333333,2.2222222222222223
49096_marine,46,49,42,2,95,91.30434782608695,4.3478260869565215
49097_marine,46,50,42,2,96,91.30434782608695,4.3478260869565215
49098_marine,48,50,44,2,98,91.66666666666666,4.166666666666666
49099_marine,48,50,44,2,98,91.66666666666666,4.166666666666666
49100_marine,45,50,41,2,95,91.11111111111111,4.444444444444445
49101_marine,45,49,41,2,94,91.11111111111111,4.444444444444445
49102_marine,43,49,41,2,92,95.34883720930233,4.651162790697675
49103_marine,43,49,41,2,92,95.34883720930233,4.651162790697675
49104_marine,43,49,41,2,92,95.34883720930233,4.651162790697675
49105_marine,43,49,41,2,92,95.34883720930233,4.651162790697675
49106_marine,43,50,41,2,93,95.34883720930233,4.651162790697675
49107_marine,43,50,41,2,93,95.34883720930233,4.651162790697675
49108_marine,43,51,41,2,94,95.34883720930233,4.651162790697675
49109_marine,42,51,40,2,93,95.23809523809523,4.761904761904762
49110_marine,43,51,41,2,94,95.34883720930233,4.651162790697675
49111_marine,43,51,41,2,94,95.34883720930233,4.651162790697675
49112_marine,43,51,41,2,94,95.34883720930233,4.651162790697675
49113_marine,43,51,41,2,94,95.34883720930233,4.651162790697675
49114_marine,43,51,41,2,94,95.34883720930233,4.651162790697675
49115_marine,43,51,41,2,94,95.34883720930233,4.651162790697675
49116_marine,42,50,40,2,92,95.23809523809523,4.761904761904762
49117_marine,42,51,40,2,93,95.23809523809523,4.761904761904762
49118_marine,41,51,39,1,92,95.1219512195122,2.4390243902439024
49119_marine,40,51,39,0,91,97.5,0
49120_marine,40,51,39,0,91,97.5,0
49121_marine,40,51,39,0,91,97.5,0
49122_marine,40,51,39,0,91,97.5,0
49123_marine,40,51,39,0,91,97.5,0
49124_marine,40,52,39,0,92,97.5,0
49125_marine,40,53,39,0,93,97.5,0
49126_marine,40,53,39,0,93,97.5,0
49127_marine,40,54,39,0,94,97.5,0
49128_marine,40,54,39,0,94,97.5,0
49129_marine,40,54,39,0,94,97.5,0
49130_marine,40,54,39,0,94,97.5,0
49131_marine,40,54,39,0,94,97.5,0
49132_marine,42,54,41,0,96,97.61904761904762,0
49133_marine,42,54,41,0,96,97.61904761904762,0
49134_marine,40,54,39,0,94,97.5,0
49135_marine,40,52,39,0,92,97.5,0
49136_marine,40,52,39,0,92,97.5,0
49137_marine,38,52,37,0,90,97.36842105263158,0
49138_marine,38,52,37,0,90,97.36842105263158,0
49139_marine,38,52,37,0,90,97.36842105263158,0
49140_marine,37,52,36,0,89,97.2972972972973,0
49141_marine,36,53,35,0,89,97.22222222222221,0
49142_marine,36,53,35,0,89,97.22222222222221,0
49143_marine,37,52,35,1,89,94.5945945945946,2.7027027027027026
49144_marine,37,52,35,1,89,94.5945945945946,2.7027027027027026
49145_marine,37,52,35,1,89,94.5945945945946,2.7027027027027026
49146_marine,37,52,35,1,89,94.5945945945946,2.7027027027027026
49147_marine,37,52,35,1,89,94.5945945945946,2.7027027027027026
49148_marine,39,52,37,1,91,94.87179487179486,2.564102564102564
49149_marine,37,52,35,1,89,94.5945945945946,2.7027027027027026
49150_marine,37,52,35,1,89,94.5945945945946,2.7027027027027026
49151_marine,39,52,37,1,91,94.87179487179486,2.564102564102564
49152_marine,37,52,35,1,89,94.5945945945946,2.7027027027027026
49153_marine,38,52,35,2,90,92.10526315789474,5.263157894736842
49154_marine,38,51,35,2,89,92.10526315789474,5.263157894736842
49155_marine,38,51,35,2,89,92.10526315789474,5.263157894736842
49156_marine,39,51,36,2,90,92.3076923076923,5.128205128205128
49157_marine,38,52,35,2,90,92.10526315789474,5.263157894736842
49158_marine,38,52,35,2,90,92.10526315789474,5.263157894736842
49159_marine,38,52,35,2,90,92.10526315789474,5.263157894736842
49160_marine,38,53,35,2,91,92.10526315789474,5.263157894736842
49161_marine,38,53,35,2,91,92.10526315789474,5.263157894736842
49162_marine,38,57,35,2,95,92.10526315789474,5.263157894736842
49163_marine,37,57,34,2,94,91.8918918918919,5.405405405405405
49164_marine,36,57,33,2,93,91.66666666666666,5.555555555555555
49165_marine,36,54,33,2,90,91.66666666666666,5.555555555555555
49166_marine,35,54,32,2,89,91.42857142857143,5.714285714285714
49167_marine,37,54,34,2,91,91.8918918918919,5.405405405405405
49168_marine,37,54,34,2,91,91.8918918918919,5.405405405405405
49169_marine,37,55,34,2,92,91.8918918918919,5.405405405405405
49170_marine,37,57,34,2,94,91.8918918918919,5.405405405405405
49171_marine,37,58,34,2,95,91.8918918918919,5.405405405405405
49172_marine,37,60,34,2,97,91.8918918918919,5.405405405405405
49173_marine,37,61,34,2,98,91.8918918918919,5.405405405405405
49174_marine,37,61,34,2,98,91.8918918918919,5.405405405405405
49175_marine,37,61,34,2,98,91.8918918918919,5.405405405405405
49176_marine,39,64,36,4,103,92.3076923076923,10.256410256410255
49177_marine,42,63,39,5,105,92.85714285714286,11.904761904761903
49178_marine,58,80,52,12,138,89.65517241379311,20.689655172413794
49179_marine,57,80,51,12,137,89.47368421052632,21.052631578947366
49180_marine,42,65,39,5,107,92.85714285714286,11.904761904761903
49181_marine,42,62,39,5,104,92.85714285714286,11.904761904761903
49182_marine,42,68,39,5,110,92.85714285714286,11.904761904761903
49183_marine,42,68,39,5,110,92.85714285714286,11.904761904761903
49184_marine,42,68,39,5,110,92.85714285714286,11.904761904761903
49185_marine,42,64,39,5,106,92.85714285714286,11.904761904761903
49186_marine,41,63,38,5,104,92.6829268292683,12.195121951219512
49187_marine,40,63,37,5,103,92.5,12.5
49188_marine,40,63,37,5,103,92.5,12.5
49189_marine,40,63,37,5,103,92.5,12.5
49190_marine,41,62,37,6,103,90.2439024390244,14.634146341463413
49191_marine,54,80,48,12,134,88.88888888888889,22.22222222222222
49192_marine,55,80,49,12,135,89.0909090909091,21.818181818181817
49193_marine,55,80,49,12,135,89.0909090909091,21.818181818181817
49194_marine,38,61,35,5,99,92.10526315789474,13.157894736842104
49195_marine,38,60,35,5,98,92.10526315789474,13.157894736842104
49196_marine,36,60,33,5,96,91.66666666666666,13.88888888888889
49197_marine,36,60,33,5,96,91.66666666666666,13.88888888888889
49198_marine,36,60,33,5,96,91.66666666666666,13.88888888888889
49199_marine,36,60,33,5,96,91.66666666666666,13.88888888888889
49200_marine,36,60,33,5,96,91.66666666666666,13.88888888888889
49201_marine,36,60,33,5,96,91.66666666666666,13.88888888888889
49202_marine,36,60,33,5,96,91.66666666666666,13.88888888888889
49203_marine,36,62,33,5,98,91.66666666666666,13.88888888888889
49204_marine,36,62,33,5,98,91.66666666666666,13.88888888888889
49205_marine,36,63,33,5,99,91.66666666666666,13.88888888888889
49206_marine,36,65,33,5,101,91.66666666666666,13.88888888888889
49207_marine,36,65,33,5,101,91.66666666666666,13.88888888888889
49208_marine,36,72,33,5,108,91.66666666666666,13.88888888888889
49209_marine,36,71,33,5,107,91.66666666666666,13.88888888888889
49210_marine,36,68,33,5,104,91.66666666666666,13.88888888888889
49211_marine,35,69,32,4,104,91.42857142857143,11.428571428571429
49212_marine,35,67,32,4,102,91.42857142857143,11.428571428571429
49213_marine,37,61,34,4,98,91.8918918918919,10.81081081081081
49214_marine,37,59,34,4,96,91.8918918918919,10.81081081081081
49215_marine,39,59,36,4,98,92.3076923076923,10.256410256410255
49216_marine,39,59,36,4,98,92.3076923076923,10.256410256410255
49217_marine,39,58,36,4,97,92.3076923076923,10.256410256410255
49218_marine,39,57,36,4,96,92.3076923076923,10.256410256410255
49219_marine,39,55,36,4,94,92.3076923076923,10.256410256410255
49220_marine,39,55,36,4,94,92.3076923076923,10.256410256410255
49221_marine,38,54,35,3,92,92.10526315789474,7.894736842105263
49222_marine,38,54,35,3,92,92.10526315789474,7.894736842105263
49223_marine,38,54,35,3,92,92.10526315789474,7.894736842105263
49224_marine,38,52,35,3,90,92.10526315789474,7.894736842105263
49225_marine,38,51,35,3,89,92.10526315789474,7.894736842105263
49226_marine,38,51,35,3,89,92.10526315789474,7.894736842105263
49227_marine,37,51,35,2,88,94.5945945945946,5.405405405405405
49228_marine,36,51,34,1,87,94.44444444444444,2.7777777777777777
49229_marine,37,51,35,1,88,94.5945945945946,2.7027027027027026
49230_marine,37,51,35,1,88,94.5945945945946,2.7027027027027026
49231_marine,37,51,35,1,88,94.5945945945946,2.7027027027027026
49232_marine,38,51,36,1,89,94.73684210526315,2.631578947368421
49233_marine,39,51,36,1,90,92.3076923076923,2.564102564102564
49234_marine,39,52,36,1,91,92.3076923076923,2.564102564102564
49235_marine,39,54,36,1,93,92.3076923076923,2.564102564102564
49236_marine,38,54,36,1,92,94.73684210526315,2.631578947368421
49237_marine,40,54,38,1,94,95,2.5
49238_marine,40,54,38,1,94,95,2.5
49239_marine,40,54,38,1,94,95,2.5
49240_marine,41,56,38,1,97,92.6829268292683,2.4390243902439024
49241_marine,41,54,38,1,95,92.6829268292683,2.4390243902439024
49242_marine,41,54,38,1,95,92.6829268292683,2.4390243902439024
49243_marine,41,54,38,1,95,92.6829268292683,2.4390243902439024
49244_marine,41,53,37,1,94,90.2439024390244,2.4390243902439024
49245_marine,41,53,37,1,94,90.2439024390244,2.4390243902439024
49246_marine,41,53,37,1,94,90.2439024390244,2.4390243902439024
49247_marine,41,53,37,1,94,90.2439024390244,2.4390243902439024
49248_marine,43,53,39,1,96,90.69767441860465,2.3255813953488373
49249_marine,43,55,39,1,98,90.69767441860465,2.3255813953488373
49250_marine,43,55,39,1,98,90.69767441860465,2.3255813953488373
49251_marine,42,55,39,1,97,92.85714285714286,2.380952380952381
49252_marine,42,55,39,1,97,92.85714285714286,2.380952380952381
49253_marine,42,55,39,1,97,92.85714285714286,2.380952380952381
49254_marine,42,55,39,1,97,92.85714285714286,2.380952380952381
49255_marine,42,55,39,1,97,92.85714285714286,2.380952380952381
49256_marine,41,53,39,0,94,95.1219512195122,0
49257_marine,41,53,39,0,94,95.1219512195122,0
49258_marine,42,53,40,0,95,95.23809523809523,0
49259_marine,42,53,40,0,95,95.23809523809523,0
49260_marine,42,53,40,0,95,95.23809523809523,0
49261_marine,42,53,40,0,95,95.23809523809523,0
49262_marine,42,55,40,0,97,95.23809523809523,0
49263_marine,42,55,40,0,97,95.23809523809523,0
49264_marine,42,53,40,0,95,95.23809523809523,0
49265_marine,42,54,40,0,96,95.23809523809523,0
49266_marine,42,54,40,0,96,95.23809523809523,0
49267_marine,42,54,40,0,96,95.23809523809523,0
49268_marine,42,54,40,0,96,95.23809523809523,0
49269_marine,42,54,40,0,96,95.23809523809523,0
49270_marine,42,53,40,0,95,95.23809523809523,0
49271_marine,42,53,40,0,95,95.23809523809523,0
49272_marine,42,53,40,0,95,95.23809523809523,0
49273_marine,42,56,40,0,98,95.23809523809523,0
49274_marine,42,58,40,0,100,95.23809523809523,0
49275_marine,42,58,40,0,100,95.23809523809523,0
49276_marine,45,58,43,0,103,95.55555555555556,0
49277_marine,45,58,43,0,103,95.55555555555556,0
49278_marine,45,60,43,0,105,95.55555555555556,0
49279_marine,45,61,43,0,106,95.55555555555556,0
49280_marine,45,63,43,0,108,95.55555555555556,0
49281_marine,45,65,43,0,110,95.55555555555556,0
49282_marine,45,67,43,0,112,95.55555555555556,0
49283_marine,46,67,44,1,113,95.65217391304348,2.1739130434782608
49284_marine,50,66,47,1,116,94,2
49285_marine,54,66,51,1,120,94.44444444444444,1.8518518518518516
49286_marine,58,67,55,1,125,94.82758620689656,1.7241379310344827
49287_marine,59,67,56,1,126,94.91525423728814,1.694915254237288
49288_marine,59,71,56,1,130,94.91525423728814,1.694915254237288
49289_marine,60,71,57,1,131,95,1.6666666666666667
49290_marine,57,67,54,1,124,94.73684210526315,1.7543859649122806
49291_marine,57,69,54,1,126,94.73684210526315,1.7543859649122806
49292_marine,58,67,54,2,125,93.10344827586206,3.4482758620689653
49293_marine,58,67,54,2,125,93.10344827586206,3.4482758620689653
49294_marine,58,68,54,2,126,93.10344827586206,3.4482758620689653
49295_marine,58,68,54,2,126,93.10344827586206,3.4482758620689653
49296_marine,60,68,56,2,128,93.33333333333333,3.3333333333333335
49297_marine,62,67,56,2,129,90.32258064516128,3.225806451612903
49298_marine,62,68,56,2,130,90.32258064516128,3.225806451612903
49299_marine,61,69,56,2,130,91.80327868852459,3.278688524590164
49300_marine,61,69,56,2,130,91.80327868852459,3.278688524590164
49301_marine,59,69,54,2,128,91.52542372881356,3.389830508474576
49302_marine,62,68,57,2,130,91.93548387096774,3.225806451612903
49303_marine,63,69,57,2,132,90.47619047619048,3.1746031746031744
49304_marine,68,70,62,4,138,91.17647058823529,5.88235294117647
49305_marine,73,82,67,4,155,91.78082191780823,5.47945205479452
49306_marine,119,196,110,12,315,92.43697478991596,10.084033613445378
49311_marine,128,215,114,19,343,89.0625,14.84375
49312_marine,122,215,110,14,337,90.1639344262295,11.475409836065573
49313_marine,91,124,84,2,215,92.3076923076923,2.197802197802198
49314_marine,65,78,61,1,143,93.84615384615384,1.5384615384615385
49315_marine,64,76,60,1,140,93.75,1.5625
49316_marine,62,74,59,1,136,95.16129032258065,1.6129032258064515
49317_marine,60,73,57,1,133,95,1.6666666666666667
49318_marine,59,71,56,0,130,94.91525423728814,0
49319_marine,59,87,55,1,146,93.22033898305084,1.694915254237288
49320_marine,59,82,55,1,141,93.22033898305084,1.694915254237288
49321_marine,59,71,56,2,130,94.91525423728814,3.389830508474576
49322_marine,57,67,54,2,124,94.73684210526315,3.508771929824561
49323_marine,55,59,52,2,114,94.54545454545455,3.6363636363636362
49324_marine,51,58,48,2,109,94.11764705882352,3.9215686274509802
49325_marine,50,58,47,1,108,94,2
49326_marine,47,58,44,1,105,93.61702127659575,2.127659574468085
49327_marine,47,55,44,1,102,93.61702127659575,2.127659574468085
49328_marine,45,55,42,1,100,93.33333333333333,2.2222222222222223
49329_marine,44,53,41,1,97,93.18181818181817,2.272727272727273
49330_marine,42,53,39,1,95,92.85714285714286,2.380952380952381
49331_marine,40,53,37,1,93,92.5,2.5
49332_marine,40,53,37,1,93,92.5,2.5
49333_marine,41,53,38,1,94,92.6829268292683,2.4390243902439024
49334_marine,40,53,38,0,93,95,0
49335_marine,40,54,38,0,94,95,0
49336_marine,39,53,37,0,92,94.87179487179486,0
49337_marine,39,52,37,0,91,94.87179487179486,0
49338_marine,39,52,37,0,91,94.87179487179486,0
49339_marine,39,52,37,0,91,94.87179487179486,0
49340_marine,39,52,37,0,91,94.87179487179486,0
49341_marine,39,51,37,0,90,94.87179487179486,0
49342_marine,38,51,36,0,89,94.73684210526315,0
49343_marine,38,51,36,0,89,94.73684210526315,0
49344_marine,38,51,36,0,89,94.73684210526315,0
49345_marine,38,51,36,0,89,94.73684210526315,0
49346_marine,38,51,36,0,89,94.73684210526315,0
49347_marine,38,51,36,0,89,94.73684210526315,0
49348_marine,38,51,36,0,89,94.73684210526315,0
49349_marine,38,51,36,0,89,94.73684210526315,0
49350_marine,37,51,35,0,88,94.5945945945946,0
49351_marine,37,49,35,0,86,94.5945945945946,0
49352_marine,37,49,35,0,86,94.5945945945946,0
49353_marine,37,49,35,0,86,94.5945945945946,0
49354_marine,35,49,35,0,84,100,0
49355_marine,35,49,35,0,84,100,0
49356_marine,35,50,35,0,85,100,0
49357_marine,35,50,35,0,85,100,0
49358_marine,35,50,35,0,85,100,0
49359_marine,35,50,35,0,85,100,0
49360_marine,35,50,35,0,85,100,0
49361_marine,35,50,35,0,85,100,0
49362_marine,35,50,35,0,85,100,0
49363_marine,35,50,35,0,85,100,0
49364_marine,35,51,35,0,86,100,0
49365_marine,35,51,35,0,86,100,0
49366_marine,35,51,35,0,86,100,0
49367_marine,33,51,33,0,84,100,0
49368_marine,33,51,33,0,84,100,0
49369_marine,33,51,33,0,84,100,0
49370_marine,33,49,33,0,82,100,0
49371_marine,33,49,33,0,82,100,0
49372_marine,33,49,33,0,82,100,0
49373_marine,33,50,33,0,83,100,0
49374_marine,33,50,33,0,83,100,0
49375_marine,33,52,33,0,85,100,0
49376_marine,31,52,31,0,83,100,0
49377_marine,31,52,31,0,83,100,0
49378_marine,31,52,31,0,83,100,0
49379_marine,31,52,31,0,83,100,0
49380_marine,31,52,31,0,83,100,0
49381_marine,31,52,31,0,83,100,0
49382_marine,31,52,31,0,83,100,0
49383_marine,31,52,31,0,83,100,0
49384_marine,31,51,31,0,82,100,0
49385_marine,31,51,31,0,82,100,0
49386_marine,31,51,31,0,82,100,0
49387_marine,31,51,31,0,82,100,0
49388_marine,31,51,31,0,82,100,0
49389_marine,31,51,31,0,82,100,0
49390_marine,31,51,31,0,82,100,0
49391_marine,29,51,29,0,80,100,0
49392_marine,29,51,29,0,80,100,0
49393_marine,29,51,29,0,80,100,0
49394_marine,29,51,29,0,80,100,0
49395_marine,29,51,29,0,80,100,0
49396_marine,31,50,31,0,81,100,0
49397_marine,31,50,31,0,81,100,0
49398_marine,31,50,31,0,81,100,0
49399_marine,31,50,31,0,81,100,0
49400_marine,31,49,31,0,80,100,0
49401_marine,31,49,31,0,80,100,0
49402_marine,29,49,29,0,78,100,0
49403_marine,29,49,29,0,78,100,0
49404_marine,29,49,29,0,78,100,0
49405_marine,29,49,29,0,78,100,0
49406_marine,29,49,29,0,78,100,0
49407_marine,29,49,29,0,78,100,0
49408_marine,29,49,29,0,78,100,0
49409_marine,29,50,29,0,79,100,0
49410_marine,29,50,29,0,79,100,0
49411_marine,29,50,29,0,79,100,0
49412_marine,29,50,29,0,79,100,0
49413_marine,29,50,29,0,79,100,0
49414_marine,30,50,30,0,80,100,0
49415_marine,29,50,29,0,79,100,0
49416_marine,29,50,29,0,79,100,0
49417_marine,28,50,28,0,78,100,0
49418_marine,28,49,28,0,77,100,0
49419_marine,30,49,28,1,79,93.33333333333333,3.3333333333333335
49420_marine,31,50,28,1,81,90.32258064516128,3.225806451612903
49421_marine,32,50,28,2,82,87.5,6.25
49422_marine,34,53,30,2,87,88.23529411764706,5.88235294117647
49423_marine,38,54,34,3,92,89.47368421052632,7.894736842105263
49424_marine,61,96,52,7,157,85.24590163934425,11.475409836065573
49425_marine,106,161,72,48,267,67.9245283018868,45.28301886792453
49426_marine,119,171,76,52,290,63.86554621848739,43.69747899159664
49427_marine,111,163,70,51,274,63.06306306306306,45.94594594594595
49434_marine,156,186,99,77,342,63.46153846153846,49.358974358974365
49435_marine,160,199,102,79,359,63.74999999999999,49.375
49436_marine,68,122,58,10,190,85.29411764705883,14.705882352941178
49437_marine,62,119,54,8,181,87.09677419354838,12.903225806451612
49438_marine,62,116,54,8,178,87.09677419354838,12.903225806451612
49439_marine,60,119,52,8,179,86.66666666666667,13.333333333333334
49440_marine,58,117,50,8,175,86.20689655172413,13.793103448275861
49441_marine,46,75,40,7,121,86.95652173913044,15.217391304347828
49442_marine,47,58,41,7,105,87.2340425531915,14.893617021276595
49443_marine,46,50,42,7,96,91.30434782608695,15.217391304347828
49444_marine,44,50,40,5,94,90.9090909090909,11.363636363636363
49445_marine,44,50,40,5,94,90.9090909090909,11.363636363636363
49446_marine,46,50,42,5,96,91.30434782608695,10.869565217391305
49447_marine,44,50,41,3,94,93.18181818181817,6.8181818181818175
49448_marine,45,51,42,3,96,93.33333333333333,6.666666666666667
49449_marine,43,50,40,3,93,93.02325581395348,6.976744186046512
49450_marine,43,49,40,3,92,93.02325581395348,6.976744186046512
49451_marine,41,50,39,2,91,95.1219512195122,4.878048780487805
49452_marine,40,50,38,1,90,95,2.5
49453_marine,40,50,38,1,90,95,2.5
49454_marine,42,50,39,2,92,92.85714285714286,4.761904761904762
49455_marine,42,50,39,2,92,92.85714285714286,4.761904761904762
49456_marine,42,50,39,2,92,92.85714285714286,4.761904761904762
49457_marine,42,50,39,2,92,92.85714285714286,4.761904761904762
49458_marine,43,50,40,2,93,93.02325581395348,4.651162790697675
49459_marine,42,49,39,2,91,92.85714285714286,4.761904761904762
49460_marine,40,50,39,2,90,97.5,5
49461_marine,40,50,39,2,90,97.5,5
49462_marine,41,50,40,2,91,97.5609756097561,4.878048780487805
49463_marine,41,50,40,2,91,97.5609756097561,4.878048780487805
49464_marine,41,50,40,2,91,97.5609756097561,4.878048780487805
49465_marine,41,50,40,2,91,97.5609756097561,4.878048780487805
49466_marine,41,50,40,2,91,97.5609756097561,4.878048780487805
49467_marine,40,50,39,2,90,97.5,5
49468_marine,40,50,39,2,90,97.5,5
49469_marine,39,49,38,2,88,97.43589743589743,5.128205128205128
49470_marine,39,49,38,2,88,97.43589743589743,5.128205128205128
49471_marine,40,50,39,2,90,97.5,5
49472_marine,40,50,39,2,90,97.5,5
49473_marine,40,50,39,2,90,97.5,5
49474_marine,40,50,39,2,90,97.5,5
49475_marine,40,50,39,2,90,97.5,5
49476_marine,39,50,38,2,89,97.43589743589743,5.128205128205128
49477_marine,39,51,38,2,90,97.43589743589743,5.128205128205128
49478_marine,39,51,38,2,90,97.43589743589743,5.128205128205128
49479_marine,38,51,37,1,89,97.36842105263158,2.631578947368421
49480_marine,38,51,37,1,89,97.36842105263158,2.631578947368421
49481_marine,38,52,37,1,90,97.36842105263158,2.631578947368421
49482_marine,38,52,37,1,90,97.36842105263158,2.631578947368421
49483_marine,38,52,37,1,90,97.36842105263158,2.631578947368421
49484_marine,39,52,38,1,91,97.43589743589743,2.564102564102564
49485_marine,39,53,38,1,92,97.43589743589743,2.564102564102564
49486_marine,38,53,38,0,91,100,0
49487_marine,36,53,36,0,89,100,0
49488_marine,38,54,38,0,92,100,0
49489_marine,36,54,36,0,90,100,0
49490_marine,38,54,38,0,92,100,0
49491_marine,38,54,38,0,92,100,0
49492_marine,38,54,38,0,92,100,0
49493_marine,36,54,36,0,90,100,0
49494_marine,36,54,36,0,90,100,0
49495_marine,36,53,36,0,89,100,0
49496_marine,36,52,36,0,88,100,0
49497_marine,36,52,36,0,88,100,0
49498_marine,35,52,35,0,87,100,0
49499_marine,35,52,35,0,87,100,0
49500_marine,34,53,34,0,87,100,0
49501_marine,34,53,33,1,87,97.05882352941177,2.941176470588235
49502_marine,34,52,33,1,86,97.05882352941177,2.941176470588235
49503_marine,34,52,33,1,86,97.05882352941177,2.941176470588235
49504_marine,34,52,33,1,86,97.05882352941177,2.941176470588235
49505_marine,34,52,33,1,86,97.05882352941177,2.941176470588235
49506_marine,34,52,33,1,86,97.05882352941177,2.941176470588235
49507_marine,35,52,34,1,87,97.14285714285714,2.857142857142857
49508_marine,35,52,34,1,87,97.14285714285714,2.857142857142857
49509_marine,38,52,36,2,90,94.73684210526315,5.263157894736842
49510_marine,38,52,36,2,90,94.73684210526315,5.263157894736842
49511_marine,38,52,36,2,90,94.73684210526315,5.263157894736842
49512_marine,38,52,36,2,90,94.73684210526315,5.263157894736842
49513_marine,36,51,34,2,87,94.44444444444444,5.555555555555555
49514_marine,36,49,34,2,85,94.44444444444444,5.555555555555555
49515_marine,36,49,34,2,85,94.44444444444444,5.555555555555555
49516_marine,36,49,34,2,85,94.44444444444444,5.555555555555555
49517_marine,36,49,34,2,85,94.44444444444444,5.555555555555555
49518_marine,36,50,34,2,86,94.44444444444444,5.555555555555555
49519_marine,36,50,34,2,86,94.44444444444444,5.555555555555555
49520_marine,36,50,34,2,86,94.44444444444444,5.555555555555555
49521_marine,36,50,34,2,86,94.44444444444444,5.555555555555555
49522_marine,36,53,34,2,89,94.44444444444444,5.555555555555555
49523_marine,35,53,33,2,88,94.28571428571428,5.714285714285714
49524_marine,35,54,33,2,89,94.28571428571428,5.714285714285714
49525_marine,34,54,32,2,88,94.11764705882352,5.88235294117647
49526_marine,34,52,32,2,86,94.11764705882352,5.88235294117647
49527_marine,34,54,32,2,88,94.11764705882352,5.88235294117647
49528_marine,36,54,34,2,90,94.44444444444444,5.555555555555555
49529_marine,36,54,34,2,90,94.44444444444444,5.555555555555555
49530_marine,36,57,34,2,93,94.44444444444444,5.555555555555555
49531_marine,36,58,34,2,94,94.44444444444444,5.555555555555555
49532_marine,36,58,34,2,94,94.44444444444444,5.555555555555555
49533_marine,36,60,34,2,96,94.44444444444444,5.555555555555555
49534_marine,37,60,35,3,97,94.5945945945946,8.108108108108109
49535_marine,37,60,35,3,97,94.5945945945946,8.108108108108109
49536_marine,40,61,38,5,101,95,12.5
49537_marine,41,63,39,5,104,95.1219512195122,12.195121951219512
49538_marine,42,66,39,6,108,92.85714285714286,14.285714285714285
49539_marine,42,64,39,6,106,92.85714285714286,14.285714285714285
49540_marine,41,63,39,5,104,95.1219512195122,12.195121951219512
49541_marine,41,61,39,5,102,95.1219512195122,12.195121951219512
49542_marine,41,65,39,5,106,95.1219512195122,12.195121951219512
49543_marine,41,65,39,5,106,95.1219512195122,12.195121951219512
49544_marine,41,67,39,5,108,95.1219512195122,12.195121951219512
49545_marine,39,63,37,5,102,94.87179487179486,12.82051282051282
49546_marine,37,63,35,5,100,94.5945945945946,13.513513513513514
49547_marine,37,63,35,5,100,94.5945945945946,13.513513513513514
49548_marine,37,61,35,5,98,94.5945945945946,13.513513513513514
49549_marine,37,62,35,5,99,94.5945945945946,13.513513513513514
49550_marine,37,62,35,5,99,94.5945945945946,13.513513513513514
49551_marine,37,61,35,5,98,94.5945945945946,13.513513513513514
49552_marine,37,61,35,5,98,94.5945945945946,13.513513513513514
49553_marine,37,61,35,5,98,94.5945945945946,13.513513513513514
49554_marine,35,61,33,5,96,94.28571428571428,14.285714285714285
49555_marine,35,60,33,5,95,94.28571428571428,14.285714285714285
49556_marine,35,60,33,5,95,94.28571428571428,14.285714285714285
49557_marine,35,60,33,5,95,94.28571428571428,14.285714285714285
49558_marine,35,60,33,5,95,94.28571428571428,14.285714285714285
49559_marine,35,60,33,5,95,94.28571428571428,14.285714285714285
49560_marine,35,60,33,5,95,94.28571428571428,14.285714285714285
49561_marine,35,62,33,5,97,94.28571428571428,14.285714285714285
49562_marine,35,62,33,5,97,94.28571428571428,14.285714285714285
49563_marine,35,62,33,5,97,94.28571428571428,14.285714285714285
49564_marine,35,63,33,5,98,94.28571428571428,14.285714285714285
49565_marine,35,63,33,5,98,94.28571428571428,14.285714285714285
49566_marine,35,65,33,5,100,94.28571428571428,14.285714285714285
49567_marine,35,69,33,5,104,94.28571428571428,14.285714285714285
49568_marine,37,76,33,5,113,89.1891891891892,13.513513513513514
49569_marine,37,75,33,5,112,89.1891891891892,13.513513513513514
49570_marine,37,75,33,5,112,89.1891891891892,13.513513513513514
49571_marine,37,75,33,5,112,89.1891891891892,13.513513513513514
49572_marine,37,75,33,5,112,89.1891891891892,13.513513513513514
49573_marine,37,69,33,5,106,89.1891891891892,13.513513513513514
49574_marine,36,61,34,5,97,94.44444444444444,13.88888888888889
49575_marine,35,61,33,4,96,94.28571428571428,11.428571428571429
49576_marine,35,61,33,4,96,94.28571428571428,11.428571428571429
49577_marine,35,59,33,4,94,94.28571428571428,11.428571428571429
49578_marine,35,59,33,4,94,94.28571428571428,11.428571428571429
49579_marine,35,58,33,4,93,94.28571428571428,11.428571428571429
49580_marine,35,56,33,4,91,94.28571428571428,11.428571428571429
49581_marine,38,55,36,4,93,94.73684210526315,10.526315789473683
49582_marine,37,55,35,3,92,94.5945945945946,8.108108108108109
49583_marine,37,53,35,3,90,94.5945945945946,8.108108108108109
49584_marine,37,53,35,3,90,94.5945945945946,8.108108108108109
49585_marine,37,51,35,3,88,94.5945945945946,8.108108108108109
49586_marine,37,51,35,3,88,94.5945945945946,8.108108108108109
49587_marine,36,51,34,2,87,94.44444444444444,5.555555555555555
49588_marine,37,51,35,2,88,94.5945945945946,5.405405405405405
49589_marine,37,51,35,2,88,94.5945945945946,5.405405405405405
49590_marine,37,51,35,2,88,94.5945945945946,5.405405405405405
49591_marine,37,51,35,2,88,94.5945945945946,5.405405405405405
49592_marine,38,51,36,2,89,94.73684210526315,5.263157894736842
49593_marine,38,51,36,2,89,94.73684210526315,5.263157894736842
49594_marine,37,51,36,1,88,97.2972972972973,2.7027027027027026
49595_marine,37,52,36,1,89,97.2972972972973,2.7027027027027026
49596_marine,37,55,36,1,92,97.2972972972973,2.7027027027027026
49597_marine,37,55,36,1,92,97.2972972972973,2.7027027027027026
49598_marine,37,55,36,1,92,97.2972972972973,2.7027027027027026
49599_marine,37,55,36,1,92,97.2972972972973,2.7027027027027026
49600_marine,37,56,36,1,93,97.2972972972973,2.7027027027027026
49601_marine,36,54,35,1,90,97.22222222222221,2.7777777777777777
49602_marine,36,53,35,1,89,97.22222222222221,2.7777777777777777
49603_marine,36,53,35,1,89,97.22222222222221,2.7777777777777777
49604_marine,36,53,35,1,89,97.22222222222221,2.7777777777777777
49605_marine,38,53,37,1,91,97.36842105263158,2.631578947368421
49606_marine,38,53,37,1,91,97.36842105263158,2.631578947368421
49607_marine,38,53,37,1,91,97.36842105263158,2.631578947368421
49608_marine,38,53,37,1,91,97.36842105263158,2.631578947368421
49609_marine,38,55,37,1,93,97.36842105263158,2.631578947368421
49610_marine,38,55,37,1,93,97.36842105263158,2.631578947368421
49611_marine,40,55,39,1,95,97.5,2.5
49612_marine,40,55,39,1,95,97.5,2.5
49613_marine,40,55,39,1,95,97.5,2.5
49614_marine,40,55,39,1,95,97.5,2.5
49615_marine,40,55,39,1,95,97.5,2.5
49616_marine,40,53,39,1,93,97.5,2.5
49617_marine,40,53,39,1,93,97.5,2.5
49618_marine,40,53,39,1,93,97.5,2.5
49619_marine,39,53,39,0,92,100,0
49620_marine,39,53,39,0,92,100,0
49621_marine,40,53,40,0,93,100,0
49622_marine,40,53,40,0,93,100,0
49623_marine,40,53,40,0,93,100,0
49624_marine,40,53,40,0,93,100,0
49625_marine,40,53,40,0,93,100,0
49626_marine,40,54,40,0,94,100,0
49627_marine,40,54,40,0,94,100,0
49628_marine,41,52,40,0,93,97.5609756097561,0
49629_marine,41,52,40,0,93,97.5609756097561,0
49630_marine,41,52,40,0,93,97.5609756097561,0
49631_marine,41,52,40,0,93,97.5609756097561,0
49632_marine,41,52,40,0,93,97.5609756097561,0
49633_marine,41,52,40,0,93,97.5609756097561,0
49634_marine,41,52,40,0,93,97.5609756097561,0
49635_marine,41,54,40,0,95,97.5609756097561,0
49636_marine,41,56,40,0,97,97.5609756097561,0
49637_marine,42,56,41,0,98,97.61904761904762,0
49638_marine,42,58,41,0,100,97.61904761904762,0
49639_marine,42,58,41,0,100,97.61904761904762,0
49640_marine,42,59,41,0,101,97.61904761904762,0
49641_marine,42,63,41,0,105,97.61904761904762,0
49642_marine,42,63,41,0,105,97.61904761904762,0
49643_marine,43,63,42,0,106,97.67441860465115,0
49644_marine,44,63,43,1,107,97.72727272727273,2.272727272727273
49645_marine,45,65,44,1,110,97.77777777777777,2.2222222222222223
49646_marine,45,65,44,1,110,97.77777777777777,2.2222222222222223
49647_marine,46,66,45,1,112,97.82608695652173,2.1739130434782608
49648_marine,46,72,45,1,118,97.82608695652173,2.1739130434782608
49649_marine,46,72,45,1,118,97.82608695652173,2.1739130434782608
49650_marine,46,65,45,1,111,97.82608695652173,2.1739130434782608
49651_marine,46,63,45,1,109,97.82608695652173,2.1739130434782608
49652_marine,49,61,48,1,110,97.95918367346938,2.0408163265306123
49653_marine,49,63,48,1,112,97.95918367346938,2.0408163265306123
49654_marine,49,62,48,1,111,97.95918367346938,2.0408163265306123
49655_marine,49,63,48,1,112,97.95918367346938,2.0408163265306123
49656_marine,50,68,48,2,118,96,4
49657_marine,52,69,50,2,121,96.15384615384616,3.8461538461538463
49658_marine,51,69,50,2,120,98.0392156862745,3.9215686274509802
49659_marine,51,71,50,2,122,98.0392156862745,3.9215686274509802
49660_marine,52,71,50,2,123,96.15384615384616,3.8461538461538463
49661_marine,54,69,50,2,123,92.5925925925926,3.7037037037037033
49662_marine,55,69,50,2,124,90.9090909090909,3.6363636363636362
49663_marine,59,70,54,2,129,91.52542372881356,3.389830508474576
49664_marine,60,68,55,2,128,91.66666666666666,3.3333333333333335
49665_marine,66,75,62,4,141,93.93939393939394,6.0606060606060606
49666_marine,101,188,94,9,289,93.06930693069307,8.91089108910891
49667_marine,121,202,113,13,323,93.38842975206612,10.743801652892563
49670_marine,119,218,110,15,337,92.43697478991596,12.605042016806722
49671_marine,114,211,105,14,325,92.10526315789474,12.280701754385964
49672_marine,91,193,87,5,284,95.6043956043956,5.4945054945054945
49673_marine,66,92,63,4,158,95.45454545454545,6.0606060606060606
49674_marine,65,78,62,4,143,95.38461538461539,6.153846153846154
49675_marine,62,72,60,4,134,96.7741935483871,6.451612903225806
49676_marine,62,75,60,4,137,96.7741935483871,6.451612903225806
49677_marine,60,78,57,4,138,95,6.666666666666667
49678_marine,57,77,54,2,134,94.73684210526315,3.508771929824561
49679_marine,59,82,56,4,141,94.91525423728814,6.779661016949152
49680_marine,73,90,66,14,163,90.41095890410958,19.17808219178082
49681_marine,53,71,50,2,124,94.33962264150944,3.7735849056603774
49682_marine,51,68,48,2,119,94.11764705882352,3.9215686274509802
49683_marine,45,60,42,2,105,93.33333333333333,4.444444444444445
49684_marine,45,60,42,2,105,93.33333333333333,4.444444444444445
49685_marine,45,60,42,2,105,93.33333333333333,4.444444444444445
49686_marine,42,55,39,1,97,92.85714285714286,2.380952380952381
49687_marine,40,55,39,1,95,97.5,2.5
49688_marine,39,54,38,1,93,97.43589743589743,2.564102564102564
49689_marine,39,51,38,1,90,97.43589743589743,2.564102564102564
49690_marine,38,51,37,1,89,97.36842105263158,2.631578947368421
49691_marine,38,53,37,1,91,97.36842105263158,2.631578947368421
49692_marine,38,53,37,1,91,97.36842105263158,2.631578947368421
49693_marine,38,53,37,1,91,97.36842105263158,2.631578947368421
49694_marine,38,53,37,1,91,97.36842105263158,2.631578947368421
49695_marine,39,53,38,1,92,97.43589743589743,2.564102564102564
49696_marine,39,52,38,1,91,97.43589743589743,2.564102564102564
49697_marine,39,52,38,1,91,97.43589743589743,2.564102564102564
49698_marine,39,53,38,1,92,97.43589743589743,2.564102564102564
49699_marine,39,53,38,1,92,97.43589743589743,2.564102564102564
49700_marine,39,53,38,1,92,97.43589743589743,2.564102564102564
49701_marine,39,51,38,1,90,97.43589743589743,2.564102564102564
49702_marine,38,51,37,1,89,97.36842105263158,2.631578947368421
49703_marine,37,51,36,1,88,97.2972972972973,2.7027027027027026
49704_marine,37,51,36,1,88,97.2972972972973,2.7027027027027026
49705_marine,37,51,36,1,88,97.2972972972973,2.7027027027027026
49706_marine,37,51,36,1,88,97.2972972972973,2.7027027027027026
49707_marine,36,51,36,0,87,100,0
49708_marine,36,51,36,0,87,100,0
49709_marine,36,52,36,0,88,100,0
49710_marine,35,52,35,0,87,100,0
49711_marine,35,51,35,0,86,100,0
49712_marine,35,51,35,0,86,100,0
49713_marine,35,51,35,0,86,100,0
49714_marine,35,51,35,0,86,100,0
49715_marine,35,51,35,0,86,100,0
49716_marine,35,51,35,0,86,100,0
49717_marine,35,51,35,0,86,100,0
49718_marine,35,50,35,0,85,100,0
49719_marine,35,50,35,0,85,100,0
49720_marine,35,50,35,0,85,100,0
49721_marine,33,50,33,0,83,100,0
49722_marine,33,50,33,0,83,100,0
49723_marine,33,50,33,0,83,100,0
49724_marine,33,51,33,0,84,100,0
49725_marine,33,52,33,0,85,100,0
49726_marine,33,51,33,0,84,100,0
49727_marine,33,51,33,0,84,100,0
49728_marine,33,51,33,0,84,100,0
49729_marine,33,51,33,0,84,100,0
49730_marine,33,51,33,0,84,100,0
49731_marine,33,51,33,0,84,100,0
49732_marine,31,51,31,0,82,100,0
49733_marine,31,51,31,0,82,100,0
49734_marine,31,51,31,0,82,100,0
49735_marine,31,51,31,0,82,100,0
49736_marine,31,51,31,0,82,100,0
49737_marine,31,51,31,0,82,100,0
49738_marine,29,51,29,0,80,100,0
49739_marine,29,51,29,0,80,100,0
49740_marine,29,51,29,0,80,100,0
49741_marine,29,51,29,0,80,100,0
49742_marine,29,51,29,0,80,100,0
49743_marine,29,51,29,0,80,100,0
49744_marine,29,51,29,0,80,100,0
49745_marine,29,51,29,0,80,100,0
49746_marine,29,51,29,0,80,100,0
49747_marine,29,51,29,0,80,100,0
49748_marine,29,51,29,0,80,100,0
49749_marine,29,52,29,0,81,100,0
49750_marine,29,52,29,0,81,100,0
49751_marine,29,52,29,0,81,100,0
49752_marine,29,51,29,0,80,100,0
49753_marine,29,51,29,0,80,100,0
49754_marine,29,51,29,0,80,100,0
49755_marine,29,50,29,0,79,100,0
49756_marine,27,50,27,0,77,100,0
49757_marine,27,50,27,0,77,100,0
49758_marine,27,50,27,0,77,100,0
49759_marine,27,49,27,0,76,100,0
49760_marine,27,49,27,0,76,100,0
49761_marine,27,49,27,0,76,100,0
49762_marine,27,49,27,0,76,100,0
49763_marine,27,49,27,0,76,100,0
49764_marine,27,49,27,0,76,100,0
49765_marine,27,49,27,0,76,100,0
49766_marine,27,49,27,0,76,100,0
49767_marine,27,49,27,0,76,100,0
49768_marine,27,50,27,0,77,100,0
49769_marine,27,49,27,0,76,100,0
49770_marine,27,49,27,0,76,100,0
49771_marine,26,49,26,0,75,100,0
49772_marine,26,49,26,0,75,100,0
49773_marine,26,49,26,0,75,100,0
49774_marine,27,49,27,0,76,100,0
49775_marine,27,49,27,0,76,100,0
49776_marine,27,49,27,0,76,100,0
49777_marine,26,48,26,0,74,100,0
49778_marine,26,48,26,0,74,100,0
49779_marine,28,48,26,1,76,92.85714285714286,3.571428571428571
49780_marine,29,48,26,1,77,89.65517241379311,3.4482758620689653
49781_marine,29,48,26,1,77,89.65517241379311,3.4482758620689653
49782_marine,29,47,26,1,76,89.65517241379311,3.4482758620689653
49783_marine,35,51,32,2,86,91.42857142857143,5.714285714285714
49784_marine,55,94,47,5,149,85.45454545454545,9.090909090909092
49785_marine,106,163,68,46,269,64.15094339622641,43.39622641509434
49786_marine,116,170,74,51,286,63.793103448275865,43.96551724137931
49787_marine,110,161,66,52,271,60,47.27272727272727
49793_marine,146,182,91,76,328,62.328767123287676,52.054794520547944
49794_marine,148,192,92,78,340,62.16216216216216,52.702702702702695
49795_marine,148,196,92,77,344,62.16216216216216,52.02702702702703
49796_marine,60,123,50,10,183,83.33333333333334,16.666666666666664
49797_marine,59,119,50,9,178,84.7457627118644,15.254237288135593
49798_marine,57,116,48,9,173,84.21052631578947,15.789473684210526
49799_marine,56,116,48,9,172,85.71428571428571,16.071428571428573
49800_marine,55,108,48,8,163,87.27272727272727,14.545454545454545
49801_marine,45,73,38,8,118,84.44444444444444,17.77777777777778
49802_marine,45,70,38,8,115,84.44444444444444,17.77777777777778
49803_marine,48,70,41,8,118,85.41666666666666,16.666666666666664
49804_marine,47,68,42,8,115,89.36170212765957,17.02127659574468
49805_marine,45,66,40,6,111,88.88888888888889,13.333333333333334
49806_marine,45,52,40,6,97,88.88888888888889,13.333333333333334
49807_marine,43,52,39,4,95,90.69767441860465,9.30232558139535
49808_marine,43,53,39,4,96,90.69767441860465,9.30232558139535
49809_marine,43,54,39,4,97,90.69767441860465,9.30232558139535
49810_marine,42,55,39,3,97,92.85714285714286,7.142857142857142
49811_marine,42,55,40,3,97,95.23809523809523,7.142857142857142
49812_marine,42,53,39,3,95,92.85714285714286,7.142857142857142
49813_marine,42,53,39,3,95,92.85714285714286,7.142857142857142
49814_marine,42,52,39,2,94,92.85714285714286,4.761904761904762
49815_marine,42,52,39,2,94,92.85714285714286,4.761904761904762
49816_marine,42,52,39,2,94,92.85714285714286,4.761904761904762
49817_marine,42,51,39,2,93,92.85714285714286,4.761904761904762
49818_marine,40,51,39,2,91,97.5,5
49819_marine,39,50,38,2,89,97.43589743589743,5.128205128205128
49820_marine,39,50,38,2,89,97.43589743589743,5.128205128205128
49821_marine,39,50,38,2,89,97.43589743589743,5.128205128205128
49822_marine,39,50,38,2,89,97.43589743589743,5.128205128205128
49823_marine,39,50,38,2,89,97.43589743589743,5.128205128205128
49824_marine,39,50,38,2,89,97.43589743589743,5.128205128205128
49825_marine,39,50,38,2,89,97.43589743589743,5.128205128205128
49826_marine,39,50,38,2,89,97.43589743589743,5.128205128205128
49827_marine,39,50,38,2,89,97.43589743589743,5.128205128205128
49828_marine,39,50,38,2,89,97.43589743589743,5.128205128205128
49829_marine,39,50,38,2,89,97.43589743589743,5.128205128205128
49830_marine,39,50,38,2,89,97.43589743589743,5.128205128205128
49831_marine,39,50,38,2,89,97.43589743589743,5.128205128205128
49832_marine,39,50,38,2,89,97.43589743589743,5.128205128205128
49833_marine,39,51,38,2,90,97.43589743589743,5.128205128205128
49834_marine,39,51,38,2,90,97.43589743589743,5.128205128205128
49835_marine,39,50,38,2,89,97.43589743589743,5.128205128205128
49836_marine,39,51,38,2,90,97.43589743589743,5.128205128205128
49837_marine,39,52,38,2,91,97.43589743589743,5.128205128205128
49838_marine,39,52,38,2,91,97.43589743589743,5.128205128205128
49839_marine,38,52,37,1,90,97.36842105263158,2.631578947368421
49840_marine,38,52,37,1,90,97.36842105263158,2.631578947368421
49841_marine,36,52,35,1,88,97.22222222222221,2.7777777777777777
49842_marine,36,52,35,1,88,97.22222222222221,2.7777777777777777
49843_marine,36,52,35,1,88,97.22222222222221,2.7777777777777777
49844_marine,36,52,35,1,88,97.22222222222221,2.7777777777777777
49845_marine,37,53,36,1,90,97.2972972972973,2.7027027027027026
49846_marine,37,53,36,1,90,97.2972972972973,2.7027027027027026
49847_marine,37,53,36,1,90,97.2972972972973,2.7027027027027026
49848_marine,37,53,36,1,90,97.2972972972973,2.7027027027027026
49849_marine,37,53,36,1,90,97.2972972972973,2.7027027027027026
49850_marine,36,53,36,0,89,100,0
49851_marine,36,53,36,0,89,100,0
49852_marine,36,53,36,0,89,100,0
49853_marine,36,53,36,0,89,100,0
49854_marine,36,53,36,0,89,100,0
49855_marine,36,53,36,0,89,100,0
49856_marine,35,53,35,0,88,100,0
49857_marine,35,52,35,0,87,100,0
49858_marine,34,53,34,0,87,100,0
49859_marine,35,53,34,1,88,97.14285714285714,2.857142857142857
49860_marine,35,53,34,1,88,97.14285714285714,2.857142857142857
49861_marine,34,53,33,1,87,97.05882352941177,2.941176470588235
49862_marine,34,52,33,1,86,97.05882352941177,2.941176470588235
49863_marine,34,50,33,1,84,97.05882352941177,2.941176470588235
49864_marine,35,50,33,2,85,94.28571428571428,5.714285714285714
49865_marine,35,50,33,2,85,94.28571428571428,5.714285714285714
49866_marine,35,50,33,2,85,94.28571428571428,5.714285714285714
49867_marine,35,50,33,2,85,94.28571428571428,5.714285714285714
49868_marine,37,50,35,2,87,94.5945945945946,5.405405405405405
49869_marine,37,50,35,2,87,94.5945945945946,5.405405405405405
49870_marine,38,50,36,2,88,94.73684210526315,5.263157894736842
49871_marine,36,50,34,2,86,94.44444444444444,5.555555555555555
49872_marine,35,49,33,2,84,94.28571428571428,5.714285714285714
49873_marine,35,49,33,2,84,94.28571428571428,5.714285714285714
49874_marine,35,49,33,2,84,94.28571428571428,5.714285714285714
49875_marine,35,49,33,2,84,94.28571428571428,5.714285714285714
49876_marine,34,49,32,2,83,94.11764705882352,5.88235294117647
49877_marine,34,47,32,2,81,94.11764705882352,5.88235294117647
49878_marine,34,48,32,2,82,94.11764705882352,5.88235294117647
49879_marine,34,48,32,2,82,94.11764705882352,5.88235294117647
49880_marine,34,48,32,2,82,94.11764705882352,5.88235294117647
49881_marine,34,48,32,2,82,94.11764705882352,5.88235294117647
49882_marine,33,50,31,2,83,93.93939393939394,6.0606060606060606
49883_marine,33,51,31,2,84,93.93939393939394,6.0606060606060606
49884_marine,33,52,31,2,85,93.93939393939394,6.0606060606060606
49885_marine,33,52,31,2,85,93.93939393939394,6.0606060606060606
49886_marine,33,52,31,2,85,93.93939393939394,6.0606060606060606
49887_marine,33,50,31,2,83,93.93939393939394,6.0606060606060606
49888_marine,33,51,31,2,84,93.93939393939394,6.0606060606060606
49889_marine,33,52,31,2,85,93.93939393939394,6.0606060606060606
49890_marine,35,52,33,2,87,94.28571428571428,5.714285714285714
49891_marine,35,54,33,2,89,94.28571428571428,5.714285714285714
49892_marine,36,54,34,3,90,94.44444444444444,8.333333333333332
49893_marine,36,57,34,3,93,94.44444444444444,8.333333333333332
49894_marine,36,57,34,3,93,94.44444444444444,8.333333333333332
49895_marine,37,57,35,4,94,94.5945945945946,10.81081081081081
49896_marine,39,59,37,5,98,94.87179487179486,12.82051282051282
49897_marine,39,59,37,5,98,94.87179487179486,12.82051282051282
49898_marine,39,58,37,5,97,94.87179487179486,12.82051282051282
49899_marine,39,59,37,5,98,94.87179487179486,12.82051282051282
49900_marine,39,60,37,5,99,94.87179487179486,12.82051282051282
49901_marine,39,59,37,5,98,94.87179487179486,12.82051282051282
49902_marine,39,59,37,5,98,94.87179487179486,12.82051282051282
49903_marine,37,59,35,5,96,94.5945945945946,13.513513513513514
49904_marine,36,59,34,5,95,94.44444444444444,13.88888888888889
49905_marine,36,61,34,5,97,94.44444444444444,13.88888888888889
49906_marine,36,59,34,5,95,94.44444444444444,13.88888888888889
49907_marine,36,59,34,5,95,94.44444444444444,13.88888888888889
49908_marine,36,59,34,5,95,94.44444444444444,13.88888888888889
49909_marine,36,59,34,5,95,94.44444444444444,13.88888888888889
49910_marine,36,60,34,5,96,94.44444444444444,13.88888888888889
49911_marine,34,59,32,5,93,94.11764705882352,14.705882352941178
49912_marine,34,59,32,5,93,94.11764705882352,14.705882352941178
49913_marine,34,59,32,5,93,94.11764705882352,14.705882352941178
49914_marine,34,59,32,5,93,94.11764705882352,14.705882352941178
49915_marine,34,58,32,5,92,94.11764705882352,14.705882352941178
49916_marine,34,60,32,5,94,94.11764705882352,14.705882352941178
49917_marine,34,61,32,5,95,94.11764705882352,14.705882352941178
49918_marine,34,61,32,5,95,94.11764705882352,14.705882352941178
49919_marine,34,61,32,5,95,94.11764705882352,14.705882352941178
49920_marine,34,60,32,5,94,94.11764705882352,14.705882352941178
49921_marine,34,62,32,5,96,94.11764705882352,14.705882352941178
49922_marine,34,62,32,5,96,94.11764705882352,14.705882352941178
49923_marine,34,63,32,5,97,94.11764705882352,14.705882352941178
49924_marine,34,63,32,5,97,94.11764705882352,14.705882352941178
49925_marine,34,65,32,5,99,94.11764705882352,14.705882352941178
49926_marine,34,67,32,5,101,94.11764705882352,14.705882352941178
49927_marine,34,67,32,5,101,94.11764705882352,14.705882352941178
49928_marine,36,76,32,5,112,88.88888888888889,13.88888888888889
49929_marine,56,95,49,13,151,87.5,23.214285714285715
49930_marine,56,95,49,13,151,87.5,23.214285714285715
49931_marine,37,77,32,6,114,86.48648648648648,16.216216216216218
49932_marine,36,75,32,5,111,88.88888888888889,13.88888888888889
49933_marine,34,65,32,5,99,94.11764705882352,14.705882352941178
49934_marine,34,61,32,5,95,94.11764705882352,14.705882352941178
49935_marine,35,63,33,5,98,94.28571428571428,14.285714285714285
49936_marine,35,61,33,5,96,94.28571428571428,14.285714285714285
49937_marine,35,61,33,5,96,94.28571428571428,14.285714285714285
49938_marine,35,61,33,5,96,94.28571428571428,14.285714285714285
49939_marine,34,61,32,4,95,94.11764705882352,11.76470588235294
49940_marine,34,61,32,4,95,94.11764705882352,11.76470588235294
49941_marine,34,58,32,4,92,94.11764705882352,11.76470588235294
49942_marine,34,58,32,4,92,94.11764705882352,11.76470588235294
49943_marine,34,56,32,4,90,94.11764705882352,11.76470588235294
49944_marine,33,55,31,3,88,93.93939393939394,9.090909090909092
49945_marine,35,53,33,3,88,94.28571428571428,8.571428571428571
49946_marine,35,51,33,3,86,94.28571428571428,8.571428571428571
49947_marine,35,51,33,2,86,94.28571428571428,5.714285714285714
49948_marine,35,51,33,2,86,94.28571428571428,5.714285714285714
49949_marine,35,51,33,2,86,94.28571428571428,5.714285714285714
49950_marine,35,52,33,2,87,94.28571428571428,5.714285714285714
49951_marine,36,52,34,2,88,94.44444444444444,5.555555555555555
49952_marine,36,52,34,2,88,94.44444444444444,5.555555555555555
49953_marine,36,52,34,2,88,94.44444444444444,5.555555555555555
49954_marine,36,52,34,2,88,94.44444444444444,5.555555555555555
49955_marine,36,52,34,2,88,94.44444444444444,5.555555555555555
49956_marine,36,52,34,2,88,94.44444444444444,5.555555555555555
49957_marine,36,54,34,2,90,94.44444444444444,5.555555555555555
49958_marine,36,55,34,2,91,94.44444444444444,5.555555555555555
49959_marine,36,54,34,2,90,94.44444444444444,5.555555555555555
49960_marine,36,53,34,2,89,94.44444444444444,5.555555555555555
49961_marine,36,53,34,2,89,94.44444444444444,5.555555555555555
49962_marine,35,53,34,1,88,97.14285714285714,2.857142857142857
49963_marine,35,53,34,1,88,97.14285714285714,2.857142857142857
49964_marine,35,53,34,1,88,97.14285714285714,2.857142857142857
49965_marine,35,53,34,1,88,97.14285714285714,2.857142857142857
49966_marine,35,53,34,1,88,97.14285714285714,2.857142857142857
49967_marine,35,53,34,1,88,97.14285714285714,2.857142857142857
49968_marine,35,53,34,1,88,97.14285714285714,2.857142857142857
49969_marine,35,53,34,1,88,97.14285714285714,2.857142857142857
49970_marine,35,53,34,1,88,97.14285714285714,2.857142857142857
49971_marine,35,53,34,1,88,97.14285714285714,2.857142857142857
49972_marine,37,53,36,1,90,97.2972972972973,2.7027027027027026
49973_marine,37,53,36,1,90,97.2972972972973,2.7027027027027026
49974_marine,37,53,36,1,90,97.2972972972973,2.7027027027027026
49975_marine,39,53,38,1,92,97.43589743589743,2.564102564102564
49976_marine,39,53,38,1,92,97.43589743589743,2.564102564102564
49977_marine,39,53,38,1,92,97.43589743589743,2.564102564102564
49978_marine,39,53,38,1,92,97.43589743589743,2.564102564102564
49979_marine,39,53,38,1,92,97.43589743589743,2.564102564102564
49980_marine,38,53,38,0,91,100,0
49981_marine,38,53,38,0,91,100,0
49982_marine,38,53,38,0,91,100,0
49983_marine,39,53,39,0,92,100,0
49984_marine,39,53,39,0,92,100,0
49985_marine,39,53,39,0,92,100,0
49986_marine,39,53,39,0,92,100,0
49987_marine,39,54,39,0,93,100,0
49988_marine,39,54,39,0,93,100,0
49989_marine,39,54,39,0,93,100,0
49990_marine,40,54,39,0,94,97.5,0
49991_marine,40,54,39,0,94,97.5,0
49992_marine,40,52,39,0,92,97.5,0
49993_marine,40,52,39,0,92,97.5,0
49994_marine,40,53,39,0,93,97.5,0
49995_marine,40,53,39,0,93,97.5,0
49996_marine,40,53,39,0,93,97.5,0
49997_marine,40,57,39,0,97,97.5,0
49998_marine,40,59,39,0,99,97.5,0
49999_marine,41,58,40,0,99,97.5609756097561,0
50000_marine,41,58,40,0,99,97.5609756097561,0
50001_marine,41,62,40,0,103,97.5609756097561,0
50002_marine,42,62,41,0,104,97.61904761904762,0
50003_marine,42,63,41,0,105,97.61904761904762,0
50004_marine,41,63,40,0,104,97.5609756097561,0
50005_marine,41,63,40,0,104,97.5609756097561,0
50006_marine,44,64,43,1,108,97.72727272727273,2.272727272727273
50007_marine,45,64,44,1,109,97.77777777777777,2.2222222222222223
50008_marine,44,65,43,1,109,97.72727272727273,2.272727272727273
50009_marine,45,65,44,1,110,97.77777777777777,2.2222222222222223
50010_marine,45,63,44,1,108,97.77777777777777,2.2222222222222223
50011_marine,45,63,44,1,108,97.77777777777777,2.2222222222222223
50012_marine,45,63,44,1,108,97.77777777777777,2.2222222222222223
50013_marine,45,61,44,1,106,97.77777777777777,2.2222222222222223
50014_marine,43,61,42,1,104,97.67441860465115,2.3255813953488373
50015_marine,45,61,44,1,106,97.77777777777777,2.2222222222222223
50016_marine,45,61,44,1,106,97.77777777777777,2.2222222222222223
50017_marine,44,63,44,1,107,100,2.272727272727273
50018_marine,44,65,44,1,109,100,2.272727272727273
50019_marine,44,65,44,1,109,100,2.272727272727273
50020_marine,44,67,44,1,111,100,2.272727272727273
50021_marine,44,66,44,1,110,100,2.272727272727273
50022_marine,47,68,47,1,115,100,2.127659574468085
50023_marine,51,68,49,2,119,96.07843137254902,3.9215686274509802
50024_marine,53,78,51,3,131,96.22641509433963,5.660377358490567
50025_marine,58,85,54,3,143,93.10344827586206,5.172413793103448
50026_marine,86,136,80,9,222,93.02325581395348,10.465116279069768
50027_marine,116,213,103,25,329,88.79310344827587,21.551724137931032
50028_marine,100,205,91,14,305,91,14.000000000000002
50029_marine,106,205,97,14,311,91.50943396226415,13.20754716981132
50030_marine,87,188,83,5,275,95.40229885057471,5.747126436781609
50031_marine,66,112,63,4,178,95.45454545454545,6.0606060606060606
50032_marine,66,98,63,4,164,95.45454545454545,6.0606060606060606
50033_marine,63,100,62,4,163,98.4126984126984,6.349206349206349
50034_marine,58,98,58,4,156,100,6.896551724137931
50035_marine,56,94,55,5,150,98.21428571428571,8.928571428571429
50036_marine,55,94,54,4,149,98.18181818181819,7.2727272727272725
50037_marine,53,70,52,4,123,98.11320754716981,7.547169811320755
50038_marine,56,85,55,2,141,98.21428571428571,3.571428571428571
50039_marine,56,86,55,2,142,98.21428571428571,3.571428571428571
50040_marine,54,82,53,2,136,98.14814814814815,3.7037037037037033
50041_marine,43,66,42,2,109,97.67441860465115,4.651162790697675
50042_marine,40,60,39,2,100,97.5,5
50043_marine,42,60,41,2,102,97.61904761904762,4.761904761904762
50044_marine,41,60,40,2,101,97.5609756097561,4.878048780487805
50045_marine,41,58,40,2,99,97.5609756097561,4.878048780487805
50046_marine,39,57,38,1,96,97.43589743589743,2.564102564102564
50047_marine,39,57,38,1,96,97.43589743589743,2.564102564102564
50048_marine,39,56,38,1,95,97.43589743589743,2.564102564102564
50049_marine,39,55,38,1,94,97.43589743589743,2.564102564102564
50050_marine,39,55,38,1,94,97.43589743589743,2.564102564102564
50051_marine,38,53,37,1,91,97.36842105263158,2.631578947368421
50052_marine,38,53,37,1,91,97.36842105263158,2.631578947368421
50053_marine,38,53,37,1,91,97.36842105263158,2.631578947368421
50054_marine,38,53,37,1,91,97.36842105263158,2.631578947368421
50055_marine,38,53,37,1,91,97.36842105263158,2.631578947368421
50056_marine,38,52,37,1,90,97.36842105263158,2.631578947368421
50057_marine,38,52,37,1,90,97.36842105263158,2.631578947368421
50058_marine,38,52,37,1,90,97.36842105263158,2.631578947368421
50059_marine,38,52,37,1,90,97.36842105263158,2.631578947368421
50060_marine,38,52,37,1,90,97.36842105263158,2.631578947368421
50061_marine,39,52,38,1,91,97.43589743589743,2.564102564102564
50062_marine,37,52,36,1,89,97.2972972972973,2.7027027027027026
50063_marine,36,52,35,1,88,97.22222222222221,2.7777777777777777
50064_marine,36,52,35,1,88,97.22222222222221,2.7777777777777777
50065_marine,36,52,35,1,88,97.22222222222221,2.7777777777777777
50066_marine,36,52,35,1,88,97.22222222222221,2.7777777777777777
50067_marine,36,54,35,1,90,97.22222222222221,2.7777777777777777
50068_marine,36,54,35,1,90,97.22222222222221,2.7777777777777777
50069_marine,35,54,34,1,89,97.14285714285714,2.857142857142857
50070_marine,35,54,34,1,89,97.14285714285714,2.857142857142857
50071_marine,35,53,34,1,88,97.14285714285714,2.857142857142857
50072_marine,34,53,33,1,87,97.05882352941177,2.941176470588235
50073_marine,34,53,33,1,87,97.05882352941177,2.941176470588235
50074_marine,32,53,31,1,85,96.875,3.125
50075_marine,32,53,31,1,85,96.875,3.125
50076_marine,31,53,31,0,84,100,0
50077_marine,31,53,31,0,84,100,0
50078_marine,31,52,31,0,83,100,0
50079_marine,31,52,31,0,83,100,0
50080_marine,31,54,31,0,85,100,0
50081_marine,31,55,31,0,86,100,0
50082_marine,31,55,31,0,86,100,0
50083_marine,31,55,31,0,86,100,0
50084_marine,31,56,31,0,87,100,0
50085_marine,29,53,29,0,82,100,0
50086_marine,29,53,29,0,82,100,0
50087_marine,29,53,29,0,82,100,0
50088_marine,29,53,29,0,82,100,0
50089_marine,29,53,29,0,82,100,0
50090_marine,27,53,27,0,80,100,0
50091_marine,27,51,27,0,78,100,0
50092_marine,27,51,27,0,78,100,0
50093_marine,27,51,27,0,78,100,0
50094_marine,27,51,27,0,78,100,0
50095_marine,27,51,27,0,78,100,0
50096_marine,27,51,27,0,78,100,0
50097_marine,27,51,27,0,78,100,0
50098_marine,27,51,27,0,78,100,0
50099_marine,27,51,27,0,78,100,0
50100_marine,27,51,27,0,78,100,0
50101_marine,27,51,27,0,78,100,0
50102_marine,27,51,27,0,78,100,0
50103_marine,27,51,27,0,78,100,0
50104_marine,27,51,27,0,78,100,0
50105_marine,27,51,27,0,78,100,0
50106_marine,27,51,27,0,78,100,0
50107_marine,27,51,27,0,78,100,0
50108_marine,27,51,27,0,78,100,0
50109_marine,27,51,27,0,78,100,0
50110_marine,27,52,27,0,79,100,0
50111_marine,27,52,27,0,79,100,0
50112_marine,27,52,27,0,79,100,0
50113_marine,27,52,27,0,79,100,0
50114_marine,27,51,27,0,78,100,0
50115_marine,27,50,27,0,77,100,0
50116_marine,27,50,27,0,77,100,0
50117_marine,27,50,27,0,77,100,0
50118_marine,27,49,27,0,76,100,0
50119_marine,27,48,27,0,75,100,0
50120_marine,27,48,27,0,75,100,0
50121_marine,27,48,27,0,75,100,0
50122_marine,27,48,27,0,75,100,0
50123_marine,27,48,27,0,75,100,0
50124_marine,27,48,27,0,75,100,0
50125_marine,27,48,27,0,75,100,0
50126_marine,27,48,27,0,75,100,0
50127_marine,26,48,26,0,74,100,0
50128_marine,26,49,26,0,75,100,0
50129_marine,26,49,26,0,75,100,0
50130_marine,26,49,26,0,75,100,0
50131_marine,26,49,26,0,75,100,0
50132_marine,26,49,26,0,75,100,0
50133_marine,26,49,26,0,75,100,0
50134_marine,27,48,27,0,75,100,0
50135_marine,27,47,27,0,74,100,0
50136_marine,27,47,27,0,74,100,0
50137_marine,27,47,27,0,74,100,0
50138_marine,27,47,26,1,74,96.29629629629629,3.7037037037037033
50139_marine,28,47,26,1,75,92.85714285714286,3.571428571428571
50140_marine,29,47,26,1,76,89.65517241379311,3.4482758620689653
50141_marine,29,47,26,1,76,89.65517241379311,3.4482758620689653
50142_marine,29,47,26,1,76,89.65517241379311,3.4482758620689653
50143_marine,34,48,32,2,82,94.11764705882352,5.88235294117647
50144_marine,54,94,47,6,148,87.03703703703704,11.11111111111111
50145_marine,105,157,67,47,262,63.8095238095238,44.761904761904766
50146_marine,117,173,72,53,290,61.53846153846154,45.2991452991453
50147_marine,105,131,62,49,236,59.04761904761905,46.666666666666664
50152_marine,135,162,80,72,297,59.25925925925925,53.333333333333336
50153_marine,148,185,93,79,333,62.83783783783784,53.37837837837838
50154_marine,64,121,53,12,185,82.8125,18.75
50155_marine,61,119,52,11,180,85.24590163934425,18.0327868852459
50156_marine,59,115,51,9,174,86.4406779661017,15.254237288135593
50157_marine,56,111,48,9,167,85.71428571428571,16.071428571428573
50158_marine,57,110,48,10,167,84.21052631578947,17.543859649122805
50159_marine,57,100,48,10,157,84.21052631578947,17.543859649122805
50160_marine,55,97,48,8,152,87.27272727272727,14.545454545454545
50161_marine,54,97,46,9,151,85.18518518518519,16.666666666666664
50162_marine,52,95,44,9,147,84.61538461538461,17.307692307692307
50163_marine,53,72,45,9,125,84.90566037735849,16.9811320754717
50164_marine,49,71,43,9,120,87.75510204081633,18.367346938775512
50165_marine,45,67,39,7,112,86.66666666666667,15.555555555555555
50166_marine,43,63,37,7,106,86.04651162790698,16.27906976744186
50167_marine,42,53,36,6,95,85.71428571428571,14.285714285714285
50168_marine,43,53,38,5,96,88.37209302325581,11.627906976744185
50169_marine,43,54,38,5,97,88.37209302325581,11.627906976744185
50170_marine,43,55,38,5,98,88.37209302325581,11.627906976744185
50171_marine,43,55,38,5,98,88.37209302325581,11.627906976744185
50172_marine,42,55,38,5,97,90.47619047619048,11.904761904761903
50173_marine,41,55,37,4,96,90.2439024390244,9.75609756097561
50174_marine,42,55,38,4,97,90.47619047619048,9.523809523809524
50175_marine,43,52,39,4,95,90.69767441860465,9.30232558139535
50176_marine,44,52,40,4,96,90.9090909090909,9.090909090909092
50177_marine,41,52,40,3,93,97.5609756097561,7.317073170731707
50178_marine,39,51,38,2,90,97.43589743589743,5.128205128205128
50179_marine,39,51,38,2,90,97.43589743589743,5.128205128205128
50180_marine,39,51,38,2,90,97.43589743589743,5.128205128205128
50181_marine,39,51,38,2,90,97.43589743589743,5.128205128205128
50182_marine,39,51,38,2,90,97.43589743589743,5.128205128205128
50183_marine,39,50,38,2,89,97.43589743589743,5.128205128205128
50184_marine,39,50,38,2,89,97.43589743589743,5.128205128205128
50185_marine,39,50,38,2,89,97.43589743589743,5.128205128205128
50186_marine,40,50,39,3,90,97.5,7.5
50187_marine,39,50,38,2,89,97.43589743589743,5.128205128205128
50188_marine,38,50,37,2,88,97.36842105263158,5.263157894736842
50189_marine,38,50,37,2,88,97.36842105263158,5.263157894736842
50190_marine,38,50,37,2,88,97.36842105263158,5.263157894736842
50191_marine,38,50,37,2,88,97.36842105263158,5.263157894736842
50192_marine,39,50,38,2,89,97.43589743589743,5.128205128205128
50193_marine,39,50,38,2,89,97.43589743589743,5.128205128205128
50194_marine,37,50,36,2,87,97.2972972972973,5.405405405405405
50195_marine,37,50,36,2,87,97.2972972972973,5.405405405405405
50196_marine,37,51,36,2,88,97.2972972972973,5.405405405405405
50197_marine,37,52,36,2,89,97.2972972972973,5.405405405405405
50198_marine,37,52,36,2,89,97.2972972972973,5.405405405405405
50199_marine,37,52,36,2,89,97.2972972972973,5.405405405405405
50200_marine,36,52,35,1,88,97.22222222222221,2.7777777777777777
50201_marine,36,52,35,1,88,97.22222222222221,2.7777777777777777
50202_marine,37,52,35,2,89,94.5945945945946,5.405405405405405
50203_marine,37,52,35,2,89,94.5945945945946,5.405405405405405
50204_marine,37,51,35,2,88,94.5945945945946,5.405405405405405
50205_marine,38,51,36,2,89,94.73684210526315,5.263157894736842
50206_marine,38,52,36,2,90,94.73684210526315,5.263157894736842
50207_marine,38,53,36,2,91,94.73684210526315,5.263157894736842
50208_marine,38,53,36,2,91,94.73684210526315,5.263157894736842
50209_marine,38,53,36,2,91,94.73684210526315,5.263157894736842
50210_marine,38,51,36,2,89,94.73684210526315,5.263157894736842
50211_marine,38,51,36,2,89,94.73684210526315,5.263157894736842
50212_marine,37,51,36,1,88,97.2972972972973,2.7027027027027026
50213_marine,37,51,36,1,88,97.2972972972973,2.7027027027027026
50214_marine,37,51,36,1,88,97.2972972972973,2.7027027027027026
50215_marine,36,52,35,1,88,97.22222222222221,2.7777777777777777
50216_marine,35,52,34,1,87,97.14285714285714,2.857142857142857
50217_marine,36,52,34,2,88,94.44444444444444,5.555555555555555
50218_marine,37,52,34,3,89,91.8918918918919,8.108108108108109
50219_marine,37,51,34,3,88,91.8918918918919,8.108108108108109
50220_marine,37,51,34,3,88,91.8918918918919,8.108108108108109
50221_marine,37,50,34,3,87,91.8918918918919,8.108108108108109
50222_marine,36,50,33,3,86,91.66666666666666,8.333333333333332
50223_marine,36,50,33,3,86,91.66666666666666,8.333333333333332
50224_marine,36,50,33,3,86,91.66666666666666,8.333333333333332
50225_marine,36,50,33,3,86,91.66666666666666,8.333333333333332
50226_marine,38,50,35,3,88,92.10526315789474,7.894736842105263
50227_marine,38,49,35,3,87,92.10526315789474,7.894736842105263
50228_marine,37,49,34,3,86,91.8918918918919,8.108108108108109
50229_marine,37,49,34,3,86,91.8918918918919,8.108108108108109
50230_marine,35,49,32,3,84,91.42857142857143,8.571428571428571
50231_marine,35,49,32,3,84,91.42857142857143,8.571428571428571
50232_marine,35,47,32,3,82,91.42857142857143,8.571428571428571
50233_marine,35,47,32,3,82,91.42857142857143,8.571428571428571
50234_marine,35,47,32,3,82,91.42857142857143,8.571428571428571
50235_marine,35,47,32,3,82,91.42857142857143,8.571428571428571
50236_marine,35,47,32,3,82,91.42857142857143,8.571428571428571
50237_marine,35,47,32,3,82,91.42857142857143,8.571428571428571
50238_marine,35,47,32,3,82,91.42857142857143,8.571428571428571
50239_marine,35,48,32,3,83,91.42857142857143,8.571428571428571
50240_marine,34,48,31,3,82,91.17647058823529,8.823529411764707
50241_marine,34,48,31,3,82,91.17647058823529,8.823529411764707
50242_marine,34,50,31,3,84,91.17647058823529,8.823529411764707
50243_marine,34,50,31,3,84,91.17647058823529,8.823529411764707
50244_marine,34,51,31,3,85,91.17647058823529,8.823529411764707
50245_marine,34,52,31,3,86,91.17647058823529,8.823529411764707
50246_marine,34,54,31,3,88,91.17647058823529,8.823529411764707
50247_marine,34,51,31,3,85,91.17647058823529,8.823529411764707
50248_marine,33,51,31,2,84,93.93939393939394,6.0606060606060606
50249_marine,33,52,31,2,85,93.93939393939394,6.0606060606060606
50250_marine,34,52,32,3,86,94.11764705882352,8.823529411764707
50251_marine,34,53,32,3,87,94.11764705882352,8.823529411764707
50252_marine,34,53,32,3,87,94.11764705882352,8.823529411764707
50253_marine,35,54,33,4,89,94.28571428571428,11.428571428571429
50254_marine,35,54,33,4,89,94.28571428571428,11.428571428571429
50255_marine,35,54,33,4,89,94.28571428571428,11.428571428571429
50256_marine,36,55,34,4,91,94.44444444444444,11.11111111111111
50257_marine,37,55,35,5,92,94.5945945945946,13.513513513513514
50258_marine,37,55,35,5,92,94.5945945945946,13.513513513513514
50259_marine,35,55,33,5,90,94.28571428571428,14.285714285714285
50260_marine,35,54,33,5,89,94.28571428571428,14.285714285714285
50261_marine,35,53,33,5,88,94.28571428571428,14.285714285714285
50262_marine,35,53,33,5,88,94.28571428571428,14.285714285714285
50263_marine,34,55,32,5,89,94.11764705882352,14.705882352941178
50264_marine,34,56,32,5,90,94.11764705882352,14.705882352941178
50265_marine,34,56,32,5,90,94.11764705882352,14.705882352941178
50266_marine,34,56,32,5,90,94.11764705882352,14.705882352941178
50267_marine,32,56,30,5,88,93.75,15.625
50268_marine,32,56,30,5,88,93.75,15.625
50269_marine,32,56,30,5,88,93.75,15.625
50270_marine,32,56,30,5,88,93.75,15.625
50271_marine,32,56,30,5,88,93.75,15.625
50272_marine,32,56,30,5,88,93.75,15.625
50273_marine,32,56,30,5,88,93.75,15.625
50274_marine,32,56,30,5,88,93.75,15.625
50275_marine,32,57,30,5,89,93.75,15.625
50276_marine,32,57,30,5,89,93.75,15.625
50277_marine,34,57,32,5,91,94.11764705882352,14.705882352941178
50278_marine,34,57,32,5,91,94.11764705882352,14.705882352941178
50279_marine,34,57,32,5,91,94.11764705882352,14.705882352941178
50280_marine,34,59,32,5,93,94.11764705882352,14.705882352941178
50281_marine,34,61,32,5,95,94.11764705882352,14.705882352941178
50282_marine,34,61,32,5,95,94.11764705882352,14.705882352941178
50283_marine,34,62,32,5,96,94.11764705882352,14.705882352941178
50284_marine,34,65,32,5,99,94.11764705882352,14.705882352941178
50285_marine,34,67,32,5,101,94.11764705882352,14.705882352941178
50286_marine,34,66,32,5,100,94.11764705882352,14.705882352941178
50287_marine,34,72,32,5,106,94.11764705882352,14.705882352941178
50288_marine,36,75,32,5,111,88.88888888888889,13.88888888888889
50289_marine,56,94,49,13,150,87.5,23.214285714285715
50290_marine,54,94,49,13,148,90.74074074074075,24.074074074074073
50291_marine,56,96,49,13,152,87.5,23.214285714285715
50292_marine,36,75,32,5,111,88.88888888888889,13.88888888888889
50293_marine,34,65,32,5,99,94.11764705882352,14.705882352941178
50294_marine,34,63,32,5,97,94.11764705882352,14.705882352941178
50295_marine,36,66,32,5,102,88.88888888888889,13.88888888888889
50296_marine,34,62,32,5,96,94.11764705882352,14.705882352941178
50297_marine,35,60,33,5,95,94.28571428571428,14.285714285714285
50298_marine,35,60,33,5,95,94.28571428571428,14.285714285714285
50299_marine,35,60,33,5,95,94.28571428571428,14.285714285714285
50300_marine,35,61,33,5,96,94.28571428571428,14.285714285714285
50301_marine,35,61,33,5,96,94.28571428571428,14.285714285714285
50302_marine,35,58,33,5,93,94.28571428571428,14.285714285714285
50303_marine,34,57,32,4,91,94.11764705882352,11.76470588235294
50304_marine,34,56,32,4,90,94.11764705882352,11.76470588235294
50305_marine,34,54,32,4,88,94.11764705882352,11.76470588235294
50306_marine,35,53,33,4,88,94.28571428571428,11.428571428571429
50307_marine,33,53,31,2,86,93.93939393939394,6.0606060606060606
50308_marine,33,53,31,2,86,93.93939393939394,6.0606060606060606
50309_marine,33,53,31,2,86,93.93939393939394,6.0606060606060606
50310_marine,35,53,33,2,88,94.28571428571428,5.714285714285714
50311_marine,36,53,34,2,89,94.44444444444444,5.555555555555555
50312_marine,36,53,34,2,89,94.44444444444444,5.555555555555555
50313_marine,36,53,34,2,89,94.44444444444444,5.555555555555555
50314_marine,36,53,34,2,89,94.44444444444444,5.555555555555555
50315_marine,36,53,34,2,89,94.44444444444444,5.555555555555555
50316_marine,36,51,34,2,87,94.44444444444444,5.555555555555555
50317_marine,36,50,34,2,86,94.44444444444444,5.555555555555555
50318_marine,36,50,34,2,86,94.44444444444444,5.555555555555555
50319_marine,36,50,34,2,86,94.44444444444444,5.555555555555555
50320_marine,36,52,34,2,88,94.44444444444444,5.555555555555555
50321_marine,36,52,34,2,88,94.44444444444444,5.555555555555555
50322_marine,36,52,34,2,88,94.44444444444444,5.555555555555555
50323_marine,36,52,34,2,88,94.44444444444444,5.555555555555555
50324_marine,36,52,34,2,88,94.44444444444444,5.555555555555555
50325_marine,36,52,34,2,88,94.44444444444444,5.555555555555555
50326_marine,36,53,34,2,89,94.44444444444444,5.555555555555555
50327_marine,36,53,34,2,89,94.44444444444444,5.555555555555555
50328_marine,36,53,34,2,89,94.44444444444444,5.555555555555555
50329_marine,36,53,34,2,89,94.44444444444444,5.555555555555555
50330_marine,35,53,34,1,88,97.14285714285714,2.857142857142857
50331_marine,35,53,34,1,88,97.14285714285714,2.857142857142857
50332_marine,35,53,34,1,88,97.14285714285714,2.857142857142857
50333_marine,35,53,34,1,88,97.14285714285714,2.857142857142857
50334_marine,35,53,34,1,88,97.14285714285714,2.857142857142857
50335_marine,35,53,34,1,88,97.14285714285714,2.857142857142857
50336_marine,35,53,34,1,88,97.14285714285714,2.857142857142857
50337_marine,35,53,34,1,88,97.14285714285714,2.857142857142857
50338_marine,35,53,34,1,88,97.14285714285714,2.857142857142857
50339_marine,39,53,38,1,92,97.43589743589743,2.564102564102564
50340_marine,39,53,38,1,92,97.43589743589743,2.564102564102564
50341_marine,38,53,38,0,91,100,0
50342_marine,38,53,38,0,91,100,0
50343_marine,38,53,38,0,91,100,0
50344_marine,38,53,38,0,91,100,0
50345_marine,39,53,39,0,92,100,0
50346_marine,39,53,39,0,92,100,0
50347_marine,39,53,39,0,92,100,0
50348_marine,39,54,39,0,93,100,0
50349_marine,39,54,39,0,93,100,0
50350_marine,39,54,39,0,93,100,0
50351_marine,37,54,37,0,91,100,0
50352_marine,38,54,37,0,92,97.36842105263158,0
50353_marine,38,54,37,0,92,97.36842105263158,0
50354_marine,38,54,37,0,92,97.36842105263158,0
50355_marine,40,55,39,0,95,97.5,0
50356_marine,40,55,39,0,95,97.5,0
50357_marine,40,53,39,0,93,97.5,0
50358_marine,40,55,39,0,95,97.5,0
50359_marine,40,59,39,0,99,97.5,0
50360_marine,42,59,41,0,101,97.61904761904762,0
50361_marine,42,61,41,0,103,97.61904761904762,0
50362_marine,42,62,41,0,104,97.61904761904762,0
50363_marine,41,62,40,0,103,97.5609756097561,0
50364_marine,41,63,40,0,104,97.5609756097561,0
50365_marine,41,62,40,0,103,97.5609756097561,0
50366_marine,41,64,40,0,105,97.5609756097561,0
50367_marine,39,62,38,0,101,97.43589743589743,0
50368_marine,40,62,39,0,102,97.5,0
50369_marine,39,63,38,0,102,97.43589743589743,0
50370_marine,39,63,38,0,102,97.43589743589743,0
50371_marine,42,63,41,0,105,97.61904761904762,0
50372_marine,42,63,41,0,105,97.61904761904762,0
50373_marine,43,61,42,1,104,97.67441860465115,2.3255813953488373
50374_marine,43,61,42,1,104,97.67441860465115,2.3255813953488373
50375_marine,41,60,40,1,101,97.5609756097561,2.4390243902439024
50376_marine,40,61,40,1,101,100,2.5
50377_marine,40,62,40,1,102,100,2.5
50378_marine,40,62,40,1,102,100,2.5
50379_marine,40,62,40,1,102,100,2.5
50380_marine,40,63,40,1,103,100,2.5
50381_marine,42,65,42,1,107,100,2.380952380952381
50382_marine,44,65,44,2,109,100,4.545454545454546
50383_marine,44,69,43,2,113,97.72727272727273,4.545454545454546
50384_marine,49,79,48,2,128,97.95918367346938,4.081632653061225
50385_marine,52,84,51,2,136,98.07692307692307,3.8461538461538463
50386_marine,66,121,63,4,187,95.45454545454545,6.0606060606060606
50387_marine,75,137,71,7,212,94.66666666666667,9.333333333333334
50388_marine,76,139,72,7,215,94.73684210526315,9.210526315789473
50389_marine,64,107,62,5,171,96.875,7.8125
50390_marine,62,102,60,5,164,96.7741935483871,8.064516129032258
50391_marine,56,99,55,4,155,98.21428571428571,7.142857142857142
50392_marine,53,98,52,5,151,98.11320754716981,9.433962264150944
50393_marine,53,96,52,5,149,98.11320754716981,9.433962264150944
50394_marine,48,90,47,4,138,97.91666666666666,8.333333333333332
50395_marine,48,88,47,4,136,97.91666666666666,8.333333333333332
50396_marine,48,87,47,4,135,97.91666666666666,8.333333333333332
50397_marine,47,72,46,4,119,97.87234042553192,8.51063829787234
50398_marine,45,83,44,2,128,97.77777777777777,4.444444444444445
50399_marine,65,100,59,15,165,90.76923076923077,23.076923076923077
50400_marine,45,80,44,2,125,97.77777777777777,4.444444444444445
50401_marine,40,60,39,2,100,97.5,5
50402_marine,40,59,39,2,99,97.5,5
50403_marine,39,59,38,2,98,97.43589743589743,5.128205128205128
50404_marine,38,57,37,2,95,97.36842105263158,5.263157894736842
50405_marine,38,57,37,2,95,97.36842105263158,5.263157894736842
50406_marine,37,56,36,1,93,97.2972972972973,2.7027027027027026
50407_marine,37,56,36,1,93,97.2972972972973,2.7027027027027026
50408_marine,39,54,38,1,93,97.43589743589743,2.564102564102564
50409_marine,37,54,36,1,91,97.2972972972973,2.7027027027027026
50410_marine,37,54,36,1,91,97.2972972972973,2.7027027027027026
50411_marine,37,55,36,1,92,97.2972972972973,2.7027027027027026
50412_marine,37,55,36,1,92,97.2972972972973,2.7027027027027026
50413_marine,36,55,35,1,91,97.22222222222221,2.7777777777777777
50414_marine,36,55,35,1,91,97.22222222222221,2.7777777777777777
50415_marine,36,55,35,1,91,97.22222222222221,2.7777777777777777
50416_marine,36,52,35,1,88,97.22222222222221,2.7777777777777777
50417_marine,36,52,35,1,88,97.22222222222221,2.7777777777777777
50418_marine,36,52,35,1,88,97.22222222222221,2.7777777777777777
50419_marine,36,52,35,1,88,97.22222222222221,2.7777777777777777
50420_marine,36,52,35,1,88,97.22222222222221,2.7777777777777777
50421_marine,36,51,35,1,87,97.22222222222221,2.7777777777777777
50422_marine,36,51,35,1,87,97.22222222222221,2.7777777777777777
50423_marine,35,51,34,1,86,97.14285714285714,2.857142857142857
50424_marine,35,52,34,1,87,97.14285714285714,2.857142857142857
50425_marine,35,52,34,1,87,97.14285714285714,2.857142857142857
50426_marine,35,52,34,1,87,97.14285714285714,2.857142857142857
50427_marine,33,52,32,1,85,96.96969696969697,3.0303030303030303
50428_marine,33,52,32,1,85,96.96969696969697,3.0303030303030303
50429_marine,32,51,31,1,83,96.875,3.125
50430_marine,32,53,31,1,85,96.875,3.125
50431_marine,33,52,32,1,85,96.96969696969697,3.0303030303030303
50432_marine,33,52,32,1,85,96.96969696969697,3.0303030303030303
50433_marine,33,52,32,1,85,96.96969696969697,3.0303030303030303
50434_marine,33,52,32,1,85,96.96969696969697,3.0303030303030303
50435_marine,32,52,31,1,84,96.875,3.125
50436_marine,32,52,31,1,84,96.875,3.125
50437_marine,30,53,29,1,83,96.66666666666667,3.3333333333333335
50438_marine,30,53,29,1,83,96.66666666666667,3.3333333333333335
50439_marine,30,53,29,1,83,96.66666666666667,3.3333333333333335
50440_marine,30,53,29,1,83,96.66666666666667,3.3333333333333335
50441_marine,30,51,29,1,81,96.66666666666667,3.3333333333333335
50442_marine,28,51,27,1,79,96.42857142857143,3.571428571428571
50443_marine,28,51,27,1,79,96.42857142857143,3.571428571428571
50444_marine,28,52,27,1,80,96.42857142857143,3.571428571428571
50445_marine,28,52,27,1,80,96.42857142857143,3.571428571428571
50446_marine,27,52,27,0,79,100,0
50447_marine,27,52,27,0,79,100,0
50448_marine,27,52,27,0,79,100,0
50449_marine,27,52,27,0,79,100,0
50450_marine,27,52,27,0,79,100,0
50451_marine,27,54,27,0,81,100,0
50452_marine,27,53,27,0,80,100,0
50453_marine,27,53,27,0,80,100,0
50454_marine,27,53,27,0,80,100,0
50455_marine,27,53,27,0,80,100,0
50456_marine,27,53,27,0,80,100,0
50457_marine,27,53,27,0,80,100,0
50458_marine,27,53,27,0,80,100,0
50459_marine,27,53,27,0,80,100,0
50460_marine,27,53,27,0,80,100,0
50461_marine,27,53,27,0,80,100,0
50462_marine,27,53,27,0,80,100,0
50463_marine,27,53,27,0,80,100,0
50464_marine,27,53,27,0,80,100,0
50465_marine,27,53,27,0,80,100,0
50466_marine,27,53,27,0,80,100,0
50467_marine,27,53,27,0,80,100,0
50468_marine,27,53,27,0,80,100,0
50469_marine,27,53,27,0,80,100,0
50470_marine,27,53,27,0,80,100,0
50471_marine,27,52,27,0,79,100,0
50472_marine,27,52,27,0,79,100,0
50473_marine,27,52,27,0,79,100,0
50474_marine,27,52,27,0,79,100,0
50475_marine,27,52,27,0,79,100,0
50476_marine,27,52,27,0,79,100,0
50477_marine,27,49,27,0,76,100,0
50478_marine,27,48,27,0,75,100,0
50479_marine,27,48,27,0,75,100,0
50480_marine,27,48,27,0,75,100,0
50481_marine,27,48,27,0,75,100,0
50482_marine,27,48,27,0,75,100,0
50483_marine,27,48,27,0,75,100,0
50484_marine,27,48,27,0,75,100,0
50485_marine,26,47,26,0,73,100,0
50486_marine,26,47,26,0,73,100,0
50487_marine,26,48,26,0,74,100,0
50488_marine,26,48,26,0,74,100,0
50489_marine,26,47,26,0,73,100,0
50490_marine,26,47,26,0,73,100,0
50491_marine,26,47,26,0,73,100,0
50492_marine,26,47,26,0,73,100,0
50493_marine,26,46,26,0,72,100,0
50494_marine,27,46,27,0,73,100,0
50495_marine,27,46,27,0,73,100,0
50496_marine,27,46,27,0,73,100,0
50497_marine,28,46,27,1,74,96.42857142857143,3.571428571428571
50498_marine,28,46,27,1,74,96.42857142857143,3.571428571428571
50499_marine,27,46,26,1,73,96.29629629629629,3.7037037037037033
50500_marine,29,47,26,1,76,89.65517241379311,3.4482758620689653
50501_marine,29,47,26,1,76,89.65517241379311,3.4482758620689653
50502_marine,29,48,26,1,77,89.65517241379311,3.4482758620689653
50503_marine,34,51,32,2,85,94.11764705882352,5.88235294117647
50504_marine,52,108,47,6,160,90.38461538461539,11.538461538461538
50505_marine,103,155,64,47,258,62.13592233009708,45.63106796116505
50506_marine,115,165,70,53,280,60.86956521739131,46.08695652173913
50507_marine,114,150,68,53,264,59.64912280701754,46.49122807017544
50511_marine,144,183,85,75,327,59.02777777777778,52.083333333333336
50512_marine,148,193,90,76,341,60.810810810810814,51.35135135135135
50513_marine,144,176,90,75,320,62.5,52.083333333333336
50514_marine,60,119,50,10,179,83.33333333333334,16.666666666666664
50515_marine,59,116,50,9,175,84.7457627118644,15.254237288135593
50516_marine,58,111,49,8,169,84.48275862068965,13.793103448275861
50517_marine,58,107,49,8,165,84.48275862068965,13.793103448275861
50518_marine,57,102,48,9,159,84.21052631578947,15.789473684210526
50519_marine,60,107,51,10,167,85,16.666666666666664
50520_marine,60,99,50,11,159,83.33333333333334,18.333333333333332
50521_marine,58,101,48,11,159,82.75862068965517,18.96551724137931
50522_marine,58,103,48,11,161,82.75862068965517,18.96551724137931
50523_marine,57,104,47,10,161,82.45614035087719,17.543859649122805
50524_marine,54,95,47,8,149,87.03703703703704,14.814814814814813
50525_marine,43,67,37,7,110,86.04651162790698,16.27906976744186
50526_marine,43,57,37,7,100,86.04651162790698,16.27906976744186
50527_marine,42,53,36,6,95,85.71428571428571,14.285714285714285
50528_marine,42,54,36,6,96,85.71428571428571,14.285714285714285
50529_marine,42,54,36,6,96,85.71428571428571,14.285714285714285
50530_marine,44,54,38,6,98,86.36363636363636,13.636363636363635
50531_marine,44,55,38,6,99,86.36363636363636,13.636363636363635
50532_marine,42,55,38,5,97,90.47619047619048,11.904761904761903
50533_marine,40,54,36,5,94,90,12.5
50534_marine,43,54,39,5,97,90.69767441860465,11.627906976744185
50535_marine,41,54,39,4,95,95.1219512195122,9.75609756097561
50536_marine,41,53,39,4,94,95.1219512195122,9.75609756097561
50537_marine,40,53,38,4,93,95,10
50538_marine,40,53,38,4,93,95,10
50539_marine,40,53,38,4,93,95,10
50540_marine,41,53,39,5,94,95.1219512195122,12.195121951219512
50541_marine,40,53,39,4,93,97.5,10
50542_marine,40,53,39,4,93,97.5,10
50543_marine,40,52,39,4,92,97.5,10
50544_marine,40,51,39,4,91,97.5,10
50545_marine,40,50,39,4,90,97.5,10
50546_marine,39,50,38,3,89,97.43589743589743,7.6923076923076925
50547_marine,37,50,36,3,87,97.2972972972973,8.108108108108109
50548_marine,37,50,36,3,87,97.2972972972973,8.108108108108109
50549_marine,36,50,35,2,86,97.22222222222221,5.555555555555555
50550_marine,36,50,35,2,86,97.22222222222221,5.555555555555555
50551_marine,36,50,35,2,86,97.22222222222221,5.555555555555555
50552_marine,37,50,35,3,87,94.5945945945946,8.108108108108109
50553_marine,37,50,35,3,87,94.5945945945946,8.108108108108109
50554_marine,38,48,36,3,86,94.73684210526315,7.894736842105263
50555_marine,38,48,36,3,86,94.73684210526315,7.894736842105263
50556_marine,38,48,36,3,86,94.73684210526315,7.894736842105263
50557_marine,38,48,36,3,86,94.73684210526315,7.894736842105263
50558_marine,38,48,36,3,86,94.73684210526315,7.894736842105263
50559_marine,38,49,36,3,87,94.73684210526315,7.894736842105263
50560_marine,38,50,36,3,88,94.73684210526315,7.894736842105263
50561_marine,37,50,35,2,87,94.5945945945946,5.405405405405405
50562_marine,37,49,35,2,86,94.5945945945946,5.405405405405405
50563_marine,37,49,35,2,86,94.5945945945946,5.405405405405405
50564_marine,37,49,35,2,86,94.5945945945946,5.405405405405405
50565_marine,37,49,35,2,86,94.5945945945946,5.405405405405405
50566_marine,38,49,36,2,87,94.73684210526315,5.263157894736842
50567_marine,36,49,34,2,85,94.44444444444444,5.555555555555555
50568_marine,36,51,34,2,87,94.44444444444444,5.555555555555555
50569_marine,36,51,34,2,87,94.44444444444444,5.555555555555555
50570_marine,36,51,34,2,87,94.44444444444444,5.555555555555555
50571_marine,36,51,34,2,87,94.44444444444444,5.555555555555555
50572_marine,36,52,34,2,88,94.44444444444444,5.555555555555555
50573_marine,35,52,33,2,87,94.28571428571428,5.714285714285714
50574_marine,34,52,32,2,86,94.11764705882352,5.88235294117647
50575_marine,35,52,32,3,87,91.42857142857143,8.571428571428571
50576_marine,35,52,32,3,87,91.42857142857143,8.571428571428571
50577_marine,37,52,34,3,89,91.8918918918919,8.108108108108109
50578_marine,37,52,34,3,89,91.8918918918919,8.108108108108109
50579_marine,37,52,34,3,89,91.8918918918919,8.108108108108109
50580_marine,39,51,36,3,90,92.3076923076923,7.6923076923076925
50581_marine,38,50,35,3,88,92.10526315789474,7.894736842105263
50582_marine,37,50,34,3,87,91.8918918918919,8.108108108108109
50583_marine,35,50,32,3,85,91.42857142857143,8.571428571428571
50584_marine,35,50,32,3,85,91.42857142857143,8.571428571428571
50585_marine,35,49,32,3,84,91.42857142857143,8.571428571428571
50586_marine,35,49,32,3,84,91.42857142857143,8.571428571428571
50587_marine,33,49,30,3,82,90.9090909090909,9.090909090909092
50588_marine,31,47,28,3,78,90.32258064516128,9.67741935483871
50589_marine,31,47,28,3,78,90.32258064516128,9.67741935483871
50590_marine,31,47,28,3,78,90.32258064516128,9.67741935483871
50591_marine,31,47,28,3,78,90.32258064516128,9.67741935483871
50592_marine,33,47,30,3,80,90.9090909090909,9.090909090909092
50593_marine,33,47,30,3,80,90.9090909090909,9.090909090909092
50594_marine,33,47,30,3,80,90.9090909090909,9.090909090909092
50595_marine,33,47,30,3,80,90.9090909090909,9.090909090909092
50596_marine,33,47,30,3,80,90.9090909090909,9.090909090909092
50597_marine,33,47,30,3,80,90.9090909090909,9.090909090909092
50598_marine,33,47,30,3,80,90.9090909090909,9.090909090909092
50599_marine,30,47,27,3,77,90,10
50600_marine,30,48,27,3,78,90,10
50601_marine,30,50,27,3,80,90,10
50602_marine,32,52,29,3,84,90.625,9.375
50603_marine,32,52,29,3,84,90.625,9.375
50604_marine,32,52,29,3,84,90.625,9.375
50605_marine,32,53,29,3,85,90.625,9.375
50606_marine,32,52,29,3,84,90.625,9.375
50607_marine,32,50,29,3,82,90.625,9.375
50608_marine,33,49,30,4,82,90.9090909090909,12.121212121212121
50609_marine,33,50,30,4,83,90.9090909090909,12.121212121212121
50610_marine,33,50,30,4,83,90.9090909090909,12.121212121212121
50611_marine,33,50,30,4,83,90.9090909090909,12.121212121212121
50612_marine,34,50,31,5,84,91.17647058823529,14.705882352941178
50613_marine,34,51,31,5,85,91.17647058823529,14.705882352941178
50614_marine,32,52,29,5,84,90.625,15.625
50615_marine,32,52,29,5,84,90.625,15.625
50616_marine,35,53,32,5,88,91.42857142857143,14.285714285714285
50617_marine,35,52,32,5,87,91.42857142857143,14.285714285714285
50618_marine,36,52,33,6,88,91.66666666666666,16.666666666666664
50619_marine,36,52,33,6,88,91.66666666666666,16.666666666666664
50620_marine,34,52,31,6,86,91.17647058823529,17.647058823529413
50621_marine,33,52,30,6,85,90.9090909090909,18.181818181818183
50622_marine,32,52,30,5,84,93.75,15.625
50623_marine,32,52,30,5,84,93.75,15.625
50624_marine,32,52,30,5,84,93.75,15.625
50625_marine,32,52,30,5,84,93.75,15.625
50626_marine,32,52,30,5,84,93.75,15.625
50627_marine,32,52,30,5,84,93.75,15.625
50628_marine,32,52,30,5,84,93.75,15.625
50629_marine,32,53,30,5,85,93.75,15.625
50630_marine,32,53,30,5,85,93.75,15.625
50631_marine,32,53,30,5,85,93.75,15.625
50632_marine,32,55,30,5,87,93.75,15.625
50633_marine,32,55,30,5,87,93.75,15.625
50634_marine,32,55,30,5,87,93.75,15.625
50635_marine,32,55,30,5,87,93.75,15.625
50636_marine,32,55,30,5,87,93.75,15.625
50637_marine,32,55,30,5,87,93.75,15.625
50638_marine,32,55,30,5,87,93.75,15.625
50639_marine,32,55,30,5,87,93.75,15.625
50640_marine,32,57,30,5,89,93.75,15.625
50641_marine,32,59,30,5,91,93.75,15.625
50642_marine,32,57,30,5,89,93.75,15.625
50643_marine,32,60,30,5,92,93.75,15.625
50644_marine,32,62,30,5,94,93.75,15.625
50645_marine,32,64,30,5,96,93.75,15.625
50646_marine,32,65,30,5,97,93.75,15.625
50647_marine,32,67,30,5,99,93.75,15.625
50648_marine,34,76,30,5,110,88.23529411764706,14.705882352941178
50649_marine,46,95,39,13,141,84.78260869565217,28.26086956521739
50650_marine,36,77,31,7,113,86.11111111111111,19.444444444444446
50651_marine,34,77,30,5,111,88.23529411764706,14.705882352941178
50652_marine,34,76,30,5,110,88.23529411764706,14.705882352941178
50653_marine,32,67,30,5,99,93.75,15.625
50654_marine,34,64,32,5,98,94.11764705882352,14.705882352941178
50655_marine,34,66,32,5,100,94.11764705882352,14.705882352941178
50656_marine,34,63,32,5,97,94.11764705882352,14.705882352941178
50657_marine,34,63,32,5,97,94.11764705882352,14.705882352941178
50658_marine,34,63,32,5,97,94.11764705882352,14.705882352941178
50659_marine,35,61,33,5,96,94.28571428571428,14.285714285714285
50660_marine,35,60,33,5,95,94.28571428571428,14.285714285714285
50661_marine,35,60,33,5,95,94.28571428571428,14.285714285714285
50662_marine,35,57,33,5,92,94.28571428571428,14.285714285714285
50663_marine,35,57,33,5,92,94.28571428571428,14.285714285714285
50664_marine,35,57,33,5,92,94.28571428571428,14.285714285714285
50665_marine,36,57,34,5,93,94.44444444444444,13.88888888888889
50666_marine,35,53,33,4,88,94.28571428571428,11.428571428571429
50667_marine,35,53,33,4,88,94.28571428571428,11.428571428571429
50668_marine,35,53,33,4,88,94.28571428571428,11.428571428571429
50669_marine,34,53,32,3,87,94.11764705882352,8.823529411764707
50670_marine,34,53,32,3,87,94.11764705882352,8.823529411764707
50671_marine,35,51,33,3,86,94.28571428571428,8.571428571428571
50672_marine,35,51,33,3,86,94.28571428571428,8.571428571428571
50673_marine,35,51,33,3,86,94.28571428571428,8.571428571428571
50674_marine,35,51,33,3,86,94.28571428571428,8.571428571428571
50675_marine,35,50,33,3,85,94.28571428571428,8.571428571428571
50676_marine,35,50,33,3,85,94.28571428571428,8.571428571428571
50677_marine,37,50,35,3,87,94.5945945945946,8.108108108108109
50678_marine,37,50,35,3,87,94.5945945945946,8.108108108108109
50679_marine,37,50,35,3,87,94.5945945945946,8.108108108108109
50680_marine,37,50,35,3,87,94.5945945945946,8.108108108108109
50681_marine,37,51,35,3,88,94.5945945945946,8.108108108108109
50682_marine,37,52,35,3,89,94.5945945945946,8.108108108108109
50683_marine,37,54,35,3,91,94.5945945945946,8.108108108108109
50684_marine,37,54,35,3,91,94.5945945945946,8.108108108108109
50685_marine,37,54,35,3,91,94.5945945945946,8.108108108108109
50686_marine,35,54,33,3,89,94.28571428571428,8.571428571428571
50687_marine,35,54,33,3,89,94.28571428571428,8.571428571428571
50688_marine,35,54,33,3,89,94.28571428571428,8.571428571428571
50689_marine,35,54,33,3,89,94.28571428571428,8.571428571428571
50690_marine,33,54,31,3,87,93.93939393939394,9.090909090909092
50691_marine,33,54,31,3,87,93.93939393939394,9.090909090909092
50692_marine,33,54,31,3,87,93.93939393939394,9.090909090909092
50693_marine,32,54,30,2,86,93.75,6.25
50694_marine,32,54,30,2,86,93.75,6.25
50695_marine,32,54,30,2,86,93.75,6.25
50696_marine,32,52,30,2,84,93.75,6.25
50697_marine,32,52,30,2,84,93.75,6.25
50698_marine,32,52,30,2,84,93.75,6.25
50699_marine,31,52,30,1,83,96.7741935483871,3.225806451612903
50700_marine,31,52,30,1,83,96.7741935483871,3.225806451612903
50701_marine,32,52,32,0,84,100,0
50702_marine,32,52,32,0,84,100,0
50703_marine,34,52,34,0,86,100,0
50704_marine,34,52,34,0,86,100,0
50705_marine,34,52,34,0,86,100,0
50706_marine,36,52,36,0,88,100,0
50707_marine,37,52,37,0,89,100,0
50708_marine,37,52,37,0,89,100,0
50709_marine,37,53,37,0,90,100,0
50710_marine,37,53,37,0,90,100,0
50711_marine,37,53,37,0,90,100,0
50712_marine,37,53,37,0,90,100,0
50713_marine,37,53,37,0,90,100,0
50714_marine,38,53,37,0,91,97.36842105263158,0
50715_marine,38,54,37,0,92,97.36842105263158,0
50716_marine,38,54,37,0,92,97.36842105263158,0
50717_marine,39,54,38,0,93,97.43589743589743,0
50718_marine,39,53,38,0,92,97.43589743589743,0
50719_marine,37,55,36,0,92,97.2972972972973,0
50720_marine,37,60,36,0,97,97.2972972972973,0
50721_marine,36,60,35,0,96,97.22222222222221,0
50722_marine,37,63,36,0,100,97.2972972972973,0
50723_marine,36,62,35,0,98,97.22222222222221,0
50724_marine,34,62,33,0,96,97.05882352941177,0
50725_marine,34,63,33,0,97,97.05882352941177,0
50726_marine,34,61,33,0,95,97.05882352941177,0
50727_marine,34,63,33,0,97,97.05882352941177,0
50728_marine,37,63,36,0,100,97.2972972972973,0
50729_marine,37,63,36,0,100,97.2972972972973,0
50730_marine,37,64,36,0,101,97.2972972972973,0
50731_marine,37,63,36,0,100,97.2972972972973,0
50732_marine,37,61,36,0,98,97.2972972972973,0
50733_marine,36,60,36,0,96,100,0
50734_marine,36,60,36,0,96,100,0
50735_marine,38,60,38,1,98,100,2.631578947368421
50736_marine,38,61,38,1,99,100,2.631578947368421
50737_marine,38,62,38,1,100,100,2.631578947368421
50738_marine,38,62,38,1,100,100,2.631578947368421
50739_marine,37,62,37,1,99,100,2.7027027027027026
50740_marine,37,63,37,1,100,100,2.7027027027027026
50741_marine,37,66,37,1,103,100,2.7027027027027026
50742_marine,37,67,37,1,104,100,2.7027027027027026
50743_marine,38,69,37,1,107,97.36842105263158,2.631578947368421
50744_marine,39,78,38,1,117,97.43589743589743,2.564102564102564
50745_marine,47,95,44,3,142,93.61702127659575,6.382978723404255
50746_marine,78,124,63,22,202,80.76923076923077,28.205128205128204
50747_marine,79,133,64,22,212,81.0126582278481,27.848101265822784
50748_marine,51,111,47,4,162,92.15686274509804,7.8431372549019605
50749_marine,49,97,47,4,146,95.91836734693877,8.16326530612245
50750_marine,45,96,43,5,141,95.55555555555556,11.11111111111111
50751_marine,47,95,46,4,142,97.87234042553192,8.51063829787234
50752_marine,47,92,46,4,139,97.87234042553192,8.51063829787234
50753_marine,47,90,46,4,137,97.87234042553192,8.51063829787234
50754_marine,45,90,44,4,135,97.77777777777777,8.88888888888889
50755_marine,46,85,45,4,131,97.82608695652173,8.695652173913043
50756_marine,43,82,42,4,125,97.67441860465115,9.30232558139535
50757_marine,43,65,42,4,108,97.67441860465115,9.30232558139535
50758_marine,45,82,44,2,127,97.77777777777777,4.444444444444445
50759_marine,45,76,44,2,121,97.77777777777777,4.444444444444445
50760_marine,44,77,43,2,121,97.72727272727273,4.545454545454546
50761_marine,36,60,35,2,96,97.22222222222221,5.555555555555555
50762_marine,34,60,33,2,94,97.05882352941177,5.88235294117647
50763_marine,34,58,33,2,92,97.05882352941177,5.88235294117647
50764_marine,34,58,33,2,92,97.05882352941177,5.88235294117647
50765_marine,33,57,32,1,90,96.96969696969697,3.0303030303030303
50766_marine,33,57,32,1,90,96.96969696969697,3.0303030303030303
50767_marine,33,56,32,1,89,96.96969696969697,3.0303030303030303
50768_marine,33,55,32,1,88,96.96969696969697,3.0303030303030303
50769_marine,33,55,32,1,88,96.96969696969697,3.0303030303030303
50770_marine,33,55,32,1,88,96.96969696969697,3.0303030303030303
50771_marine,33,55,32,1,88,96.96969696969697,3.0303030303030303
50772_marine,33,54,32,1,87,96.96969696969697,3.0303030303030303
50773_marine,33,54,32,1,87,96.96969696969697,3.0303030303030303
50774_marine,32,54,31,1,86,96.875,3.125
50775_marine,32,54,31,1,86,96.875,3.125
50776_marine,32,53,31,1,85,96.875,3.125
50777_marine,32,53,31,1,85,96.875,3.125
50778_marine,32,53,31,1,85,96.875,3.125
50779_marine,32,53,31,1,85,96.875,3.125
50780_marine,32,53,31,1,85,96.875,3.125
50781_marine,32,53,31,1,85,96.875,3.125
50782_marine,32,53,31,1,85,96.875,3.125
50783_marine,31,53,30,1,84,96.7741935483871,3.225806451612903
50784_marine,31,53,30,1,84,96.7741935483871,3.225806451612903
50785_marine,31,53,30,1,84,96.7741935483871,3.225806451612903
50786_marine,31,53,30,1,84,96.7741935483871,3.225806451612903
50787_marine,31,53,30,1,84,96.7741935483871,3.225806451612903
50788_marine,28,53,27,1,81,96.42857142857143,3.571428571428571
50789_marine,28,53,27,1,81,96.42857142857143,3.571428571428571
50790_marine,28,53,27,1,81,96.42857142857143,3.571428571428571
50791_marine,28,52,27,1,80,96.42857142857143,3.571428571428571
50792_marine,28,52,27,1,80,96.42857142857143,3.571428571428571
50793_marine,28,53,27,1,81,96.42857142857143,3.571428571428571
50794_marine,29,53,28,1,82,96.55172413793103,3.4482758620689653
50795_marine,29,53,28,1,82,96.55172413793103,3.4482758620689653
50796_marine,29,51,28,1,80,96.55172413793103,3.4482758620689653
50797_marine,28,51,27,1,79,96.42857142857143,3.571428571428571
50798_marine,28,51,27,1,79,96.42857142857143,3.571428571428571
50799_marine,28,51,27,1,79,96.42857142857143,3.571428571428571
50800_marine,28,51,27,1,79,96.42857142857143,3.571428571428571
50801_marine,28,51,27,1,79,96.42857142857143,3.571428571428571
50802_marine,28,51,27,1,79,96.42857142857143,3.571428571428571
50803_marine,28,51,27,1,79,96.42857142857143,3.571428571428571
50804_marine,28,52,27,1,80,96.42857142857143,3.571428571428571
50805_marine,28,52,27,1,80,96.42857142857143,3.571428571428571
50806_marine,28,52,27,1,80,96.42857142857143,3.571428571428571
50807_marine,28,52,27,1,80,96.42857142857143,3.571428571428571
50808_marine,28,52,27,1,80,96.42857142857143,3.571428571428571
50809_marine,28,52,27,1,80,96.42857142857143,3.571428571428571
50810_marine,28,52,27,1,80,96.42857142857143,3.571428571428571
50811_marine,28,52,27,1,80,96.42857142857143,3.571428571428571
50812_marine,28,52,27,1,80,96.42857142857143,3.571428571428571
50813_marine,28,52,27,1,80,96.42857142857143,3.571428571428571
50814_marine,28,52,27,1,80,96.42857142857143,3.571428571428571
50815_marine,28,52,27,1,80,96.42857142857143,3.571428571428571
50816_marine,28,52,27,1,80,96.42857142857143,3.571428571428571
50817_marine,28,52,27,1,80,96.42857142857143,3.571428571428571
50818_marine,28,52,27,1,80,96.42857142857143,3.571428571428571
50819_marine,28,51,27,1,79,96.42857142857143,3.571428571428571
50820_marine,28,51,27,1,79,96.42857142857143,3.571428571428571
50821_marine,28,51,27,1,79,96.42857142857143,3.571428571428571
50822_marine,28,50,27,1,78,96.42857142857143,3.571428571428571
50823_marine,28,50,27,1,78,96.42857142857143,3.571428571428571
50824_marine,28,50,27,1,78,96.42857142857143,3.571428571428571
50825_marine,28,50,27,1,78,96.42857142857143,3.571428571428571
50826_marine,28,50,27,1,78,96.42857142857143,3.571428571428571
50827_marine,28,49,27,1,77,96.42857142857143,3.571428571428571
50828_marine,27,49,27,0,76,100,0
50829_marine,27,51,27,0,78,100,0
50830_marine,27,51,27,0,78,100,0
50831_marine,27,52,27,0,79,100,0
50832_marine,27,52,27,0,79,100,0
50833_marine,27,52,27,0,79,100,0
50834_marine,27,52,27,0,79,100,0
50835_marine,27,52,27,0,79,100,0
50836_marine,27,51,27,0,78,100,0
50837_marine,27,51,27,0,78,100,0
50838_marine,27,51,27,0,78,100,0
50839_marine,27,51,27,0,78,100,0
50840_marine,27,50,27,0,77,100,0
50841_marine,27,50,27,0,77,100,0
50842_marine,27,50,27,0,77,100,0
50843_marine,26,49,26,0,75,100,0
50844_marine,26,50,26,0,76,100,0
50845_marine,26,50,26,0,76,100,0
50846_marine,26,49,26,0,75,100,0
50847_marine,26,48,26,0,74,100,0
50848_marine,26,48,26,0,74,100,0
50849_marine,26,48,26,0,74,100,0
50850_marine,26,48,26,0,74,100,0
50851_marine,26,48,26,0,74,100,0
50852_marine,26,48,26,0,74,100,0
50853_marine,26,48,26,0,74,100,0
50854_marine,26,48,26,0,74,100,0
50855_marine,27,48,27,0,75,100,0
50856_marine,27,48,27,0,75,100,0
50857_marine,28,48,27,1,76,96.42857142857143,3.571428571428571
50858_marine,28,48,27,1,76,96.42857142857143,3.571428571428571
50859_marine,28,48,27,1,76,96.42857142857143,3.571428571428571
50860_marine,28,48,26,1,76,92.85714285714286,3.571428571428571
50861_marine,28,49,26,1,77,92.85714285714286,3.571428571428571
50862_marine,28,49,26,1,77,92.85714285714286,3.571428571428571
50863_marine,34,50,32,2,84,94.11764705882352,5.88235294117647
50864_marine,47,86,43,5,133,91.48936170212765,10.638297872340425
50865_marine,106,157,67,50,263,63.20754716981132,47.16981132075472
50866_marine,107,162,65,51,269,60.747663551401864,47.66355140186916
50867_marine,121,174,68,62,295,56.19834710743802,51.2396694214876
50868_marine,124,178,72,64,302,58.06451612903226,51.61290322580645
50871_marine,142,189,85,74,331,59.859154929577464,52.112676056338024
50872_marine,142,186,86,74,328,60.56338028169014,52.112676056338024
50873_marine,56,116,48,8,172,85.71428571428571,14.285714285714285
50874_marine,56,118,47,8,174,83.92857142857143,14.285714285714285
50875_marine,54,113,47,6,167,87.03703703703704,11.11111111111111
50876_marine,54,106,47,6,160,87.03703703703704,11.11111111111111
50877_marine,53,107,45,7,160,84.90566037735849,13.20754716981132
50878_marine,54,110,46,8,164,85.18518518518519,14.814814814814813
50879_marine,90,135,67,39,225,74.44444444444444,43.333333333333336
50880_marine,95,126,69,40,221,72.63157894736842,42.10526315789473
50881_marine,94,129,68,41,223,72.3404255319149,43.61702127659575
50882_marine,92,129,66,40,221,71.73913043478261,43.47826086956522
50883_marine,95,137,69,41,232,72.63157894736842,43.15789473684211
50884_marine,55,97,46,9,152,83.63636363636363,16.363636363636363
50885_marine,43,66,37,7,109,86.04651162790698,16.27906976744186
50886_marine,43,52,37,7,95,86.04651162790698,16.27906976744186
50887_marine,42,53,36,6,95,85.71428571428571,14.285714285714285
50888_marine,42,54,36,6,96,85.71428571428571,14.285714285714285
50889_marine,42,54,36,6,96,85.71428571428571,14.285714285714285
50890_marine,42,54,36,6,96,85.71428571428571,14.285714285714285
50891_marine,39,53,34,6,92,87.17948717948718,15.384615384615385
50892_marine,37,53,34,6,90,91.8918918918919,16.216216216216218
50893_marine,37,54,34,6,91,91.8918918918919,16.216216216216218
50894_marine,37,54,34,6,91,91.8918918918919,16.216216216216218
50895_marine,38,54,36,5,92,94.73684210526315,13.157894736842104
50896_marine,37,54,35,5,91,94.5945945945946,13.513513513513514
50897_marine,39,54,37,5,93,94.87179487179486,12.82051282051282
50898_marine,39,54,37,5,93,94.87179487179486,12.82051282051282
50899_marine,39,53,37,5,92,94.87179487179486,12.82051282051282
50900_marine,39,53,37,5,92,94.87179487179486,12.82051282051282
50901_marine,39,51,37,5,90,94.87179487179486,12.82051282051282
50902_marine,37,51,35,5,88,94.5945945945946,13.513513513513514
50903_marine,37,52,35,5,89,94.5945945945946,13.513513513513514
50904_marine,37,52,35,5,89,94.5945945945946,13.513513513513514
50905_marine,39,52,37,5,91,94.87179487179486,12.82051282051282
50906_marine,39,52,37,5,91,94.87179487179486,12.82051282051282
50907_marine,38,51,36,4,89,94.73684210526315,10.526315789473683
50908_marine,36,50,34,4,86,94.44444444444444,11.11111111111111
50909_marine,36,50,34,4,86,94.44444444444444,11.11111111111111
50910_marine,35,50,33,3,85,94.28571428571428,8.571428571428571
50911_marine,35,49,33,3,84,94.28571428571428,8.571428571428571
50912_marine,35,49,33,3,84,94.28571428571428,8.571428571428571
50913_marine,35,49,33,3,84,94.28571428571428,8.571428571428571
50914_marine,33,49,31,3,82,93.93939393939394,9.090909090909092
50915_marine,33,49,31,3,82,93.93939393939394,9.090909090909092
50916_marine,33,51,31,3,84,93.93939393939394,9.090909090909092
50917_marine,34,50,32,3,84,94.11764705882352,8.823529411764707
50918_marine,36,50,34,3,86,94.44444444444444,8.333333333333332
50919_marine,36,50,34,3,86,94.44444444444444,8.333333333333332
50920_marine,36,51,34,3,87,94.44444444444444,8.333333333333332
50921_marine,36,51,34,3,87,94.44444444444444,8.333333333333332
50922_marine,35,51,33,2,86,94.28571428571428,5.714285714285714
50923_marine,35,51,33,2,86,94.28571428571428,5.714285714285714
50924_marine,33,52,31,2,85,93.93939393939394,6.0606060606060606
50925_marine,33,52,31,2,85,93.93939393939394,6.0606060606060606
50926_marine,33,52,31,2,85,93.93939393939394,6.0606060606060606
50927_marine,33,52,31,2,85,93.93939393939394,6.0606060606060606
50928_marine,34,53,32,2,87,94.11764705882352,5.88235294117647
50929_marine,34,54,32,2,88,94.11764705882352,5.88235294117647
50930_marine,34,54,32,2,88,94.11764705882352,5.88235294117647
50931_marine,33,54,30,3,87,90.9090909090909,9.090909090909092
50932_marine,33,54,30,3,87,90.9090909090909,9.090909090909092
50933_marine,33,54,30,3,87,90.9090909090909,9.090909090909092
50934_marine,33,54,30,3,87,90.9090909090909,9.090909090909092
50935_marine,33,54,30,3,87,90.9090909090909,9.090909090909092
50936_marine,33,54,30,3,87,90.9090909090909,9.090909090909092
50937_marine,33,54,30,3,87,90.9090909090909,9.090909090909092
50938_marine,32,54,29,3,86,90.625,9.375
50939_marine,32,54,29,3,86,90.625,9.375
50940_marine,32,52,29,3,84,90.625,9.375
50941_marine,34,52,31,3,86,91.17647058823529,8.823529411764707
50942_marine,33,50,30,3,83,90.9090909090909,9.090909090909092
50943_marine,31,47,28,3,78,90.32258064516128,9.67741935483871
50944_marine,31,47,28,3,78,90.32258064516128,9.67741935483871
50945_marine,31,46,28,3,77,90.32258064516128,9.67741935483871
50946_marine,29,46,26,3,75,89.65517241379311,10.344827586206897
50947_marine,29,46,26,3,75,89.65517241379311,10.344827586206897
50948_marine,29,47,26,3,76,89.65517241379311,10.344827586206897
50949_marine,29,47,26,3,76,89.65517241379311,10.344827586206897
50950_marine,29,49,26,3,78,89.65517241379311,10.344827586206897
50951_marine,29,49,26,3,78,89.65517241379311,10.344827586206897
50952_marine,29,49,26,3,78,89.65517241379311,10.344827586206897
50953_marine,29,49,26,3,78,89.65517241379311,10.344827586206897
50954_marine,29,48,26,3,77,89.65517241379311,10.344827586206897
50955_marine,29,48,26,3,77,89.65517241379311,10.344827586206897
50956_marine,29,48,26,3,77,89.65517241379311,10.344827586206897
50957_marine,29,48,26,3,77,89.65517241379311,10.344827586206897
50958_marine,28,48,25,3,76,89.28571428571429,10.714285714285714
50959_marine,28,48,25,3,76,89.28571428571429,10.714285714285714
50960_marine,28,48,25,3,76,89.28571428571429,10.714285714285714
50961_marine,28,49,25,3,77,89.28571428571429,10.714285714285714
50962_marine,28,51,25,3,79,89.28571428571429,10.714285714285714
50963_marine,28,51,25,3,79,89.28571428571429,10.714285714285714
50964_marine,28,50,25,3,78,89.28571428571429,10.714285714285714
50965_marine,29,50,26,4,79,89.65517241379311,13.793103448275861
50966_marine,29,50,26,4,79,89.65517241379311,13.793103448275861
50967_marine,29,48,26,4,77,89.65517241379311,13.793103448275861
50968_marine,29,49,26,4,78,89.65517241379311,13.793103448275861
50969_marine,29,49,26,4,78,89.65517241379311,13.793103448275861
50970_marine,30,49,27,5,79,90,16.666666666666664
50971_marine,30,49,27,5,79,90,16.666666666666664
50972_marine,30,49,27,5,79,90,16.666666666666664
50973_marine,30,49,27,5,79,90,16.666666666666664
50974_marine,30,50,27,5,80,90,16.666666666666664
50975_marine,30,50,27,5,80,90,16.666666666666664
50976_marine,30,51,27,5,81,90,16.666666666666664
50977_marine,30,52,27,5,82,90,16.666666666666664
50978_marine,30,52,27,5,82,90,16.666666666666664
50979_marine,30,52,27,5,82,90,16.666666666666664
50980_marine,31,52,28,6,83,90.32258064516128,19.35483870967742
50981_marine,31,52,28,6,83,90.32258064516128,19.35483870967742
50982_marine,33,52,30,6,85,90.9090909090909,18.181818181818183
50983_marine,33,51,30,6,84,90.9090909090909,18.181818181818183
50984_marine,33,51,30,6,84,90.9090909090909,18.181818181818183
50985_marine,33,51,30,6,84,90.9090909090909,18.181818181818183
50986_marine,33,51,30,6,84,90.9090909090909,18.181818181818183
50987_marine,33,51,30,6,84,90.9090909090909,18.181818181818183
50988_marine,33,51,30,6,84,90.9090909090909,18.181818181818183
50989_marine,33,51,30,6,84,90.9090909090909,18.181818181818183
50990_marine,33,51,30,6,84,90.9090909090909,18.181818181818183
50991_marine,33,51,30,6,84,90.9090909090909,18.181818181818183
50992_marine,32,51,30,5,83,93.75,15.625
50993_marine,32,51,30,5,83,93.75,15.625
50994_marine,32,51,30,5,83,93.75,15.625
50995_marine,32,51,30,5,83,93.75,15.625
50996_marine,32,52,30,5,84,93.75,15.625
50997_marine,32,52,30,5,84,93.75,15.625
50998_marine,32,52,30,5,84,93.75,15.625
50999_marine,32,52,30,5,84,93.75,15.625
51000_marine,32,54,30,5,86,93.75,15.625
51001_marine,32,54,30,5,86,93.75,15.625
51002_marine,32,54,30,5,86,93.75,15.625
51003_marine,32,56,30,5,88,93.75,15.625
51004_marine,32,56,30,5,88,93.75,15.625
51005_marine,32,60,30,5,92,93.75,15.625
51006_marine,32,62,30,5,94,93.75,15.625
51007_marine,30,59,28,5,89,93.33333333333333,16.666666666666664
51008_marine,30,60,28,5,90,93.33333333333333,16.666666666666664
51009_marine,30,68,28,5,98,93.33333333333333,16.666666666666664
51010_marine,32,71,28,5,103,87.5,15.625
51011_marine,32,75,28,5,107,87.5,15.625
51012_marine,32,75,28,5,107,87.5,15.625
51013_marine,32,69,28,5,101,87.5,15.625
51014_marine,32,68,28,5,100,87.5,15.625
51015_marine,32,68,28,5,100,87.5,15.625
51016_marine,30,66,28,5,96,93.33333333333333,16.666666666666664
51017_marine,30,64,28,5,94,93.33333333333333,16.666666666666664
51018_marine,30,62,28,5,92,93.33333333333333,16.666666666666664
51019_marine,30,60,28,5,90,93.33333333333333,16.666666666666664
51020_marine,30,60,28,5,90,93.33333333333333,16.666666666666664
51021_marine,30,59,28,5,89,93.33333333333333,16.666666666666664
51022_marine,30,59,28,5,89,93.33333333333333,16.666666666666664
51023_marine,30,57,28,5,87,93.33333333333333,16.666666666666664
51024_marine,31,57,29,5,88,93.54838709677419,16.129032258064516
51025_marine,30,57,28,4,87,93.33333333333333,13.333333333333334
51026_marine,32,55,30,4,87,93.75,12.5
51027_marine,32,52,30,4,84,93.75,12.5
51028_marine,32,51,30,4,83,93.75,12.5
51029_marine,32,51,30,4,83,93.75,12.5
51030_marine,33,50,31,4,83,93.93939393939394,12.121212121212121
51031_marine,33,50,31,4,83,93.93939393939394,12.121212121212121
51032_marine,33,50,31,4,83,93.93939393939394,12.121212121212121
51033_marine,33,49,31,4,82,93.93939393939394,12.121212121212121
51034_marine,33,49,31,4,82,93.93939393939394,12.121212121212121
51035_marine,32,49,30,3,81,93.75,9.375
51036_marine,32,49,30,3,81,93.75,9.375
51037_marine,32,49,30,3,81,93.75,9.375
51038_marine,30,49,28,3,79,93.33333333333333,10
51039_marine,30,49,28,3,79,93.33333333333333,10
51040_marine,30,49,28,3,79,93.33333333333333,10
51041_marine,30,50,28,3,80,93.33333333333333,10
51042_marine,30,50,28,3,80,93.33333333333333,10
51043_marine,30,50,28,3,80,93.33333333333333,10
51044_marine,30,51,28,3,81,93.33333333333333,10
51045_marine,30,51,28,3,81,93.33333333333333,10
51046_marine,30,51,28,3,81,93.33333333333333,10
51047_marine,30,51,28,3,81,93.33333333333333,10
51048_marine,30,51,28,3,81,93.33333333333333,10
51049_marine,30,51,28,3,81,93.33333333333333,10
51050_marine,30,53,28,3,83,93.33333333333333,10
51051_marine,32,53,30,3,85,93.75,9.375
51052_marine,32,53,30,3,85,93.75,9.375
51053_marine,32,53,30,3,85,93.75,9.375
51054_marine,32,53,30,3,85,93.75,9.375
51055_marine,32,53,30,3,85,93.75,9.375
51056_marine,32,53,30,3,85,93.75,9.375
51057_marine,32,54,30,3,86,93.75,9.375
51058_marine,32,54,30,3,86,93.75,9.375
51059_marine,32,54,30,3,86,93.75,9.375
51060_marine,32,54,30,3,86,93.75,9.375
51061_marine,31,54,30,2,85,96.7741935483871,6.451612903225806
51062_marine,31,54,30,2,85,96.7741935483871,6.451612903225806
51063_marine,31,54,30,2,85,96.7741935483871,6.451612903225806
51064_marine,31,52,30,2,83,96.7741935483871,6.451612903225806
51065_marine,30,52,29,1,82,96.66666666666667,3.3333333333333335
51066_marine,30,52,29,1,82,96.66666666666667,3.3333333333333335
51067_marine,30,52,29,1,82,96.66666666666667,3.3333333333333335
51068_marine,32,52,31,1,84,96.875,3.125
51069_marine,31,53,30,1,84,96.7741935483871,3.225806451612903
51070_marine,32,53,31,2,85,96.875,6.25
51071_marine,31,52,31,1,83,100,3.225806451612903
51072_marine,31,52,31,1,83,100,3.225806451612903
51073_marine,31,52,31,1,83,100,3.225806451612903
51074_marine,32,52,32,1,84,100,3.125
51075_marine,32,52,32,1,84,100,3.125
51076_marine,32,53,32,1,85,100,3.125
51077_marine,32,53,32,1,85,100,3.125
51078_marine,31,53,31,1,84,100,3.225806451612903
51079_marine,31,53,31,1,84,100,3.225806451612903
51080_marine,31,55,31,1,86,100,3.225806451612903
51081_marine,33,57,33,1,90,100,3.0303030303030303
51082_marine,33,59,33,1,92,100,3.0303030303030303
51083_marine,34,62,34,2,96,100,5.88235294117647
51084_marine,35,63,35,2,98,100,5.714285714285714
51085_marine,35,64,35,2,99,100,5.714285714285714
51086_marine,35,62,35,2,97,100,5.714285714285714
51087_marine,35,62,35,2,97,100,5.714285714285714
51088_marine,35,63,35,2,98,100,5.714285714285714
51089_marine,38,63,38,2,101,100,5.263157894736842
51090_marine,37,62,37,2,99,100,5.405405405405405
51091_marine,38,62,38,2,100,100,5.263157894736842
51092_marine,37,63,37,1,100,100,2.7027027027027026
51093_marine,35,63,35,1,98,100,2.857142857142857
51094_marine,35,63,35,1,98,100,2.857142857142857
51095_marine,35,64,35,1,99,100,2.857142857142857
51096_marine,35,64,35,1,99,100,2.857142857142857
51097_marine,35,63,35,1,98,100,2.857142857142857
51098_marine,35,62,35,1,97,100,2.857142857142857
51099_marine,36,63,36,2,99,100,5.555555555555555
51100_marine,38,65,38,2,103,100,5.263157894736842
51101_marine,38,65,37,3,103,97.36842105263158,7.894736842105263
51102_marine,39,68,38,3,107,97.43589743589743,7.6923076923076925
51103_marine,38,68,37,3,106,97.36842105263158,7.894736842105263
51104_marine,39,66,37,3,105,94.87179487179486,7.6923076923076925
51105_marine,43,91,41,3,134,95.34883720930233,6.976744186046512
51106_marine,52,99,46,7,151,88.46153846153845,13.461538461538462
51107_marine,62,118,52,15,180,83.87096774193549,24.193548387096776
51108_marine,51,105,46,6,156,90.19607843137256,11.76470588235294
51109_marine,49,98,47,4,147,95.91836734693877,8.16326530612245
51110_marine,52,99,50,6,151,96.15384615384616,11.538461538461538
51111_marine,50,100,48,6,150,96,12
51112_marine,47,90,46,5,137,97.87234042553192,10.638297872340425
51113_marine,44,89,43,4,133,97.72727272727273,9.090909090909092
51114_marine,41,89,40,4,130,97.5609756097561,9.75609756097561
51115_marine,44,86,43,4,130,97.72727272727273,9.090909090909092
51116_marine,43,82,42,4,125,97.67441860465115,9.30232558139535
51117_marine,38,65,37,2,103,97.36842105263158,5.263157894736842
51118_marine,38,64,37,2,102,97.36842105263158,5.263157894736842
51119_marine,42,76,41,2,118,97.61904761904762,4.761904761904762
51120_marine,42,75,41,2,117,97.61904761904762,4.761904761904762
51121_marine,34,61,32,3,95,94.11764705882352,8.823529411764707
51122_marine,34,58,32,3,92,94.11764705882352,8.823529411764707
51123_marine,35,58,33,3,93,94.28571428571428,8.571428571428571
51124_marine,34,58,32,2,92,94.11764705882352,5.88235294117647
51125_marine,34,56,32,2,90,94.11764705882352,5.88235294117647
51126_marine,34,56,32,2,90,94.11764705882352,5.88235294117647
51127_marine,34,55,32,2,89,94.11764705882352,5.88235294117647
51128_marine,34,54,32,2,88,94.11764705882352,5.88235294117647
51129_marine,34,54,32,2,88,94.11764705882352,5.88235294117647
51130_marine,34,54,32,2,88,94.11764705882352,5.88235294117647
51131_marine,34,54,32,2,88,94.11764705882352,5.88235294117647
51132_marine,34,54,32,2,88,94.11764705882352,5.88235294117647
51133_marine,34,54,32,2,88,94.11764705882352,5.88235294117647
51134_marine,34,55,32,2,89,94.11764705882352,5.88235294117647
51135_marine,33,55,31,2,88,93.93939393939394,6.0606060606060606
51136_marine,33,54,31,2,87,93.93939393939394,6.0606060606060606
51137_marine,30,54,28,2,84,93.33333333333333,6.666666666666667
51138_marine,30,54,28,2,84,93.33333333333333,6.666666666666667
51139_marine,30,54,28,2,84,93.33333333333333,6.666666666666667
51140_marine,30,53,28,2,83,93.33333333333333,6.666666666666667
51141_marine,31,53,29,2,84,93.54838709677419,6.451612903225806
51142_marine,30,52,28,2,82,93.33333333333333,6.666666666666667
51143_marine,30,52,28,2,82,93.33333333333333,6.666666666666667
51144_marine,30,52,28,2,82,93.33333333333333,6.666666666666667
51145_marine,30,52,28,2,82,93.33333333333333,6.666666666666667
51146_marine,30,52,28,2,82,93.33333333333333,6.666666666666667
51147_marine,30,52,28,2,82,93.33333333333333,6.666666666666667
51148_marine,29,50,27,2,79,93.10344827586206,6.896551724137931
51149_marine,29,50,27,2,79,93.10344827586206,6.896551724137931
51150_marine,29,50,27,2,79,93.10344827586206,6.896551724137931
51151_marine,29,50,27,2,79,93.10344827586206,6.896551724137931
51152_marine,28,50,26,2,78,92.85714285714286,7.142857142857142
51153_marine,28,51,26,2,79,92.85714285714286,7.142857142857142
51154_marine,28,51,26,2,79,92.85714285714286,7.142857142857142
51155_marine,28,51,26,2,79,92.85714285714286,7.142857142857142
51156_marine,30,51,28,2,81,93.33333333333333,6.666666666666667
51157_marine,30,51,28,2,81,93.33333333333333,6.666666666666667
51158_marine,29,51,27,2,80,93.10344827586206,6.896551724137931
51159_marine,29,51,27,2,80,93.10344827586206,6.896551724137931
51160_marine,29,51,27,2,80,93.10344827586206,6.896551724137931
51161_marine,29,51,27,2,80,93.10344827586206,6.896551724137931
51162_marine,29,51,27,2,80,93.10344827586206,6.896551724137931
51163_marine,29,51,27,2,80,93.10344827586206,6.896551724137931
51164_marine,29,52,27,2,81,93.10344827586206,6.896551724137931
51165_marine,29,52,27,2,81,93.10344827586206,6.896551724137931
51166_marine,29,52,27,2,81,93.10344827586206,6.896551724137931
51167_marine,29,52,27,2,81,93.10344827586206,6.896551724137931
51168_marine,29,52,27,2,81,93.10344827586206,6.896551724137931
51169_marine,29,52,27,2,81,93.10344827586206,6.896551724137931
51170_marine,29,52,27,2,81,93.10344827586206,6.896551724137931
51171_marine,29,52,27,2,81,93.10344827586206,6.896551724137931
51172_marine,29,52,27,2,81,93.10344827586206,6.896551724137931
51173_marine,29,52,27,2,81,93.10344827586206,6.896551724137931
51174_marine,29,52,27,2,81,93.10344827586206,6.896551724137931
51175_marine,29,51,27,2,80,93.10344827586206,6.896551724137931
51176_marine,28,50,26,2,78,92.85714285714286,7.142857142857142
51177_marine,28,50,26,2,78,92.85714285714286,7.142857142857142
51178_marine,28,50,26,2,78,92.85714285714286,7.142857142857142
51179_marine,29,50,27,2,79,93.10344827586206,6.896551724137931
51180_marine,29,50,27,2,79,93.10344827586206,6.896551724137931
51181_marine,29,50,27,2,79,93.10344827586206,6.896551724137931
51182_marine,29,50,27,2,79,93.10344827586206,6.896551724137931
51183_marine,29,50,27,2,79,93.10344827586206,6.896551724137931
51184_marine,28,50,27,1,78,96.42857142857143,3.571428571428571
51185_marine,28,50,27,1,78,96.42857142857143,3.571428571428571
51186_marine,28,50,27,1,78,96.42857142857143,3.571428571428571
51187_marine,28,50,27,1,78,96.42857142857143,3.571428571428571
51188_marine,28,49,27,1,77,96.42857142857143,3.571428571428571
51189_marine,28,49,27,1,77,96.42857142857143,3.571428571428571
51190_marine,28,49,27,1,77,96.42857142857143,3.571428571428571
51191_marine,28,49,27,1,77,96.42857142857143,3.571428571428571
51192_marine,28,50,27,1,78,96.42857142857143,3.571428571428571
51193_marine,28,50,27,1,78,96.42857142857143,3.571428571428571
51194_marine,28,50,27,1,78,96.42857142857143,3.571428571428571
51195_marine,28,49,27,1,77,96.42857142857143,3.571428571428571
51196_marine,28,49,27,1,77,96.42857142857143,3.571428571428571
51197_marine,28,49,27,1,77,96.42857142857143,3.571428571428571
51198_marine,28,49,27,1,77,96.42857142857143,3.571428571428571
51199_marine,28,48,27,1,76,96.42857142857143,3.571428571428571
51200_marine,28,47,27,1,75,96.42857142857143,3.571428571428571
51201_marine,26,47,25,1,73,96.15384615384616,3.8461538461538463
51202_marine,26,47,25,1,73,96.15384615384616,3.8461538461538463
51203_marine,26,47,25,1,73,96.15384615384616,3.8461538461538463
51204_marine,26,49,25,1,75,96.15384615384616,3.8461538461538463
51205_marine,26,48,25,1,74,96.15384615384616,3.8461538461538463
51206_marine,26,48,25,1,74,96.15384615384616,3.8461538461538463
51207_marine,26,48,25,1,74,96.15384615384616,3.8461538461538463
51208_marine,27,48,26,1,75,96.29629629629629,3.7037037037037033
51209_marine,27,48,26,1,75,96.29629629629629,3.7037037037037033
51210_marine,27,48,26,1,75,96.29629629629629,3.7037037037037033
51211_marine,27,48,26,1,75,96.29629629629629,3.7037037037037033
51212_marine,26,48,26,0,74,100,0
51213_marine,26,48,26,0,74,100,0
51214_marine,26,48,25,1,74,96.15384615384616,3.8461538461538463
51215_marine,27,48,26,1,75,96.29629629629629,3.7037037037037033
51216_marine,27,48,26,1,75,96.29629629629629,3.7037037037037033
51217_marine,28,49,26,2,77,92.85714285714286,7.142857142857142
51218_marine,29,49,27,2,78,93.10344827586206,6.896551724137931
51219_marine,29,49,27,2,78,93.10344827586206,6.896551724137931
51220_marine,30,49,27,2,79,90,6.666666666666667
51221_marine,29,49,26,2,78,89.65517241379311,6.896551724137931
51222_marine,29,49,26,2,78,89.65517241379311,6.896551724137931
51223_marine,35,50,32,3,85,91.42857142857143,8.571428571428571
51224_marine,46,70,41,8,116,89.13043478260869,17.391304347826086
51225_marine,104,154,66,52,258,63.46153846153846,50
51226_marine,106,158,65,52,264,61.32075471698113,49.056603773584904
51227_marine,116,173,66,57,289,56.896551724137936,49.137931034482754
51228_marine,128,182,72,68,310,56.25,53.125
51229_marine,124,183,71,65,307,57.25806451612904,52.41935483870967
51230_marine,139,191,78,76,330,56.11510791366906,54.67625899280576
51231_marine,138,187,82,71,325,59.42028985507246,51.449275362318836
51232_marine,147,195,86,75,342,58.50340136054422,51.02040816326531
51233_marine,56,113,46,8,169,82.14285714285714,14.285714285714285
51234_marine,57,110,47,7,167,82.45614035087719,12.280701754385964
51235_marine,54,106,47,6,160,87.03703703703704,11.11111111111111
51236_marine,54,111,47,6,165,87.03703703703704,11.11111111111111
51237_marine,53,99,45,7,152,84.90566037735849,13.20754716981132
51238_marine,54,102,46,8,156,85.18518518518519,14.814814814814813
51239_marine,95,136,69,41,231,72.63157894736842,43.15789473684211
51240_marine,95,134,69,40,229,72.63157894736842,42.10526315789473
51241_marine,94,135,67,41,229,71.27659574468085,43.61702127659575
51242_marine,93,136,67,40,229,72.04301075268818,43.01075268817204
51243_marine,54,105,44,11,159,81.48148148148148,20.37037037037037
51244_marine,50,96,41,8,146,82,16
51245_marine,39,55,33,7,94,84.61538461538461,17.94871794871795
51246_marine,39,52,33,7,91,84.61538461538461,17.94871794871795
51247_marine,38,53,32,6,91,84.21052631578947,15.789473684210526
51248_marine,38,53,32,6,91,84.21052631578947,15.789473684210526
51249_marine,38,52,32,6,90,84.21052631578947,15.789473684210526
51250_marine,36,53,32,6,89,88.88888888888889,16.666666666666664
51251_marine,35,53,32,6,88,91.42857142857143,17.142857142857142
51252_marine,35,51,32,6,86,91.42857142857143,17.142857142857142
51253_marine,35,51,32,6,86,91.42857142857143,17.142857142857142
51254_marine,36,51,33,6,87,91.66666666666666,16.666666666666664
51255_marine,36,52,33,6,88,91.66666666666666,16.666666666666664
51256_marine,36,52,33,6,88,91.66666666666666,16.666666666666664
51257_marine,36,52,33,6,88,91.66666666666666,16.666666666666664
51258_marine,35,52,33,5,87,94.28571428571428,14.285714285714285
51259_marine,33,52,31,5,85,93.93939393939394,15.151515151515152
51260_marine,33,56,31,5,89,93.93939393939394,15.151515151515152
51261_marine,33,58,31,5,91,93.93939393939394,15.151515151515152
51262_marine,33,59,31,5,92,93.93939393939394,15.151515151515152
51263_marine,33,59,31,5,92,93.93939393939394,15.151515151515152
51264_marine,33,59,31,5,92,93.93939393939394,15.151515151515152
51265_marine,33,59,31,5,92,93.93939393939394,15.151515151515152
51266_marine,33,59,31,5,92,93.93939393939394,15.151515151515152
51267_marine,33,54,31,5,87,93.93939393939394,15.151515151515152
51268_marine,33,53,31,5,86,93.93939393939394,15.151515151515152
51269_marine,32,52,30,4,84,93.75,12.5
51270_marine,31,52,29,3,83,93.54838709677419,9.67741935483871
51271_marine,31,52,29,3,83,93.54838709677419,9.67741935483871
51272_marine,33,52,31,3,85,93.93939393939394,9.090909090909092
51273_marine,32,52,30,3,84,93.75,9.375
51274_marine,32,51,30,3,83,93.75,9.375
51275_marine,32,51,30,3,83,93.75,9.375
51276_marine,32,51,30,3,83,93.75,9.375
51277_marine,32,51,30,3,83,93.75,9.375
51278_marine,32,51,30,3,83,93.75,9.375
51279_marine,32,51,30,3,83,93.75,9.375
51280_marine,32,51,30,3,83,93.75,9.375
51281_marine,32,51,30,3,83,93.75,9.375
51282_marine,31,51,29,2,82,93.54838709677419,6.451612903225806
51283_marine,31,51,29,2,82,93.54838709677419,6.451612903225806
51284_marine,31,51,29,2,82,93.54838709677419,6.451612903225806
51285_marine,31,51,29,2,82,93.54838709677419,6.451612903225806
51286_marine,31,51,29,2,82,93.54838709677419,6.451612903225806
51287_marine,31,51,29,2,82,93.54838709677419,6.451612903225806
51288_marine,33,51,30,3,84,90.9090909090909,9.090909090909092
51289_marine,33,53,30,3,86,90.9090909090909,9.090909090909092
51290_marine,32,53,29,3,85,90.625,9.375
51291_marine,32,54,29,3,86,90.625,9.375
51292_marine,32,54,29,3,86,90.625,9.375
51293_marine,30,54,27,3,84,90,10
51294_marine,30,54,27,3,84,90,10
51295_marine,30,54,27,3,84,90,10
51296_marine,30,54,27,3,84,90,10
51297_marine,30,53,27,3,83,90,10
51298_marine,30,52,27,3,82,90,10
51299_marine,30,49,27,3,79,90,10
51300_marine,30,49,27,3,79,90,10
51301_marine,30,49,27,3,79,90,10
51302_marine,29,49,26,3,78,89.65517241379311,10.344827586206897
51303_marine,29,50,26,3,79,89.65517241379311,10.344827586206897
51304_marine,29,49,26,3,78,89.65517241379311,10.344827586206897
51305_marine,29,49,26,3,78,89.65517241379311,10.344827586206897
51306_marine,29,48,26,3,77,89.65517241379311,10.344827586206897
51307_marine,29,48,26,3,77,89.65517241379311,10.344827586206897
51308_marine,29,48,26,3,77,89.65517241379311,10.344827586206897
51309_marine,29,47,26,3,76,89.65517241379311,10.344827586206897
51310_marine,29,48,26,3,77,89.65517241379311,10.344827586206897
51311_marine,29,48,26,3,77,89.65517241379311,10.344827586206897
51312_marine,29,48,26,3,77,89.65517241379311,10.344827586206897
51313_marine,29,48,26,3,77,89.65517241379311,10.344827586206897
51314_marine,29,48,26,3,77,89.65517241379311,10.344827586206897
51315_marine,29,48,26,3,77,89.65517241379311,10.344827586206897
51316_marine,29,48,26,3,77,89.65517241379311,10.344827586206897
51317_marine,28,48,25,3,76,89.28571428571429,10.714285714285714
51318_marine,28,48,25,3,76,89.28571428571429,10.714285714285714
51319_marine,28,45,25,3,73,89.28571428571429,10.714285714285714
51320_marine,28,45,25,3,73,89.28571428571429,10.714285714285714
51321_marine,28,45,25,3,73,89.28571428571429,10.714285714285714
51322_marine,29,46,26,4,75,89.65517241379311,13.793103448275861
51323_marine,29,48,26,4,77,89.65517241379311,13.793103448275861
51324_marine,29,47,26,4,76,89.65517241379311,13.793103448275861
51325_marine,29,48,26,4,77,89.65517241379311,13.793103448275861
51326_marine,29,46,26,4,75,89.65517241379311,13.793103448275861
51327_marine,30,46,27,5,76,90,16.666666666666664
51328_marine,30,47,27,5,77,90,16.666666666666664
51329_marine,30,47,27,5,77,90,16.666666666666664
51330_marine,30,47,27,5,77,90,16.666666666666664
51331_marine,30,47,27,5,77,90,16.666666666666664
51332_marine,30,47,27,5,77,90,16.666666666666664
51333_marine,30,47,27,5,77,90,16.666666666666664
51334_marine,30,47,27,5,77,90,16.666666666666664
51335_marine,30,47,27,5,77,90,16.666666666666664
51336_marine,30,46,27,5,76,90,16.666666666666664
51337_marine,30,46,27,5,76,90,16.666666666666664
51338_marine,30,48,27,5,78,90,16.666666666666664
51339_marine,30,48,27,5,78,90,16.666666666666664
51340_marine,30,48,27,5,78,90,16.666666666666664
51341_marine,30,48,27,5,78,90,16.666666666666664
51342_marine,30,48,27,5,78,90,16.666666666666664
51343_marine,31,48,28,6,79,90.32258064516128,19.35483870967742
51344_marine,31,48,28,6,79,90.32258064516128,19.35483870967742
51345_marine,31,49,28,6,80,90.32258064516128,19.35483870967742
51346_marine,31,49,28,6,80,90.32258064516128,19.35483870967742
51347_marine,33,49,30,6,82,90.9090909090909,18.181818181818183
51348_marine,33,49,30,6,82,90.9090909090909,18.181818181818183
51349_marine,33,49,30,6,82,90.9090909090909,18.181818181818183
51350_marine,33,48,30,6,81,90.9090909090909,18.181818181818183
51351_marine,33,48,30,6,81,90.9090909090909,18.181818181818183
51352_marine,33,48,30,6,81,90.9090909090909,18.181818181818183
51353_marine,33,48,30,6,81,90.9090909090909,18.181818181818183
51354_marine,33,49,30,6,82,90.9090909090909,18.181818181818183
51355_marine,33,49,30,6,82,90.9090909090909,18.181818181818183
51356_marine,33,49,30,6,82,90.9090909090909,18.181818181818183
51357_marine,33,51,30,6,84,90.9090909090909,18.181818181818183
51358_marine,33,51,30,6,84,90.9090909090909,18.181818181818183
51359_marine,32,51,30,5,83,93.75,15.625
51360_marine,32,51,30,5,83,93.75,15.625
51361_marine,32,51,30,5,83,93.75,15.625
51362_marine,32,52,30,5,84,93.75,15.625
51363_marine,30,55,28,5,85,93.33333333333333,16.666666666666664
51364_marine,30,55,28,5,85,93.33333333333333,16.666666666666664
51365_marine,30,55,28,5,85,93.33333333333333,16.666666666666664
51366_marine,30,55,28,5,85,93.33333333333333,16.666666666666664
51367_marine,30,55,28,5,85,93.33333333333333,16.666666666666664
51368_marine,30,55,28,5,85,93.33333333333333,16.666666666666664
51369_marine,30,57,28,5,87,93.33333333333333,16.666666666666664
51370_marine,30,57,28,5,87,93.33333333333333,16.666666666666664
51371_marine,30,64,28,5,94,93.33333333333333,16.666666666666664
51372_marine,32,65,28,5,97,87.5,15.625
51373_marine,32,66,28,5,98,87.5,15.625
51374_marine,42,76,35,12,118,83.33333333333334,28.57142857142857
51375_marine,33,66,28,6,99,84.84848484848484,18.181818181818183
51376_marine,30,63,28,5,93,93.33333333333333,16.666666666666664
51377_marine,30,61,28,5,91,93.33333333333333,16.666666666666664
51378_marine,30,61,28,5,91,93.33333333333333,16.666666666666664
51379_marine,30,61,28,5,91,93.33333333333333,16.666666666666664
51380_marine,30,61,28,5,91,93.33333333333333,16.666666666666664
51381_marine,30,60,28,5,90,93.33333333333333,16.666666666666664
51382_marine,30,58,28,5,88,93.33333333333333,16.666666666666664
51383_marine,31,56,29,5,87,93.54838709677419,16.129032258064516
51384_marine,31,53,29,5,84,93.54838709677419,16.129032258064516
51385_marine,30,53,28,4,83,93.33333333333333,13.333333333333334
51386_marine,30,51,28,4,81,93.33333333333333,13.333333333333334
51387_marine,30,51,28,4,81,93.33333333333333,13.333333333333334
51388_marine,30,51,28,4,81,93.33333333333333,13.333333333333334
51389_marine,30,50,28,4,80,93.33333333333333,13.333333333333334
51390_marine,31,50,29,4,81,93.54838709677419,12.903225806451612
51391_marine,31,49,29,4,80,93.54838709677419,12.903225806451612
51392_marine,31,49,29,4,80,93.54838709677419,12.903225806451612
51393_marine,31,49,29,4,80,93.54838709677419,12.903225806451612
51394_marine,31,49,29,4,80,93.54838709677419,12.903225806451612
51395_marine,31,49,29,4,80,93.54838709677419,12.903225806451612
51396_marine,31,49,29,4,80,93.54838709677419,12.903225806451612
51397_marine,31,49,29,4,80,93.54838709677419,12.903225806451612
51398_marine,31,49,29,4,80,93.54838709677419,12.903225806451612
51399_marine,31,49,29,4,80,93.54838709677419,12.903225806451612
51400_marine,31,49,29,4,80,93.54838709677419,12.903225806451612
51401_marine,31,50,29,4,81,93.54838709677419,12.903225806451612
51402_marine,31,50,29,4,81,93.54838709677419,12.903225806451612
51403_marine,31,50,29,4,81,93.54838709677419,12.903225806451612
51404_marine,31,50,29,4,81,93.54838709677419,12.903225806451612
51405_marine,31,50,29,4,81,93.54838709677419,12.903225806451612
51406_marine,30,51,28,3,81,93.33333333333333,10
51407_marine,30,51,28,3,81,93.33333333333333,10
51408_marine,30,51,28,3,81,93.33333333333333,10
51409_marine,30,51,28,3,81,93.33333333333333,10
51410_marine,30,51,28,3,81,93.33333333333333,10
51411_marine,30,51,28,3,81,93.33333333333333,10
51412_marine,30,51,28,3,81,93.33333333333333,10
51413_marine,30,51,28,3,81,93.33333333333333,10
51414_marine,30,51,28,3,81,93.33333333333333,10
51415_marine,30,51,28,3,81,93.33333333333333,10
51416_marine,30,51,28,3,81,93.33333333333333,10
51417_marine,31,53,29,4,84,93.54838709677419,12.903225806451612
51418_marine,31,53,29,4,84,93.54838709677419,12.903225806451612
51419_marine,31,53,29,4,84,93.54838709677419,12.903225806451612
51420_marine,30,53,29,3,83,96.66666666666667,10
51421_marine,30,52,29,3,82,96.66666666666667,10
51422_marine,30,52,29,3,82,96.66666666666667,10
51423_marine,30,52,29,3,82,96.66666666666667,10
51424_marine,30,52,29,3,82,96.66666666666667,10
51425_marine,30,52,29,3,82,96.66666666666667,10
51426_marine,30,53,29,3,83,96.66666666666667,10
51427_marine,30,53,29,3,83,96.66666666666667,10
51428_marine,30,53,29,3,83,96.66666666666667,10
51429_marine,30,53,29,3,83,96.66666666666667,10
51430_marine,30,54,29,3,84,96.66666666666667,10
51431_marine,31,54,30,2,85,96.7741935483871,6.451612903225806
51432_marine,31,52,30,2,83,96.7741935483871,6.451612903225806
51433_marine,33,52,32,2,85,96.96969696969697,6.0606060606060606
51434_marine,33,52,32,2,85,96.96969696969697,6.0606060606060606
51435_marine,32,52,31,2,84,96.875,6.25
51436_marine,32,52,31,2,84,96.875,6.25
51437_marine,32,53,31,2,85,96.875,6.25
51438_marine,33,53,32,3,86,96.96969696969697,9.090909090909092
51439_marine,33,53,32,3,86,96.96969696969697,9.090909090909092
51440_marine,33,53,32,3,86,96.96969696969697,9.090909090909092
51441_marine,33,54,32,3,87,96.96969696969697,9.090909090909092
51442_marine,35,55,34,3,90,97.14285714285714,8.571428571428571
51443_marine,34,57,34,2,91,100,5.88235294117647
51444_marine,34,59,34,2,93,100,5.88235294117647
51445_marine,34,61,34,2,95,100,5.88235294117647
51446_marine,35,63,35,2,98,100,5.714285714285714
51447_marine,35,62,35,2,97,100,5.714285714285714
51448_marine,35,62,35,2,97,100,5.714285714285714
51449_marine,36,62,36,2,98,100,5.555555555555555
51450_marine,37,62,37,2,99,100,5.405405405405405
51451_marine,37,62,37,2,99,100,5.405405405405405
51452_marine,38,62,37,3,100,97.36842105263158,7.894736842105263
51453_marine,37,63,36,3,100,97.2972972972973,8.108108108108109
51454_marine,37,63,36,3,100,97.2972972972973,8.108108108108109
51455_marine,37,64,36,3,101,97.2972972972973,8.108108108108109
51456_marine,37,64,36,3,101,97.2972972972973,8.108108108108109
51457_marine,37,66,35,2,103,94.5945945945946,5.405405405405405
51458_marine,38,67,36,3,105,94.73684210526315,7.894736842105263
51459_marine,38,71,36,3,109,94.73684210526315,7.894736842105263
51460_marine,37,71,35,3,108,94.5945945945946,8.108108108108109
51461_marine,39,68,37,3,107,94.87179487179486,7.6923076923076925
51462_marine,39,66,37,3,105,94.87179487179486,7.6923076923076925
51463_marine,39,67,37,3,106,94.87179487179486,7.6923076923076925
51464_marine,38,67,37,3,105,97.36842105263158,7.894736842105263
51465_marine,40,80,39,3,120,97.5,7.5
51466_marine,42,93,41,3,135,97.61904761904762,7.142857142857142
51467_marine,41,98,40,3,139,97.5609756097561,7.317073170731707
51468_marine,43,91,41,4,134,95.34883720930233,9.30232558139535
51469_marine,59,103,53,10,162,89.83050847457628,16.94915254237288
51470_marine,81,121,69,24,202,85.18518518518519,29.629629629629626
51471_marine,53,102,50,7,155,94.33962264150944,13.20754716981132
51472_marine,42,90,40,6,132,95.23809523809523,14.285714285714285
51473_marine,41,87,39,4,128,95.1219512195122,9.75609756097561
51474_marine,41,88,39,4,129,95.1219512195122,9.75609756097561
51475_marine,40,81,38,4,121,95,10
51476_marine,37,65,35,3,102,94.5945945945946,8.108108108108109
51477_marine,39,64,37,3,103,94.87179487179486,7.6923076923076925
51478_marine,39,63,37,3,102,94.87179487179486,7.6923076923076925
51479_marine,39,63,37,3,102,94.87179487179486,7.6923076923076925
51480_marine,38,62,36,3,100,94.73684210526315,7.894736842105263
51481_marine,34,59,32,3,93,94.11764705882352,8.823529411764707
51482_marine,33,58,31,2,91,93.93939393939394,6.0606060606060606
51483_marine,33,58,31,2,91,93.93939393939394,6.0606060606060606
51484_marine,33,57,31,2,90,93.93939393939394,6.0606060606060606
51485_marine,34,57,32,2,91,94.11764705882352,5.88235294117647
51486_marine,34,56,32,2,90,94.11764705882352,5.88235294117647
51487_marine,34,56,32,2,90,94.11764705882352,5.88235294117647
51488_marine,34,55,32,2,89,94.11764705882352,5.88235294117647
51489_marine,34,54,32,2,88,94.11764705882352,5.88235294117647
51490_marine,34,54,32,2,88,94.11764705882352,5.88235294117647
51491_marine,33,54,31,2,87,93.93939393939394,6.0606060606060606
51492_marine,33,54,31,2,87,93.93939393939394,6.0606060606060606
51493_marine,31,54,29,2,85,93.54838709677419,6.451612903225806
51494_marine,31,54,29,2,85,93.54838709677419,6.451612903225806
51495_marine,31,52,29,2,83,93.54838709677419,6.451612903225806
51496_marine,31,51,29,2,82,93.54838709677419,6.451612903225806
51497_marine,30,51,28,2,81,93.33333333333333,6.666666666666667
51498_marine,30,51,28,2,81,93.33333333333333,6.666666666666667
51499_marine,30,51,28,2,81,93.33333333333333,6.666666666666667
51500_marine,30,50,28,2,80,93.33333333333333,6.666666666666667
51501_marine,30,50,28,2,80,93.33333333333333,6.666666666666667
51502_marine,29,50,27,2,79,93.10344827586206,6.896551724137931
51503_marine,29,50,27,2,79,93.10344827586206,6.896551724137931
51504_marine,29,50,27,2,79,93.10344827586206,6.896551724137931
51505_marine,29,50,27,2,79,93.10344827586206,6.896551724137931
51506_marine,29,51,27,2,80,93.10344827586206,6.896551724137931
51507_marine,28,51,26,2,79,92.85714285714286,7.142857142857142
51508_marine,28,51,26,2,79,92.85714285714286,7.142857142857142
51509_marine,28,52,26,2,80,92.85714285714286,7.142857142857142
51510_marine,28,52,26,2,80,92.85714285714286,7.142857142857142
51511_marine,28,52,26,2,80,92.85714285714286,7.142857142857142
51512_marine,28,50,26,2,78,92.85714285714286,7.142857142857142
51513_marine,28,50,26,2,78,92.85714285714286,7.142857142857142
51514_marine,28,50,26,2,78,92.85714285714286,7.142857142857142
51515_marine,28,50,26,2,78,92.85714285714286,7.142857142857142
51516_marine,28,50,26,2,78,92.85714285714286,7.142857142857142
51517_marine,29,50,27,2,79,93.10344827586206,6.896551724137931
51518_marine,29,50,27,2,79,93.10344827586206,6.896551724137931
51519_marine,29,50,27,2,79,93.10344827586206,6.896551724137931
51520_marine,29,50,27,2,79,93.10344827586206,6.896551724137931
51521_marine,29,50,27,2,79,93.10344827586206,6.896551724137931
51522_marine,29,50,27,2,79,93.10344827586206,6.896551724137931
51523_marine,29,50,27,2,79,93.10344827586206,6.896551724137931
51524_marine,29,51,27,2,80,93.10344827586206,6.896551724137931
51525_marine,29,51,27,2,80,93.10344827586206,6.896551724137931
51526_marine,29,51,27,2,80,93.10344827586206,6.896551724137931
51527_marine,29,50,27,2,79,93.10344827586206,6.896551724137931
51528_marine,28,50,26,2,78,92.85714285714286,7.142857142857142
51529_marine,28,50,26,2,78,92.85714285714286,7.142857142857142
51530_marine,28,50,26,2,78,92.85714285714286,7.142857142857142
51531_marine,28,50,26,2,78,92.85714285714286,7.142857142857142
51532_marine,28,50,26,2,78,92.85714285714286,7.142857142857142
51533_marine,28,50,26,2,78,92.85714285714286,7.142857142857142
51534_marine,28,50,26,2,78,92.85714285714286,7.142857142857142
51535_marine,28,50,26,2,78,92.85714285714286,7.142857142857142
51536_marine,28,50,26,2,78,92.85714285714286,7.142857142857142
51537_marine,28,50,26,2,78,92.85714285714286,7.142857142857142
51538_marine,28,50,26,2,78,92.85714285714286,7.142857142857142
51539_marine,28,50,26,2,78,92.85714285714286,7.142857142857142
51540_marine,28,50,26,2,78,92.85714285714286,7.142857142857142
51541_marine,28,51,26,2,79,92.85714285714286,7.142857142857142
51542_marine,28,51,26,2,79,92.85714285714286,7.142857142857142
51543_marine,28,51,26,2,79,92.85714285714286,7.142857142857142
51544_marine,28,51,26,2,79,92.85714285714286,7.142857142857142
51545_marine,28,51,26,2,79,92.85714285714286,7.142857142857142
51546_marine,28,51,26,2,79,92.85714285714286,7.142857142857142
51547_marine,28,51,26,2,79,92.85714285714286,7.142857142857142
51548_marine,28,51,26,2,79,92.85714285714286,7.142857142857142
51549_marine,28,51,26,2,79,92.85714285714286,7.142857142857142
51550_marine,28,51,26,2,79,92.85714285714286,7.142857142857142
51551_marine,28,51,26,2,79,92.85714285714286,7.142857142857142
51552_marine,28,51,26,2,79,92.85714285714286,7.142857142857142
51553_marine,29,51,27,2,80,93.10344827586206,6.896551724137931
51554_marine,28,50,26,2,78,92.85714285714286,7.142857142857142
51555_marine,28,48,26,2,76,92.85714285714286,7.142857142857142
51556_marine,28,48,26,2,76,92.85714285714286,7.142857142857142
51557_marine,28,48,26,2,76,92.85714285714286,7.142857142857142
51558_marine,28,48,26,2,76,92.85714285714286,7.142857142857142
51559_marine,27,48,25,2,75,92.5925925925926,7.4074074074074066
51560_marine,27,49,25,2,76,92.5925925925926,7.4074074074074066
51561_marine,27,48,25,2,75,92.5925925925926,7.4074074074074066
51562_marine,27,48,25,2,75,92.5925925925926,7.4074074074074066
51563_marine,27,46,25,2,73,92.5925925925926,7.4074074074074066
51564_marine,27,46,25,2,73,92.5925925925926,7.4074074074074066
51565_marine,27,47,25,2,74,92.5925925925926,7.4074074074074066
51566_marine,27,47,25,2,74,92.5925925925926,7.4074074074074066
51567_marine,27,47,25,2,74,92.5925925925926,7.4074074074074066
51568_marine,27,47,25,2,74,92.5925925925926,7.4074074074074066
51569_marine,26,47,25,1,73,96.15384615384616,3.8461538461538463
51570_marine,26,47,25,1,73,96.15384615384616,3.8461538461538463
51571_marine,26,47,25,1,73,96.15384615384616,3.8461538461538463
51572_marine,26,47,25,1,73,96.15384615384616,3.8461538461538463
51573_marine,26,47,25,1,73,96.15384615384616,3.8461538461538463
51574_marine,26,47,25,1,73,96.15384615384616,3.8461538461538463
51575_marine,27,47,26,1,74,96.29629629629629,3.7037037037037033
51576_marine,27,47,26,1,74,96.29629629629629,3.7037037037037033
51577_marine,28,47,26,2,75,92.85714285714286,7.142857142857142
51578_marine,28,49,26,2,77,92.85714285714286,7.142857142857142
51579_marine,28,49,26,2,77,92.85714285714286,7.142857142857142
51580_marine,29,49,26,2,78,89.65517241379311,6.896551724137931
51581_marine,30,49,27,3,79,90,10
51582_marine,30,49,27,3,79,90,10
51583_marine,33,50,30,3,83,90.9090909090909,9.090909090909092
51584_marine,39,51,34,7,90,87.17948717948718,17.94871794871795
51585_marine,51,94,45,9,145,88.23529411764706,17.647058823529413
51586_marine,109,154,67,55,263,61.46788990825688,50.45871559633027
51587_marine,117,175,68,59,292,58.119658119658126,50.427350427350426
51588_marine,122,174,68,62,296,55.73770491803278,50.81967213114754
51589_marine,127,189,73,66,316,57.48031496062992,51.96850393700787
51590_marine,136,199,77,73,335,56.61764705882353,53.67647058823529
51591_marine,120,163,70,66,283,58.333333333333336,55.00000000000001
51592_marine,127,160,79,65,287,62.20472440944882,51.181102362204726
51593_marine,123,157,75,64,280,60.97560975609756,52.03252032520326
51594_marine,54,106,46,8,160,85.18518518518519,14.814814814814813
51595_marine,55,108,47,8,163,85.45454545454545,14.545454545454545
51596_marine,57,112,46,8,169,80.7017543859649,14.035087719298245
51597_marine,56,106,47,8,162,83.92857142857143,14.285714285714285
51598_marine,49,83,41,7,132,83.6734693877551,14.285714285714285
51599_marine,50,100,42,8,150,84,16
51600_marine,50,99,41,9,149,82,18
51601_marine,53,100,43,10,153,81.13207547169812,18.867924528301888
51602_marine,51,99,41,10,150,80.3921568627451,19.607843137254903
51603_marine,46,76,37,9,122,80.43478260869566,19.565217391304348
51604_marine,43,58,35,7,101,81.3953488372093,16.27906976744186
51605_marine,39,54,33,7,93,84.61538461538461,17.94871794871795
51606_marine,39,51,33,7,90,84.61538461538461,17.94871794871795
51607_marine,38,53,32,6,91,84.21052631578947,15.789473684210526
51608_marine,36,50,32,6,86,88.88888888888889,16.666666666666664
51609_marine,36,50,32,6,86,88.88888888888889,16.666666666666664
51610_marine,35,50,32,6,85,91.42857142857143,17.142857142857142
51611_marine,35,50,32,6,85,91.42857142857143,17.142857142857142
51612_marine,35,50,32,6,85,91.42857142857143,17.142857142857142
51613_marine,36,50,33,6,86,91.66666666666666,16.666666666666664
51614_marine,36,50,33,6,86,91.66666666666666,16.666666666666664
51615_marine,35,50,32,6,85,91.42857142857143,17.142857142857142
51616_marine,35,51,32,6,86,91.42857142857143,17.142857142857142
51617_marine,34,55,31,6,89,91.17647058823529,17.647058823529413
51618_marine,34,58,31,6,92,91.17647058823529,17.647058823529413
51619_marine,36,59,32,8,95,88.88888888888889,22.22222222222222
51620_marine,34,60,31,6,94,91.17647058823529,17.647058823529413
51621_marine,34,64,31,6,98,91.17647058823529,17.647058823529413
51622_marine,48,80,41,15,128,85.41666666666666,31.25
51623_marine,48,80,41,14,128,85.41666666666666,29.166666666666668
51624_marine,35,63,31,7,98,88.57142857142857,20
51625_marine,34,63,31,6,97,91.17647058823529,17.647058823529413
51626_marine,84,60,31,56,144,36.904761904761905,66.66666666666666
51627_marine,33,59,31,5,92,93.93939393939394,15.151515151515152
51628_marine,33,59,31,5,92,93.93939393939394,15.151515151515152
51629_marine,33,58,31,5,91,93.93939393939394,15.151515151515152
51630_marine,31,56,29,4,87,93.54838709677419,12.903225806451612
51631_marine,31,52,29,4,83,93.54838709677419,12.903225806451612
51632_marine,31,52,29,4,83,93.54838709677419,12.903225806451612
51633_marine,30,50,28,3,80,93.33333333333333,10
51634_marine,30,50,28,3,80,93.33333333333333,10
51635_marine,30,50,28,3,80,93.33333333333333,10
51636_marine,30,50,28,3,80,93.33333333333333,10
51637_marine,30,49,28,3,79,93.33333333333333,10
51638_marine,30,49,28,3,79,93.33333333333333,10
51639_marine,30,49,28,3,79,93.33333333333333,10
51640_marine,30,49,28,3,79,93.33333333333333,10
51641_marine,30,49,28,3,79,93.33333333333333,10
51642_marine,30,49,28,3,79,93.33333333333333,10
51643_marine,30,49,28,3,79,93.33333333333333,10
51644_marine,31,49,28,4,80,90.32258064516128,12.903225806451612
51645_marine,31,49,28,4,80,90.32258064516128,12.903225806451612
51646_marine,30,49,27,3,79,90,10
51647_marine,29,49,26,3,78,89.65517241379311,10.344827586206897
51648_marine,29,49,26,3,78,89.65517241379311,10.344827586206897
51649_marine,29,49,26,3,78,89.65517241379311,10.344827586206897
51650_marine,29,50,26,3,79,89.65517241379311,10.344827586206897
51651_marine,29,49,26,3,78,89.65517241379311,10.344827586206897
51652_marine,29,49,26,3,78,89.65517241379311,10.344827586206897
51653_marine,30,50,27,3,80,90,10
51654_marine,30,48,27,3,78,90,10
51655_marine,30,48,27,3,78,90,10
51656_marine,30,45,27,3,75,90,10
51657_marine,30,44,27,3,74,90,10
51658_marine,30,44,27,3,74,90,10
51659_marine,30,44,27,3,74,90,10
51660_marine,30,44,27,3,74,90,10
51661_marine,30,44,27,3,74,90,10
51662_marine,29,45,26,3,74,89.65517241379311,10.344827586206897
51663_marine,29,45,26,3,74,89.65517241379311,10.344827586206897
51664_marine,29,45,26,3,74,89.65517241379311,10.344827586206897
51665_marine,29,44,26,3,73,89.65517241379311,10.344827586206897
51666_marine,29,44,26,3,73,89.65517241379311,10.344827586206897
51667_marine,29,42,26,3,71,89.65517241379311,10.344827586206897
51668_marine,29,42,26,3,71,89.65517241379311,10.344827586206897
51669_marine,29,42,26,3,71,89.65517241379311,10.344827586206897
51670_marine,29,43,26,3,72,89.65517241379311,10.344827586206897
51671_marine,29,44,26,3,73,89.65517241379311,10.344827586206897
51672_marine,29,44,26,3,73,89.65517241379311,10.344827586206897
51673_marine,29,44,26,3,73,89.65517241379311,10.344827586206897
51674_marine,29,44,26,3,73,89.65517241379311,10.344827586206897
51675_marine,29,44,26,3,73,89.65517241379311,10.344827586206897
51676_marine,28,43,25,3,71,89.28571428571429,10.714285714285714
51677_marine,28,43,25,3,71,89.28571428571429,10.714285714285714
51678_marine,28,43,25,3,71,89.28571428571429,10.714285714285714
51679_marine,29,43,26,4,72,89.65517241379311,13.793103448275861
51680_marine,29,43,26,4,72,89.65517241379311,13.793103448275861
51681_marine,29,43,26,4,72,89.65517241379311,13.793103448275861
51682_marine,29,42,26,4,71,89.65517241379311,13.793103448275861
51683_marine,30,43,27,5,73,90,16.666666666666664
51684_marine,30,45,27,5,75,90,16.666666666666664
51685_marine,30,45,27,5,75,90,16.666666666666664
51686_marine,30,45,27,5,75,90,16.666666666666664
51687_marine,30,45,27,5,75,90,16.666666666666664
51688_marine,30,45,27,5,75,90,16.666666666666664
51689_marine,30,46,27,5,76,90,16.666666666666664
51690_marine,30,44,27,5,74,90,16.666666666666664
51691_marine,30,46,27,5,76,90,16.666666666666664
51692_marine,30,46,27,5,76,90,16.666666666666664
51693_marine,30,46,27,5,76,90,16.666666666666664
51694_marine,30,46,27,5,76,90,16.666666666666664
51695_marine,30,46,27,5,76,90,16.666666666666664
51696_marine,30,46,27,5,76,90,16.666666666666664
51697_marine,30,46,27,5,76,90,16.666666666666664
51698_marine,30,46,27,5,76,90,16.666666666666664
51699_marine,30,46,27,5,76,90,16.666666666666664
51700_marine,30,46,27,5,76,90,16.666666666666664
51701_marine,30,48,27,5,78,90,16.666666666666664
51702_marine,30,48,27,5,78,90,16.666666666666664
51703_marine,30,48,27,5,78,90,16.666666666666664
51704_marine,30,48,27,5,78,90,16.666666666666664
51705_marine,30,48,27,5,78,90,16.666666666666664
51706_marine,31,48,28,6,79,90.32258064516128,19.35483870967742
51707_marine,31,47,28,6,78,90.32258064516128,19.35483870967742
51708_marine,31,47,28,6,78,90.32258064516128,19.35483870967742
51709_marine,31,47,28,6,78,90.32258064516128,19.35483870967742
51710_marine,31,47,28,6,78,90.32258064516128,19.35483870967742
51711_marine,31,47,28,6,78,90.32258064516128,19.35483870967742
51712_marine,31,47,28,6,78,90.32258064516128,19.35483870967742
51713_marine,31,47,28,6,78,90.32258064516128,19.35483870967742
51714_marine,31,47,28,6,78,90.32258064516128,19.35483870967742
51715_marine,31,48,28,6,79,90.32258064516128,19.35483870967742
51716_marine,31,48,28,6,79,90.32258064516128,19.35483870967742
51717_marine,31,49,28,6,80,90.32258064516128,19.35483870967742
51718_marine,31,49,28,6,80,90.32258064516128,19.35483870967742
51719_marine,31,49,28,6,80,90.32258064516128,19.35483870967742
51720_marine,31,49,28,6,80,90.32258064516128,19.35483870967742
51721_marine,31,49,28,6,80,90.32258064516128,19.35483870967742
51722_marine,31,49,28,6,80,90.32258064516128,19.35483870967742
51723_marine,31,49,28,6,80,90.32258064516128,19.35483870967742
51724_marine,31,49,28,6,80,90.32258064516128,19.35483870967742
51725_marine,31,50,28,6,81,90.32258064516128,19.35483870967742
51726_marine,31,53,28,6,84,90.32258064516128,19.35483870967742
51727_marine,31,53,28,6,84,90.32258064516128,19.35483870967742
51728_marine,31,53,28,6,84,90.32258064516128,19.35483870967742
51729_marine,31,53,28,6,84,90.32258064516128,19.35483870967742
51730_marine,31,53,28,6,84,90.32258064516128,19.35483870967742
51731_marine,30,53,28,5,83,93.33333333333333,16.666666666666664
51732_marine,32,59,28,5,91,87.5,15.625
51733_marine,36,63,30,8,99,83.33333333333334,22.22222222222222
51734_marine,42,70,35,12,112,83.33333333333334,28.57142857142857
51735_marine,33,62,28,6,95,84.84848484848484,18.181818181818183
51736_marine,30,58,28,5,88,93.33333333333333,16.666666666666664
51737_marine,30,59,28,5,89,93.33333333333333,16.666666666666664
51738_marine,30,59,28,5,89,93.33333333333333,16.666666666666664
51739_marine,30,55,28,5,85,93.33333333333333,16.666666666666664
51740_marine,30,56,28,5,86,93.33333333333333,16.666666666666664
51741_marine,30,55,28,5,85,93.33333333333333,16.666666666666664
51742_marine,31,55,29,5,86,93.54838709677419,16.129032258064516
51743_marine,30,53,28,4,83,93.33333333333333,13.333333333333334
51744_marine,30,53,28,4,83,93.33333333333333,13.333333333333334
51745_marine,30,52,28,4,82,93.33333333333333,13.333333333333334
51746_marine,30,49,28,4,79,93.33333333333333,13.333333333333334
51747_marine,30,48,28,4,78,93.33333333333333,13.333333333333334
51748_marine,30,47,28,4,77,93.33333333333333,13.333333333333334
51749_marine,30,47,28,4,77,93.33333333333333,13.333333333333334
51750_marine,31,46,29,4,77,93.54838709677419,12.903225806451612
51751_marine,31,48,29,4,79,93.54838709677419,12.903225806451612
51752_marine,31,48,29,4,79,93.54838709677419,12.903225806451612
51753_marine,31,48,29,4,79,93.54838709677419,12.903225806451612
51754_marine,31,49,29,4,80,93.54838709677419,12.903225806451612
51755_marine,31,49,29,4,80,93.54838709677419,12.903225806451612
51756_marine,31,49,29,4,80,93.54838709677419,12.903225806451612
51757_marine,31,49,29,4,80,93.54838709677419,12.903225806451612
51758_marine,31,49,29,4,80,93.54838709677419,12.903225806451612
51759_marine,31,49,29,4,80,93.54838709677419,12.903225806451612
51760_marine,31,49,29,4,80,93.54838709677419,12.903225806451612
51761_marine,31,50,29,4,81,93.54838709677419,12.903225806451612
51762_marine,31,50,29,4,81,93.54838709677419,12.903225806451612
51763_marine,31,50,29,4,81,93.54838709677419,12.903225806451612
51764_marine,31,50,29,4,81,93.54838709677419,12.903225806451612
51765_marine,31,50,29,4,81,93.54838709677419,12.903225806451612
51766_marine,30,50,29,3,80,96.66666666666667,10
51767_marine,30,50,29,3,80,96.66666666666667,10
51768_marine,30,51,29,3,81,96.66666666666667,10
51769_marine,30,51,29,3,81,96.66666666666667,10
51770_marine,30,50,29,3,80,96.66666666666667,10
51771_marine,30,50,29,3,80,96.66666666666667,10
51772_marine,30,50,29,3,80,96.66666666666667,10
51773_marine,30,50,29,3,80,96.66666666666667,10
51774_marine,30,50,29,3,80,96.66666666666667,10
51775_marine,30,50,29,3,80,96.66666666666667,10
51776_marine,30,50,29,3,80,96.66666666666667,10
51777_marine,30,50,29,3,80,96.66666666666667,10
51778_marine,30,50,29,3,80,96.66666666666667,10
51779_marine,30,50,29,3,80,96.66666666666667,10
51780_marine,30,50,29,3,80,96.66666666666667,10
51781_marine,30,50,29,3,80,96.66666666666667,10
51782_marine,30,50,29,3,80,96.66666666666667,10
51783_marine,30,50,29,3,80,96.66666666666667,10
51784_marine,30,52,29,3,82,96.66666666666667,10
51785_marine,30,52,29,3,82,96.66666666666667,10
51786_marine,31,52,30,3,83,96.7741935483871,9.67741935483871
51787_marine,31,52,30,3,83,96.7741935483871,9.67741935483871
51788_marine,31,52,30,3,83,96.7741935483871,9.67741935483871
51789_marine,31,52,30,3,83,96.7741935483871,9.67741935483871
51790_marine,31,52,30,3,83,96.7741935483871,9.67741935483871
51791_marine,31,54,30,3,85,96.7741935483871,9.67741935483871
51792_marine,30,54,29,3,84,96.66666666666667,10
51793_marine,30,54,29,3,84,96.66666666666667,10
51794_marine,31,54,30,3,85,96.7741935483871,9.67741935483871
51795_marine,31,54,30,3,85,96.7741935483871,9.67741935483871
51796_marine,31,54,30,3,85,96.7741935483871,9.67741935483871
51797_marine,31,54,30,3,85,96.7741935483871,9.67741935483871
51798_marine,33,55,32,3,88,96.96969696969697,9.090909090909092
51799_marine,33,55,32,3,88,96.96969696969697,9.090909090909092
51800_marine,33,54,32,3,87,96.96969696969697,9.090909090909092
51801_marine,33,55,32,3,88,96.96969696969697,9.090909090909092
51802_marine,33,56,32,3,89,96.96969696969697,9.090909090909092
51803_marine,35,56,34,3,91,97.14285714285714,8.571428571428571
51804_marine,35,56,34,3,91,97.14285714285714,8.571428571428571
51805_marine,35,58,34,3,93,97.14285714285714,8.571428571428571
51806_marine,35,62,34,3,97,97.14285714285714,8.571428571428571
51807_marine,35,63,34,3,98,97.14285714285714,8.571428571428571
51808_marine,35,63,34,3,98,97.14285714285714,8.571428571428571
51809_marine,36,63,35,3,99,97.22222222222221,8.333333333333332
51810_marine,36,64,35,3,100,97.22222222222221,8.333333333333332
51811_marine,36,64,35,3,100,97.22222222222221,8.333333333333332
51812_marine,38,64,37,3,102,97.36842105263158,7.894736842105263
51813_marine,36,64,35,3,100,97.22222222222221,8.333333333333332
51814_marine,36,65,35,3,101,97.22222222222221,8.333333333333332
51815_marine,37,66,35,4,103,94.5945945945946,10.81081081081081
51816_marine,38,67,35,4,105,92.10526315789474,10.526315789473683
51817_marine,39,68,36,4,107,92.3076923076923,10.256410256410255
51818_marine,40,71,37,5,111,92.5,12.5
51819_marine,40,72,37,5,112,92.5,12.5
51820_marine,38,73,35,5,111,92.10526315789474,13.157894736842104
51821_marine,40,73,37,5,113,92.5,12.5
51822_marine,40,68,37,5,108,92.5,12.5
51823_marine,41,68,38,5,109,92.6829268292683,12.195121951219512
51824_marine,38,67,36,4,105,94.73684210526315,10.526315789473683
51825_marine,38,67,36,4,105,94.73684210526315,10.526315789473683
51826_marine,40,81,38,4,121,95,10
51827_marine,40,85,38,4,125,95,10
51828_marine,43,89,40,5,132,93.02325581395348,11.627906976744185
51829_marine,48,96,45,5,144,93.75,10.416666666666668
51830_marine,48,96,45,5,144,93.75,10.416666666666668
51831_marine,47,98,45,4,145,95.74468085106383,8.51063829787234
51832_marine,39,87,37,4,126,94.87179487179486,10.256410256410255
51833_marine,41,87,39,4,128,95.1219512195122,9.75609756097561
51834_marine,38,84,36,4,122,94.73684210526315,10.526315789473683
51835_marine,38,78,36,4,116,94.73684210526315,10.526315789473683
51836_marine,38,65,36,4,103,94.73684210526315,10.526315789473683
51837_marine,37,65,35,3,102,94.5945945945946,8.108108108108109
51838_marine,36,64,34,3,100,94.44444444444444,8.333333333333332
51839_marine,36,62,34,3,98,94.44444444444444,8.333333333333332
51840_marine,34,61,32,3,95,94.11764705882352,8.823529411764707
51841_marine,33,59,31,2,92,93.93939393939394,6.0606060606060606
51842_marine,33,58,31,2,91,93.93939393939394,6.0606060606060606
51843_marine,33,57,31,2,90,93.93939393939394,6.0606060606060606
51844_marine,33,57,31,2,90,93.93939393939394,6.0606060606060606
51845_marine,33,57,31,2,90,93.93939393939394,6.0606060606060606
51846_marine,34,56,32,2,90,94.11764705882352,5.88235294117647
51847_marine,33,55,31,2,88,93.93939393939394,6.0606060606060606
51848_marine,33,55,31,2,88,93.93939393939394,6.0606060606060606
51849_marine,33,55,31,2,88,93.93939393939394,6.0606060606060606
51850_marine,31,53,29,2,84,93.54838709677419,6.451612903225806
51851_marine,31,53,29,2,84,93.54838709677419,6.451612903225806
51852_marine,31,53,29,2,84,93.54838709677419,6.451612903225806
51853_marine,31,52,29,2,83,93.54838709677419,6.451612903225806
51854_marine,31,52,29,2,83,93.54838709677419,6.451612903225806
51855_marine,31,52,29,2,83,93.54838709677419,6.451612903225806
51856_marine,31,51,29,2,82,93.54838709677419,6.451612903225806
51857_marine,31,51,29,2,82,93.54838709677419,6.451612903225806
51858_marine,30,51,28,2,81,93.33333333333333,6.666666666666667
51859_marine,30,50,28,2,80,93.33333333333333,6.666666666666667
51860_marine,30,50,28,2,80,93.33333333333333,6.666666666666667
51861_marine,29,50,27,2,79,93.10344827586206,6.896551724137931
51862_marine,29,50,27,2,79,93.10344827586206,6.896551724137931
51863_marine,29,50,27,2,79,93.10344827586206,6.896551724137931
51864_marine,29,50,27,2,79,93.10344827586206,6.896551724137931
51865_marine,29,50,27,2,79,93.10344827586206,6.896551724137931
51866_marine,28,50,26,2,78,92.85714285714286,7.142857142857142
51867_marine,28,50,26,2,78,92.85714285714286,7.142857142857142
51868_marine,28,50,26,2,78,92.85714285714286,7.142857142857142
51869_marine,28,50,26,2,78,92.85714285714286,7.142857142857142
51870_marine,28,50,26,2,78,92.85714285714286,7.142857142857142
51871_marine,28,50,26,2,78,92.85714285714286,7.142857142857142
51872_marine,28,49,26,2,77,92.85714285714286,7.142857142857142
51873_marine,28,49,26,2,77,92.85714285714286,7.142857142857142
51874_marine,28,49,26,2,77,92.85714285714286,7.142857142857142
51875_marine,28,49,26,2,77,92.85714285714286,7.142857142857142
51876_marine,28,49,26,2,77,92.85714285714286,7.142857142857142
51877_marine,28,49,26,2,77,92.85714285714286,7.142857142857142
51878_marine,29,50,27,2,79,93.10344827586206,6.896551724137931
51879_marine,29,50,27,2,79,93.10344827586206,6.896551724137931
51880_marine,28,49,26,2,77,92.85714285714286,7.142857142857142
51881_marine,28,49,26,2,77,92.85714285714286,7.142857142857142
51882_marine,28,49,26,2,77,92.85714285714286,7.142857142857142
51883_marine,28,49,26,2,77,92.85714285714286,7.142857142857142
51884_marine,28,50,26,2,78,92.85714285714286,7.142857142857142
51885_marine,28,50,26,2,78,92.85714285714286,7.142857142857142
51886_marine,28,50,26,2,78,92.85714285714286,7.142857142857142
51887_marine,28,50,26,2,78,92.85714285714286,7.142857142857142
51888_marine,28,50,26,2,78,92.85714285714286,7.142857142857142
51889_marine,28,49,26,2,77,92.85714285714286,7.142857142857142
51890_marine,28,49,26,2,77,92.85714285714286,7.142857142857142
51891_marine,28,49,26,2,77,92.85714285714286,7.142857142857142
51892_marine,28,50,26,2,78,92.85714285714286,7.142857142857142
51893_marine,28,50,26,2,78,92.85714285714286,7.142857142857142
51894_marine,28,50,26,2,78,92.85714285714286,7.142857142857142
51895_marine,28,50,26,2,78,92.85714285714286,7.142857142857142
51896_marine,28,50,26,2,78,92.85714285714286,7.142857142857142
51897_marine,28,50,26,2,78,92.85714285714286,7.142857142857142
51898_marine,28,50,26,2,78,92.85714285714286,7.142857142857142
51899_marine,28,50,26,2,78,92.85714285714286,7.142857142857142
51900_marine,28,50,26,2,78,92.85714285714286,7.142857142857142
51901_marine,28,50,26,2,78,92.85714285714286,7.142857142857142
51902_marine,28,50,26,2,78,92.85714285714286,7.142857142857142
51903_marine,28,50,26,2,78,92.85714285714286,7.142857142857142
51904_marine,28,50,26,2,78,92.85714285714286,7.142857142857142
51905_marine,28,50,26,2,78,92.85714285714286,7.142857142857142
51906_marine,28,50,26,2,78,92.85714285714286,7.142857142857142
51907_marine,28,50,26,2,78,92.85714285714286,7.142857142857142
51908_marine,28,50,26,2,78,92.85714285714286,7.142857142857142
51909_marine,28,50,26,2,78,92.85714285714286,7.142857142857142
51910_marine,28,50,26,2,78,92.85714285714286,7.142857142857142
51911_marine,28,49,26,2,77,92.85714285714286,7.142857142857142
51912_marine,28,49,26,2,77,92.85714285714286,7.142857142857142
51913_marine,28,48,26,2,76,92.85714285714286,7.142857142857142
51914_marine,28,49,26,2,77,92.85714285714286,7.142857142857142
51915_marine,28,49,26,2,77,92.85714285714286,7.142857142857142
51916_marine,28,49,26,2,77,92.85714285714286,7.142857142857142
51917_marine,28,49,26,2,77,92.85714285714286,7.142857142857142
51918_marine,28,49,26,2,77,92.85714285714286,7.142857142857142
51919_marine,27,49,25,2,76,92.5925925925926,7.4074074074074066
51920_marine,27,49,25,2,76,92.5925925925926,7.4074074074074066
51921_marine,27,49,25,2,76,92.5925925925926,7.4074074074074066
51922_marine,27,48,25,2,75,92.5925925925926,7.4074074074074066
51923_marine,27,48,25,2,75,92.5925925925926,7.4074074074074066
51924_marine,27,47,25,2,74,92.5925925925926,7.4074074074074066
51925_marine,27,47,25,2,74,92.5925925925926,7.4074074074074066
51926_marine,27,47,25,2,74,92.5925925925926,7.4074074074074066
51927_marine,27,47,25,2,74,92.5925925925926,7.4074074074074066
51928_marine,27,47,25,2,74,92.5925925925926,7.4074074074074066
51929_marine,27,47,25,2,74,92.5925925925926,7.4074074074074066
51930_marine,27,47,25,2,74,92.5925925925926,7.4074074074074066
51931_marine,27,47,25,2,74,92.5925925925926,7.4074074074074066
51932_marine,27,47,25,2,74,92.5925925925926,7.4074074074074066
51933_marine,27,47,25,2,74,92.5925925925926,7.4074074074074066
51934_marine,27,47,25,2,74,92.5925925925926,7.4074074074074066
51935_marine,27,47,25,2,74,92.5925925925926,7.4074074074074066
51936_marine,28,48,26,2,76,92.85714285714286,7.142857142857142
51937_marine,30,48,27,4,78,90,13.333333333333334
51938_marine,30,48,27,4,78,90,13.333333333333334
51939_marine,30,48,27,4,78,90,13.333333333333334
51940_marine,30,48,27,4,78,90,13.333333333333334
51941_marine,31,48,27,4,79,87.09677419354838,12.903225806451612
51942_marine,30,48,26,4,78,86.66666666666667,13.333333333333334
51943_marine,35,48,31,5,83,88.57142857142857,14.285714285714285
51944_marine,36,49,32,6,85,88.88888888888889,16.666666666666664
51945_marine,43,52,38,7,95,88.37209302325581,16.27906976744186
51946_marine,48,92,41,10,140,85.41666666666666,20.833333333333336
51947_marine,106,153,65,56,259,61.32075471698113,52.83018867924528
51948_marine,113,171,65,57,284,57.52212389380531,50.442477876106196
51949_marine,116,164,68,58,280,58.620689655172406,50
51950_marine,124,169,71,66,293,57.25806451612904,53.2258064516129
51951_marine,124,160,71,66,284,57.25806451612904,53.2258064516129
51952_marine,120,152,72,60,272,60,50
51953_marine,136,164,81,71,300,59.55882352941176,52.20588235294118
51954_marine,126,167,74,65,293,58.730158730158735,51.587301587301596
51955_marine,120,158,74,61,278,61.66666666666667,50.83333333333333
51956_marine,102,145,67,50,247,65.68627450980392,49.01960784313725
51957_marine,102,141,68,49,243,66.66666666666666,48.03921568627451
51958_marine,50,99,43,9,149,86,18
51959_marine,46,81,40,7,127,86.95652173913044,15.217391304347828
51960_marine,45,74,39,7,119,86.66666666666667,15.555555555555555
51961_marine,44,74,38,7,118,86.36363636363636,15.909090909090908
51962_marine,44,69,38,7,113,86.36363636363636,15.909090909090908
51963_marine,44,69,38,7,113,86.36363636363636,15.909090909090908
51964_marine,45,68,39,7,113,86.66666666666667,15.555555555555555
51965_marine,36,63,32,6,99,88.88888888888889,16.666666666666664
51966_marine,36,53,32,6,89,88.88888888888889,16.666666666666664
51967_marine,36,53,32,6,89,88.88888888888889,16.666666666666664
51968_marine,36,49,32,6,85,88.88888888888889,16.666666666666664
51969_marine,35,49,32,6,84,91.42857142857143,17.142857142857142
51970_marine,35,49,32,6,84,91.42857142857143,17.142857142857142
51971_marine,35,49,32,6,84,91.42857142857143,17.142857142857142
51972_marine,36,48,33,6,84,91.66666666666666,16.666666666666664
51973_marine,36,48,33,6,84,91.66666666666666,16.666666666666664
51974_marine,33,50,30,6,83,90.9090909090909,18.181818181818183
51975_marine,33,54,30,6,87,90.9090909090909,18.181818181818183
51976_marine,33,54,30,6,87,90.9090909090909,18.181818181818183
51977_marine,33,54,30,6,87,90.9090909090909,18.181818181818183
51978_marine,33,54,30,6,87,90.9090909090909,18.181818181818183
51979_marine,33,54,30,6,87,90.9090909090909,18.181818181818183
51980_marine,33,56,30,6,89,90.9090909090909,18.181818181818183
51981_marine,33,60,30,6,93,90.9090909090909,18.181818181818183
51982_marine,49,76,42,15,125,85.71428571428571,30.612244897959183
51983_marine,49,77,42,15,126,85.71428571428571,30.612244897959183
51984_marine,47,75,40,14,122,85.1063829787234,29.78723404255319
51985_marine,46,75,39,14,121,84.78260869565217,30.434782608695656
51986_marine,39,59,30,12,98,76.92307692307693,30.76923076923077
51987_marine,39,55,30,12,94,76.92307692307693,30.76923076923077
51988_marine,33,55,30,6,88,90.9090909090909,18.181818181818183
51989_marine,33,54,30,6,87,90.9090909090909,18.181818181818183
51990_marine,32,54,29,5,86,90.625,15.625
51991_marine,32,53,29,5,85,90.625,15.625
51992_marine,32,54,29,5,86,90.625,15.625
51993_marine,32,53,29,5,85,90.625,15.625
51994_marine,32,49,29,5,81,90.625,15.625
51995_marine,32,48,29,5,80,90.625,15.625
51996_marine,32,48,29,5,80,90.625,15.625
51997_marine,32,48,29,5,80,90.625,15.625
51998_marine,32,47,29,5,79,90.625,15.625
51999_marine,31,47,28,4,78,90.32258064516128,12.903225806451612
52000_marine,31,47,28,4,78,90.32258064516128,12.903225806451612
52001_marine,31,47,28,4,78,90.32258064516128,12.903225806451612
52002_marine,31,47,28,4,78,90.32258064516128,12.903225806451612
52003_marine,30,47,27,4,77,90,13.333333333333334
52004_marine,30,47,27,4,77,90,13.333333333333334
52005_marine,30,46,27,4,76,90,13.333333333333334
52006_marine,30,46,27,4,76,90,13.333333333333334
52007_marine,30,46,27,4,76,90,13.333333333333334
52008_marine,30,46,27,4,76,90,13.333333333333334
52009_marine,30,46,27,4,76,90,13.333333333333334
52010_marine,30,46,27,4,76,90,13.333333333333334
52011_marine,30,46,27,4,76,90,13.333333333333334
52012_marine,30,46,27,4,76,90,13.333333333333334
52013_marine,30,46,27,4,76,90,13.333333333333334
52014_marine,30,44,27,4,74,90,13.333333333333334
52015_marine,30,44,27,4,74,90,13.333333333333334
52016_marine,31,44,27,5,75,87.09677419354838,16.129032258064516
52017_marine,31,44,27,5,75,87.09677419354838,16.129032258064516
52018_marine,32,44,28,5,76,87.5,15.625
52019_marine,31,44,27,4,75,87.09677419354838,12.903225806451612
52020_marine,31,43,27,4,74,87.09677419354838,12.903225806451612
52021_marine,31,43,27,4,74,87.09677419354838,12.903225806451612
52022_marine,31,44,27,5,75,87.09677419354838,16.129032258064516
52023_marine,31,44,27,5,75,87.09677419354838,16.129032258064516
52024_marine,36,52,28,9,88,77.77777777777779,25
52025_marine,31,44,27,5,75,87.09677419354838,16.129032258064516
52026_marine,31,44,27,5,75,87.09677419354838,16.129032258064516
52027_marine,31,43,27,5,74,87.09677419354838,16.129032258064516
52028_marine,31,43,27,5,74,87.09677419354838,16.129032258064516
52029_marine,31,42,27,5,73,87.09677419354838,16.129032258064516
52030_marine,31,42,27,5,73,87.09677419354838,16.129032258064516
52031_marine,30,42,27,4,72,90,13.333333333333334
52032_marine,30,42,27,4,72,90,13.333333333333334
52033_marine,30,43,27,4,73,90,13.333333333333334
52034_marine,31,42,28,5,73,90.32258064516128,16.129032258064516
52035_marine,31,42,28,5,73,90.32258064516128,16.129032258064516
52036_marine,30,42,27,5,72,90,16.666666666666664
52037_marine,30,42,27,5,72,90,16.666666666666664
52038_marine,30,50,27,5,80,90,16.666666666666664
52039_marine,30,50,27,5,80,90,16.666666666666664
52040_marine,30,50,27,5,80,90,16.666666666666664
52041_marine,30,49,27,5,79,90,16.666666666666664
52042_marine,30,41,27,5,71,90,16.666666666666664
52043_marine,30,41,27,5,71,90,16.666666666666664
52044_marine,30,41,27,5,71,90,16.666666666666664
52045_marine,29,42,26,5,71,89.65517241379311,17.24137931034483
52046_marine,29,42,26,5,71,89.65517241379311,17.24137931034483
52047_marine,29,43,26,5,72,89.65517241379311,17.24137931034483
52048_marine,29,43,26,5,72,89.65517241379311,17.24137931034483
52049_marine,29,44,26,5,73,89.65517241379311,17.24137931034483
52050_marine,29,44,26,5,73,89.65517241379311,17.24137931034483
52051_marine,29,44,26,5,73,89.65517241379311,17.24137931034483
52052_marine,29,44,26,5,73,89.65517241379311,17.24137931034483
52053_marine,29,44,26,5,73,89.65517241379311,17.24137931034483
52054_marine,29,44,26,5,73,89.65517241379311,17.24137931034483
52055_marine,29,44,26,5,73,89.65517241379311,17.24137931034483
52056_marine,29,44,26,5,73,89.65517241379311,17.24137931034483
52057_marine,29,44,26,5,73,89.65517241379311,17.24137931034483
52058_marine,29,44,26,5,73,89.65517241379311,17.24137931034483
52059_marine,29,44,26,5,73,89.65517241379311,17.24137931034483
52060_marine,30,44,27,5,74,90,16.666666666666664
52061_marine,30,44,27,5,74,90,16.666666666666664
52062_marine,30,44,27,5,74,90,16.666666666666664
52063_marine,30,44,27,5,74,90,16.666666666666664
52064_marine,30,44,27,5,74,90,16.666666666666664
52065_marine,30,44,27,5,74,90,16.666666666666664
52066_marine,30,44,27,5,74,90,16.666666666666664
52067_marine,30,44,27,5,74,90,16.666666666666664
52068_marine,30,44,27,5,74,90,16.666666666666664
52069_marine,30,44,27,5,74,90,16.666666666666664
52070_marine,31,44,28,6,75,90.32258064516128,19.35483870967742
52071_marine,31,44,28,6,75,90.32258064516128,19.35483870967742
52072_marine,31,44,28,6,75,90.32258064516128,19.35483870967742
52073_marine,31,44,28,6,75,90.32258064516128,19.35483870967742
52074_marine,31,44,28,6,75,90.32258064516128,19.35483870967742
52075_marine,31,44,28,6,75,90.32258064516128,19.35483870967742
52076_marine,31,45,28,6,76,90.32258064516128,19.35483870967742
52077_marine,31,45,28,6,76,90.32258064516128,19.35483870967742
52078_marine,31,45,28,6,76,90.32258064516128,19.35483870967742
52079_marine,31,45,28,6,76,90.32258064516128,19.35483870967742
52080_marine,31,45,28,6,76,90.32258064516128,19.35483870967742
52081_marine,31,46,28,6,77,90.32258064516128,19.35483870967742
52082_marine,31,46,28,6,77,90.32258064516128,19.35483870967742
52083_marine,31,47,28,6,78,90.32258064516128,19.35483870967742
52084_marine,31,47,28,6,78,90.32258064516128,19.35483870967742
52085_marine,31,47,28,6,78,90.32258064516128,19.35483870967742
52086_marine,31,47,28,6,78,90.32258064516128,19.35483870967742
52087_marine,31,47,28,6,78,90.32258064516128,19.35483870967742
52088_marine,31,48,28,6,79,90.32258064516128,19.35483870967742
52089_marine,31,51,28,6,82,90.32258064516128,19.35483870967742
52090_marine,31,51,28,6,82,90.32258064516128,19.35483870967742
52091_marine,31,51,28,6,82,90.32258064516128,19.35483870967742
52092_marine,31,52,28,6,83,90.32258064516128,19.35483870967742
52093_marine,33,54,28,6,87,84.84848484848484,18.181818181818183
52094_marine,31,54,28,6,85,90.32258064516128,19.35483870967742
52095_marine,31,54,28,6,85,90.32258064516128,19.35483870967742
52096_marine,31,52,28,6,83,90.32258064516128,19.35483870967742
52097_marine,31,51,28,6,82,90.32258064516128,19.35483870967742
52098_marine,31,50,28,6,81,90.32258064516128,19.35483870967742
52099_marine,31,50,28,6,81,90.32258064516128,19.35483870967742
52100_marine,31,51,28,6,82,90.32258064516128,19.35483870967742
52101_marine,32,51,29,6,83,90.625,18.75
52102_marine,31,51,28,5,82,90.32258064516128,16.129032258064516
52103_marine,31,51,28,5,82,90.32258064516128,16.129032258064516
52104_marine,31,51,28,5,82,90.32258064516128,16.129032258064516
52105_marine,31,47,28,5,78,90.32258064516128,16.129032258064516
52106_marine,31,46,28,5,77,90.32258064516128,16.129032258064516
52107_marine,31,45,28,5,76,90.32258064516128,16.129032258064516
52108_marine,31,44,28,5,75,90.32258064516128,16.129032258064516
52109_marine,32,44,29,5,76,90.625,15.625
52110_marine,32,43,29,5,75,90.625,15.625
52111_marine,32,43,29,5,75,90.625,15.625
52112_marine,32,43,29,5,75,90.625,15.625
52113_marine,32,43,29,5,75,90.625,15.625
52114_marine,31,44,29,4,75,93.54838709677419,12.903225806451612
52115_marine,31,44,29,4,75,93.54838709677419,12.903225806451612
52116_marine,31,44,29,4,75,93.54838709677419,12.903225806451612
52117_marine,31,44,29,4,75,93.54838709677419,12.903225806451612
52118_marine,31,44,29,4,75,93.54838709677419,12.903225806451612
52119_marine,31,43,29,4,74,93.54838709677419,12.903225806451612
52120_marine,31,43,29,4,74,93.54838709677419,12.903225806451612
52121_marine,31,44,29,4,75,93.54838709677419,12.903225806451612
52122_marine,31,44,29,4,75,93.54838709677419,12.903225806451612
52123_marine,30,44,29,3,74,96.66666666666667,10
52124_marine,30,44,29,3,74,96.66666666666667,10
52125_marine,30,44,29,3,74,96.66666666666667,10
52126_marine,30,44,29,3,74,96.66666666666667,10
52127_marine,30,44,29,3,74,96.66666666666667,10
52128_marine,30,44,29,3,74,96.66666666666667,10
52129_marine,30,45,29,3,75,96.66666666666667,10
52130_marine,30,45,29,3,75,96.66666666666667,10
52131_marine,30,46,29,3,76,96.66666666666667,10
52132_marine,30,46,29,3,76,96.66666666666667,10
52133_marine,30,48,29,3,78,96.66666666666667,10
52134_marine,30,48,29,3,78,96.66666666666667,10
52135_marine,30,48,29,3,78,96.66666666666667,10
52136_marine,30,48,29,3,78,96.66666666666667,10
52137_marine,30,48,29,3,78,96.66666666666667,10
52138_marine,30,48,29,3,78,96.66666666666667,10
52139_marine,30,48,29,3,78,96.66666666666667,10
52140_marine,30,48,29,3,78,96.66666666666667,10
52141_marine,32,48,30,4,80,93.75,12.5
52142_marine,32,48,30,4,80,93.75,12.5
52143_marine,32,47,30,4,79,93.75,12.5
52144_marine,32,47,30,4,79,93.75,12.5
52145_marine,32,47,30,4,79,93.75,12.5
52146_marine,32,47,30,4,79,93.75,12.5
52147_marine,31,47,29,4,78,93.54838709677419,12.903225806451612
52148_marine,31,49,29,4,80,93.54838709677419,12.903225806451612
52149_marine,31,49,29,4,80,93.54838709677419,12.903225806451612
52150_marine,31,49,29,4,80,93.54838709677419,12.903225806451612
52151_marine,31,49,29,4,80,93.54838709677419,12.903225806451612
52152_marine,31,50,29,4,81,93.54838709677419,12.903225806451612
52153_marine,31,50,29,4,81,93.54838709677419,12.903225806451612
52154_marine,31,50,29,4,81,93.54838709677419,12.903225806451612
52155_marine,31,51,29,4,82,93.54838709677419,12.903225806451612
52156_marine,31,52,29,4,83,93.54838709677419,12.903225806451612
52157_marine,32,52,30,4,84,93.75,12.5
52158_marine,32,52,30,4,84,93.75,12.5
52159_marine,32,53,30,4,85,93.75,12.5
52160_marine,32,55,30,4,87,93.75,12.5
52161_marine,32,55,30,4,87,93.75,12.5
52162_marine,32,56,30,4,88,93.75,12.5
52163_marine,36,56,34,4,92,94.44444444444444,11.11111111111111
52164_marine,36,56,34,4,92,94.44444444444444,11.11111111111111
52165_marine,36,56,34,4,92,94.44444444444444,11.11111111111111
52166_marine,36,56,34,4,92,94.44444444444444,11.11111111111111
52167_marine,36,59,34,4,95,94.44444444444444,11.11111111111111
52168_marine,36,61,34,4,97,94.44444444444444,11.11111111111111
52169_marine,36,63,34,4,99,94.44444444444444,11.11111111111111
52170_marine,35,63,33,4,98,94.28571428571428,11.428571428571429
52171_marine,36,63,34,4,99,94.44444444444444,11.11111111111111
52172_marine,36,63,34,4,99,94.44444444444444,11.11111111111111
52173_marine,34,64,32,4,98,94.11764705882352,11.76470588235294
52174_marine,34,64,32,4,98,94.11764705882352,11.76470588235294
52175_marine,34,65,32,4,99,94.11764705882352,11.76470588235294
52176_marine,37,67,34,4,104,91.8918918918919,10.81081081081081
52177_marine,38,68,35,5,106,92.10526315789474,13.157894736842104
52178_marine,38,73,35,5,111,92.10526315789474,13.157894736842104
52179_marine,73,90,63,23,163,86.3013698630137,31.506849315068493
52180_marine,43,72,38,7,115,88.37209302325581,16.27906976744186
52181_marine,37,73,34,5,110,91.8918918918919,13.513513513513514
52182_marine,38,70,35,5,108,92.10526315789474,13.157894736842104
52183_marine,38,68,35,5,106,92.10526315789474,13.157894736842104
52184_marine,38,68,36,5,106,94.73684210526315,13.157894736842104
52185_marine,39,67,37,5,106,94.87179487179486,12.82051282051282
52186_marine,41,77,39,5,118,95.1219512195122,12.195121951219512
52187_marine,41,83,39,5,124,95.1219512195122,12.195121951219512
52188_marine,42,89,40,4,131,95.23809523809523,9.523809523809524
52189_marine,44,95,42,4,139,95.45454545454545,9.090909090909092
52190_marine,45,94,43,4,139,95.55555555555556,8.88888888888889
52191_marine,39,84,37,4,123,94.87179487179486,10.256410256410255
52192_marine,39,81,37,4,120,94.87179487179486,10.256410256410255
52193_marine,39,80,37,4,119,94.87179487179486,10.256410256410255
52194_marine,38,81,36,4,119,94.73684210526315,10.526315789473683
52195_marine,35,65,33,4,100,94.28571428571428,11.428571428571429
52196_marine,36,65,34,4,101,94.44444444444444,11.11111111111111
52197_marine,36,63,34,4,99,94.44444444444444,11.11111111111111
52198_marine,35,62,33,3,97,94.28571428571428,8.571428571428571
52199_marine,34,60,32,3,94,94.11764705882352,8.823529411764707
52200_marine,33,60,31,2,93,93.93939393939394,6.0606060606060606
52201_marine,31,52,29,2,83,93.54838709677419,6.451612903225806
52202_marine,30,51,28,2,81,93.33333333333333,6.666666666666667
52203_marine,30,51,28,2,81,93.33333333333333,6.666666666666667
52204_marine,30,51,28,2,81,93.33333333333333,6.666666666666667
52205_marine,30,50,28,2,80,93.33333333333333,6.666666666666667
52206_marine,30,50,28,2,80,93.33333333333333,6.666666666666667
52207_marine,30,49,28,2,79,93.33333333333333,6.666666666666667
52208_marine,31,49,29,2,80,93.54838709677419,6.451612903225806
52209_marine,31,48,29,2,79,93.54838709677419,6.451612903225806
52210_marine,31,48,29,2,79,93.54838709677419,6.451612903225806
52211_marine,31,48,29,2,79,93.54838709677419,6.451612903225806
52212_marine,31,48,29,2,79,93.54838709677419,6.451612903225806
52213_marine,31,48,29,2,79,93.54838709677419,6.451612903225806
52214_marine,31,48,29,2,79,93.54838709677419,6.451612903225806
52215_marine,31,46,29,2,77,93.54838709677419,6.451612903225806
52216_marine,31,46,29,2,77,93.54838709677419,6.451612903225806
52217_marine,31,46,29,2,77,93.54838709677419,6.451612903225806
52218_marine,30,46,28,2,76,93.33333333333333,6.666666666666667
52219_marine,30,45,28,2,75,93.33333333333333,6.666666666666667
52220_marine,29,45,27,2,74,93.10344827586206,6.896551724137931
52221_marine,29,45,27,2,74,93.10344827586206,6.896551724137931
52222_marine,29,45,27,2,74,93.10344827586206,6.896551724137931
52223_marine,29,45,27,2,74,93.10344827586206,6.896551724137931
52224_marine,28,45,26,2,73,92.85714285714286,7.142857142857142
52225_marine,28,45,26,2,73,92.85714285714286,7.142857142857142
52226_marine,28,45,26,2,73,92.85714285714286,7.142857142857142
52227_marine,28,45,26,2,73,92.85714285714286,7.142857142857142
52228_marine,28,45,26,2,73,92.85714285714286,7.142857142857142
52229_marine,28,45,26,2,73,92.85714285714286,7.142857142857142
52230_marine,28,45,26,2,73,92.85714285714286,7.142857142857142
52231_marine,28,45,26,2,73,92.85714285714286,7.142857142857142
52232_marine,28,44,26,2,72,92.85714285714286,7.142857142857142
52233_marine,28,44,26,2,72,92.85714285714286,7.142857142857142
52234_marine,28,44,26,2,72,92.85714285714286,7.142857142857142
52235_marine,28,44,26,2,72,92.85714285714286,7.142857142857142
52236_marine,28,44,26,2,72,92.85714285714286,7.142857142857142
52237_marine,28,44,26,2,72,92.85714285714286,7.142857142857142
52238_marine,28,44,26,2,72,92.85714285714286,7.142857142857142
52239_marine,29,44,27,2,73,93.10344827586206,6.896551724137931
52240_marine,29,44,27,2,73,93.10344827586206,6.896551724137931
52241_marine,28,46,26,2,74,92.85714285714286,7.142857142857142
52242_marine,28,46,26,2,74,92.85714285714286,7.142857142857142
52243_marine,28,46,26,2,74,92.85714285714286,7.142857142857142
52244_marine,28,48,26,2,76,92.85714285714286,7.142857142857142
52245_marine,28,48,26,2,76,92.85714285714286,7.142857142857142
52246_marine,28,47,26,2,75,92.85714285714286,7.142857142857142
52247_marine,28,47,26,2,75,92.85714285714286,7.142857142857142
52248_marine,28,47,26,2,75,92.85714285714286,7.142857142857142
52249_marine,28,47,26,2,75,92.85714285714286,7.142857142857142
52250_marine,28,48,26,2,76,92.85714285714286,7.142857142857142
52251_marine,28,48,26,2,76,92.85714285714286,7.142857142857142
52252_marine,28,48,26,2,76,92.85714285714286,7.142857142857142
52253_marine,28,48,26,2,76,92.85714285714286,7.142857142857142
52254_marine,28,48,26,2,76,92.85714285714286,7.142857142857142
52255_marine,28,48,26,2,76,92.85714285714286,7.142857142857142
52256_marine,28,48,26,2,76,92.85714285714286,7.142857142857142
52257_marine,28,48,26,2,76,92.85714285714286,7.142857142857142
52258_marine,28,48,26,2,76,92.85714285714286,7.142857142857142
52259_marine,28,48,26,2,76,92.85714285714286,7.142857142857142
52260_marine,28,48,26,2,76,92.85714285714286,7.142857142857142
52261_marine,28,48,26,2,76,92.85714285714286,7.142857142857142
52262_marine,28,48,26,2,76,92.85714285714286,7.142857142857142
52263_marine,27,47,25,2,74,92.5925925925926,7.4074074074074066
52264_marine,27,47,25,2,74,92.5925925925926,7.4074074074074066
52265_marine,27,46,25,2,73,92.5925925925926,7.4074074074074066
52266_marine,27,46,25,2,73,92.5925925925926,7.4074074074074066
52267_marine,27,46,25,2,73,92.5925925925926,7.4074074074074066
52268_marine,27,46,25,2,73,92.5925925925926,7.4074074074074066
52269_marine,27,46,25,2,73,92.5925925925926,7.4074074074074066
52270_marine,27,46,25,2,73,92.5925925925926,7.4074074074074066
52271_marine,27,46,25,2,73,92.5925925925926,7.4074074074074066
52272_marine,27,46,25,2,73,92.5925925925926,7.4074074074074066
52273_marine,27,45,25,2,72,92.5925925925926,7.4074074074074066
52274_marine,27,45,25,2,72,92.5925925925926,7.4074074074074066
52275_marine,27,45,25,2,72,92.5925925925926,7.4074074074074066
52276_marine,27,46,25,2,73,92.5925925925926,7.4074074074074066
52277_marine,27,46,25,2,73,92.5925925925926,7.4074074074074066
52278_marine,27,46,25,2,73,92.5925925925926,7.4074074074074066
52279_marine,26,46,24,2,72,92.3076923076923,7.6923076923076925
52280_marine,26,45,24,2,71,92.3076923076923,7.6923076923076925
52281_marine,26,45,24,2,71,92.3076923076923,7.6923076923076925
52282_marine,26,45,24,2,71,92.3076923076923,7.6923076923076925
52283_marine,26,45,24,2,71,92.3076923076923,7.6923076923076925
52284_marine,26,45,24,2,71,92.3076923076923,7.6923076923076925
52285_marine,26,45,24,2,71,92.3076923076923,7.6923076923076925
52286_marine,26,42,24,2,68,92.3076923076923,7.6923076923076925
52287_marine,26,42,24,2,68,92.3076923076923,7.6923076923076925
52288_marine,26,42,24,2,68,92.3076923076923,7.6923076923076925
52289_marine,26,42,24,2,68,92.3076923076923,7.6923076923076925
52290_marine,26,42,24,2,68,92.3076923076923,7.6923076923076925
52291_marine,26,42,24,2,68,92.3076923076923,7.6923076923076925
52292_marine,27,42,25,3,69,92.5925925925926,11.11111111111111
52293_marine,27,42,25,3,69,92.5925925925926,11.11111111111111
52294_marine,27,42,25,3,69,92.5925925925926,11.11111111111111
52295_marine,27,42,25,3,69,92.5925925925926,11.11111111111111
52296_marine,27,42,25,3,69,92.5925925925926,11.11111111111111
52297_marine,30,43,27,4,73,90,13.333333333333334
52298_marine,30,43,27,4,73,90,13.333333333333334
52299_marine,30,43,27,4,73,90,13.333333333333334
52300_marine,30,43,27,4,73,90,13.333333333333334
52301_marine,31,43,27,4,74,87.09677419354838,12.903225806451612
52302_marine,30,42,26,4,72,86.66666666666667,13.333333333333334
52303_marine,32,42,28,5,74,87.5,15.625
52304_marine,34,43,30,5,77,88.23529411764706,14.705882352941178
52305_marine,35,45,31,6,80,88.57142857142857,17.142857142857142
52306_marine,39,48,34,7,87,87.17948717948718,17.94871794871795
52307_marine,43,60,37,9,103,86.04651162790698,20.930232558139537
52308_marine,54,104,43,10,158,79.62962962962963,18.51851851851852
52309_marine,101,145,64,51,246,63.366336633663366,50.495049504950494
52310_marine,108,148,65,56,256,60.18518518518518,51.85185185185185
52311_marine,113,147,67,58,260,59.29203539823009,51.32743362831859
52312_marine,114,150,68,59,264,59.64912280701754,51.75438596491229
52313_marine,109,145,68,59,254,62.38532110091744,54.12844036697248
52314_marine,123,160,74,65,283,60.16260162601627,52.84552845528455
52315_marine,55,94,44,10,149,80,18.181818181818183
52316_marine,53,88,43,10,141,81.13207547169812,18.867924528301888
52317_marine,47,68,39,10,115,82.97872340425532,21.27659574468085
52318_marine,46,65,38,9,111,82.6086956521739,19.565217391304348
52319_marine,41,50,35,7,91,85.36585365853658,17.073170731707318
52320_marine,41,49,35,7,90,85.36585365853658,17.073170731707318
52321_marine,39,50,33,7,89,84.61538461538461,17.94871794871795
52322_marine,38,50,32,6,88,84.21052631578947,15.789473684210526
52323_marine,38,54,32,6,92,84.21052631578947,15.789473684210526
52324_marine,37,55,31,6,92,83.78378378378379,16.216216216216218
52325_marine,35,49,31,6,84,88.57142857142857,17.142857142857142
52326_marine,35,47,31,6,82,88.57142857142857,17.142857142857142
52327_marine,35,47,31,6,82,88.57142857142857,17.142857142857142
52328_marine,35,47,32,6,82,91.42857142857143,17.142857142857142
52329_marine,35,47,32,6,82,91.42857142857143,17.142857142857142
52330_marine,35,47,32,6,82,91.42857142857143,17.142857142857142
52331_marine,36,49,33,6,85,91.66666666666666,16.666666666666664
52332_marine,34,49,31,6,83,91.17647058823529,17.647058823529413
52333_marine,33,52,30,6,85,90.9090909090909,18.181818181818183
52334_marine,33,52,30,6,85,90.9090909090909,18.181818181818183
52335_marine,33,52,30,6,85,90.9090909090909,18.181818181818183
52336_marine,33,52,30,6,85,90.9090909090909,18.181818181818183
52337_marine,33,52,30,6,85,90.9090909090909,18.181818181818183
52338_marine,33,52,30,6,85,90.9090909090909,18.181818181818183
52339_marine,32,50,29,6,82,90.625,18.75
52340_marine,32,51,29,6,83,90.625,18.75
52341_marine,32,52,29,6,84,90.625,18.75
52342_marine,32,52,29,6,84,90.625,18.75
52343_marine,33,55,30,6,88,90.9090909090909,18.181818181818183
52344_marine,34,55,30,7,89,88.23529411764706,20.588235294117645
52345_marine,34,55,30,7,89,88.23529411764706,20.588235294117645
52346_marine,33,56,30,6,89,90.9090909090909,18.181818181818183
52347_marine,33,51,30,6,84,90.9090909090909,18.181818181818183
52348_marine,32,51,29,6,83,90.625,18.75
52349_marine,32,50,29,6,82,90.625,18.75
52350_marine,31,49,28,5,80,90.32258064516128,16.129032258064516
52351_marine,31,50,28,5,81,90.32258064516128,16.129032258064516
52352_marine,31,50,28,5,81,90.32258064516128,16.129032258064516
52353_marine,32,49,28,6,81,87.5,18.75
52354_marine,31,50,28,5,81,90.32258064516128,16.129032258064516
52355_marine,31,50,28,5,81,90.32258064516128,16.129032258064516
52356_marine,31,45,28,5,76,90.32258064516128,16.129032258064516
52357_marine,31,45,28,5,76,90.32258064516128,16.129032258064516
52358_marine,31,45,28,5,76,90.32258064516128,16.129032258064516
52359_marine,30,45,27,5,75,90,16.666666666666664
52360_marine,30,44,27,5,74,90,16.666666666666664
52361_marine,31,43,28,5,74,90.32258064516128,16.129032258064516
52362_marine,31,43,28,5,74,90.32258064516128,16.129032258064516
52363_marine,31,43,28,5,74,90.32258064516128,16.129032258064516
52364_marine,31,43,28,5,74,90.32258064516128,16.129032258064516
52365_marine,31,43,28,5,74,90.32258064516128,16.129032258064516
52366_marine,31,43,28,5,74,90.32258064516128,16.129032258064516
52367_marine,31,43,28,5,74,90.32258064516128,16.129032258064516
52368_marine,30,44,27,4,74,90,13.333333333333334
52369_marine,30,43,27,4,73,90,13.333333333333334
52370_marine,30,43,27,4,73,90,13.333333333333334
52371_marine,30,41,27,4,71,90,13.333333333333334
52372_marine,30,41,27,4,71,90,13.333333333333334
52373_marine,30,41,27,4,71,90,13.333333333333334
52374_marine,31,41,27,5,72,87.09677419354838,16.129032258064516
52375_marine,31,40,27,5,71,87.09677419354838,16.129032258064516
52376_marine,31,40,27,5,71,87.09677419354838,16.129032258064516
52377_marine,31,41,27,5,72,87.09677419354838,16.129032258064516
52378_marine,31,41,27,5,72,87.09677419354838,16.129032258064516
52379_marine,31,41,27,5,72,87.09677419354838,16.129032258064516
52380_marine,31,41,27,5,72,87.09677419354838,16.129032258064516
52381_marine,31,41,27,5,72,87.09677419354838,16.129032258064516
52382_marine,31,42,27,5,73,87.09677419354838,16.129032258064516
52383_marine,31,42,27,5,73,87.09677419354838,16.129032258064516
52384_marine,31,50,27,5,81,87.09677419354838,16.129032258064516
52385_marine,31,50,27,5,81,87.09677419354838,16.129032258064516
52386_marine,31,48,27,5,79,87.09677419354838,16.129032258064516
52387_marine,31,48,27,5,79,87.09677419354838,16.129032258064516
52388_marine,32,48,28,6,80,87.5,18.75
52389_marine,32,48,28,6,80,87.5,18.75
52390_marine,32,48,28,6,80,87.5,18.75
52391_marine,32,48,28,6,80,87.5,18.75
52392_marine,32,46,28,6,78,87.5,18.75
52393_marine,32,46,28,6,78,87.5,18.75
52394_marine,31,46,28,5,77,90.32258064516128,16.129032258064516
52395_marine,30,46,27,5,76,90,16.666666666666664
52396_marine,30,46,27,5,76,90,16.666666666666664
52397_marine,29,46,26,5,75,89.65517241379311,17.24137931034483
52398_marine,29,46,26,5,75,89.65517241379311,17.24137931034483
52399_marine,29,46,26,5,75,89.65517241379311,17.24137931034483
52400_marine,29,46,26,5,75,89.65517241379311,17.24137931034483
52401_marine,29,46,26,5,75,89.65517241379311,17.24137931034483
52402_marine,29,46,26,5,75,89.65517241379311,17.24137931034483
52403_marine,29,46,26,5,75,89.65517241379311,17.24137931034483
52404_marine,29,46,26,5,75,89.65517241379311,17.24137931034483
52405_marine,29,46,26,5,75,89.65517241379311,17.24137931034483
52406_marine,29,38,26,5,67,89.65517241379311,17.24137931034483
52407_marine,29,39,26,5,68,89.65517241379311,17.24137931034483
52408_marine,29,39,26,5,68,89.65517241379311,17.24137931034483
52409_marine,29,40,26,5,69,89.65517241379311,17.24137931034483
52410_marine,29,41,26,5,70,89.65517241379311,17.24137931034483
52411_marine,29,41,26,5,70,89.65517241379311,17.24137931034483
52412_marine,29,41,26,5,70,89.65517241379311,17.24137931034483
52413_marine,29,41,26,5,70,89.65517241379311,17.24137931034483
52414_marine,29,41,26,5,70,89.65517241379311,17.24137931034483
52415_marine,29,41,26,5,70,89.65517241379311,17.24137931034483
52416_marine,29,41,26,5,70,89.65517241379311,17.24137931034483
52417_marine,29,41,26,5,70,89.65517241379311,17.24137931034483
52418_marine,29,41,26,5,70,89.65517241379311,17.24137931034483
52419_marine,29,40,26,5,69,89.65517241379311,17.24137931034483
52420_marine,29,40,26,5,69,89.65517241379311,17.24137931034483
52421_marine,29,40,26,5,69,89.65517241379311,17.24137931034483
52422_marine,29,40,26,5,69,89.65517241379311,17.24137931034483
52423_marine,29,40,26,5,69,89.65517241379311,17.24137931034483
52424_marine,29,40,26,5,69,89.65517241379311,17.24137931034483
52425_marine,29,40,26,5,69,89.65517241379311,17.24137931034483
52426_marine,29,40,26,5,69,89.65517241379311,17.24137931034483
52427_marine,29,41,26,5,70,89.65517241379311,17.24137931034483
52428_marine,29,41,26,5,70,89.65517241379311,17.24137931034483
52429_marine,29,41,26,5,70,89.65517241379311,17.24137931034483
52430_marine,29,42,26,5,71,89.65517241379311,17.24137931034483
52431_marine,29,42,26,5,71,89.65517241379311,17.24137931034483
52432_marine,29,42,26,5,71,89.65517241379311,17.24137931034483
52433_marine,29,42,26,5,71,89.65517241379311,17.24137931034483
52434_marine,29,42,26,5,71,89.65517241379311,17.24137931034483
52435_marine,30,42,27,6,72,90,20
52436_marine,30,42,27,6,72,90,20
52437_marine,30,42,27,6,72,90,20
52438_marine,30,42,27,6,72,90,20
52439_marine,30,42,27,6,72,90,20
52440_marine,30,42,27,6,72,90,20
52441_marine,30,42,27,6,72,90,20
52442_marine,30,42,27,6,72,90,20
52443_marine,30,42,27,6,72,90,20
52444_marine,30,43,27,6,73,90,20
52445_marine,31,43,28,6,74,90.32258064516128,19.35483870967742
52446_marine,31,43,28,6,74,90.32258064516128,19.35483870967742
52447_marine,31,43,28,6,74,90.32258064516128,19.35483870967742
52448_marine,31,43,28,6,74,90.32258064516128,19.35483870967742
52449_marine,31,44,28,6,75,90.32258064516128,19.35483870967742
52450_marine,31,44,28,6,75,90.32258064516128,19.35483870967742
52451_marine,31,46,28,6,77,90.32258064516128,19.35483870967742
52452_marine,31,46,28,6,77,90.32258064516128,19.35483870967742
52453_marine,31,47,28,6,78,90.32258064516128,19.35483870967742
52454_marine,31,46,28,6,77,90.32258064516128,19.35483870967742
52455_marine,31,46,28,6,77,90.32258064516128,19.35483870967742
52456_marine,31,45,28,6,76,90.32258064516128,19.35483870967742
52457_marine,31,45,28,6,76,90.32258064516128,19.35483870967742
52458_marine,30,47,27,5,77,90,16.666666666666664
52459_marine,31,46,28,5,77,90.32258064516128,16.129032258064516
52460_marine,31,46,28,5,77,90.32258064516128,16.129032258064516
52461_marine,31,46,28,5,77,90.32258064516128,16.129032258064516
52462_marine,31,46,28,5,77,90.32258064516128,16.129032258064516
52463_marine,31,46,28,5,77,90.32258064516128,16.129032258064516
52464_marine,31,44,28,5,75,90.32258064516128,16.129032258064516
52465_marine,31,43,28,5,74,90.32258064516128,16.129032258064516
52466_marine,31,42,28,5,73,90.32258064516128,16.129032258064516
52467_marine,31,42,28,5,73,90.32258064516128,16.129032258064516
52468_marine,31,41,28,5,72,90.32258064516128,16.129032258064516
52469_marine,32,41,29,5,73,90.625,15.625
52470_marine,32,41,29,5,73,90.625,15.625
52471_marine,32,41,29,5,73,90.625,15.625
52472_marine,32,40,29,5,72,90.625,15.625
52473_marine,32,40,29,5,72,90.625,15.625
52474_marine,32,40,29,5,72,90.625,15.625
52475_marine,32,40,29,5,72,90.625,15.625
52476_marine,32,40,29,5,72,90.625,15.625
52477_marine,32,40,29,5,72,90.625,15.625
52478_marine,32,40,29,5,72,90.625,15.625
52479_marine,32,40,29,5,72,90.625,15.625
52480_marine,31,40,29,4,71,93.54838709677419,12.903225806451612
52481_marine,31,41,29,4,72,93.54838709677419,12.903225806451612
52482_marine,31,41,29,4,72,93.54838709677419,12.903225806451612
52483_marine,31,41,29,4,72,93.54838709677419,12.903225806451612
52484_marine,31,41,29,4,72,93.54838709677419,12.903225806451612
52485_marine,31,41,29,4,72,93.54838709677419,12.903225806451612
52486_marine,31,41,29,4,72,93.54838709677419,12.903225806451612
52487_marine,31,41,29,4,72,93.54838709677419,12.903225806451612
52488_marine,31,42,29,4,73,93.54838709677419,12.903225806451612
52489_marine,31,42,29,4,73,93.54838709677419,12.903225806451612
52490_marine,31,42,29,4,73,93.54838709677419,12.903225806451612
52491_marine,31,42,29,4,73,93.54838709677419,12.903225806451612
52492_marine,31,42,29,4,73,93.54838709677419,12.903225806451612
52493_marine,31,42,29,4,73,93.54838709677419,12.903225806451612
52494_marine,31,43,29,4,74,93.54838709677419,12.903225806451612
52495_marine,31,43,29,4,74,93.54838709677419,12.903225806451612
52496_marine,31,43,29,4,74,93.54838709677419,12.903225806451612
52497_marine,31,43,29,4,74,93.54838709677419,12.903225806451612
52498_marine,31,43,29,4,74,93.54838709677419,12.903225806451612
52499_marine,32,43,30,4,75,93.75,12.5
52500_marine,32,43,30,4,75,93.75,12.5
52501_marine,32,43,30,4,75,93.75,12.5
52502_marine,31,43,29,4,74,93.54838709677419,12.903225806451612
52503_marine,31,43,29,4,74,93.54838709677419,12.903225806451612
52504_marine,31,43,29,4,74,93.54838709677419,12.903225806451612
52505_marine,31,43,29,4,74,93.54838709677419,12.903225806451612
52506_marine,31,43,29,4,74,93.54838709677419,12.903225806451612
52507_marine,31,43,29,4,74,93.54838709677419,12.903225806451612
52508_marine,31,43,29,4,74,93.54838709677419,12.903225806451612
52509_marine,31,43,29,4,74,93.54838709677419,12.903225806451612
52510_marine,31,43,29,4,74,93.54838709677419,12.903225806451612
52511_marine,31,44,29,4,75,93.54838709677419,12.903225806451612
52512_marine,31,46,29,4,77,93.54838709677419,12.903225806451612
52513_marine,31,47,29,4,78,93.54838709677419,12.903225806451612
52514_marine,31,47,29,4,78,93.54838709677419,12.903225806451612
52515_marine,31,47,29,4,78,93.54838709677419,12.903225806451612
52516_marine,31,47,29,4,78,93.54838709677419,12.903225806451612
52517_marine,31,47,29,4,78,93.54838709677419,12.903225806451612
52518_marine,31,47,29,4,78,93.54838709677419,12.903225806451612
52519_marine,31,47,29,4,78,93.54838709677419,12.903225806451612
52520_marine,31,48,29,4,79,93.54838709677419,12.903225806451612
52521_marine,32,48,30,4,80,93.75,12.5
52522_marine,32,49,30,4,81,93.75,12.5
52523_marine,32,49,30,4,81,93.75,12.5
52524_marine,34,50,32,4,84,94.11764705882352,11.76470588235294
52525_marine,34,50,32,4,84,94.11764705882352,11.76470588235294
52526_marine,34,50,32,4,84,94.11764705882352,11.76470588235294
52527_marine,34,50,32,4,84,94.11764705882352,11.76470588235294
52528_marine,34,51,32,4,85,94.11764705882352,11.76470588235294
52529_marine,36,53,34,4,89,94.44444444444444,11.11111111111111
52530_marine,35,55,33,4,90,94.28571428571428,11.428571428571429
52531_marine,35,55,33,4,90,94.28571428571428,11.428571428571429
52532_marine,34,57,32,4,91,94.11764705882352,11.76470588235294
52533_marine,34,59,32,4,93,94.11764705882352,11.76470588235294
52534_marine,34,60,32,4,94,94.11764705882352,11.76470588235294
52535_marine,35,61,32,4,96,91.42857142857143,11.428571428571429
52536_marine,34,62,31,4,96,91.17647058823529,11.76470588235294
52537_marine,35,63,32,5,98,91.42857142857143,14.285714285714285
52538_marine,34,69,31,5,103,91.17647058823529,14.705882352941178
52539_marine,43,71,38,7,114,88.37209302325581,16.27906976744186
52540_marine,34,68,31,5,102,91.17647058823529,14.705882352941178
52541_marine,34,67,31,5,101,91.17647058823529,14.705882352941178
52542_marine,36,66,33,5,102,91.66666666666666,13.88888888888889
52543_marine,36,64,33,5,100,91.66666666666666,13.88888888888889
52544_marine,36,64,34,5,100,94.44444444444444,13.88888888888889
52545_marine,36,64,34,5,100,94.44444444444444,13.88888888888889
52546_marine,37,61,35,5,98,94.5945945945946,13.513513513513514
52547_marine,39,71,37,5,110,94.87179487179486,12.82051282051282
52548_marine,38,72,36,5,110,94.73684210526315,13.157894736842104
52549_marine,36,62,34,5,98,94.44444444444444,13.88888888888889
52550_marine,36,61,34,5,97,94.44444444444444,13.88888888888889
52551_marine,34,60,32,4,94,94.11764705882352,11.76470588235294
52552_marine,33,58,31,4,91,93.93939393939394,12.121212121212121
52553_marine,32,56,30,4,88,93.75,12.5
52554_marine,32,56,30,4,88,93.75,12.5
52555_marine,32,57,30,4,89,93.75,12.5
52556_marine,33,58,31,4,91,93.93939393939394,12.121212121212121
52557_marine,33,56,31,4,89,93.93939393939394,12.121212121212121
52558_marine,31,56,29,2,87,93.54838709677419,6.451612903225806
52559_marine,30,56,28,2,86,93.33333333333333,6.666666666666667
52560_marine,31,56,29,2,87,93.54838709677419,6.451612903225806
52561_marine,30,48,28,2,78,93.33333333333333,6.666666666666667
52562_marine,30,50,28,2,80,93.33333333333333,6.666666666666667
52563_marine,30,50,28,2,80,93.33333333333333,6.666666666666667
52564_marine,30,50,28,2,80,93.33333333333333,6.666666666666667
52565_marine,28,49,26,2,77,92.85714285714286,7.142857142857142
52566_marine,28,48,26,2,76,92.85714285714286,7.142857142857142
52567_marine,27,47,25,2,74,92.5925925925926,7.4074074074074066
52568_marine,27,47,25,2,74,92.5925925925926,7.4074074074074066
52569_marine,27,47,25,2,74,92.5925925925926,7.4074074074074066
52570_marine,27,46,25,2,73,92.5925925925926,7.4074074074074066
52571_marine,28,47,26,2,75,92.85714285714286,7.142857142857142
52572_marine,28,47,26,2,75,92.85714285714286,7.142857142857142
52573_marine,28,47,26,2,75,92.85714285714286,7.142857142857142
52574_marine,28,47,26,2,75,92.85714285714286,7.142857142857142
52575_marine,28,46,26,2,74,92.85714285714286,7.142857142857142
52576_marine,28,46,26,2,74,92.85714285714286,7.142857142857142
52577_marine,28,46,26,2,74,92.85714285714286,7.142857142857142
52578_marine,28,46,26,2,74,92.85714285714286,7.142857142857142
52579_marine,27,45,25,2,72,92.5925925925926,7.4074074074074066
52580_marine,27,45,25,2,72,92.5925925925926,7.4074074074074066
52581_marine,27,45,25,2,72,92.5925925925926,7.4074074074074066
52582_marine,27,45,25,2,72,92.5925925925926,7.4074074074074066
52583_marine,26,45,24,2,71,92.3076923076923,7.6923076923076925
52584_marine,26,45,24,2,71,92.3076923076923,7.6923076923076925
52585_marine,26,45,24,2,71,92.3076923076923,7.6923076923076925
52586_marine,26,45,24,2,71,92.3076923076923,7.6923076923076925
52587_marine,26,45,24,2,71,92.3076923076923,7.6923076923076925
52588_marine,26,45,24,2,71,92.3076923076923,7.6923076923076925
52589_marine,26,45,24,2,71,92.3076923076923,7.6923076923076925
52590_marine,26,45,24,2,71,92.3076923076923,7.6923076923076925
52591_marine,28,45,26,2,73,92.85714285714286,7.142857142857142
52592_marine,28,44,26,2,72,92.85714285714286,7.142857142857142
52593_marine,28,44,26,2,72,92.85714285714286,7.142857142857142
52594_marine,28,44,26,2,72,92.85714285714286,7.142857142857142
52595_marine,28,45,26,2,73,92.85714285714286,7.142857142857142
52596_marine,28,45,26,2,73,92.85714285714286,7.142857142857142
52597_marine,27,44,25,2,71,92.5925925925926,7.4074074074074066
52598_marine,27,44,25,2,71,92.5925925925926,7.4074074074074066
52599_marine,27,44,25,2,71,92.5925925925926,7.4074074074074066
52600_marine,28,44,26,2,72,92.85714285714286,7.142857142857142
52601_marine,28,44,26,2,72,92.85714285714286,7.142857142857142
52602_marine,27,44,25,2,71,92.5925925925926,7.4074074074074066
52603_marine,27,44,25,2,71,92.5925925925926,7.4074074074074066
52604_marine,27,44,25,2,71,92.5925925925926,7.4074074074074066
52605_marine,27,44,25,2,71,92.5925925925926,7.4074074074074066
52606_marine,27,44,25,2,71,92.5925925925926,7.4074074074074066
52607_marine,27,44,25,2,71,92.5925925925926,7.4074074074074066
52608_marine,27,44,25,2,71,92.5925925925926,7.4074074074074066
52609_marine,27,44,25,2,71,92.5925925925926,7.4074074074074066
52610_marine,27,44,25,2,71,92.5925925925926,7.4074074074074066
52611_marine,27,44,25,2,71,92.5925925925926,7.4074074074074066
52612_marine,27,44,25,2,71,92.5925925925926,7.4074074074074066
52613_marine,27,44,25,2,71,92.5925925925926,7.4074074074074066
52614_marine,26,44,24,2,70,92.3076923076923,7.6923076923076925
52615_marine,26,44,24,2,70,92.3076923076923,7.6923076923076925
52616_marine,26,44,24,2,70,92.3076923076923,7.6923076923076925
52617_marine,26,44,24,2,70,92.3076923076923,7.6923076923076925
52618_marine,26,44,24,2,70,92.3076923076923,7.6923076923076925
52619_marine,26,44,24,2,70,92.3076923076923,7.6923076923076925
52620_marine,26,44,24,2,70,92.3076923076923,7.6923076923076925
52621_marine,26,43,24,2,69,92.3076923076923,7.6923076923076925
52622_marine,26,43,24,2,69,92.3076923076923,7.6923076923076925
52623_marine,26,44,24,2,70,92.3076923076923,7.6923076923076925
52624_marine,27,44,25,2,71,92.5925925925926,7.4074074074074066
52625_marine,27,44,25,2,71,92.5925925925926,7.4074074074074066
52626_marine,27,44,25,2,71,92.5925925925926,7.4074074074074066
52627_marine,27,44,25,2,71,92.5925925925926,7.4074074074074066
52628_marine,27,44,25,2,71,92.5925925925926,7.4074074074074066
52629_marine,27,44,25,2,71,92.5925925925926,7.4074074074074066
52630_marine,27,44,25,2,71,92.5925925925926,7.4074074074074066
52631_marine,27,44,25,2,71,92.5925925925926,7.4074074074074066
52632_marine,27,43,25,2,70,92.5925925925926,7.4074074074074066
52633_marine,27,43,25,2,70,92.5925925925926,7.4074074074074066
52634_marine,27,43,25,2,70,92.5925925925926,7.4074074074074066
52635_marine,27,43,25,2,70,92.5925925925926,7.4074074074074066
52636_marine,27,43,25,2,70,92.5925925925926,7.4074074074074066
52637_marine,27,44,25,2,71,92.5925925925926,7.4074074074074066
52638_marine,26,43,24,2,69,92.3076923076923,7.6923076923076925
52639_marine,26,43,24,2,69,92.3076923076923,7.6923076923076925
52640_marine,26,43,24,2,69,92.3076923076923,7.6923076923076925
52641_marine,26,43,24,2,69,92.3076923076923,7.6923076923076925
52642_marine,26,43,24,2,69,92.3076923076923,7.6923076923076925
52643_marine,26,43,24,2,69,92.3076923076923,7.6923076923076925
52644_marine,26,43,24,2,69,92.3076923076923,7.6923076923076925
52645_marine,27,43,25,3,70,92.5925925925926,11.11111111111111
52646_marine,27,43,25,3,70,92.5925925925926,11.11111111111111
52647_marine,27,42,25,3,69,92.5925925925926,11.11111111111111
52648_marine,27,42,25,3,69,92.5925925925926,11.11111111111111
52649_marine,27,42,25,3,69,92.5925925925926,11.11111111111111
52650_marine,27,42,25,3,69,92.5925925925926,11.11111111111111
52651_marine,27,42,25,3,69,92.5925925925926,11.11111111111111
52652_marine,27,42,25,3,69,92.5925925925926,11.11111111111111
52653_marine,27,42,25,3,69,92.5925925925926,11.11111111111111
52654_marine,27,42,25,3,69,92.5925925925926,11.11111111111111
52655_marine,27,42,25,3,69,92.5925925925926,11.11111111111111
52656_marine,27,42,25,3,69,92.5925925925926,11.11111111111111
52657_marine,28,42,25,4,70,89.28571428571429,14.285714285714285
52658_marine,28,42,25,4,70,89.28571428571429,14.285714285714285
52659_marine,29,42,26,4,71,89.65517241379311,13.793103448275861
52660_marine,29,42,26,4,71,89.65517241379311,13.793103448275861
52661_marine,29,42,26,4,71,89.65517241379311,13.793103448275861
52662_marine,31,42,27,5,73,87.09677419354838,16.129032258064516
52663_marine,30,42,26,5,72,86.66666666666667,16.666666666666664
52664_marine,31,42,27,5,73,87.09677419354838,16.129032258064516
52665_marine,33,43,29,5,76,87.87878787878788,15.151515151515152
52666_marine,34,44,30,6,78,88.23529411764706,17.647058823529413
52667_marine,38,48,34,6,86,89.47368421052632,15.789473684210526
52668_marine,41,49,34,7,90,82.92682926829268,17.073170731707318
52669_marine,42,60,35,7,102,83.33333333333334,16.666666666666664
52670_marine,51,89,43,10,140,84.31372549019608,19.607843137254903
52671_marine,53,97,42,11,150,79.24528301886792,20.754716981132077
52672_marine,54,102,43,11,156,79.62962962962963,20.37037037037037
52673_marine,51,102,42,11,153,82.35294117647058,21.568627450980394
52674_marine,51,94,40,11,145,78.43137254901961,21.568627450980394
52675_marine,46,68,36,10,114,78.26086956521739,21.73913043478261
52676_marine,45,49,37,10,94,82.22222222222221,22.22222222222222
52677_marine,40,47,34,7,87,85,17.5
52678_marine,40,46,34,7,86,85,17.5
52679_marine,39,45,33,7,84,84.61538461538461,17.94871794871795
52680_marine,38,45,32,6,83,84.21052631578947,15.789473684210526
52681_marine,36,45,30,6,81,83.33333333333334,16.666666666666664
52682_marine,36,45,30,6,81,83.33333333333334,16.666666666666664
52683_marine,36,46,30,6,82,83.33333333333334,16.666666666666664
52684_marine,37,46,31,6,83,83.78378378378379,16.216216216216218
52685_marine,35,46,31,6,81,88.57142857142857,17.142857142857142
52686_marine,35,47,31,6,82,88.57142857142857,17.142857142857142
52687_marine,34,47,31,6,81,91.17647058823529,17.647058823529413
52688_marine,34,48,31,6,82,91.17647058823529,17.647058823529413
52689_marine,32,48,29,6,80,90.625,18.75
52690_marine,32,52,29,6,84,90.625,18.75
52691_marine,33,52,30,6,85,90.9090909090909,18.181818181818183
52692_marine,32,52,29,6,84,90.625,18.75
52693_marine,32,52,29,6,84,90.625,18.75
52694_marine,33,52,30,6,85,90.9090909090909,18.181818181818183
52695_marine,32,49,29,6,81,90.625,18.75
52696_marine,32,49,29,6,81,90.625,18.75
52697_marine,32,49,29,6,81,90.625,18.75
52698_marine,32,50,29,6,82,90.625,18.75
52699_marine,32,50,29,6,82,90.625,18.75
52700_marine,32,51,29,6,83,90.625,18.75
52701_marine,32,51,29,6,83,90.625,18.75
52702_marine,32,52,29,6,84,90.625,18.75
52703_marine,32,52,29,6,84,90.625,18.75
52704_marine,31,54,28,6,85,90.32258064516128,19.35483870967742
52705_marine,31,52,28,6,83,90.32258064516128,19.35483870967742
52706_marine,31,52,28,6,83,90.32258064516128,19.35483870967742
52707_marine,31,51,28,6,82,90.32258064516128,19.35483870967742
52708_marine,31,51,28,6,82,90.32258064516128,19.35483870967742
52709_marine,31,50,28,5,81,90.32258064516128,16.129032258064516
52710_marine,31,49,28,5,80,90.32258064516128,16.129032258064516
52711_marine,31,54,28,5,85,90.32258064516128,16.129032258064516
52712_marine,31,53,28,5,84,90.32258064516128,16.129032258064516
52713_marine,37,61,30,11,98,81.08108108108108,29.72972972972973
52714_marine,31,53,27,6,84,87.09677419354838,19.35483870967742
52715_marine,30,53,27,5,83,90,16.666666666666664
52716_marine,30,53,27,5,83,90,16.666666666666664
52717_marine,30,51,27,5,81,90,16.666666666666664
52718_marine,30,43,27,5,73,90,16.666666666666664
52719_marine,30,44,27,5,74,90,16.666666666666664
52720_marine,30,44,27,5,74,90,16.666666666666664
52721_marine,30,42,27,5,72,90,16.666666666666664
52722_marine,30,42,27,5,72,90,16.666666666666664
52723_marine,31,42,28,5,73,90.32258064516128,16.129032258064516
52724_marine,31,42,28,5,73,90.32258064516128,16.129032258064516
52725_marine,31,42,28,5,73,90.32258064516128,16.129032258064516
52726_marine,31,42,28,5,73,90.32258064516128,16.129032258064516
52727_marine,31,42,28,5,73,90.32258064516128,16.129032258064516
52728_marine,31,40,28,5,71,90.32258064516128,16.129032258064516
52729_marine,31,39,28,5,70,90.32258064516128,16.129032258064516
52730_marine,31,39,28,5,70,90.32258064516128,16.129032258064516
52731_marine,32,39,28,6,71,87.5,18.75
52732_marine,32,39,28,6,71,87.5,18.75
52733_marine,32,39,28,6,71,87.5,18.75
52734_marine,32,47,28,6,79,87.5,18.75
52735_marine,32,47,28,6,79,87.5,18.75
52736_marine,32,48,28,6,80,87.5,18.75
52737_marine,32,48,28,6,80,87.5,18.75
52738_marine,32,48,28,6,80,87.5,18.75
52739_marine,32,48,28,6,80,87.5,18.75
52740_marine,32,48,28,6,80,87.5,18.75
52741_marine,32,48,28,6,80,87.5,18.75
52742_marine,31,48,27,6,79,87.09677419354838,19.35483870967742
52743_marine,31,49,27,6,80,87.09677419354838,19.35483870967742
52744_marine,31,49,27,6,80,87.09677419354838,19.35483870967742
52745_marine,31,49,27,6,80,87.09677419354838,19.35483870967742
52746_marine,31,48,27,6,79,87.09677419354838,19.35483870967742
52747_marine,31,48,27,6,79,87.09677419354838,19.35483870967742
52748_marine,31,48,27,6,79,87.09677419354838,19.35483870967742
52749_marine,31,48,27,6,79,87.09677419354838,19.35483870967742
52750_marine,31,47,27,6,78,87.09677419354838,19.35483870967742
52751_marine,31,47,27,6,78,87.09677419354838,19.35483870967742
52752_marine,31,47,27,6,78,87.09677419354838,19.35483870967742
52753_marine,31,47,27,6,78,87.09677419354838,19.35483870967742
52754_marine,29,46,25,6,75,86.20689655172413,20.689655172413794
52755_marine,29,46,25,6,75,86.20689655172413,20.689655172413794
52756_marine,29,46,25,6,75,86.20689655172413,20.689655172413794
52757_marine,28,44,25,5,72,89.28571428571429,17.857142857142858
52758_marine,28,44,25,5,72,89.28571428571429,17.857142857142858
52759_marine,28,44,25,5,72,89.28571428571429,17.857142857142858
52760_marine,28,44,25,5,72,89.28571428571429,17.857142857142858
52761_marine,28,44,25,5,72,89.28571428571429,17.857142857142858
52762_marine,28,44,25,5,72,89.28571428571429,17.857142857142858
52763_marine,28,44,25,5,72,89.28571428571429,17.857142857142858
52764_marine,28,44,25,5,72,89.28571428571429,17.857142857142858
52765_marine,28,44,25,5,72,89.28571428571429,17.857142857142858
52766_marine,28,44,25,5,72,89.28571428571429,17.857142857142858
52767_marine,28,36,25,5,64,89.28571428571429,17.857142857142858
52768_marine,28,36,25,5,64,89.28571428571429,17.857142857142858
52769_marine,28,37,25,5,65,89.28571428571429,17.857142857142858
52770_marine,29,37,26,5,66,89.65517241379311,17.24137931034483
52771_marine,29,37,26,5,66,89.65517241379311,17.24137931034483
52772_marine,29,37,26,5,66,89.65517241379311,17.24137931034483
52773_marine,29,37,26,5,66,89.65517241379311,17.24137931034483
52774_marine,29,37,26,5,66,89.65517241379311,17.24137931034483
52775_marine,29,37,26,5,66,89.65517241379311,17.24137931034483
52776_marine,29,37,26,5,66,89.65517241379311,17.24137931034483
52777_marine,29,37,26,5,66,89.65517241379311,17.24137931034483
52778_marine,29,37,26,5,66,89.65517241379311,17.24137931034483
52779_marine,29,37,26,5,66,89.65517241379311,17.24137931034483
52780_marine,29,37,26,5,66,89.65517241379311,17.24137931034483
52781_marine,29,37,26,5,66,89.65517241379311,17.24137931034483
52782_marine,29,37,26,5,66,89.65517241379311,17.24137931034483
52783_marine,29,37,26,5,66,89.65517241379311,17.24137931034483
52784_marine,29,37,26,5,66,89.65517241379311,17.24137931034483
52785_marine,29,37,26,5,66,89.65517241379311,17.24137931034483
52786_marine,29,37,26,5,66,89.65517241379311,17.24137931034483
52787_marine,29,37,26,5,66,89.65517241379311,17.24137931034483
52788_marine,29,37,26,5,66,89.65517241379311,17.24137931034483
52789_marine,29,37,26,5,66,89.65517241379311,17.24137931034483
52790_marine,29,37,26,5,66,89.65517241379311,17.24137931034483
52791_marine,29,38,26,5,67,89.65517241379311,17.24137931034483
52792_marine,29,38,26,5,67,89.65517241379311,17.24137931034483
52793_marine,29,38,26,5,67,89.65517241379311,17.24137931034483
52794_marine,29,39,26,5,68,89.65517241379311,17.24137931034483
52795_marine,29,39,26,5,68,89.65517241379311,17.24137931034483
52796_marine,29,40,26,5,69,89.65517241379311,17.24137931034483
52797_marine,29,40,26,5,69,89.65517241379311,17.24137931034483
52798_marine,29,40,26,5,69,89.65517241379311,17.24137931034483
52799_marine,29,40,26,5,69,89.65517241379311,17.24137931034483
52800_marine,28,40,25,5,68,89.28571428571429,17.857142857142858
52801_marine,28,40,25,5,68,89.28571428571429,17.857142857142858
52802_marine,29,40,26,6,69,89.65517241379311,20.689655172413794
52803_marine,29,40,26,6,69,89.65517241379311,20.689655172413794
52804_marine,29,40,26,6,69,89.65517241379311,20.689655172413794
52805_marine,30,40,27,6,70,90,20
52806_marine,30,40,27,6,70,90,20
52807_marine,30,41,27,6,71,90,20
52808_marine,30,41,27,6,71,90,20
52809_marine,30,41,27,6,71,90,20
52810_marine,30,41,27,6,71,90,20
52811_marine,29,41,26,5,70,89.65517241379311,17.24137931034483
52812_marine,29,41,26,5,70,89.65517241379311,17.24137931034483
52813_marine,29,42,26,5,71,89.65517241379311,17.24137931034483
52814_marine,29,42,26,5,71,89.65517241379311,17.24137931034483
52815_marine,29,43,26,5,72,89.65517241379311,17.24137931034483
52816_marine,29,43,26,5,72,89.65517241379311,17.24137931034483
52817_marine,30,43,27,5,73,90,16.666666666666664
52818_marine,30,44,27,5,74,90,16.666666666666664
52819_marine,30,45,27,5,75,90,16.666666666666664
52820_marine,29,53,27,4,82,93.10344827586206,13.793103448275861
52821_marine,29,52,27,4,81,93.10344827586206,13.793103448275861
52822_marine,29,51,27,4,80,93.10344827586206,13.793103448275861
52823_marine,29,51,27,4,80,93.10344827586206,13.793103448275861
52824_marine,29,43,27,4,72,93.10344827586206,13.793103448275861
52825_marine,29,42,27,4,71,93.10344827586206,13.793103448275861
52826_marine,29,42,27,4,71,93.10344827586206,13.793103448275861
52827_marine,30,41,27,5,71,90,16.666666666666664
52828_marine,31,40,28,5,71,90.32258064516128,16.129032258064516
52829_marine,31,40,28,5,71,90.32258064516128,16.129032258064516
52830_marine,31,40,28,5,71,90.32258064516128,16.129032258064516
52831_marine,32,40,29,5,72,90.625,15.625
52832_marine,32,40,29,5,72,90.625,15.625
52833_marine,32,40,29,5,72,90.625,15.625
52834_marine,32,40,29,5,72,90.625,15.625
52835_marine,32,40,29,5,72,90.625,15.625
52836_marine,31,40,29,4,71,93.54838709677419,12.903225806451612
52837_marine,31,40,29,4,71,93.54838709677419,12.903225806451612
52838_marine,31,40,29,4,71,93.54838709677419,12.903225806451612
52839_marine,31,40,29,4,71,93.54838709677419,12.903225806451612
52840_marine,31,40,29,4,71,93.54838709677419,12.903225806451612
52841_marine,31,41,29,4,72,93.54838709677419,12.903225806451612
52842_marine,31,41,29,4,72,93.54838709677419,12.903225806451612
52843_marine,31,41,29,4,72,93.54838709677419,12.903225806451612
52844_marine,31,41,29,4,72,93.54838709677419,12.903225806451612
52845_marine,31,41,29,4,72,93.54838709677419,12.903225806451612
52846_marine,31,41,29,4,72,93.54838709677419,12.903225806451612
52847_marine,30,41,28,4,71,93.33333333333333,13.333333333333334
52848_marine,30,41,28,4,71,93.33333333333333,13.333333333333334
52849_marine,30,41,28,4,71,93.33333333333333,13.333333333333334
52850_marine,30,41,28,4,71,93.33333333333333,13.333333333333334
52851_marine,30,41,28,4,71,93.33333333333333,13.333333333333334
52852_marine,30,41,28,4,71,93.33333333333333,13.333333333333334
52853_marine,31,41,29,4,72,93.54838709677419,12.903225806451612
52854_marine,31,42,29,4,73,93.54838709677419,12.903225806451612
52855_marine,31,42,29,4,73,93.54838709677419,12.903225806451612
52856_marine,31,42,29,4,73,93.54838709677419,12.903225806451612
52857_marine,31,43,29,4,74,93.54838709677419,12.903225806451612
52858_marine,32,43,30,4,75,93.75,12.5
52859_marine,32,43,30,4,75,93.75,12.5
52860_marine,31,43,29,4,74,93.54838709677419,12.903225806451612
52861_marine,31,43,29,4,74,93.54838709677419,12.903225806451612
52862_marine,31,43,29,4,74,93.54838709677419,12.903225806451612
52863_marine,31,43,29,4,74,93.54838709677419,12.903225806451612
52864_marine,31,43,29,4,74,93.54838709677419,12.903225806451612
52865_marine,31,43,29,4,74,93.54838709677419,12.903225806451612
52866_marine,31,44,29,4,75,93.54838709677419,12.903225806451612
52867_marine,31,44,29,4,75,93.54838709677419,12.903225806451612
52868_marine,31,44,29,4,75,93.54838709677419,12.903225806451612
52869_marine,31,44,29,4,75,93.54838709677419,12.903225806451612
52870_marine,31,44,29,4,75,93.54838709677419,12.903225806451612
52871_marine,31,44,29,4,75,93.54838709677419,12.903225806451612
52872_marine,31,44,29,4,75,93.54838709677419,12.903225806451612
52873_marine,31,45,29,4,76,93.54838709677419,12.903225806451612
52874_marine,31,45,29,4,76,93.54838709677419,12.903225806451612
52875_marine,31,45,29,4,76,93.54838709677419,12.903225806451612
52876_marine,31,47,29,4,78,93.54838709677419,12.903225806451612
52877_marine,31,47,29,4,78,93.54838709677419,12.903225806451612
52878_marine,31,47,29,4,78,93.54838709677419,12.903225806451612
52879_marine,31,47,29,4,78,93.54838709677419,12.903225806451612
52880_marine,31,47,29,4,78,93.54838709677419,12.903225806451612
52881_marine,31,48,29,4,79,93.54838709677419,12.903225806451612
52882_marine,31,48,29,4,79,93.54838709677419,12.903225806451612
52883_marine,31,48,29,4,79,93.54838709677419,12.903225806451612
52884_marine,31,48,29,4,79,93.54838709677419,12.903225806451612
52885_marine,33,48,31,4,81,93.93939393939394,12.121212121212121
52886_marine,33,49,31,4,82,93.93939393939394,12.121212121212121
52887_marine,33,50,31,4,83,93.93939393939394,12.121212121212121
52888_marine,33,50,31,4,83,93.93939393939394,12.121212121212121
52889_marine,33,51,31,4,84,93.93939393939394,12.121212121212121
52890_marine,33,51,31,4,84,93.93939393939394,12.121212121212121
52891_marine,32,53,30,4,85,93.75,12.5
52892_marine,30,55,28,4,85,93.33333333333333,13.333333333333334
52893_marine,30,55,28,4,85,93.33333333333333,13.333333333333334
52894_marine,30,56,28,4,86,93.33333333333333,13.333333333333334
52895_marine,33,58,30,4,91,90.9090909090909,12.121212121212121
52896_marine,33,60,30,4,93,90.9090909090909,12.121212121212121
52897_marine,32,60,29,4,92,90.625,12.5
52898_marine,33,61,30,5,94,90.9090909090909,15.151515151515152
52899_marine,33,66,30,5,99,90.9090909090909,15.151515151515152
52900_marine,33,66,30,5,99,90.9090909090909,15.151515151515152
52901_marine,33,64,30,5,97,90.9090909090909,15.151515151515152
52902_marine,36,63,33,5,99,91.66666666666666,13.88888888888889
52903_marine,35,61,33,5,96,94.28571428571428,14.285714285714285
52904_marine,35,60,33,5,95,94.28571428571428,14.285714285714285
52905_marine,35,60,33,5,95,94.28571428571428,14.285714285714285
52906_marine,35,58,33,5,93,94.28571428571428,14.285714285714285
52907_marine,35,58,33,5,93,94.28571428571428,14.285714285714285
52908_marine,35,58,33,5,93,94.28571428571428,14.285714285714285
52909_marine,35,55,33,5,90,94.28571428571428,14.285714285714285
52910_marine,35,54,33,5,89,94.28571428571428,14.285714285714285
52911_marine,34,54,32,5,88,94.11764705882352,14.705882352941178
52912_marine,34,54,32,5,88,94.11764705882352,14.705882352941178
52913_marine,32,54,30,4,86,93.75,12.5
52914_marine,32,52,30,4,84,93.75,12.5
52915_marine,31,52,29,3,83,93.54838709677419,9.67741935483871
52916_marine,32,51,30,3,83,93.75,9.375
52917_marine,31,53,29,2,84,93.54838709677419,6.451612903225806
52918_marine,30,53,28,2,83,93.33333333333333,6.666666666666667
52919_marine,30,51,28,2,81,93.33333333333333,6.666666666666667
52920_marine,30,50,28,2,80,93.33333333333333,6.666666666666667
52921_marine,29,46,27,2,75,93.10344827586206,6.896551724137931
52922_marine,27,46,25,2,73,92.5925925925926,7.4074074074074066
52923_marine,27,46,25,2,73,92.5925925925926,7.4074074074074066
52924_marine,27,45,25,2,72,92.5925925925926,7.4074074074074066
52925_marine,27,44,25,2,71,92.5925925925926,7.4074074074074066
52926_marine,27,44,25,2,71,92.5925925925926,7.4074074074074066
52927_marine,27,44,25,2,71,92.5925925925926,7.4074074074074066
52928_marine,27,44,25,2,71,92.5925925925926,7.4074074074074066
52929_marine,27,44,25,2,71,92.5925925925926,7.4074074074074066
52930_marine,27,46,25,2,73,92.5925925925926,7.4074074074074066
52931_marine,27,46,25,2,73,92.5925925925926,7.4074074074074066
52932_marine,27,46,25,2,73,92.5925925925926,7.4074074074074066
52933_marine,27,46,25,2,73,92.5925925925926,7.4074074074074066
52934_marine,27,45,25,2,72,92.5925925925926,7.4074074074074066
52935_marine,27,45,25,2,72,92.5925925925926,7.4074074074074066
52936_marine,27,45,25,2,72,92.5925925925926,7.4074074074074066
52937_marine,27,45,25,2,72,92.5925925925926,7.4074074074074066
52938_marine,27,44,25,2,71,92.5925925925926,7.4074074074074066
52939_marine,27,44,25,2,71,92.5925925925926,7.4074074074074066
52940_marine,27,44,25,2,71,92.5925925925926,7.4074074074074066
52941_marine,25,44,23,2,69,92,8
52942_marine,25,44,23,2,69,92,8
52943_marine,25,44,23,2,69,92,8
52944_marine,25,44,23,2,69,92,8
52945_marine,25,44,23,2,69,92,8
52946_marine,25,44,23,2,69,92,8
52947_marine,25,45,23,2,70,92,8
52948_marine,25,45,23,2,70,92,8
52949_marine,25,45,23,2,70,92,8
52950_marine,25,45,23,2,70,92,8
52951_marine,25,45,23,2,70,92,8
52952_marine,25,44,23,2,69,92,8
52953_marine,25,44,23,2,69,92,8
52954_marine,25,44,23,2,69,92,8
52955_marine,25,44,23,2,69,92,8
52956_marine,25,44,23,2,69,92,8
52957_marine,25,44,23,2,69,92,8
52958_marine,25,44,23,2,69,92,8
52959_marine,25,44,23,2,69,92,8
52960_marine,25,44,23,2,69,92,8
52961_marine,26,44,24,2,70,92.3076923076923,7.6923076923076925
52962_marine,25,44,23,2,69,92,8
52963_marine,25,43,23,2,68,92,8
52964_marine,25,44,23,2,69,92,8
52965_marine,25,44,23,2,69,92,8
52966_marine,25,44,23,2,69,92,8
52967_marine,25,44,23,2,69,92,8
52968_marine,25,44,23,2,69,92,8
52969_marine,24,44,22,2,68,91.66666666666666,8.333333333333332
52970_marine,24,44,22,2,68,91.66666666666666,8.333333333333332
52971_marine,26,44,24,2,70,92.3076923076923,7.6923076923076925
52972_marine,26,44,24,2,70,92.3076923076923,7.6923076923076925
52973_marine,26,44,24,2,70,92.3076923076923,7.6923076923076925
52974_marine,26,44,24,2,70,92.3076923076923,7.6923076923076925
52975_marine,26,43,24,2,69,92.3076923076923,7.6923076923076925
52976_marine,26,43,24,2,69,92.3076923076923,7.6923076923076925
52977_marine,26,43,24,2,69,92.3076923076923,7.6923076923076925
52978_marine,26,43,24,2,69,92.3076923076923,7.6923076923076925
52979_marine,26,43,24,2,69,92.3076923076923,7.6923076923076925
52980_marine,26,43,24,2,69,92.3076923076923,7.6923076923076925
52981_marine,26,43,24,2,69,92.3076923076923,7.6923076923076925
52982_marine,26,43,24,2,69,92.3076923076923,7.6923076923076925
52983_marine,26,43,24,2,69,92.3076923076923,7.6923076923076925
52984_marine,26,43,24,2,69,92.3076923076923,7.6923076923076925
52985_marine,26,43,24,2,69,92.3076923076923,7.6923076923076925
52986_marine,26,43,24,2,69,92.3076923076923,7.6923076923076925
52987_marine,27,43,25,2,70,92.5925925925926,7.4074074074074066
52988_marine,27,43,25,2,70,92.5925925925926,7.4074074074074066
52989_marine,27,43,25,2,70,92.5925925925926,7.4074074074074066
52990_marine,27,43,25,2,70,92.5925925925926,7.4074074074074066
52991_marine,27,42,25,2,69,92.5925925925926,7.4074074074074066
52992_marine,27,42,25,2,69,92.5925925925926,7.4074074074074066
52993_marine,27,41,25,2,68,92.5925925925926,7.4074074074074066
52994_marine,27,41,25,2,68,92.5925925925926,7.4074074074074066
52995_marine,27,41,25,3,68,92.5925925925926,11.11111111111111
52996_marine,27,41,25,3,68,92.5925925925926,11.11111111111111
52997_marine,27,41,25,3,68,92.5925925925926,11.11111111111111
52998_marine,27,42,25,3,69,92.5925925925926,11.11111111111111
52999_marine,27,42,25,3,69,92.5925925925926,11.11111111111111
53000_marine,27,42,25,3,69,92.5925925925926,11.11111111111111
53001_marine,27,42,25,3,69,92.5925925925926,11.11111111111111
53002_marine,27,42,25,3,69,92.5925925925926,11.11111111111111
53003_marine,27,42,25,3,69,92.5925925925926,11.11111111111111
53004_marine,27,42,25,3,69,92.5925925925926,11.11111111111111
53005_marine,27,42,25,3,69,92.5925925925926,11.11111111111111
53006_marine,27,42,25,3,69,92.5925925925926,11.11111111111111
53007_marine,27,43,25,3,70,92.5925925925926,11.11111111111111
53008_marine,27,43,25,3,70,92.5925925925926,11.11111111111111
53009_marine,27,42,25,3,69,92.5925925925926,11.11111111111111
53010_marine,27,42,25,3,69,92.5925925925926,11.11111111111111
53011_marine,27,42,25,3,69,92.5925925925926,11.11111111111111
53012_marine,27,42,25,3,69,92.5925925925926,11.11111111111111
53013_marine,27,42,25,3,69,92.5925925925926,11.11111111111111
53014_marine,27,42,25,3,69,92.5925925925926,11.11111111111111
53015_marine,27,42,25,3,69,92.5925925925926,11.11111111111111
53016_marine,27,41,25,3,68,92.5925925925926,11.11111111111111
53017_marine,28,41,25,4,69,89.28571428571429,14.285714285714285
53018_marine,28,41,25,4,69,89.28571428571429,14.285714285714285
53019_marine,28,41,25,4,69,89.28571428571429,14.285714285714285
53020_marine,28,41,25,4,69,89.28571428571429,14.285714285714285
53021_marine,29,42,26,4,71,89.65517241379311,13.793103448275861
53022_marine,30,42,27,5,72,90,16.666666666666664
53023_marine,30,42,26,5,72,86.66666666666667,16.666666666666664
53024_marine,30,42,26,5,72,86.66666666666667,16.666666666666664
53025_marine,30,42,26,5,72,86.66666666666667,16.666666666666664
53026_marine,31,42,27,5,73,87.09677419354838,16.129032258064516
53027_marine,31,43,27,5,74,87.09677419354838,16.129032258064516
53028_marine,32,43,28,6,75,87.5,18.75
53029_marine,35,46,31,7,81,88.57142857142857,20
53030_marine,42,46,36,7,88,85.71428571428571,16.666666666666664
53031_marine,42,47,35,8,89,83.33333333333334,19.047619047619047
53032_marine,42,46,35,8,88,83.33333333333334,19.047619047619047
53033_marine,42,56,35,8,98,83.33333333333334,19.047619047619047
53034_marine,40,60,33,8,100,82.5,20
53035_marine,39,46,33,7,85,84.61538461538461,17.94871794871795
53036_marine,39,45,33,7,84,84.61538461538461,17.94871794871795
53037_marine,39,45,33,7,84,84.61538461538461,17.94871794871795
53038_marine,38,44,32,6,82,84.21052631578947,15.789473684210526
53039_marine,38,44,32,6,82,84.21052631578947,15.789473684210526
53040_marine,38,44,32,6,82,84.21052631578947,15.789473684210526
53041_marine,36,45,30,6,81,83.33333333333334,16.666666666666664
53042_marine,36,45,30,6,81,83.33333333333334,16.666666666666664
53043_marine,36,45,30,6,81,83.33333333333334,16.666666666666664
53044_marine,37,47,31,6,84,83.78378378378379,16.216216216216218
53045_marine,34,47,31,6,81,91.17647058823529,17.647058823529413
53046_marine,32,47,29,6,79,90.625,18.75
53047_marine,32,51,29,6,83,90.625,18.75
53048_marine,32,51,29,6,83,90.625,18.75
53049_marine,32,51,29,6,83,90.625,18.75
53050_marine,33,51,30,6,84,90.9090909090909,18.181818181818183
53051_marine,33,49,30,6,82,90.9090909090909,18.181818181818183
53052_marine,32,50,29,6,82,90.625,18.75
53053_marine,32,50,29,6,82,90.625,18.75
53054_marine,31,50,28,6,81,90.32258064516128,19.35483870967742
53055_marine,31,50,28,6,81,90.32258064516128,19.35483870967742
53056_marine,31,49,28,6,80,90.32258064516128,19.35483870967742
53057_marine,30,49,27,5,79,90,16.666666666666664
53058_marine,30,49,27,5,79,90,16.666666666666664
53059_marine,30,49,27,5,79,90,16.666666666666664
53060_marine,31,50,28,6,81,90.32258064516128,19.35483870967742
53061_marine,31,50,28,6,81,90.32258064516128,19.35483870967742
53062_marine,31,50,28,6,81,90.32258064516128,19.35483870967742
53063_marine,31,54,28,6,85,90.32258064516128,19.35483870967742
53064_marine,31,54,28,6,85,90.32258064516128,19.35483870967742
53065_marine,31,54,28,6,85,90.32258064516128,19.35483870967742
53066_marine,30,54,27,6,84,90,20
53067_marine,29,54,26,5,83,89.65517241379311,17.24137931034483
53068_marine,29,53,26,5,82,89.65517241379311,17.24137931034483
53069_marine,29,53,26,5,82,89.65517241379311,17.24137931034483
53070_marine,29,52,26,5,81,89.65517241379311,17.24137931034483
53071_marine,29,53,26,5,82,89.65517241379311,17.24137931034483
53072_marine,29,53,26,5,82,89.65517241379311,17.24137931034483
53073_marine,31,52,27,6,83,87.09677419354838,19.35483870967742
53074_marine,37,59,30,11,96,81.08108108108108,29.72972972972973
53075_marine,30,51,27,5,81,90,16.666666666666664
53076_marine,30,51,27,5,81,90,16.666666666666664
53077_marine,30,50,27,5,80,90,16.666666666666664
53078_marine,30,49,27,5,79,90,16.666666666666664
53079_marine,30,49,27,5,79,90,16.666666666666664
53080_marine,30,49,27,5,79,90,16.666666666666664
53081_marine,30,48,27,5,78,90,16.666666666666664
53082_marine,30,48,27,5,78,90,16.666666666666664
53083_marine,30,48,27,5,78,90,16.666666666666664
53084_marine,30,48,27,5,78,90,16.666666666666664
53085_marine,30,47,27,5,77,90,16.666666666666664
53086_marine,31,47,28,5,78,90.32258064516128,16.129032258064516
53087_marine,31,47,28,5,78,90.32258064516128,16.129032258064516
53088_marine,32,47,28,6,79,87.5,18.75
53089_marine,32,47,28,6,79,87.5,18.75
53090_marine,32,47,28,6,79,87.5,18.75
53091_marine,32,47,28,6,79,87.5,18.75
53092_marine,32,46,28,6,78,87.5,18.75
53093_marine,32,46,28,6,78,87.5,18.75
53094_marine,32,46,28,6,78,87.5,18.75
53095_marine,32,46,28,6,78,87.5,18.75
53096_marine,32,46,28,6,78,87.5,18.75
53097_marine,32,46,28,6,78,87.5,18.75
53098_marine,32,46,28,6,78,87.5,18.75
53099_marine,32,47,28,6,79,87.5,18.75
53100_marine,32,47,28,6,79,87.5,18.75
53101_marine,32,47,28,6,79,87.5,18.75
53102_marine,31,47,27,6,78,87.09677419354838,19.35483870967742
53103_marine,31,46,27,6,77,87.09677419354838,19.35483870967742
53104_marine,31,46,27,6,77,87.09677419354838,19.35483870967742
53105_marine,31,46,27,6,77,87.09677419354838,19.35483870967742
53106_marine,31,46,27,6,77,87.09677419354838,19.35483870967742
53107_marine,31,45,27,6,76,87.09677419354838,19.35483870967742
53108_marine,31,45,27,6,76,87.09677419354838,19.35483870967742
53109_marine,30,45,26,6,75,86.66666666666667,20
53110_marine,30,45,26,6,75,86.66666666666667,20
53111_marine,30,45,26,6,75,86.66666666666667,20
53112_marine,30,45,26,6,75,86.66666666666667,20
53113_marine,29,45,25,6,74,86.20689655172413,20.689655172413794
53114_marine,29,45,25,6,74,86.20689655172413,20.689655172413794
53115_marine,29,45,25,6,74,86.20689655172413,20.689655172413794
53116_marine,29,45,25,6,74,86.20689655172413,20.689655172413794
53117_marine,29,45,25,6,74,86.20689655172413,20.689655172413794
53118_marine,29,45,25,6,74,86.20689655172413,20.689655172413794
53119_marine,29,45,25,6,74,86.20689655172413,20.689655172413794
53120_marine,28,45,25,5,73,89.28571428571429,17.857142857142858
53121_marine,28,45,25,5,73,89.28571428571429,17.857142857142858
53122_marine,28,45,25,5,73,89.28571428571429,17.857142857142858
53123_marine,28,44,25,5,72,89.28571428571429,17.857142857142858
53124_marine,28,44,25,5,72,89.28571428571429,17.857142857142858
53125_marine,27,44,25,4,71,92.5925925925926,14.814814814814813
53126_marine,27,44,25,4,71,92.5925925925926,14.814814814814813
53127_marine,27,44,25,4,71,92.5925925925926,14.814814814814813
53128_marine,27,44,25,4,71,92.5925925925926,14.814814814814813
53129_marine,27,44,25,4,71,92.5925925925926,14.814814814814813
53130_marine,27,44,25,4,71,92.5925925925926,14.814814814814813
53131_marine,27,44,25,4,71,92.5925925925926,14.814814814814813
53132_marine,27,45,25,4,72,92.5925925925926,14.814814814814813
53133_marine,27,45,25,4,72,92.5925925925926,14.814814814814813
53134_marine,28,45,26,4,73,92.85714285714286,14.285714285714285
53135_marine,28,45,26,4,73,92.85714285714286,14.285714285714285
53136_marine,28,45,26,4,73,92.85714285714286,14.285714285714285
53137_marine,28,45,26,4,73,92.85714285714286,14.285714285714285
53138_marine,28,45,26,4,73,92.85714285714286,14.285714285714285
53139_marine,28,45,26,4,73,92.85714285714286,14.285714285714285
53140_marine,28,45,26,4,73,92.85714285714286,14.285714285714285
53141_marine,28,45,26,4,73,92.85714285714286,14.285714285714285
53142_marine,29,45,26,5,74,89.65517241379311,17.24137931034483
53143_marine,29,45,26,5,74,89.65517241379311,17.24137931034483
53144_marine,29,45,26,5,74,89.65517241379311,17.24137931034483
53145_marine,29,37,26,5,66,89.65517241379311,17.24137931034483
53146_marine,29,37,26,5,66,89.65517241379311,17.24137931034483
53147_marine,29,37,26,5,66,89.65517241379311,17.24137931034483
53148_marine,29,37,26,5,66,89.65517241379311,17.24137931034483
53149_marine,29,37,26,5,66,89.65517241379311,17.24137931034483
53150_marine,29,37,26,5,66,89.65517241379311,17.24137931034483
53151_marine,29,37,26,5,66,89.65517241379311,17.24137931034483
53152_marine,29,37,26,5,66,89.65517241379311,17.24137931034483
53153_marine,29,37,26,5,66,89.65517241379311,17.24137931034483
53154_marine,29,37,26,5,66,89.65517241379311,17.24137931034483
53155_marine,29,37,26,5,66,89.65517241379311,17.24137931034483
53156_marine,29,37,26,5,66,89.65517241379311,17.24137931034483
53157_marine,28,37,25,5,65,89.28571428571429,17.857142857142858
53158_marine,28,37,25,5,65,89.28571428571429,17.857142857142858
53159_marine,28,45,25,5,73,89.28571428571429,17.857142857142858
53160_marine,28,45,25,5,73,89.28571428571429,17.857142857142858
53161_marine,28,46,25,5,74,89.28571428571429,17.857142857142858
53162_marine,28,46,25,5,74,89.28571428571429,17.857142857142858
53163_marine,28,46,25,5,74,89.28571428571429,17.857142857142858
53164_marine,28,47,25,5,75,89.28571428571429,17.857142857142858
53165_marine,28,47,25,5,75,89.28571428571429,17.857142857142858
53166_marine,28,39,25,5,67,89.28571428571429,17.857142857142858
53167_marine,28,40,25,5,68,89.28571428571429,17.857142857142858
53168_marine,28,40,25,5,68,89.28571428571429,17.857142857142858
53169_marine,28,40,25,5,68,89.28571428571429,17.857142857142858
53170_marine,28,48,25,5,76,89.28571428571429,17.857142857142858
53171_marine,26,49,23,5,75,88.46153846153845,19.230769230769234
53172_marine,27,49,24,5,76,88.88888888888889,18.51851851851852
53173_marine,27,49,24,5,76,88.88888888888889,18.51851851851852
53174_marine,27,49,24,5,76,88.88888888888889,18.51851851851852
53175_marine,28,49,25,5,77,89.28571428571429,17.857142857142858
53176_marine,28,49,25,5,77,89.28571428571429,17.857142857142858
53177_marine,28,49,25,5,77,89.28571428571429,17.857142857142858
53178_marine,28,48,25,5,76,89.28571428571429,17.857142857142858
53179_marine,27,47,25,4,74,92.5925925925926,14.814814814814813
53180_marine,27,47,25,4,74,92.5925925925926,14.814814814814813
53181_marine,27,50,25,4,77,92.5925925925926,14.814814814814813
53182_marine,27,50,25,4,77,92.5925925925926,14.814814814814813
53183_marine,29,49,27,4,78,93.10344827586206,13.793103448275861
53184_marine,29,48,27,4,77,93.10344827586206,13.793103448275861
53185_marine,29,49,27,4,78,93.10344827586206,13.793103448275861
53186_marine,29,49,27,4,78,93.10344827586206,13.793103448275861
53187_marine,29,41,27,4,70,93.10344827586206,13.793103448275861
53188_marine,30,40,28,4,70,93.33333333333333,13.333333333333334
53189_marine,30,40,28,4,70,93.33333333333333,13.333333333333334
53190_marine,30,40,28,4,70,93.33333333333333,13.333333333333334
53191_marine,30,40,28,4,70,93.33333333333333,13.333333333333334
53192_marine,30,40,28,4,70,93.33333333333333,13.333333333333334
53193_marine,30,48,28,4,78,93.33333333333333,13.333333333333334
53194_marine,30,48,28,4,78,93.33333333333333,13.333333333333334
53195_marine,30,48,28,4,78,93.33333333333333,13.333333333333334
53196_marine,30,48,28,4,78,93.33333333333333,13.333333333333334
53197_marine,30,48,28,4,78,93.33333333333333,13.333333333333334
53198_marine,30,48,28,4,78,93.33333333333333,13.333333333333334
53199_marine,30,48,28,4,78,93.33333333333333,13.333333333333334
53200_marine,30,48,28,4,78,93.33333333333333,13.333333333333334
53201_marine,30,49,28,4,79,93.33333333333333,13.333333333333334
53202_marine,30,49,28,4,79,93.33333333333333,13.333333333333334
53203_marine,29,49,27,4,78,93.10344827586206,13.793103448275861
53204_marine,29,49,27,4,78,93.10344827586206,13.793103448275861
53205_marine,29,41,27,4,70,93.10344827586206,13.793103448275861
53206_marine,29,41,27,4,70,93.10344827586206,13.793103448275861
53207_marine,29,41,27,4,70,93.10344827586206,13.793103448275861
53208_marine,29,41,27,4,70,93.10344827586206,13.793103448275861
53209_marine,29,41,27,4,70,93.10344827586206,13.793103448275861
53210_marine,29,41,27,4,70,93.10344827586206,13.793103448275861
53211_marine,29,41,27,4,70,93.10344827586206,13.793103448275861
53212_marine,29,41,27,4,70,93.10344827586206,13.793103448275861
53213_marine,29,41,27,4,70,93.10344827586206,13.793103448275861
53214_marine,29,41,27,4,70,93.10344827586206,13.793103448275861
53215_marine,29,41,27,4,70,93.10344827586206,13.793103448275861
53216_marine,29,41,27,4,70,93.10344827586206,13.793103448275861
53217_marine,29,41,27,4,70,93.10344827586206,13.793103448275861
53218_marine,30,41,28,4,71,93.33333333333333,13.333333333333334
53219_marine,29,43,27,4,72,93.10344827586206,13.793103448275861
53220_marine,30,43,28,4,73,93.33333333333333,13.333333333333334
53221_marine,30,44,28,4,74,93.33333333333333,13.333333333333334
53222_marine,30,44,28,4,74,93.33333333333333,13.333333333333334
53223_marine,30,44,28,4,74,93.33333333333333,13.333333333333334
53224_marine,30,44,28,4,74,93.33333333333333,13.333333333333334
53225_marine,30,44,28,4,74,93.33333333333333,13.333333333333334
53226_marine,30,44,28,4,74,93.33333333333333,13.333333333333334
53227_marine,30,44,28,4,74,93.33333333333333,13.333333333333334
53228_marine,30,44,28,4,74,93.33333333333333,13.333333333333334
53229_marine,30,44,28,4,74,93.33333333333333,13.333333333333334
53230_marine,30,44,28,4,74,93.33333333333333,13.333333333333334
53231_marine,30,44,28,4,74,93.33333333333333,13.333333333333334
53232_marine,30,44,28,4,74,93.33333333333333,13.333333333333334
53233_marine,30,44,28,4,74,93.33333333333333,13.333333333333334
53234_marine,30,45,28,4,75,93.33333333333333,13.333333333333334
53235_marine,30,45,28,4,75,93.33333333333333,13.333333333333334
53236_marine,30,45,28,4,75,93.33333333333333,13.333333333333334
53237_marine,30,45,28,4,75,93.33333333333333,13.333333333333334
53238_marine,30,45,28,4,75,93.33333333333333,13.333333333333334
53239_marine,30,45,28,4,75,93.33333333333333,13.333333333333334
53240_marine,30,47,28,4,77,93.33333333333333,13.333333333333334
53241_marine,30,47,28,4,77,93.33333333333333,13.333333333333334
53242_marine,30,48,28,4,78,93.33333333333333,13.333333333333334
53243_marine,30,48,28,4,78,93.33333333333333,13.333333333333334
53244_marine,30,48,28,4,78,93.33333333333333,13.333333333333334
53245_marine,32,48,30,4,80,93.75,12.5
53246_marine,32,48,30,4,80,93.75,12.5
53247_marine,32,48,30,4,80,93.75,12.5
53248_marine,32,49,30,4,81,93.75,12.5
53249_marine,32,50,30,4,82,93.75,12.5
53250_marine,32,50,30,4,82,93.75,12.5
53251_marine,31,51,29,4,82,93.54838709677419,12.903225806451612
53252_marine,29,51,27,4,80,93.10344827586206,13.793103448275861
53253_marine,30,53,28,4,83,93.33333333333333,13.333333333333334
53254_marine,30,55,28,4,85,93.33333333333333,13.333333333333334
53255_marine,29,56,27,4,85,93.10344827586206,13.793103448275861
53256_marine,30,57,27,4,87,90,13.333333333333334
53257_marine,30,58,27,4,88,90,13.333333333333334
53258_marine,30,58,27,4,88,90,13.333333333333334
53259_marine,31,60,28,5,91,90.32258064516128,16.129032258064516
53260_marine,32,61,29,5,93,90.625,15.625
53261_marine,32,61,29,5,93,90.625,15.625
53262_marine,33,60,31,5,93,93.93939393939394,15.151515151515152
53263_marine,33,58,31,5,91,93.93939393939394,15.151515151515152
53264_marine,33,58,31,5,91,93.93939393939394,15.151515151515152
53265_marine,33,58,31,5,91,93.93939393939394,15.151515151515152
53266_marine,33,54,31,5,87,93.93939393939394,15.151515151515152
53267_marine,33,54,31,5,87,93.93939393939394,15.151515151515152
53268_marine,33,52,31,5,85,93.93939393939394,15.151515151515152
53269_marine,33,52,31,5,85,93.93939393939394,15.151515151515152
53270_marine,33,52,31,5,85,93.93939393939394,15.151515151515152
53271_marine,31,52,29,5,83,93.54838709677419,16.129032258064516
53272_marine,31,52,29,5,83,93.54838709677419,16.129032258064516
53273_marine,30,52,28,4,82,93.33333333333333,13.333333333333334
53274_marine,30,51,28,4,81,93.33333333333333,13.333333333333334
53275_marine,30,51,28,4,81,93.33333333333333,13.333333333333334
53276_marine,29,51,27,2,80,93.10344827586206,6.896551724137931
53277_marine,27,49,25,2,76,92.5925925925926,7.4074074074074066
53278_marine,29,48,27,2,77,93.10344827586206,6.896551724137931
53279_marine,29,48,27,2,77,93.10344827586206,6.896551724137931
53280_marine,29,47,27,2,76,93.10344827586206,6.896551724137931
53281_marine,27,46,25,2,73,92.5925925925926,7.4074074074074066
53282_marine,27,46,25,2,73,92.5925925925926,7.4074074074074066
53283_marine,27,46,25,2,73,92.5925925925926,7.4074074074074066
53284_marine,27,44,25,2,71,92.5925925925926,7.4074074074074066
53285_marine,27,44,25,2,71,92.5925925925926,7.4074074074074066
53286_marine,27,44,25,2,71,92.5925925925926,7.4074074074074066
53287_marine,27,44,25,2,71,92.5925925925926,7.4074074074074066
53288_marine,27,43,25,2,70,92.5925925925926,7.4074074074074066
53289_marine,27,43,25,2,70,92.5925925925926,7.4074074074074066
53290_marine,27,43,25,2,70,92.5925925925926,7.4074074074074066
53291_marine,27,43,25,2,70,92.5925925925926,7.4074074074074066
53292_marine,27,43,25,2,70,92.5925925925926,7.4074074074074066
53293_marine,27,43,25,2,70,92.5925925925926,7.4074074074074066
53294_marine,27,42,25,2,69,92.5925925925926,7.4074074074074066
53295_marine,27,42,25,2,69,92.5925925925926,7.4074074074074066
53296_marine,27,42,25,2,69,92.5925925925926,7.4074074074074066
53297_marine,26,41,24,2,67,92.3076923076923,7.6923076923076925
53298_marine,26,44,24,2,70,92.3076923076923,7.6923076923076925
53299_marine,26,44,24,2,70,92.3076923076923,7.6923076923076925
53300_marine,26,44,24,2,70,92.3076923076923,7.6923076923076925
53301_marine,26,44,24,2,70,92.3076923076923,7.6923076923076925
53302_marine,25,44,23,2,69,92,8
53303_marine,25,44,23,2,69,92,8
53304_marine,25,44,23,2,69,92,8
53305_marine,25,44,23,2,69,92,8
53306_marine,25,45,23,2,70,92,8
53307_marine,25,45,23,2,70,92,8
53308_marine,25,45,23,2,70,92,8
53309_marine,25,45,23,2,70,92,8
53310_marine,25,45,23,2,70,92,8
53311_marine,25,45,23,2,70,92,8
53312_marine,25,44,23,2,69,92,8
53313_marine,25,44,23,2,69,92,8
53314_marine,25,44,23,2,69,92,8
53315_marine,25,44,23,2,69,92,8
53316_marine,25,44,23,2,69,92,8
53317_marine,25,44,23,2,69,92,8
53318_marine,25,44,23,2,69,92,8
53319_marine,25,44,23,2,69,92,8
53320_marine,25,44,23,2,69,92,8
53321_marine,26,44,24,2,70,92.3076923076923,7.6923076923076925
53322_marine,24,43,22,2,67,91.66666666666666,8.333333333333332
53323_marine,24,43,22,2,67,91.66666666666666,8.333333333333332
53324_marine,24,44,22,2,68,91.66666666666666,8.333333333333332
53325_marine,24,44,22,2,68,91.66666666666666,8.333333333333332
53326_marine,24,44,22,2,68,91.66666666666666,8.333333333333332
53327_marine,24,43,22,2,67,91.66666666666666,8.333333333333332
53328_marine,24,43,22,2,67,91.66666666666666,8.333333333333332
53329_marine,24,43,22,2,67,91.66666666666666,8.333333333333332
53330_marine,24,43,22,2,67,91.66666666666666,8.333333333333332
53331_marine,24,43,22,2,67,91.66666666666666,8.333333333333332
53332_marine,24,43,22,2,67,91.66666666666666,8.333333333333332
53333_marine,24,43,22,2,67,91.66666666666666,8.333333333333332
53334_marine,24,43,22,2,67,91.66666666666666,8.333333333333332
53335_marine,24,43,22,2,67,91.66666666666666,8.333333333333332
53336_marine,24,42,22,2,66,91.66666666666666,8.333333333333332
53337_marine,24,42,22,2,66,91.66666666666666,8.333333333333332
53338_marine,24,42,22,2,66,91.66666666666666,8.333333333333332
53339_marine,24,42,22,2,66,91.66666666666666,8.333333333333332
53340_marine,25,42,23,3,67,92,12
53341_marine,25,42,23,3,67,92,12
53342_marine,25,42,23,3,67,92,12
53343_marine,25,42,23,3,67,92,12
53344_marine,25,42,23,3,67,92,12
53345_marine,25,42,23,3,67,92,12
53346_marine,25,42,23,3,67,92,12
53347_marine,25,42,23,3,67,92,12
53348_marine,25,42,23,3,67,92,12
53349_marine,25,42,23,3,67,92,12
53350_marine,25,42,23,3,67,92,12
53351_marine,25,41,23,3,66,92,12
53352_marine,25,41,23,3,66,92,12
53353_marine,25,41,23,3,66,92,12
53354_marine,25,41,23,3,66,92,12
53355_marine,25,41,23,3,66,92,12
53356_marine,25,41,23,3,66,92,12
53357_marine,25,41,23,3,66,92,12
53358_marine,25,42,23,3,67,92,12
53359_marine,25,42,23,3,67,92,12
53360_marine,25,42,23,3,67,92,12
53361_marine,25,42,23,3,67,92,12
53362_marine,25,42,23,3,67,92,12
53363_marine,25,42,23,3,67,92,12
53364_marine,25,42,23,3,67,92,12
53365_marine,25,42,23,3,67,92,12
53366_marine,25,42,23,3,67,92,12
53367_marine,25,42,23,3,67,92,12
53368_marine,25,42,23,3,67,92,12
53369_marine,27,42,25,3,69,92.5925925925926,11.11111111111111
53370_marine,27,42,25,3,69,92.5925925925926,11.11111111111111
53371_marine,27,41,25,3,68,92.5925925925926,11.11111111111111
53372_marine,27,40,25,3,67,92.5925925925926,11.11111111111111
53373_marine,27,40,25,3,67,92.5925925925926,11.11111111111111
53374_marine,27,40,25,3,67,92.5925925925926,11.11111111111111
53375_marine,27,40,25,3,67,92.5925925925926,11.11111111111111
53376_marine,27,40,25,3,67,92.5925925925926,11.11111111111111
53377_marine,28,40,25,4,68,89.28571428571429,14.285714285714285
53378_marine,28,40,25,4,68,89.28571428571429,14.285714285714285
53379_marine,28,40,25,4,68,89.28571428571429,14.285714285714285
53380_marine,28,40,25,4,68,89.28571428571429,14.285714285714285
53381_marine,28,40,25,4,68,89.28571428571429,14.285714285714285
53382_marine,30,41,27,5,71,90,16.666666666666664
53383_marine,29,41,26,5,70,89.65517241379311,17.24137931034483
53384_marine,30,41,26,5,71,86.66666666666667,16.666666666666664
53385_marine,30,41,26,5,71,86.66666666666667,16.666666666666664
53386_marine,30,41,26,5,71,86.66666666666667,16.666666666666664
53387_marine,30,41,26,5,71,86.66666666666667,16.666666666666664
53388_marine,31,42,27,6,73,87.09677419354838,19.35483870967742
53389_marine,31,42,27,6,73,87.09677419354838,19.35483870967742
53390_marine,34,43,30,6,77,88.23529411764706,17.647058823529413
53391_marine,36,44,30,6,80,83.33333333333334,16.666666666666664
53392_marine,35,43,29,6,78,82.85714285714286,17.142857142857142
53393_marine,35,43,29,6,78,82.85714285714286,17.142857142857142
53394_marine,35,43,29,6,78,82.85714285714286,17.142857142857142
53395_marine,37,43,31,6,80,83.78378378378379,16.216216216216218
53396_marine,37,43,31,6,80,83.78378378378379,16.216216216216218
53397_marine,37,43,31,6,80,83.78378378378379,16.216216216216218
53398_marine,36,43,30,6,79,83.33333333333334,16.666666666666664
53399_marine,36,43,30,6,79,83.33333333333334,16.666666666666664
53400_marine,36,44,30,6,80,83.33333333333334,16.666666666666664
53401_marine,34,46,28,6,80,82.35294117647058,17.647058823529413
53402_marine,33,46,28,6,79,84.84848484848484,18.181818181818183
53403_marine,33,46,28,6,79,84.84848484848484,18.181818181818183
53404_marine,34,51,29,6,85,85.29411764705883,17.647058823529413
53405_marine,32,51,29,6,83,90.625,18.75
53406_marine,32,51,29,6,83,90.625,18.75
53407_marine,32,51,29,6,83,90.625,18.75
53408_marine,32,48,29,6,80,90.625,18.75
53409_marine,33,48,30,6,81,90.9090909090909,18.181818181818183
53410_marine,33,48,30,6,81,90.9090909090909,18.181818181818183
53411_marine,32,48,29,6,80,90.625,18.75
53412_marine,31,48,28,6,79,90.32258064516128,19.35483870967742
53413_marine,31,49,28,6,80,90.32258064516128,19.35483870967742
53414_marine,31,49,28,6,80,90.32258064516128,19.35483870967742
53415_marine,31,49,28,6,80,90.32258064516128,19.35483870967742
53416_marine,30,49,27,5,79,90,16.666666666666664
53417_marine,29,48,26,5,77,89.65517241379311,17.24137931034483
53418_marine,29,51,26,5,80,89.65517241379311,17.24137931034483
53419_marine,29,51,26,5,80,89.65517241379311,17.24137931034483
53420_marine,29,52,26,5,81,89.65517241379311,17.24137931034483
53421_marine,29,53,26,5,82,89.65517241379311,17.24137931034483
53422_marine,29,53,26,5,82,89.65517241379311,17.24137931034483
53423_marine,29,53,26,5,82,89.65517241379311,17.24137931034483
53424_marine,29,53,26,5,82,89.65517241379311,17.24137931034483
53425_marine,29,52,25,6,81,86.20689655172413,20.689655172413794
53426_marine,29,52,25,6,81,86.20689655172413,20.689655172413794
53427_marine,28,52,24,6,80,85.71428571428571,21.428571428571427
53428_marine,28,52,24,6,80,85.71428571428571,21.428571428571427
53429_marine,29,52,25,6,81,86.20689655172413,20.689655172413794
53430_marine,29,51,25,6,80,86.20689655172413,20.689655172413794
53431_marine,29,50,25,6,79,86.20689655172413,20.689655172413794
53432_marine,29,51,25,6,80,86.20689655172413,20.689655172413794
53433_marine,29,50,25,6,79,86.20689655172413,20.689655172413794
53434_marine,36,58,28,12,94,77.77777777777779,33.33333333333333
53435_marine,29,50,25,6,79,86.20689655172413,20.689655172413794
53436_marine,30,50,26,6,80,86.66666666666667,20
53437_marine,30,49,27,5,79,90,16.666666666666664
53438_marine,30,49,27,5,79,90,16.666666666666664
53439_marine,30,49,27,5,79,90,16.666666666666664
53440_marine,30,49,27,5,79,90,16.666666666666664
53441_marine,30,48,27,5,78,90,16.666666666666664
53442_marine,30,45,27,5,75,90,16.666666666666664
53443_marine,31,45,27,6,76,87.09677419354838,19.35483870967742
53444_marine,31,45,27,6,76,87.09677419354838,19.35483870967742
53445_marine,31,45,27,6,76,87.09677419354838,19.35483870967742
53446_marine,31,45,27,6,76,87.09677419354838,19.35483870967742
53447_marine,31,45,27,6,76,87.09677419354838,19.35483870967742
53448_marine,31,45,27,6,76,87.09677419354838,19.35483870967742
53449_marine,32,45,28,6,77,87.5,18.75
53450_marine,32,46,28,6,78,87.5,18.75
53451_marine,32,46,28,6,78,87.5,18.75
53452_marine,32,46,28,6,78,87.5,18.75
53453_marine,32,46,28,6,78,87.5,18.75
53454_marine,32,45,28,6,77,87.5,18.75
53455_marine,32,45,28,6,77,87.5,18.75
53456_marine,32,45,28,6,77,87.5,18.75
53457_marine,32,45,28,6,77,87.5,18.75
53458_marine,32,45,28,6,77,87.5,18.75
53459_marine,32,45,28,6,77,87.5,18.75
53460_marine,32,45,28,6,77,87.5,18.75
53461_marine,32,45,28,6,77,87.5,18.75
53462_marine,31,45,27,6,76,87.09677419354838,19.35483870967742
53463_marine,31,45,27,6,76,87.09677419354838,19.35483870967742
53464_marine,30,45,26,6,75,86.66666666666667,20
53465_marine,30,45,26,6,75,86.66666666666667,20
53466_marine,30,45,26,6,75,86.66666666666667,20
53467_marine,30,45,26,6,75,86.66666666666667,20
53468_marine,30,45,26,6,75,86.66666666666667,20
53469_marine,30,45,26,6,75,86.66666666666667,20
53470_marine,30,45,26,6,75,86.66666666666667,20
53471_marine,30,45,26,6,75,86.66666666666667,20
53472_marine,29,45,25,6,74,86.20689655172413,20.689655172413794
53473_marine,29,45,25,6,74,86.20689655172413,20.689655172413794
53474_marine,29,45,25,6,74,86.20689655172413,20.689655172413794
53475_marine,29,45,25,6,74,86.20689655172413,20.689655172413794
53476_marine,29,45,25,6,74,86.20689655172413,20.689655172413794
53477_marine,29,45,25,6,74,86.20689655172413,20.689655172413794
53478_marine,28,45,25,5,73,89.28571428571429,17.857142857142858
53479_marine,28,45,25,5,73,89.28571428571429,17.857142857142858
53480_marine,28,45,25,5,73,89.28571428571429,17.857142857142858
53481_marine,28,45,25,5,73,89.28571428571429,17.857142857142858
53482_marine,28,45,25,5,73,89.28571428571429,17.857142857142858
53483_marine,27,45,25,4,72,92.5925925925926,14.814814814814813
53484_marine,27,45,25,4,72,92.5925925925926,14.814814814814813
53485_marine,27,45,25,4,72,92.5925925925926,14.814814814814813
53486_marine,27,45,25,4,72,92.5925925925926,14.814814814814813
53487_marine,27,45,25,4,72,92.5925925925926,14.814814814814813
53488_marine,27,45,25,4,72,92.5925925925926,14.814814814814813
53489_marine,27,45,25,4,72,92.5925925925926,14.814814814814813
53490_marine,27,45,25,4,72,92.5925925925926,14.814814814814813
53491_marine,27,45,25,4,72,92.5925925925926,14.814814814814813
53492_marine,27,45,25,4,72,92.5925925925926,14.814814814814813
53493_marine,27,45,25,4,72,92.5925925925926,14.814814814814813
53494_marine,27,44,25,4,71,92.5925925925926,14.814814814814813
53495_marine,27,45,25,4,72,92.5925925925926,14.814814814814813
53496_marine,27,45,25,4,72,92.5925925925926,14.814814814814813
53497_marine,28,45,26,4,73,92.85714285714286,14.285714285714285
53498_marine,28,45,26,4,73,92.85714285714286,14.285714285714285
53499_marine,28,45,26,4,73,92.85714285714286,14.285714285714285
53500_marine,28,45,26,4,73,92.85714285714286,14.285714285714285
53501_marine,28,45,26,4,73,92.85714285714286,14.285714285714285
53502_marine,28,45,26,4,73,92.85714285714286,14.285714285714285
53503_marine,28,45,26,4,73,92.85714285714286,14.285714285714285
53504_marine,28,45,26,4,73,92.85714285714286,14.285714285714285
53505_marine,28,45,26,4,73,92.85714285714286,14.285714285714285
53506_marine,28,45,26,4,73,92.85714285714286,14.285714285714285
53507_marine,28,45,26,4,73,92.85714285714286,14.285714285714285
53508_marine,28,45,26,4,73,92.85714285714286,14.285714285714285
53509_marine,29,45,26,5,74,89.65517241379311,17.24137931034483
53510_marine,29,45,26,5,74,89.65517241379311,17.24137931034483
53511_marine,29,45,26,5,74,89.65517241379311,17.24137931034483
53512_marine,29,45,26,5,74,89.65517241379311,17.24137931034483
53513_marine,30,45,26,6,75,86.66666666666667,20
53514_marine,29,45,25,6,74,86.20689655172413,20.689655172413794
53515_marine,29,45,25,6,74,86.20689655172413,20.689655172413794
53516_marine,29,45,25,6,74,86.20689655172413,20.689655172413794
53517_marine,29,45,25,6,74,86.20689655172413,20.689655172413794
53518_marine,29,45,25,6,74,86.20689655172413,20.689655172413794
53519_marine,29,45,25,6,74,86.20689655172413,20.689655172413794
53520_marine,29,45,25,6,74,86.20689655172413,20.689655172413794
53521_marine,29,45,25,6,74,86.20689655172413,20.689655172413794
53522_marine,28,45,25,5,73,89.28571428571429,17.857142857142858
53523_marine,28,45,25,5,73,89.28571428571429,17.857142857142858
53524_marine,28,45,25,5,73,89.28571428571429,17.857142857142858
53525_marine,26,45,23,5,71,88.46153846153845,19.230769230769234
53526_marine,26,46,23,5,72,88.46153846153845,19.230769230769234
53527_marine,26,46,23,5,72,88.46153846153845,19.230769230769234
53528_marine,26,46,23,5,72,88.46153846153845,19.230769230769234
53529_marine,26,46,23,5,72,88.46153846153845,19.230769230769234
53530_marine,26,47,23,5,73,88.46153846153845,19.230769230769234
53531_marine,26,47,23,5,73,88.46153846153845,19.230769230769234
53532_marine,26,47,23,5,73,88.46153846153845,19.230769230769234
53533_marine,27,47,24,5,74,88.88888888888889,18.51851851851852
53534_marine,27,47,24,5,74,88.88888888888889,18.51851851851852
53535_marine,27,47,24,5,74,88.88888888888889,18.51851851851852
53536_marine,27,47,24,5,74,88.88888888888889,18.51851851851852
53537_marine,26,46,24,4,72,92.3076923076923,15.384615384615385
53538_marine,26,45,24,4,71,92.3076923076923,15.384615384615385
53539_marine,26,45,24,4,71,92.3076923076923,15.384615384615385
53540_marine,26,45,24,4,71,92.3076923076923,15.384615384615385
53541_marine,26,45,24,4,71,92.3076923076923,15.384615384615385
53542_marine,26,47,24,4,73,92.3076923076923,15.384615384615385
53543_marine,26,46,24,4,72,92.3076923076923,15.384615384615385
53544_marine,26,47,24,4,73,92.3076923076923,15.384615384615385
53545_marine,26,47,24,4,73,92.3076923076923,15.384615384615385
53546_marine,26,47,24,4,73,92.3076923076923,15.384615384615385
53547_marine,26,47,24,4,73,92.3076923076923,15.384615384615385
53548_marine,27,47,25,4,74,92.5925925925926,14.814814814814813
53549_marine,27,47,25,4,74,92.5925925925926,14.814814814814813
53550_marine,27,47,25,4,74,92.5925925925926,14.814814814814813
53551_marine,27,47,25,4,74,92.5925925925926,14.814814814814813
53552_marine,27,47,25,4,74,92.5925925925926,14.814814814814813
53553_marine,27,48,25,4,75,92.5925925925926,14.814814814814813
53554_marine,27,48,25,4,75,92.5925925925926,14.814814814814813
53555_marine,27,48,25,4,75,92.5925925925926,14.814814814814813
53556_marine,27,48,25,4,75,92.5925925925926,14.814814814814813
53557_marine,27,48,25,4,75,92.5925925925926,14.814814814814813
53558_marine,27,48,25,4,75,92.5925925925926,14.814814814814813
53559_marine,27,48,25,4,75,92.5925925925926,14.814814814814813
53560_marine,27,48,25,4,75,92.5925925925926,14.814814814814813
53561_marine,27,48,25,4,75,92.5925925925926,14.814814814814813
53562_marine,27,49,25,4,76,92.5925925925926,14.814814814814813
53563_marine,27,49,25,4,76,92.5925925925926,14.814814814814813
53564_marine,26,48,24,4,74,92.3076923076923,15.384615384615385
53565_marine,26,48,24,4,74,92.3076923076923,15.384615384615385
53566_marine,26,48,24,4,74,92.3076923076923,15.384615384615385
53567_marine,26,48,24,4,74,92.3076923076923,15.384615384615385
53568_marine,26,48,24,4,74,92.3076923076923,15.384615384615385
53569_marine,26,40,24,4,66,92.3076923076923,15.384615384615385
53570_marine,26,40,24,4,66,92.3076923076923,15.384615384615385
53571_marine,26,40,24,4,66,92.3076923076923,15.384615384615385
53572_marine,26,40,24,4,66,92.3076923076923,15.384615384615385
53573_marine,26,41,24,4,67,92.3076923076923,15.384615384615385
53574_marine,26,41,24,4,67,92.3076923076923,15.384615384615385
53575_marine,26,41,24,4,67,92.3076923076923,15.384615384615385
53576_marine,26,41,24,4,67,92.3076923076923,15.384615384615385
53577_marine,26,41,24,4,67,92.3076923076923,15.384615384615385
53578_marine,27,41,25,4,68,92.5925925925926,14.814814814814813
53579_marine,26,41,24,4,67,92.3076923076923,15.384615384615385
53580_marine,26,41,24,4,67,92.3076923076923,15.384615384615385
53581_marine,26,41,24,4,67,92.3076923076923,15.384615384615385
53582_marine,26,42,24,4,68,92.3076923076923,15.384615384615385
53583_marine,27,42,25,4,69,92.5925925925926,14.814814814814813
53584_marine,27,42,25,4,69,92.5925925925926,14.814814814814813
53585_marine,27,42,25,4,69,92.5925925925926,14.814814814814813
53586_marine,27,42,25,4,69,92.5925925925926,14.814814814814813
53587_marine,29,42,27,4,71,93.10344827586206,13.793103448275861
53588_marine,29,42,27,4,71,93.10344827586206,13.793103448275861
53589_marine,29,42,27,4,71,93.10344827586206,13.793103448275861
53590_marine,29,42,27,4,71,93.10344827586206,13.793103448275861
53591_marine,29,43,27,4,72,93.10344827586206,13.793103448275861
53592_marine,29,43,27,4,72,93.10344827586206,13.793103448275861
53593_marine,29,43,27,4,72,93.10344827586206,13.793103448275861
53594_marine,29,43,27,4,72,93.10344827586206,13.793103448275861
53595_marine,29,44,27,4,73,93.10344827586206,13.793103448275861
53596_marine,29,44,27,4,73,93.10344827586206,13.793103448275861
53597_marine,29,44,27,4,73,93.10344827586206,13.793103448275861
53598_marine,29,44,27,4,73,93.10344827586206,13.793103448275861
53599_marine,29,44,27,4,73,93.10344827586206,13.793103448275861
53600_marine,29,44,27,4,73,93.10344827586206,13.793103448275861
53601_marine,29,44,27,4,73,93.10344827586206,13.793103448275861
53602_marine,29,44,27,4,73,93.10344827586206,13.793103448275861
53603_marine,29,46,27,4,75,93.10344827586206,13.793103448275861
53604_marine,29,46,27,4,75,93.10344827586206,13.793103448275861
53605_marine,29,47,27,4,76,93.10344827586206,13.793103448275861
53606_marine,31,47,29,4,78,93.54838709677419,12.903225806451612
53607_marine,31,47,29,4,78,93.54838709677419,12.903225806451612
53608_marine,31,47,29,4,78,93.54838709677419,12.903225806451612
53609_marine,31,47,29,4,78,93.54838709677419,12.903225806451612
53610_marine,31,49,29,4,80,93.54838709677419,12.903225806451612
53611_marine,30,49,28,4,79,93.33333333333333,13.333333333333334
53612_marine,28,49,26,4,77,92.85714285714286,14.285714285714285
53613_marine,28,49,26,4,77,92.85714285714286,14.285714285714285
53614_marine,28,51,26,4,79,92.85714285714286,14.285714285714285
53615_marine,29,51,27,4,80,93.10344827586206,13.793103448275861
53616_marine,29,55,27,4,84,93.10344827586206,13.793103448275861
53617_marine,29,56,27,4,85,93.10344827586206,13.793103448275861
53618_marine,30,56,28,4,86,93.33333333333333,13.333333333333334
53619_marine,30,57,28,4,87,93.33333333333333,13.333333333333334
53620_marine,30,57,28,4,87,93.33333333333333,13.333333333333334
53621_marine,31,58,29,5,89,93.54838709677419,16.129032258064516
53622_marine,31,58,29,5,89,93.54838709677419,16.129032258064516
53623_marine,33,56,31,5,89,93.93939393939394,15.151515151515152
53624_marine,33,55,31,5,88,93.93939393939394,15.151515151515152
53625_marine,33,55,31,5,88,93.93939393939394,15.151515151515152
53626_marine,33,52,31,5,85,93.93939393939394,15.151515151515152
53627_marine,33,52,31,5,85,93.93939393939394,15.151515151515152
53628_marine,33,52,31,5,85,93.93939393939394,15.151515151515152
53629_marine,30,52,28,4,82,93.33333333333333,13.333333333333334
53630_marine,30,52,28,4,82,93.33333333333333,13.333333333333334
53631_marine,30,52,28,4,82,93.33333333333333,13.333333333333334
53632_marine,29,51,27,4,80,93.10344827586206,13.793103448275861
53633_marine,30,51,28,4,81,93.33333333333333,13.333333333333334
53634_marine,29,50,27,4,79,93.10344827586206,13.793103448275861
53635_marine,28,47,26,3,75,92.85714285714286,10.714285714285714
53636_marine,28,47,26,3,75,92.85714285714286,10.714285714285714
53637_marine,28,47,26,3,75,92.85714285714286,10.714285714285714
53638_marine,27,48,25,2,75,92.5925925925926,7.4074074074074066
53639_marine,27,48,25,2,75,92.5925925925926,7.4074074074074066
53640_marine,27,47,25,2,74,92.5925925925926,7.4074074074074066
53641_marine,27,45,25,2,72,92.5925925925926,7.4074074074074066
53642_marine,27,45,25,2,72,92.5925925925926,7.4074074074074066
53643_marine,27,44,25,2,71,92.5925925925926,7.4074074074074066
53644_marine,27,43,25,2,70,92.5925925925926,7.4074074074074066
53645_marine,27,43,25,2,70,92.5925925925926,7.4074074074074066
53646_marine,27,43,25,2,70,92.5925925925926,7.4074074074074066
53647_marine,27,43,25,2,70,92.5925925925926,7.4074074074074066
53648_marine,26,43,24,2,69,92.3076923076923,7.6923076923076925
53649_marine,26,43,24,2,69,92.3076923076923,7.6923076923076925
53650_marine,26,43,24,2,69,92.3076923076923,7.6923076923076925
53651_marine,26,44,24,2,70,92.3076923076923,7.6923076923076925
53652_marine,25,44,23,2,69,92,8
53653_marine,25,43,23,2,68,92,8
53654_marine,25,43,23,2,68,92,8
53655_marine,25,43,23,2,68,92,8
53656_marine,25,42,23,2,67,92,8
53657_marine,25,42,23,2,67,92,8
53658_marine,25,42,23,2,67,92,8
53659_marine,25,42,23,2,67,92,8
53660_marine,25,42,23,2,67,92,8
53661_marine,25,42,23,2,67,92,8
53662_marine,26,42,24,2,68,92.3076923076923,7.6923076923076925
53663_marine,25,42,23,2,67,92,8
53664_marine,25,42,23,2,67,92,8
53665_marine,25,42,23,2,67,92,8
53666_marine,25,42,23,2,67,92,8
53667_marine,25,42,23,2,67,92,8
53668_marine,25,42,23,2,67,92,8
53669_marine,25,42,23,2,67,92,8
53670_marine,24,42,22,2,66,91.66666666666666,8.333333333333332
53671_marine,24,42,22,2,66,91.66666666666666,8.333333333333332
53672_marine,24,41,22,2,65,91.66666666666666,8.333333333333332
53673_marine,24,41,22,2,65,91.66666666666666,8.333333333333332
53674_marine,24,41,22,2,65,91.66666666666666,8.333333333333332
53675_marine,24,43,22,2,67,91.66666666666666,8.333333333333332
53676_marine,24,42,22,2,66,91.66666666666666,8.333333333333332
53677_marine,24,42,22,2,66,91.66666666666666,8.333333333333332
53678_marine,24,41,22,2,65,91.66666666666666,8.333333333333332
53679_marine,24,41,22,2,65,91.66666666666666,8.333333333333332
53680_marine,24,41,22,2,65,91.66666666666666,8.333333333333332
53681_marine,25,41,23,2,66,92,8
53682_marine,24,41,22,2,65,91.66666666666666,8.333333333333332
53683_marine,24,41,22,2,65,91.66666666666666,8.333333333333332
53684_marine,24,42,22,2,66,91.66666666666666,8.333333333333332
53685_marine,24,42,22,2,66,91.66666666666666,8.333333333333332
53686_marine,24,42,22,2,66,91.66666666666666,8.333333333333332
53687_marine,24,42,22,2,66,91.66666666666666,8.333333333333332
53688_marine,24,42,22,2,66,91.66666666666666,8.333333333333332
53689_marine,24,42,22,2,66,91.66666666666666,8.333333333333332
53690_marine,24,42,22,2,66,91.66666666666666,8.333333333333332
53691_marine,24,42,22,2,66,91.66666666666666,8.333333333333332
53692_marine,24,42,22,2,66,91.66666666666666,8.333333333333332
53693_marine,25,42,23,3,67,92,12
53694_marine,25,42,23,3,67,92,12
53695_marine,25,42,23,3,67,92,12
53696_marine,25,42,23,3,67,92,12
53697_marine,25,42,23,3,67,92,12
53698_marine,25,42,23,3,67,92,12
53699_marine,25,42,23,3,67,92,12
53700_marine,25,42,23,3,67,92,12
53701_marine,25,42,23,3,67,92,12
53702_marine,25,42,23,3,67,92,12
53703_marine,25,42,23,3,67,92,12
53704_marine,25,42,23,3,67,92,12
53705_marine,25,42,23,3,67,92,12
53706_marine,25,42,23,3,67,92,12
53707_marine,25,42,23,3,67,92,12
53708_marine,25,42,23,3,67,92,12
53709_marine,25,41,23,3,66,92,12
53710_marine,25,41,23,3,66,92,12
53711_marine,25,41,23,3,66,92,12
53712_marine,25,41,23,3,66,92,12
53713_marine,25,41,23,3,66,92,12
53714_marine,25,41,23,3,66,92,12
53715_marine,25,41,23,3,66,92,12
53716_marine,25,41,23,3,66,92,12
53717_marine,25,41,23,3,66,92,12
53718_marine,25,41,23,3,66,92,12
53719_marine,25,42,23,3,67,92,12
53720_marine,25,42,23,3,67,92,12
53721_marine,25,42,23,3,67,92,12
53722_marine,25,42,23,3,67,92,12
53723_marine,25,42,23,3,67,92,12
53724_marine,25,42,23,3,67,92,12
53725_marine,25,42,23,3,67,92,12
53726_marine,25,42,23,3,67,92,12
53727_marine,25,42,23,3,67,92,12
53728_marine,25,42,23,3,67,92,12
53729_marine,25,41,23,3,66,92,12
53730_marine,25,41,23,3,66,92,12
53731_marine,25,41,23,3,66,92,12
53732_marine,25,41,23,3,66,92,12
53733_marine,25,40,23,3,65,92,12
53734_marine,25,40,23,3,65,92,12
53735_marine,25,40,23,3,65,92,12
53736_marine,25,40,23,3,65,92,12
53737_marine,25,40,23,3,65,92,12
53738_marine,26,40,23,4,66,88.46153846153845,15.384615384615385
53739_marine,26,40,23,4,66,88.46153846153845,15.384615384615385
53740_marine,26,40,23,4,66,88.46153846153845,15.384615384615385
53741_marine,26,40,23,4,66,88.46153846153845,15.384615384615385
53742_marine,27,40,24,5,67,88.88888888888889,18.51851851851852
53743_marine,27,41,24,5,68,88.88888888888889,18.51851851851852
53744_marine,27,41,24,5,68,88.88888888888889,18.51851851851852
53745_marine,27,41,24,5,68,88.88888888888889,18.51851851851852
53746_marine,27,41,24,5,68,88.88888888888889,18.51851851851852
53747_marine,28,41,24,5,69,85.71428571428571,17.857142857142858
53748_marine,29,41,25,6,70,86.20689655172413,20.689655172413794
53749_marine,29,41,25,6,70,86.20689655172413,20.689655172413794
53750_marine,31,43,27,6,74,87.09677419354838,19.35483870967742
53751_marine,32,44,28,6,76,87.5,18.75
53752_marine,31,43,27,6,74,87.09677419354838,19.35483870967742
53753_marine,35,43,29,6,78,82.85714285714286,17.142857142857142
53754_marine,35,43,29,6,78,82.85714285714286,17.142857142857142
53755_marine,35,43,29,6,78,82.85714285714286,17.142857142857142
53756_marine,33,43,27,6,76,81.81818181818183,18.181818181818183
53757_marine,31,43,25,6,74,80.64516129032258,19.35483870967742
53758_marine,31,44,25,6,75,80.64516129032258,19.35483870967742
53759_marine,30,44,25,6,74,83.33333333333334,20
53760_marine,30,51,25,6,81,83.33333333333334,20
53761_marine,31,51,25,7,82,80.64516129032258,22.58064516129032
53762_marine,31,51,25,7,82,80.64516129032258,22.58064516129032
53763_marine,31,49,25,7,80,80.64516129032258,22.58064516129032
53764_marine,30,49,26,7,79,86.66666666666667,23.333333333333332
53765_marine,30,48,26,7,78,86.66666666666667,23.333333333333332
53766_marine,30,48,26,7,78,86.66666666666667,23.333333333333332
53767_marine,31,49,26,8,80,83.87096774193549,25.806451612903224
53768_marine,31,49,26,8,80,83.87096774193549,25.806451612903224
53769_marine,32,48,27,8,80,84.375,25
53770_marine,31,48,26,8,79,83.87096774193549,25.806451612903224
53771_marine,30,52,25,8,82,83.33333333333334,26.666666666666668
53772_marine,29,52,25,7,81,86.20689655172413,24.137931034482758
53773_marine,29,53,25,7,82,86.20689655172413,24.137931034482758
53774_marine,29,52,25,7,81,86.20689655172413,24.137931034482758
53775_marine,29,52,25,7,81,86.20689655172413,24.137931034482758
53776_marine,28,52,24,6,80,85.71428571428571,21.428571428571427
53777_marine,28,53,24,6,81,85.71428571428571,21.428571428571427
53778_marine,27,52,23,6,79,85.18518518518519,22.22222222222222
53779_marine,27,51,23,6,78,85.18518518518519,22.22222222222222
53780_marine,27,52,23,6,79,85.18518518518519,22.22222222222222
53781_marine,26,52,23,5,78,88.46153846153845,19.230769230769234
53782_marine,27,52,23,6,79,85.18518518518519,22.22222222222222
53783_marine,26,52,22,6,78,84.61538461538461,23.076923076923077
53784_marine,26,52,22,6,78,84.61538461538461,23.076923076923077
53785_marine,26,52,22,6,78,84.61538461538461,23.076923076923077
53786_marine,26,52,22,6,78,84.61538461538461,23.076923076923077
53787_marine,26,51,22,6,77,84.61538461538461,23.076923076923077
53788_marine,26,51,22,6,77,84.61538461538461,23.076923076923077
53789_marine,26,50,22,6,76,84.61538461538461,23.076923076923077
53790_marine,26,50,22,6,76,84.61538461538461,23.076923076923077
53791_marine,26,50,22,6,76,84.61538461538461,23.076923076923077
53792_marine,27,51,23,6,78,85.18518518518519,22.22222222222222
53793_marine,35,57,26,13,92,74.28571428571429,37.142857142857146
53794_marine,35,57,26,13,92,74.28571428571429,37.142857142857146
53795_marine,27,49,23,6,76,85.18518518518519,22.22222222222222
53796_marine,27,49,23,6,76,85.18518518518519,22.22222222222222
53797_marine,27,48,23,6,75,85.18518518518519,22.22222222222222
53798_marine,28,48,24,6,76,85.71428571428571,21.428571428571427
53799_marine,29,46,25,6,75,86.20689655172413,20.689655172413794
53800_marine,29,46,25,6,75,86.20689655172413,20.689655172413794
53801_marine,29,46,25,6,75,86.20689655172413,20.689655172413794
53802_marine,29,45,25,6,74,86.20689655172413,20.689655172413794
53803_marine,29,45,25,6,74,86.20689655172413,20.689655172413794
53804_marine,29,45,25,6,74,86.20689655172413,20.689655172413794
53805_marine,29,45,25,6,74,86.20689655172413,20.689655172413794
53806_marine,29,44,25,6,73,86.20689655172413,20.689655172413794
53807_marine,29,44,25,6,73,86.20689655172413,20.689655172413794
53808_marine,29,44,25,6,73,86.20689655172413,20.689655172413794
53809_marine,29,44,25,6,73,86.20689655172413,20.689655172413794
53810_marine,29,44,25,6,73,86.20689655172413,20.689655172413794
53811_marine,31,44,27,6,75,87.09677419354838,19.35483870967742
53812_marine,32,44,28,6,76,87.5,18.75
53813_marine,32,44,28,6,76,87.5,18.75
53814_marine,32,44,28,6,76,87.5,18.75
53815_marine,32,44,28,6,76,87.5,18.75
53816_marine,33,44,28,7,77,84.84848484848484,21.21212121212121
53817_marine,33,44,28,7,77,84.84848484848484,21.21212121212121
53818_marine,33,44,28,7,77,84.84848484848484,21.21212121212121
53819_marine,33,44,28,7,77,84.84848484848484,21.21212121212121
53820_marine,33,44,28,7,77,84.84848484848484,21.21212121212121
53821_marine,32,44,27,7,76,84.375,21.875
53822_marine,31,44,26,7,75,83.87096774193549,22.58064516129032
53823_marine,31,44,26,7,75,83.87096774193549,22.58064516129032
53824_marine,31,44,26,7,75,83.87096774193549,22.58064516129032
53825_marine,31,44,26,7,75,83.87096774193549,22.58064516129032
53826_marine,31,44,26,7,75,83.87096774193549,22.58064516129032
53827_marine,31,44,26,7,75,83.87096774193549,22.58064516129032
53828_marine,30,45,26,6,75,86.66666666666667,20
53829_marine,30,45,26,6,75,86.66666666666667,20
53830_marine,30,45,26,6,75,86.66666666666667,20
53831_marine,28,45,25,5,73,89.28571428571429,17.857142857142858
53832_marine,28,45,25,5,73,89.28571428571429,17.857142857142858
53833_marine,28,45,25,5,73,89.28571428571429,17.857142857142858
53834_marine,28,45,25,5,73,89.28571428571429,17.857142857142858
53835_marine,28,45,25,5,73,89.28571428571429,17.857142857142858
53836_marine,28,45,25,5,73,89.28571428571429,17.857142857142858
53837_marine,28,45,25,5,73,89.28571428571429,17.857142857142858
53838_marine,28,45,25,5,73,89.28571428571429,17.857142857142858
53839_marine,28,45,25,5,73,89.28571428571429,17.857142857142858
53840_marine,28,45,25,5,73,89.28571428571429,17.857142857142858
53841_marine,28,45,25,5,73,89.28571428571429,17.857142857142858
53842_marine,29,45,25,6,74,86.20689655172413,20.689655172413794
53843_marine,29,45,25,6,74,86.20689655172413,20.689655172413794
53844_marine,29,45,25,6,74,86.20689655172413,20.689655172413794
53845_marine,29,45,25,6,74,86.20689655172413,20.689655172413794
53846_marine,29,45,25,6,74,86.20689655172413,20.689655172413794
53847_marine,28,45,25,5,73,89.28571428571429,17.857142857142858
53848_marine,28,45,25,5,73,89.28571428571429,17.857142857142858
53849_marine,28,45,25,5,73,89.28571428571429,17.857142857142858
53850_marine,28,45,25,5,73,89.28571428571429,17.857142857142858
53851_marine,28,45,25,5,73,89.28571428571429,17.857142857142858
53852_marine,28,45,25,5,73,89.28571428571429,17.857142857142858
53853_marine,28,45,25,5,73,89.28571428571429,17.857142857142858
53854_marine,28,45,25,5,73,89.28571428571429,17.857142857142858
53855_marine,27,45,25,4,72,92.5925925925926,14.814814814814813
53856_marine,27,45,25,4,72,92.5925925925926,14.814814814814813
53857_marine,27,45,25,4,72,92.5925925925926,14.814814814814813
53858_marine,27,45,25,4,72,92.5925925925926,14.814814814814813
53859_marine,27,46,25,4,73,92.5925925925926,14.814814814814813
53860_marine,28,46,26,4,74,92.85714285714286,14.285714285714285
53861_marine,28,46,26,4,74,92.85714285714286,14.285714285714285
53862_marine,28,46,26,4,74,92.85714285714286,14.285714285714285
53863_marine,28,46,26,4,74,92.85714285714286,14.285714285714285
53864_marine,28,46,26,4,74,92.85714285714286,14.285714285714285
53865_marine,28,46,26,4,74,92.85714285714286,14.285714285714285
53866_marine,28,46,26,4,74,92.85714285714286,14.285714285714285
53867_marine,29,46,26,5,75,89.65517241379311,17.24137931034483
53868_marine,29,46,26,5,75,89.65517241379311,17.24137931034483
53869_marine,29,46,26,5,75,89.65517241379311,17.24137931034483
53870_marine,29,45,26,5,74,89.65517241379311,17.24137931034483
53871_marine,29,45,26,5,74,89.65517241379311,17.24137931034483
53872_marine,28,45,25,5,73,89.28571428571429,17.857142857142858
53873_marine,28,45,25,5,73,89.28571428571429,17.857142857142858
53874_marine,28,45,25,5,73,89.28571428571429,17.857142857142858
53875_marine,29,45,25,6,74,86.20689655172413,20.689655172413794
53876_marine,29,45,25,6,74,86.20689655172413,20.689655172413794
53877_marine,27,45,23,6,72,85.18518518518519,22.22222222222222
53878_marine,27,45,23,6,72,85.18518518518519,22.22222222222222
53879_marine,27,45,23,6,72,85.18518518518519,22.22222222222222
53880_marine,27,45,23,6,72,85.18518518518519,22.22222222222222
53881_marine,27,45,23,6,72,85.18518518518519,22.22222222222222
53882_marine,27,45,23,6,72,85.18518518518519,22.22222222222222
53883_marine,27,45,23,6,72,85.18518518518519,22.22222222222222
53884_marine,27,45,23,6,72,85.18518518518519,22.22222222222222
53885_marine,27,45,23,6,72,85.18518518518519,22.22222222222222
53886_marine,27,45,23,6,72,85.18518518518519,22.22222222222222
53887_marine,27,45,23,6,72,85.18518518518519,22.22222222222222
53888_marine,27,45,23,6,72,85.18518518518519,22.22222222222222
53889_marine,26,45,23,5,71,88.46153846153845,19.230769230769234
53890_marine,26,46,23,5,72,88.46153846153845,19.230769230769234
53891_marine,26,46,23,5,72,88.46153846153845,19.230769230769234
53892_marine,25,46,22,5,71,88,20
53893_marine,26,45,23,5,71,88.46153846153845,19.230769230769234
53894_marine,26,45,23,5,71,88.46153846153845,19.230769230769234
53895_marine,26,45,23,5,71,88.46153846153845,19.230769230769234
53896_marine,25,45,23,4,70,92,16
53897_marine,25,45,23,4,70,92,16
53898_marine,25,45,23,4,70,92,16
53899_marine,25,45,23,4,70,92,16
53900_marine,25,45,23,4,70,92,16
53901_marine,25,44,23,4,69,92,16
53902_marine,25,44,23,4,69,92,16
53903_marine,25,46,23,4,71,92,16
53904_marine,25,46,23,4,71,92,16
53905_marine,25,46,23,4,71,92,16
53906_marine,25,46,23,4,71,92,16
53907_marine,26,45,24,4,71,92.3076923076923,15.384615384615385
53908_marine,26,45,24,4,71,92.3076923076923,15.384615384615385
53909_marine,26,45,24,4,71,92.3076923076923,15.384615384615385
53910_marine,26,45,24,4,71,92.3076923076923,15.384615384615385
53911_marine,26,45,24,4,71,92.3076923076923,15.384615384615385
53912_marine,26,45,24,4,71,92.3076923076923,15.384615384615385
53913_marine,26,45,24,4,71,92.3076923076923,15.384615384615385
53914_marine,26,46,24,4,72,92.3076923076923,15.384615384615385
53915_marine,26,46,24,4,72,92.3076923076923,15.384615384615385
53916_marine,26,46,24,4,72,92.3076923076923,15.384615384615385
53917_marine,26,46,24,4,72,92.3076923076923,15.384615384615385
53918_marine,26,46,24,4,72,92.3076923076923,15.384615384615385
53919_marine,26,47,24,4,73,92.3076923076923,15.384615384615385
53920_marine,26,46,24,4,72,92.3076923076923,15.384615384615385
53921_marine,26,46,24,4,72,92.3076923076923,15.384615384615385
53922_marine,26,47,24,4,73,92.3076923076923,15.384615384615385
53923_marine,26,48,24,4,74,92.3076923076923,15.384615384615385
53924_marine,26,48,24,4,74,92.3076923076923,15.384615384615385
53925_marine,26,48,24,4,74,92.3076923076923,15.384615384615385
53926_marine,26,48,24,4,74,92.3076923076923,15.384615384615385
53927_marine,26,49,24,4,75,92.3076923076923,15.384615384615385
53928_marine,26,49,24,4,75,92.3076923076923,15.384615384615385
53929_marine,26,49,24,4,75,92.3076923076923,15.384615384615385
53930_marine,26,49,24,4,75,92.3076923076923,15.384615384615385
53931_marine,26,49,24,4,75,92.3076923076923,15.384615384615385
53932_marine,26,49,24,4,75,92.3076923076923,15.384615384615385
53933_marine,26,49,24,4,75,92.3076923076923,15.384615384615385
53934_marine,26,49,24,4,75,92.3076923076923,15.384615384615385
53935_marine,26,49,24,4,75,92.3076923076923,15.384615384615385
53936_marine,26,49,24,4,75,92.3076923076923,15.384615384615385
53937_marine,26,49,24,4,75,92.3076923076923,15.384615384615385
53938_marine,27,49,25,4,76,92.5925925925926,14.814814814814813
53939_marine,27,41,24,5,68,88.88888888888889,18.51851851851852
53940_marine,27,41,24,5,68,88.88888888888889,18.51851851851852
53941_marine,27,41,24,5,68,88.88888888888889,18.51851851851852
53942_marine,27,41,24,5,68,88.88888888888889,18.51851851851852
53943_marine,27,41,24,5,68,88.88888888888889,18.51851851851852
53944_marine,27,42,24,5,69,88.88888888888889,18.51851851851852
53945_marine,27,42,24,5,69,88.88888888888889,18.51851851851852
53946_marine,28,42,25,5,70,89.28571428571429,17.857142857142858
53947_marine,28,42,25,5,70,89.28571428571429,17.857142857142858
53948_marine,28,42,25,5,70,89.28571428571429,17.857142857142858
53949_marine,28,42,25,5,70,89.28571428571429,17.857142857142858
53950_marine,28,42,25,5,70,89.28571428571429,17.857142857142858
53951_marine,28,42,25,5,70,89.28571428571429,17.857142857142858
53952_marine,28,42,25,5,70,89.28571428571429,17.857142857142858
53953_marine,28,42,25,5,70,89.28571428571429,17.857142857142858
53954_marine,28,42,25,5,70,89.28571428571429,17.857142857142858
53955_marine,28,42,25,5,70,89.28571428571429,17.857142857142858
53956_marine,28,42,25,5,70,89.28571428571429,17.857142857142858
53957_marine,28,43,25,5,71,89.28571428571429,17.857142857142858
53958_marine,28,44,25,5,72,89.28571428571429,17.857142857142858
53959_marine,28,44,25,5,72,89.28571428571429,17.857142857142858
53960_marine,28,44,25,5,72,89.28571428571429,17.857142857142858
53961_marine,28,44,25,5,72,89.28571428571429,17.857142857142858
53962_marine,27,44,25,4,71,92.5925925925926,14.814814814814813
53963_marine,27,44,25,4,71,92.5925925925926,14.814814814814813
53964_marine,27,44,25,4,71,92.5925925925926,14.814814814814813
53965_marine,27,44,25,4,71,92.5925925925926,14.814814814814813
53966_marine,27,44,25,4,71,92.5925925925926,14.814814814814813
53967_marine,29,46,27,4,75,93.10344827586206,13.793103448275861
53968_marine,31,46,29,4,77,93.54838709677419,12.903225806451612
53969_marine,31,46,29,4,77,93.54838709677419,12.903225806451612
53970_marine,31,48,29,4,79,93.54838709677419,12.903225806451612
53971_marine,30,48,28,4,78,93.33333333333333,13.333333333333334
53972_marine,28,48,26,4,76,92.85714285714286,14.285714285714285
53973_marine,27,49,25,4,76,92.5925925925926,14.814814814814813
53974_marine,27,49,25,4,76,92.5925925925926,14.814814814814813
53975_marine,27,49,25,4,76,92.5925925925926,14.814814814814813
53976_marine,27,51,25,4,78,92.5925925925926,14.814814814814813
53977_marine,29,51,27,4,80,93.10344827586206,13.793103448275861
53978_marine,29,51,27,4,80,93.10344827586206,13.793103448275861
53979_marine,29,54,27,4,83,93.10344827586206,13.793103448275861
53980_marine,29,55,27,4,84,93.10344827586206,13.793103448275861
53981_marine,29,55,27,4,84,93.10344827586206,13.793103448275861
53982_marine,29,55,27,4,84,93.10344827586206,13.793103448275861
53983_marine,30,54,28,4,84,93.33333333333333,13.333333333333334
53984_marine,30,54,28,4,84,93.33333333333333,13.333333333333334
53985_marine,30,52,28,4,82,93.33333333333333,13.333333333333334
53986_marine,30,52,28,4,82,93.33333333333333,13.333333333333334
53987_marine,30,52,28,4,82,93.33333333333333,13.333333333333334
53988_marine,30,51,28,4,81,93.33333333333333,13.333333333333334
53989_marine,30,51,28,4,81,93.33333333333333,13.333333333333334
53990_marine,29,50,27,4,79,93.10344827586206,13.793103448275861
53991_marine,29,50,27,4,79,93.10344827586206,13.793103448275861
53992_marine,28,48,26,4,76,92.85714285714286,14.285714285714285
53993_marine,28,47,26,4,75,92.85714285714286,14.285714285714285
53994_marine,27,47,25,3,74,92.5925925925926,11.11111111111111
53995_marine,27,47,25,3,74,92.5925925925926,11.11111111111111
53996_marine,28,47,26,3,75,92.85714285714286,10.714285714285714
53997_marine,28,47,26,3,75,92.85714285714286,10.714285714285714
53998_marine,28,48,26,3,76,92.85714285714286,10.714285714285714
53999_marine,28,48,26,3,76,92.85714285714286,10.714285714285714
54000_marine,27,46,25,3,73,92.5925925925926,11.11111111111111
54001_marine,27,45,25,3,72,92.5925925925926,11.11111111111111
54002_marine,27,43,25,3,70,92.5925925925926,11.11111111111111
54003_marine,27,43,25,3,70,92.5925925925926,11.11111111111111
54004_marine,26,43,24,2,69,92.3076923076923,7.6923076923076925
54005_marine,26,43,24,2,69,92.3076923076923,7.6923076923076925
54006_marine,26,44,24,2,70,92.3076923076923,7.6923076923076925
54007_marine,26,44,24,2,70,92.3076923076923,7.6923076923076925
54008_marine,26,43,24,2,69,92.3076923076923,7.6923076923076925
54009_marine,26,43,24,2,69,92.3076923076923,7.6923076923076925
54010_marine,25,43,23,2,68,92,8
54011_marine,25,43,23,2,68,92,8
54012_marine,25,41,23,2,66,92,8
54013_marine,25,41,23,2,66,92,8
54014_marine,25,41,23,2,66,92,8
54015_marine,25,40,23,2,65,92,8
54016_marine,25,40,23,2,65,92,8
54017_marine,25,40,23,2,65,92,8
54018_marine,25,40,23,2,65,92,8
54019_marine,25,40,23,2,65,92,8
54020_marine,25,40,23,2,65,92,8
54021_marine,25,40,23,2,65,92,8
54022_marine,25,40,23,2,65,92,8
54023_marine,25,40,23,2,65,92,8
54024_marine,25,40,23,2,65,92,8
54025_marine,24,40,22,2,64,91.66666666666666,8.333333333333332
54026_marine,24,40,22,2,64,91.66666666666666,8.333333333333332
54027_marine,24,40,22,2,64,91.66666666666666,8.333333333333332
54028_marine,24,39,22,2,63,91.66666666666666,8.333333333333332
54029_marine,24,39,22,2,63,91.66666666666666,8.333333333333332
54030_marine,24,39,22,2,63,91.66666666666666,8.333333333333332
54031_marine,24,39,22,2,63,91.66666666666666,8.333333333333332
54032_marine,24,38,22,2,62,91.66666666666666,8.333333333333332
54033_marine,24,38,22,2,62,91.66666666666666,8.333333333333332
54034_marine,24,38,22,2,62,91.66666666666666,8.333333333333332
54035_marine,24,38,22,2,62,91.66666666666666,8.333333333333332
54036_marine,24,38,22,2,62,91.66666666666666,8.333333333333332
54037_marine,24,38,22,2,62,91.66666666666666,8.333333333333332
54038_marine,24,38,22,2,62,91.66666666666666,8.333333333333332
54039_marine,24,38,22,2,62,91.66666666666666,8.333333333333332
54040_marine,24,38,22,2,62,91.66666666666666,8.333333333333332
54041_marine,25,38,23,2,63,92,8
54042_marine,24,38,22,2,62,91.66666666666666,8.333333333333332
54043_marine,24,38,22,2,62,91.66666666666666,8.333333333333332
54044_marine,24,38,22,2,62,91.66666666666666,8.333333333333332
54045_marine,24,39,22,2,63,91.66666666666666,8.333333333333332
54046_marine,24,41,22,2,65,91.66666666666666,8.333333333333332
54047_marine,24,41,22,2,65,91.66666666666666,8.333333333333332
54048_marine,24,41,22,2,65,91.66666666666666,8.333333333333332
54049_marine,25,41,23,3,66,92,12
54050_marine,25,41,23,3,66,92,12
54051_marine,25,41,23,3,66,92,12
54052_marine,25,41,23,3,66,92,12
54053_marine,25,41,23,3,66,92,12
54054_marine,25,41,23,3,66,92,12
54055_marine,25,41,23,3,66,92,12
54056_marine,25,41,23,3,66,92,12
54057_marine,25,41,23,3,66,92,12
54058_marine,25,41,23,3,66,92,12
54059_marine,25,41,23,3,66,92,12
54060_marine,25,41,23,3,66,92,12
54061_marine,25,41,23,3,66,92,12
54062_marine,25,41,23,3,66,92,12
54063_marine,25,41,23,3,66,92,12
54064_marine,25,41,23,3,66,92,12
54065_marine,25,41,23,3,66,92,12
54066_marine,25,41,23,3,66,92,12
54067_marine,25,41,23,3,66,92,12
54068_marine,25,40,23,3,65,92,12
54069_marine,25,40,23,3,65,92,12
54070_marine,25,40,23,3,65,92,12
54071_marine,25,40,23,3,65,92,12
54072_marine,25,40,23,3,65,92,12
54073_marine,25,40,23,3,65,92,12
54074_marine,25,40,23,3,65,92,12
54075_marine,25,40,23,3,65,92,12
54076_marine,25,41,23,3,66,92,12
54077_marine,25,41,23,3,66,92,12
54078_marine,25,41,23,3,66,92,12
54079_marine,25,41,23,3,66,92,12
54080_marine,25,42,23,3,67,92,12
54081_marine,25,42,23,3,67,92,12
54082_marine,25,42,23,3,67,92,12
54083_marine,25,41,23,3,66,92,12
54084_marine,25,41,23,3,66,92,12
54085_marine,25,41,23,3,66,92,12
54086_marine,25,41,23,3,66,92,12
54087_marine,25,41,23,3,66,92,12
54088_marine,25,41,23,3,66,92,12
54089_marine,25,41,23,3,66,92,12
54090_marine,25,41,23,3,66,92,12
54091_marine,25,41,23,3,66,92,12
54092_marine,25,41,23,3,66,92,12
54093_marine,25,41,23,3,66,92,12
54094_marine,25,41,23,3,66,92,12
54095_marine,25,41,23,3,66,92,12
54096_marine,25,41,23,3,66,92,12
54097_marine,25,41,23,3,66,92,12
54098_marine,26,41,23,4,67,88.46153846153845,15.384615384615385
54099_marine,26,40,23,4,66,88.46153846153845,15.384615384615385
54100_marine,26,40,23,4,66,88.46153846153845,15.384615384615385
54101_marine,26,40,23,4,66,88.46153846153845,15.384615384615385
54102_marine,26,40,23,4,66,88.46153846153845,15.384615384615385
54103_marine,25,40,22,4,65,88,16
54104_marine,25,41,22,5,66,88,20
54105_marine,25,41,22,5,66,88,20
54106_marine,25,41,22,5,66,88,20
54107_marine,26,41,23,6,67,88.46153846153845,23.076923076923077
54108_marine,26,41,23,6,67,88.46153846153845,23.076923076923077
54109_marine,26,41,23,6,67,88.46153846153845,23.076923076923077
54110_marine,28,41,25,6,69,89.28571428571429,21.428571428571427
54111_marine,29,43,26,6,72,89.65517241379311,20.689655172413794
54112_marine,28,42,25,6,70,89.28571428571429,21.428571428571427
54113_marine,28,42,25,6,70,89.28571428571429,21.428571428571427
54114_marine,28,43,25,6,71,89.28571428571429,21.428571428571427
54115_marine,28,42,25,6,70,89.28571428571429,21.428571428571427
54116_marine,30,46,25,6,76,83.33333333333334,20
54117_marine,31,47,25,7,78,80.64516129032258,22.58064516129032
54118_marine,31,47,25,7,78,80.64516129032258,22.58064516129032
54119_marine,31,47,25,7,78,80.64516129032258,22.58064516129032
54120_marine,31,47,25,7,78,80.64516129032258,22.58064516129032
54121_marine,31,46,25,7,77,80.64516129032258,22.58064516129032
54122_marine,32,46,25,8,78,78.125,25
54123_marine,30,48,25,8,78,83.33333333333334,26.666666666666668
54124_marine,31,52,26,8,83,83.87096774193549,25.806451612903224
54125_marine,39,62,29,15,101,74.35897435897436,38.46153846153847
54126_marine,32,52,26,9,84,81.25,28.125
54127_marine,32,56,26,9,88,81.25,28.125
54128_marine,31,51,26,8,82,83.87096774193549,25.806451612903224
54129_marine,32,50,27,8,82,84.375,25
54130_marine,30,52,25,8,82,83.33333333333334,26.666666666666668
54131_marine,30,50,25,8,80,83.33333333333334,26.666666666666668
54132_marine,30,50,25,8,80,83.33333333333334,26.666666666666668
54133_marine,29,50,25,7,79,86.20689655172413,24.137931034482758
54134_marine,37,64,28,14,101,75.67567567567568,37.83783783783784
54135_marine,36,64,27,13,100,75,36.11111111111111
54136_marine,35,64,26,13,99,74.28571428571429,37.142857142857146
54137_marine,27,53,23,6,80,85.18518518518519,22.22222222222222
54138_marine,27,53,23,6,80,85.18518518518519,22.22222222222222
54139_marine,27,48,23,6,75,85.18518518518519,22.22222222222222
54140_marine,27,49,23,6,76,85.18518518518519,22.22222222222222
54141_marine,27,49,23,6,76,85.18518518518519,22.22222222222222
54142_marine,26,48,22,6,74,84.61538461538461,23.076923076923077
54143_marine,26,48,22,6,74,84.61538461538461,23.076923076923077
54144_marine,26,48,22,6,74,84.61538461538461,23.076923076923077
54145_marine,26,48,22,6,74,84.61538461538461,23.076923076923077
54146_marine,26,48,22,6,74,84.61538461538461,23.076923076923077
54147_marine,26,48,22,6,74,84.61538461538461,23.076923076923077
54148_marine,26,47,22,6,73,84.61538461538461,23.076923076923077
54149_marine,26,47,22,6,73,84.61538461538461,23.076923076923077
54150_marine,26,47,22,6,73,84.61538461538461,23.076923076923077
54151_marine,26,47,22,6,73,84.61538461538461,23.076923076923077
54152_marine,26,48,22,6,74,84.61538461538461,23.076923076923077
54153_marine,27,47,23,6,74,85.18518518518519,22.22222222222222
54154_marine,27,47,23,6,74,85.18518518518519,22.22222222222222
54155_marine,27,47,23,6,74,85.18518518518519,22.22222222222222
54156_marine,27,46,23,6,73,85.18518518518519,22.22222222222222
54157_marine,27,46,23,6,73,85.18518518518519,22.22222222222222
54158_marine,27,46,23,6,73,85.18518518518519,22.22222222222222
54159_marine,28,46,24,6,74,85.71428571428571,21.428571428571427
54160_marine,29,46,25,6,75,86.20689655172413,20.689655172413794
54161_marine,29,46,25,6,75,86.20689655172413,20.689655172413794
54162_marine,29,45,25,6,74,86.20689655172413,20.689655172413794
54163_marine,29,44,25,6,73,86.20689655172413,20.689655172413794
54164_marine,29,44,25,6,73,86.20689655172413,20.689655172413794
54165_marine,29,44,25,6,73,86.20689655172413,20.689655172413794
54166_marine,29,44,25,6,73,86.20689655172413,20.689655172413794
54167_marine,29,44,25,6,73,86.20689655172413,20.689655172413794
54168_marine,29,44,25,6,73,86.20689655172413,20.689655172413794
54169_marine,29,44,25,6,73,86.20689655172413,20.689655172413794
54170_marine,29,44,25,6,73,86.20689655172413,20.689655172413794
54171_marine,30,44,25,7,74,83.33333333333334,23.333333333333332
54172_marine,30,44,25,7,74,83.33333333333334,23.333333333333332
54173_marine,30,42,25,7,72,83.33333333333334,23.333333333333332
54174_marine,30,42,25,7,72,83.33333333333334,23.333333333333332
54175_marine,30,42,25,7,72,83.33333333333334,23.333333333333332
54176_marine,30,42,25,7,72,83.33333333333334,23.333333333333332
54177_marine,30,42,25,7,72,83.33333333333334,23.333333333333332
54178_marine,30,42,25,7,72,83.33333333333334,23.333333333333332
54179_marine,30,42,25,7,72,83.33333333333334,23.333333333333332
54180_marine,30,42,25,7,72,83.33333333333334,23.333333333333332
54181_marine,30,42,25,7,72,83.33333333333334,23.333333333333332
54182_marine,29,42,24,7,71,82.75862068965517,24.137931034482758
54183_marine,29,42,24,7,71,82.75862068965517,24.137931034482758
54184_marine,29,42,24,7,71,82.75862068965517,24.137931034482758
54185_marine,28,42,24,6,70,85.71428571428571,21.428571428571427
54186_marine,28,42,24,6,70,85.71428571428571,21.428571428571427
54187_marine,28,44,24,6,72,85.71428571428571,21.428571428571427
54188_marine,28,44,24,6,72,85.71428571428571,21.428571428571427
54189_marine,28,44,24,6,72,85.71428571428571,21.428571428571427
54190_marine,30,44,26,6,74,86.66666666666667,20
54191_marine,29,44,25,6,73,86.20689655172413,20.689655172413794
54192_marine,29,44,25,6,73,86.20689655172413,20.689655172413794
54193_marine,29,44,25,6,73,86.20689655172413,20.689655172413794
54194_marine,29,45,25,6,74,86.20689655172413,20.689655172413794
54195_marine,29,45,25,6,74,86.20689655172413,20.689655172413794
54196_marine,29,45,25,6,74,86.20689655172413,20.689655172413794
54197_marine,29,45,25,6,74,86.20689655172413,20.689655172413794
54198_marine,29,45,25,6,74,86.20689655172413,20.689655172413794
54199_marine,29,45,25,6,74,86.20689655172413,20.689655172413794
54200_marine,29,45,25,6,74,86.20689655172413,20.689655172413794
54201_marine,29,45,25,6,74,86.20689655172413,20.689655172413794
54202_marine,29,45,25,6,74,86.20689655172413,20.689655172413794
54203_marine,29,45,25,6,74,86.20689655172413,20.689655172413794
54204_marine,29,45,25,6,74,86.20689655172413,20.689655172413794
54205_marine,29,45,25,6,74,86.20689655172413,20.689655172413794
54206_marine,29,45,25,6,74,86.20689655172413,20.689655172413794
54207_marine,29,45,25,6,74,86.20689655172413,20.689655172413794
54208_marine,29,45,25,6,74,86.20689655172413,20.689655172413794
54209_marine,29,45,25,6,74,86.20689655172413,20.689655172413794
54210_marine,29,45,25,6,74,86.20689655172413,20.689655172413794
54211_marine,29,45,25,6,74,86.20689655172413,20.689655172413794
54212_marine,29,43,25,6,72,86.20689655172413,20.689655172413794
54213_marine,29,43,25,6,72,86.20689655172413,20.689655172413794
54214_marine,28,43,25,5,71,89.28571428571429,17.857142857142858
54215_marine,28,43,25,5,71,89.28571428571429,17.857142857142858
54216_marine,28,43,25,5,71,89.28571428571429,17.857142857142858
54217_marine,28,43,25,5,71,89.28571428571429,17.857142857142858
54218_marine,28,43,25,5,71,89.28571428571429,17.857142857142858
54219_marine,28,43,25,5,71,89.28571428571429,17.857142857142858
54220_marine,28,43,25,5,71,89.28571428571429,17.857142857142858
54221_marine,29,43,25,6,72,86.20689655172413,20.689655172413794
54222_marine,30,43,26,6,73,86.66666666666667,20
54223_marine,29,43,25,6,72,86.20689655172413,20.689655172413794
54224_marine,29,43,25,6,72,86.20689655172413,20.689655172413794
54225_marine,29,43,25,6,72,86.20689655172413,20.689655172413794
54226_marine,28,45,25,5,73,89.28571428571429,17.857142857142858
54227_marine,28,45,25,5,73,89.28571428571429,17.857142857142858
54228_marine,28,45,25,5,73,89.28571428571429,17.857142857142858
54229_marine,28,45,25,5,73,89.28571428571429,17.857142857142858
54230_marine,25,45,22,5,70,88,20
54231_marine,25,45,22,5,70,88,20
54232_marine,25,45,22,5,70,88,20
54233_marine,25,45,22,5,70,88,20
54234_marine,25,45,22,5,70,88,20
54235_marine,25,45,22,5,70,88,20
54236_marine,25,45,22,5,70,88,20
54237_marine,25,45,22,5,70,88,20
54238_marine,25,44,22,5,69,88,20
54239_marine,25,44,22,5,69,88,20
54240_marine,26,44,22,6,70,84.61538461538461,23.076923076923077
54241_marine,26,44,22,6,70,84.61538461538461,23.076923076923077
54242_marine,26,45,22,6,71,84.61538461538461,23.076923076923077
54243_marine,26,45,22,6,71,84.61538461538461,23.076923076923077
54244_marine,26,45,22,6,71,84.61538461538461,23.076923076923077
54245_marine,26,45,22,6,71,84.61538461538461,23.076923076923077
54246_marine,26,45,22,6,71,84.61538461538461,23.076923076923077
54247_marine,26,44,22,6,70,84.61538461538461,23.076923076923077
54248_marine,26,43,22,6,69,84.61538461538461,23.076923076923077
54249_marine,26,43,22,6,69,84.61538461538461,23.076923076923077
54250_marine,26,43,22,6,69,84.61538461538461,23.076923076923077
54251_marine,26,43,22,6,69,84.61538461538461,23.076923076923077
54252_marine,26,43,22,6,69,84.61538461538461,23.076923076923077
54253_marine,27,43,23,6,70,85.18518518518519,22.22222222222222
54254_marine,26,44,23,5,70,88.46153846153845,19.230769230769234
54255_marine,26,44,23,5,70,88.46153846153845,19.230769230769234
54256_marine,26,44,23,5,70,88.46153846153845,19.230769230769234
54257_marine,26,44,23,5,70,88.46153846153845,19.230769230769234
54258_marine,26,45,23,5,71,88.46153846153845,19.230769230769234
54259_marine,26,45,23,5,71,88.46153846153845,19.230769230769234
54260_marine,26,44,23,5,70,88.46153846153845,19.230769230769234
54261_marine,26,44,23,5,70,88.46153846153845,19.230769230769234
54262_marine,26,44,23,5,70,88.46153846153845,19.230769230769234
54263_marine,26,44,23,5,70,88.46153846153845,19.230769230769234
54264_marine,25,44,22,5,69,88,20
54265_marine,25,46,22,5,71,88,20
54266_marine,25,45,22,5,70,88,20
54267_marine,26,45,23,5,71,88.46153846153845,19.230769230769234
54268_marine,26,45,23,5,71,88.46153846153845,19.230769230769234
54269_marine,26,43,23,5,69,88.46153846153845,19.230769230769234
54270_marine,26,43,23,5,69,88.46153846153845,19.230769230769234
54271_marine,26,43,23,5,69,88.46153846153845,19.230769230769234
54272_marine,26,43,23,5,69,88.46153846153845,19.230769230769234
54273_marine,26,43,23,5,69,88.46153846153845,19.230769230769234
54274_marine,26,43,23,5,69,88.46153846153845,19.230769230769234
54275_marine,26,43,23,5,69,88.46153846153845,19.230769230769234
54276_marine,26,43,23,5,69,88.46153846153845,19.230769230769234
54277_marine,26,43,23,5,69,88.46153846153845,19.230769230769234
54278_marine,26,43,23,5,69,88.46153846153845,19.230769230769234
54279_marine,25,43,22,5,68,88,20
54280_marine,25,43,22,5,68,88,20
54281_marine,25,43,22,5,68,88,20
54282_marine,25,44,22,5,69,88,20
54283_marine,24,44,21,4,68,87.5,16.666666666666664
54284_marine,24,44,21,4,68,87.5,16.666666666666664
54285_marine,24,44,21,4,68,87.5,16.666666666666664
54286_marine,24,44,21,4,68,87.5,16.666666666666664
54287_marine,24,44,21,4,68,87.5,16.666666666666664
54288_marine,24,44,21,4,68,87.5,16.666666666666664
54289_marine,24,44,21,4,68,87.5,16.666666666666664
54290_marine,24,44,21,4,68,87.5,16.666666666666664
54291_marine,24,45,21,4,69,87.5,16.666666666666664
54292_marine,24,46,21,4,70,87.5,16.666666666666664
54293_marine,24,46,21,4,70,87.5,16.666666666666664
54294_marine,24,46,21,4,70,87.5,16.666666666666664
54295_marine,24,46,21,4,70,87.5,16.666666666666664
54296_marine,24,46,21,4,70,87.5,16.666666666666664
54297_marine,24,47,21,4,71,87.5,16.666666666666664
54298_marine,24,47,21,4,71,87.5,16.666666666666664
54299_marine,24,47,21,4,71,87.5,16.666666666666664
54300_marine,24,47,21,4,71,87.5,16.666666666666664
54301_marine,24,47,21,4,71,87.5,16.666666666666664
54302_marine,24,47,21,4,71,87.5,16.666666666666664
54303_marine,24,47,21,4,71,87.5,16.666666666666664
54304_marine,24,47,21,4,71,87.5,16.666666666666664
54305_marine,25,39,22,4,64,88,16
54306_marine,25,39,22,4,64,88,16
54307_marine,25,40,22,4,65,88,16
54308_marine,25,42,22,4,67,88,16
54309_marine,26,42,23,4,68,88.46153846153845,15.384615384615385
54310_marine,26,42,23,4,68,88.46153846153845,15.384615384615385
54311_marine,26,42,23,4,68,88.46153846153845,15.384615384615385
54312_marine,26,42,23,4,68,88.46153846153845,15.384615384615385
54313_marine,26,42,23,4,68,88.46153846153845,15.384615384615385
54314_marine,26,42,23,4,68,88.46153846153845,15.384615384615385
54315_marine,26,42,23,4,68,88.46153846153845,15.384615384615385
54316_marine,26,42,23,4,68,88.46153846153845,15.384615384615385
54317_marine,26,42,23,4,68,88.46153846153845,15.384615384615385
54318_marine,26,42,23,4,68,88.46153846153845,15.384615384615385
54319_marine,26,42,23,4,68,88.46153846153845,15.384615384615385
54320_marine,26,43,23,4,69,88.46153846153845,15.384615384615385
54321_marine,26,43,23,4,69,88.46153846153845,15.384615384615385
54322_marine,27,44,23,5,71,85.18518518518519,18.51851851851852
54323_marine,27,44,23,5,71,85.18518518518519,18.51851851851852
54324_marine,27,44,23,5,71,85.18518518518519,18.51851851851852
54325_marine,27,44,23,5,71,85.18518518518519,18.51851851851852
54326_marine,27,44,23,5,71,85.18518518518519,18.51851851851852
54327_marine,27,44,23,5,71,85.18518518518519,18.51851851851852
54328_marine,29,44,25,5,73,86.20689655172413,17.24137931034483
54329_marine,29,44,25,5,73,86.20689655172413,17.24137931034483
54330_marine,28,44,25,4,72,89.28571428571429,14.285714285714285
54331_marine,26,45,23,5,71,88.46153846153845,19.230769230769234
54332_marine,26,47,23,5,73,88.46153846153845,19.230769230769234
54333_marine,28,47,25,5,75,89.28571428571429,17.857142857142858
54334_marine,28,47,25,5,75,89.28571428571429,17.857142857142858
54335_marine,29,47,26,5,76,89.65517241379311,17.24137931034483
54336_marine,28,47,26,4,75,92.85714285714286,14.285714285714285
54337_marine,28,48,26,4,76,92.85714285714286,14.285714285714285
54338_marine,28,48,26,4,76,92.85714285714286,14.285714285714285
54339_marine,28,51,26,4,79,92.85714285714286,14.285714285714285
54340_marine,28,50,26,4,78,92.85714285714286,14.285714285714285
54341_marine,28,50,26,4,78,92.85714285714286,14.285714285714285
54342_marine,28,49,26,4,77,92.85714285714286,14.285714285714285
54343_marine,28,49,26,4,77,92.85714285714286,14.285714285714285
54344_marine,28,47,26,4,75,92.85714285714286,14.285714285714285
54345_marine,28,48,26,4,76,92.85714285714286,14.285714285714285
54346_marine,28,48,26,4,76,92.85714285714286,14.285714285714285
54347_marine,28,48,26,4,76,92.85714285714286,14.285714285714285
54348_marine,28,47,26,4,75,92.85714285714286,14.285714285714285
54349_marine,28,47,26,4,75,92.85714285714286,14.285714285714285
54350_marine,28,47,26,4,75,92.85714285714286,14.285714285714285
54351_marine,28,47,26,4,75,92.85714285714286,14.285714285714285
54352_marine,28,47,26,4,75,92.85714285714286,14.285714285714285
54353_marine,26,46,24,3,72,92.3076923076923,11.538461538461538
54354_marine,26,46,24,3,72,92.3076923076923,11.538461538461538
54355_marine,26,46,24,3,72,92.3076923076923,11.538461538461538
54356_marine,26,46,24,3,72,92.3076923076923,11.538461538461538
54357_marine,27,46,25,3,73,92.5925925925926,11.11111111111111
54358_marine,27,46,25,3,73,92.5925925925926,11.11111111111111
54359_marine,27,46,25,3,73,92.5925925925926,11.11111111111111
54360_marine,27,46,25,3,73,92.5925925925926,11.11111111111111
54361_marine,27,42,25,3,69,92.5925925925926,11.11111111111111
54362_marine,27,42,25,3,69,92.5925925925926,11.11111111111111
54363_marine,27,42,25,3,69,92.5925925925926,11.11111111111111
54364_marine,27,41,25,3,68,92.5925925925926,11.11111111111111
54365_marine,27,40,25,3,67,92.5925925925926,11.11111111111111
54366_marine,27,40,25,3,67,92.5925925925926,11.11111111111111
54367_marine,27,40,25,3,67,92.5925925925926,11.11111111111111
54368_marine,25,40,23,2,65,92,8
54369_marine,25,40,23,2,65,92,8
54370_marine,25,39,23,2,64,92,8
54371_marine,25,38,23,2,63,92,8
54372_marine,25,38,23,2,63,92,8
54373_marine,25,38,23,2,63,92,8
54374_marine,25,37,23,2,62,92,8
54375_marine,25,37,23,2,62,92,8
54376_marine,25,37,23,2,62,92,8
54377_marine,25,37,23,2,62,92,8
54378_marine,25,37,23,2,62,92,8
54379_marine,25,37,23,2,62,92,8
54380_marine,25,37,23,2,62,92,8
54381_marine,25,37,23,2,62,92,8
54382_marine,25,37,23,2,62,92,8
54383_marine,25,37,23,2,62,92,8
54384_marine,25,37,23,2,62,92,8
54385_marine,25,37,23,2,62,92,8
54386_marine,25,37,23,2,62,92,8
54387_marine,24,37,22,2,61,91.66666666666666,8.333333333333332
54388_marine,24,37,22,2,61,91.66666666666666,8.333333333333332
54389_marine,24,37,22,2,61,91.66666666666666,8.333333333333332
54390_marine,24,37,22,2,61,91.66666666666666,8.333333333333332
54391_marine,24,37,22,2,61,91.66666666666666,8.333333333333332
54392_marine,24,36,22,2,60,91.66666666666666,8.333333333333332
54393_marine,24,36,22,2,60,91.66666666666666,8.333333333333332
54394_marine,24,44,22,2,68,91.66666666666666,8.333333333333332
54395_marine,24,44,22,2,68,91.66666666666666,8.333333333333332
54396_marine,24,44,22,2,68,91.66666666666666,8.333333333333332
54397_marine,24,44,22,2,68,91.66666666666666,8.333333333333332
54398_marine,24,44,22,2,68,91.66666666666666,8.333333333333332
54399_marine,24,44,22,2,68,91.66666666666666,8.333333333333332
54400_marine,25,44,23,2,69,92,8
54401_marine,25,44,23,2,69,92,8
54402_marine,24,36,22,2,60,91.66666666666666,8.333333333333332
54403_marine,24,36,22,2,60,91.66666666666666,8.333333333333332
54404_marine,25,36,23,3,61,92,12
54405_marine,25,37,23,3,62,92,12
54406_marine,25,37,23,3,62,92,12
54407_marine,25,37,23,3,62,92,12
54408_marine,25,37,23,3,62,92,12
54409_marine,25,37,23,3,62,92,12
54410_marine,25,37,23,3,62,92,12
54411_marine,25,37,23,3,62,92,12
54412_marine,25,37,23,3,62,92,12
54413_marine,25,37,23,3,62,92,12
54414_marine,25,37,23,3,62,92,12
54415_marine,25,39,23,3,64,92,12
54416_marine,25,39,23,3,64,92,12
54417_marine,25,39,23,3,64,92,12
54418_marine,25,39,23,3,64,92,12
54419_marine,25,39,23,3,64,92,12
54420_marine,25,39,23,3,64,92,12
54421_marine,25,39,23,3,64,92,12
54422_marine,25,39,23,3,64,92,12
54423_marine,25,39,23,3,64,92,12
54424_marine,25,37,23,3,62,92,12
54425_marine,25,37,23,3,62,92,12
54426_marine,25,36,23,3,61,92,12
54427_marine,25,36,23,3,61,92,12
54428_marine,25,36,23,3,61,92,12
54429_marine,25,36,23,3,61,92,12
54430_marine,25,36,23,3,61,92,12
54431_marine,25,36,23,3,61,92,12
54432_marine,25,36,23,3,61,92,12
54433_marine,25,36,23,3,61,92,12
54434_marine,25,36,23,3,61,92,12
54435_marine,25,36,23,3,61,92,12
54436_marine,25,36,23,3,61,92,12
54437_marine,25,36,23,3,61,92,12
54438_marine,25,35,23,3,60,92,12
54439_marine,25,35,23,3,60,92,12
54440_marine,25,35,23,3,60,92,12
54441_marine,25,35,23,3,60,92,12
54442_marine,25,35,23,3,60,92,12
54443_marine,25,35,23,3,60,92,12
54444_marine,25,37,23,3,62,92,12
54445_marine,25,37,23,3,62,92,12
54446_marine,25,37,23,3,62,92,12
54447_marine,25,37,23,3,62,92,12
54448_marine,25,37,23,3,62,92,12
54449_marine,25,37,23,3,62,92,12
54450_marine,25,39,23,3,64,92,12
54451_marine,25,39,23,3,64,92,12
54452_marine,25,39,23,3,64,92,12
54453_marine,25,39,23,3,64,92,12
54454_marine,25,39,23,3,64,92,12
54455_marine,23,39,21,3,62,91.30434782608695,13.043478260869565
54456_marine,23,39,21,3,62,91.30434782608695,13.043478260869565
54457_marine,23,39,21,3,62,91.30434782608695,13.043478260869565
54458_marine,23,39,21,3,62,91.30434782608695,13.043478260869565
54459_marine,24,39,21,4,63,87.5,16.666666666666664
54460_marine,24,39,21,4,63,87.5,16.666666666666664
54461_marine,24,39,21,4,63,87.5,16.666666666666664
54462_marine,24,39,21,4,63,87.5,16.666666666666664
54463_marine,23,39,20,4,62,86.95652173913044,17.391304347826086
54464_marine,23,39,20,4,62,86.95652173913044,17.391304347826086
54465_marine,23,39,20,4,62,86.95652173913044,17.391304347826086
54466_marine,23,39,20,4,62,86.95652173913044,17.391304347826086
54467_marine,25,40,22,5,65,88,20
54468_marine,26,40,23,6,66,88.46153846153845,23.076923076923077
54469_marine,26,40,23,6,66,88.46153846153845,23.076923076923077
54470_marine,28,38,25,6,66,89.28571428571429,21.428571428571427
54471_marine,29,39,26,6,68,89.65517241379311,20.689655172413794
54472_marine,29,47,26,6,76,89.65517241379311,20.689655172413794
54473_marine,28,47,25,6,75,89.28571428571429,21.428571428571427
54474_marine,29,47,25,7,76,86.20689655172413,24.137931034482758
54475_marine,29,47,25,7,76,86.20689655172413,24.137931034482758
54476_marine,29,46,25,7,75,86.20689655172413,24.137931034482758
54477_marine,29,47,25,7,76,86.20689655172413,24.137931034482758
54478_marine,30,45,25,8,75,83.33333333333334,26.666666666666668
54479_marine,30,47,25,8,77,83.33333333333334,26.666666666666668
54480_marine,30,53,25,8,83,83.33333333333334,26.666666666666668
54481_marine,31,53,25,9,84,80.64516129032258,29.03225806451613
54482_marine,38,63,28,15,101,73.68421052631578,39.473684210526315
54483_marine,38,63,28,15,101,73.68421052631578,39.473684210526315
54484_marine,36,63,26,15,99,72.22222222222221,41.66666666666667
54485_marine,38,63,28,15,101,73.68421052631578,39.473684210526315
54486_marine,38,63,28,15,101,73.68421052631578,39.473684210526315
54487_marine,37,64,27,15,101,72.97297297297297,40.54054054054054
54488_marine,30,55,25,8,85,83.33333333333334,26.666666666666668
54489_marine,30,50,25,8,80,83.33333333333334,26.666666666666668
54490_marine,29,49,24,8,78,82.75862068965517,27.586206896551722
54491_marine,28,47,23,8,75,82.14285714285714,28.57142857142857
54492_marine,28,47,23,8,75,82.14285714285714,28.57142857142857
54493_marine,28,48,23,8,76,82.14285714285714,28.57142857142857
54494_marine,26,51,22,6,77,84.61538461538461,23.076923076923077
54495_marine,26,50,21,7,76,80.76923076923077,26.923076923076923
54496_marine,26,50,21,7,76,80.76923076923077,26.923076923076923
54497_marine,26,49,22,6,75,84.61538461538461,23.076923076923077
54498_marine,26,48,22,6,74,84.61538461538461,23.076923076923077
54499_marine,26,47,22,6,73,84.61538461538461,23.076923076923077
54500_marine,25,45,21,6,70,84,24
54501_marine,25,46,21,6,71,84,24
54502_marine,25,46,21,6,71,84,24
54503_marine,25,45,21,6,70,84,24
54504_marine,25,44,21,6,69,84,24
54505_marine,25,44,21,6,69,84,24
54506_marine,25,44,21,6,69,84,24
54507_marine,25,42,21,6,67,84,24
54508_marine,25,41,21,6,66,84,24
54509_marine,25,41,21,6,66,84,24
54510_marine,25,41,21,6,66,84,24
54511_marine,25,41,21,6,66,84,24
54512_marine,25,42,21,6,67,84,24
54513_marine,25,42,21,6,67,84,24
54514_marine,25,42,21,6,67,84,24
54515_marine,26,42,22,6,68,84.61538461538461,23.076923076923077
54516_marine,26,41,22,6,67,84.61538461538461,23.076923076923077
54517_marine,26,41,22,6,67,84.61538461538461,23.076923076923077
54518_marine,26,41,22,6,67,84.61538461538461,23.076923076923077
54519_marine,26,41,22,6,67,84.61538461538461,23.076923076923077
54520_marine,27,41,23,6,68,85.18518518518519,22.22222222222222
54521_marine,28,40,24,6,68,85.71428571428571,21.428571428571427
54522_marine,28,39,24,6,67,85.71428571428571,21.428571428571427
54523_marine,28,41,24,6,69,85.71428571428571,21.428571428571427
54524_marine,28,41,24,6,69,85.71428571428571,21.428571428571427
54525_marine,28,41,24,6,69,85.71428571428571,21.428571428571427
54526_marine,28,41,24,6,69,85.71428571428571,21.428571428571427
54527_marine,28,41,24,6,69,85.71428571428571,21.428571428571427
54528_marine,29,41,24,7,70,82.75862068965517,24.137931034482758
54529_marine,29,41,24,7,70,82.75862068965517,24.137931034482758
54530_marine,29,41,24,7,70,82.75862068965517,24.137931034482758
54531_marine,29,41,24,7,70,82.75862068965517,24.137931034482758
54532_marine,29,41,24,7,70,82.75862068965517,24.137931034482758
54533_marine,29,41,24,7,70,82.75862068965517,24.137931034482758
54534_marine,29,41,24,7,70,82.75862068965517,24.137931034482758
54535_marine,29,41,24,7,70,82.75862068965517,24.137931034482758
54536_marine,29,41,24,7,70,82.75862068965517,24.137931034482758
54537_marine,29,39,24,7,68,82.75862068965517,24.137931034482758
54538_marine,29,39,24,7,68,82.75862068965517,24.137931034482758
54539_marine,28,39,24,6,67,85.71428571428571,21.428571428571427
54540_marine,28,39,24,6,67,85.71428571428571,21.428571428571427
54541_marine,28,39,24,6,67,85.71428571428571,21.428571428571427
54542_marine,27,39,23,6,66,85.18518518518519,22.22222222222222
54543_marine,27,39,23,6,66,85.18518518518519,22.22222222222222
54544_marine,27,39,23,6,66,85.18518518518519,22.22222222222222
54545_marine,27,39,23,6,66,85.18518518518519,22.22222222222222
54546_marine,27,39,23,6,66,85.18518518518519,22.22222222222222
54547_marine,27,39,23,6,66,85.18518518518519,22.22222222222222
54548_marine,27,39,23,6,66,85.18518518518519,22.22222222222222
54549_marine,27,39,23,6,66,85.18518518518519,22.22222222222222
54550_marine,26,39,22,6,65,84.61538461538461,23.076923076923077
54551_marine,26,39,22,6,65,84.61538461538461,23.076923076923077
54552_marine,26,39,22,6,65,84.61538461538461,23.076923076923077
54553_marine,26,38,22,6,64,84.61538461538461,23.076923076923077
54554_marine,26,38,22,6,64,84.61538461538461,23.076923076923077
54555_marine,26,38,22,6,64,84.61538461538461,23.076923076923077
54556_marine,26,38,22,6,64,84.61538461538461,23.076923076923077
54557_marine,26,38,22,6,64,84.61538461538461,23.076923076923077
54558_marine,26,38,22,6,64,84.61538461538461,23.076923076923077
54559_marine,26,38,22,6,64,84.61538461538461,23.076923076923077
54560_marine,26,38,22,6,64,84.61538461538461,23.076923076923077
54561_marine,26,38,22,6,64,84.61538461538461,23.076923076923077
54562_marine,26,38,22,6,64,84.61538461538461,23.076923076923077
54563_marine,26,38,22,6,64,84.61538461538461,23.076923076923077
54564_marine,26,40,22,6,66,84.61538461538461,23.076923076923077
54565_marine,26,41,22,6,67,84.61538461538461,23.076923076923077
54566_marine,26,41,22,6,67,84.61538461538461,23.076923076923077
54567_marine,26,39,22,6,65,84.61538461538461,23.076923076923077
54568_marine,26,39,22,6,65,84.61538461538461,23.076923076923077
54569_marine,26,39,22,6,65,84.61538461538461,23.076923076923077
54570_marine,28,39,24,6,67,85.71428571428571,21.428571428571427
54571_marine,28,39,24,6,67,85.71428571428571,21.428571428571427
54572_marine,28,39,24,6,67,85.71428571428571,21.428571428571427
54573_marine,28,39,24,6,67,85.71428571428571,21.428571428571427
54574_marine,28,39,24,6,67,85.71428571428571,21.428571428571427
54575_marine,28,39,24,6,67,85.71428571428571,21.428571428571427
54576_marine,28,39,24,6,67,85.71428571428571,21.428571428571427
54577_marine,26,39,22,6,65,84.61538461538461,23.076923076923077
54578_marine,26,39,22,6,65,84.61538461538461,23.076923076923077
54579_marine,26,39,22,6,65,84.61538461538461,23.076923076923077
54580_marine,26,39,22,6,65,84.61538461538461,23.076923076923077
54581_marine,26,39,22,6,65,84.61538461538461,23.076923076923077
54582_marine,26,39,22,6,65,84.61538461538461,23.076923076923077
54583_marine,26,39,22,6,65,84.61538461538461,23.076923076923077
54584_marine,27,39,23,6,66,85.18518518518519,22.22222222222222
54585_marine,27,39,23,6,66,85.18518518518519,22.22222222222222
54586_marine,27,39,23,6,66,85.18518518518519,22.22222222222222
54587_marine,26,39,22,6,65,84.61538461538461,23.076923076923077
54588_marine,26,39,22,6,65,84.61538461538461,23.076923076923077
54589_marine,26,39,22,6,65,84.61538461538461,23.076923076923077
54590_marine,26,40,22,6,66,84.61538461538461,23.076923076923077
54591_marine,26,40,22,6,66,84.61538461538461,23.076923076923077
54592_marine,25,40,22,5,65,88,20
54593_marine,25,40,22,5,65,88,20
54594_marine,25,40,22,5,65,88,20
54595_marine,25,40,22,5,65,88,20
54596_marine,25,42,22,5,67,88,20
54597_marine,25,42,22,5,67,88,20
54598_marine,24,42,21,5,66,87.5,20.833333333333336
54599_marine,24,42,21,5,66,87.5,20.833333333333336
54600_marine,24,42,21,5,66,87.5,20.833333333333336
54601_marine,23,42,20,4,65,86.95652173913044,17.391304347826086
54602_marine,23,41,20,4,64,86.95652173913044,17.391304347826086
54603_marine,23,41,20,4,64,86.95652173913044,17.391304347826086
54604_marine,23,42,20,4,65,86.95652173913044,17.391304347826086
54605_marine,23,42,20,4,65,86.95652173913044,17.391304347826086
54606_marine,23,42,20,4,65,86.95652173913044,17.391304347826086
54607_marine,22,42,19,4,64,86.36363636363636,18.181818181818183
54608_marine,22,42,19,4,64,86.36363636363636,18.181818181818183
54609_marine,22,42,19,4,64,86.36363636363636,18.181818181818183
54610_marine,22,41,19,4,63,86.36363636363636,18.181818181818183
54611_marine,22,41,19,4,63,86.36363636363636,18.181818181818183
54612_marine,22,41,19,4,63,86.36363636363636,18.181818181818183
54613_marine,23,41,20,4,64,86.95652173913044,17.391304347826086
54614_marine,23,41,20,4,64,86.95652173913044,17.391304347826086
54615_marine,23,41,20,4,64,86.95652173913044,17.391304347826086
54616_marine,23,41,20,4,64,86.95652173913044,17.391304347826086
54617_marine,23,42,20,4,65,86.95652173913044,17.391304347826086
54618_marine,23,42,20,4,65,86.95652173913044,17.391304347826086
54619_marine,23,42,20,4,65,86.95652173913044,17.391304347826086
54620_marine,24,42,21,5,66,87.5,20.833333333333336
54621_marine,24,42,21,5,66,87.5,20.833333333333336
54622_marine,24,42,21,5,66,87.5,20.833333333333336
54623_marine,24,42,21,5,66,87.5,20.833333333333336
54624_marine,23,42,20,5,65,86.95652173913044,21.73913043478261
54625_marine,23,42,20,5,65,86.95652173913044,21.73913043478261
54626_marine,23,41,20,5,64,86.95652173913044,21.73913043478261
54627_marine,24,41,21,5,65,87.5,20.833333333333336
54628_marine,24,41,21,5,65,87.5,20.833333333333336
54629_marine,24,41,21,5,65,87.5,20.833333333333336
54630_marine,23,41,20,4,64,86.95652173913044,17.391304347826086
54631_marine,23,41,20,4,64,86.95652173913044,17.391304347826086
54632_marine,23,41,20,4,64,86.95652173913044,17.391304347826086
54633_marine,23,41,20,4,64,86.95652173913044,17.391304347826086
54634_marine,23,41,20,4,64,86.95652173913044,17.391304347826086
54635_marine,23,41,20,4,64,86.95652173913044,17.391304347826086
54636_marine,23,40,20,4,63,86.95652173913044,17.391304347826086
54637_marine,23,40,20,4,63,86.95652173913044,17.391304347826086
54638_marine,23,41,20,4,64,86.95652173913044,17.391304347826086
54639_marine,23,41,20,4,64,86.95652173913044,17.391304347826086
54640_marine,23,41,20,4,64,86.95652173913044,17.391304347826086
54641_marine,23,41,20,4,64,86.95652173913044,17.391304347826086
54642_marine,23,41,20,4,64,86.95652173913044,17.391304347826086
54643_marine,23,41,20,4,64,86.95652173913044,17.391304347826086
54644_marine,23,41,20,4,64,86.95652173913044,17.391304347826086
54645_marine,23,41,20,4,64,86.95652173913044,17.391304347826086
54646_marine,23,41,20,4,64,86.95652173913044,17.391304347826086
54647_marine,23,41,20,4,64,86.95652173913044,17.391304347826086
54648_marine,23,41,20,4,64,86.95652173913044,17.391304347826086
54649_marine,23,41,20,4,64,86.95652173913044,17.391304347826086
54650_marine,23,41,20,4,64,86.95652173913044,17.391304347826086
54651_marine,23,41,20,4,64,86.95652173913044,17.391304347826086
54652_marine,23,41,20,4,64,86.95652173913044,17.391304347826086
54653_marine,24,41,21,4,65,87.5,16.666666666666664
54654_marine,24,40,21,4,64,87.5,16.666666666666664
54655_marine,24,40,21,4,64,87.5,16.666666666666664
54656_marine,24,40,21,4,64,87.5,16.666666666666664
54657_marine,24,40,21,4,64,87.5,16.666666666666664
54658_marine,24,40,21,4,64,87.5,16.666666666666664
54659_marine,24,40,21,4,64,87.5,16.666666666666664
54660_marine,24,40,21,4,64,87.5,16.666666666666664
54661_marine,24,41,21,4,65,87.5,16.666666666666664
54662_marine,25,41,21,5,66,84,20
54663_marine,25,42,21,5,67,84,20
54664_marine,25,42,21,5,67,84,20
54665_marine,25,42,21,5,67,84,20
54666_marine,26,42,22,5,68,84.61538461538461,19.230769230769234
54667_marine,26,42,22,5,68,84.61538461538461,19.230769230769234
54668_marine,26,42,22,5,68,84.61538461538461,19.230769230769234
54669_marine,26,42,22,5,68,84.61538461538461,19.230769230769234
54670_marine,26,35,22,5,61,84.61538461538461,19.230769230769234
54671_marine,27,35,23,5,62,85.18518518518519,18.51851851851852
54672_marine,27,35,23,5,62,85.18518518518519,18.51851851851852
54673_marine,27,35,23,5,62,85.18518518518519,18.51851851851852
54674_marine,26,35,22,5,61,84.61538461538461,19.230769230769234
54675_marine,27,35,23,5,62,85.18518518518519,18.51851851851852
54676_marine,27,35,23,5,62,85.18518518518519,18.51851851851852
54677_marine,27,35,23,5,62,85.18518518518519,18.51851851851852
54678_marine,27,35,23,5,62,85.18518518518519,18.51851851851852
54679_marine,27,35,23,5,62,85.18518518518519,18.51851851851852
54680_marine,27,35,23,5,62,85.18518518518519,18.51851851851852
54681_marine,27,35,23,5,62,85.18518518518519,18.51851851851852
54682_marine,27,35,23,5,62,85.18518518518519,18.51851851851852
54683_marine,27,37,23,5,64,85.18518518518519,18.51851851851852
54684_marine,27,37,23,5,64,85.18518518518519,18.51851851851852
54685_marine,27,37,23,5,64,85.18518518518519,18.51851851851852
54686_marine,27,37,23,5,64,85.18518518518519,18.51851851851852
54687_marine,27,37,23,5,64,85.18518518518519,18.51851851851852
54688_marine,27,38,23,5,65,85.18518518518519,18.51851851851852
54689_marine,27,40,23,5,67,85.18518518518519,18.51851851851852
54690_marine,27,40,23,5,67,85.18518518518519,18.51851851851852
54691_marine,26,41,22,5,67,84.61538461538461,19.230769230769234
54692_marine,26,40,22,5,66,84.61538461538461,19.230769230769234
54693_marine,27,40,23,5,67,85.18518518518519,18.51851851851852
54694_marine,27,42,23,5,69,85.18518518518519,18.51851851851852
54695_marine,27,42,23,5,69,85.18518518518519,18.51851851851852
54696_marine,27,42,23,5,69,85.18518518518519,18.51851851851852
54697_marine,28,44,24,6,72,85.71428571428571,21.428571428571427
54698_marine,29,45,26,5,74,89.65517241379311,17.24137931034483
54699_marine,29,45,26,5,74,89.65517241379311,17.24137931034483
54700_marine,29,45,26,5,74,89.65517241379311,17.24137931034483
54701_marine,29,43,26,5,72,89.65517241379311,17.24137931034483
54702_marine,29,41,26,5,70,89.65517241379311,17.24137931034483
54703_marine,28,41,26,4,69,92.85714285714286,14.285714285714285
54704_marine,28,42,26,4,70,92.85714285714286,14.285714285714285
54705_marine,28,42,26,4,70,92.85714285714286,14.285714285714285
54706_marine,28,43,26,4,71,92.85714285714286,14.285714285714285
54707_marine,28,44,26,4,72,92.85714285714286,14.285714285714285
54708_marine,28,44,26,4,72,92.85714285714286,14.285714285714285
54709_marine,28,44,26,4,72,92.85714285714286,14.285714285714285
54710_marine,28,44,26,4,72,92.85714285714286,14.285714285714285
54711_marine,28,44,26,4,72,92.85714285714286,14.285714285714285
54712_marine,27,44,25,3,71,92.5925925925926,11.11111111111111
54713_marine,27,44,25,3,71,92.5925925925926,11.11111111111111
54714_marine,26,44,24,3,70,92.3076923076923,11.538461538461538
54715_marine,26,44,24,3,70,92.3076923076923,11.538461538461538
54716_marine,26,44,24,3,70,92.3076923076923,11.538461538461538
54717_marine,26,44,24,3,70,92.3076923076923,11.538461538461538
54718_marine,27,44,25,3,71,92.5925925925926,11.11111111111111
54719_marine,27,44,25,3,71,92.5925925925926,11.11111111111111
54720_marine,27,44,25,3,71,92.5925925925926,11.11111111111111
54721_marine,27,41,25,3,68,92.5925925925926,11.11111111111111
54722_marine,27,39,25,3,66,92.5925925925926,11.11111111111111
54723_marine,27,39,25,3,66,92.5925925925926,11.11111111111111
54724_marine,27,39,25,3,66,92.5925925925926,11.11111111111111
54725_marine,27,39,25,3,66,92.5925925925926,11.11111111111111
54726_marine,26,39,24,3,65,92.3076923076923,11.538461538461538
54727_marine,26,39,24,3,65,92.3076923076923,11.538461538461538
54728_marine,26,38,24,3,64,92.3076923076923,11.538461538461538
54729_marine,26,38,24,3,64,92.3076923076923,11.538461538461538
54730_marine,26,38,24,3,64,92.3076923076923,11.538461538461538
54731_marine,26,38,24,3,64,92.3076923076923,11.538461538461538
54732_marine,26,37,24,3,63,92.3076923076923,11.538461538461538
54733_marine,25,37,23,2,62,92,8
54734_marine,25,37,23,2,62,92,8
54735_marine,25,37,23,2,62,92,8
54736_marine,25,37,23,2,62,92,8
54737_marine,25,37,23,2,62,92,8
54738_marine,25,37,23,2,62,92,8
54739_marine,25,37,23,2,62,92,8
54740_marine,25,37,23,2,62,92,8
54741_marine,25,37,23,2,62,92,8
54742_marine,25,37,23,2,62,92,8
54743_marine,25,37,23,2,62,92,8
54744_marine,25,37,23,2,62,92,8
54745_marine,25,37,23,2,62,92,8
54746_marine,25,45,23,2,70,92,8
54747_marine,25,45,23,2,70,92,8
54748_marine,25,45,23,2,70,92,8
54749_marine,25,45,23,2,70,92,8
54750_marine,24,45,22,2,69,91.66666666666666,8.333333333333332
54751_marine,24,44,22,2,68,91.66666666666666,8.333333333333332
54752_marine,24,44,22,2,68,91.66666666666666,8.333333333333332
54753_marine,24,44,22,2,68,91.66666666666666,8.333333333333332
54754_marine,24,44,22,2,68,91.66666666666666,8.333333333333332
54755_marine,24,44,22,2,68,91.66666666666666,8.333333333333332
54756_marine,24,44,22,2,68,91.66666666666666,8.333333333333332
54757_marine,24,44,22,2,68,91.66666666666666,8.333333333333332
54758_marine,24,44,22,2,68,91.66666666666666,8.333333333333332
54759_marine,26,44,24,3,70,92.3076923076923,11.538461538461538
54760_marine,26,44,24,3,70,92.3076923076923,11.538461538461538
54761_marine,25,44,23,3,69,92,12
54762_marine,25,44,23,3,69,92,12
54763_marine,25,44,23,3,69,92,12
54764_marine,25,44,23,3,69,92,12
54765_marine,25,37,23,3,62,92,12
54766_marine,25,37,23,3,62,92,12
54767_marine,25,37,23,3,62,92,12
54768_marine,25,37,23,3,62,92,12
54769_marine,25,37,23,3,62,92,12
54770_marine,25,37,23,3,62,92,12
54771_marine,25,37,23,3,62,92,12
54772_marine,25,37,23,3,62,92,12
54773_marine,25,37,23,3,62,92,12
54774_marine,25,37,23,3,62,92,12
54775_marine,25,37,23,3,62,92,12
54776_marine,25,37,23,3,62,92,12
54777_marine,25,37,23,3,62,92,12
54778_marine,25,37,23,3,62,92,12
54779_marine,25,37,23,3,62,92,12
54780_marine,25,37,23,3,62,92,12
54781_marine,25,37,23,3,62,92,12
54782_marine,25,37,23,3,62,92,12
54783_marine,25,36,23,3,61,92,12
54784_marine,25,36,23,3,61,92,12
54785_marine,25,36,23,3,61,92,12
54786_marine,25,36,23,3,61,92,12
54787_marine,25,36,23,3,61,92,12
54788_marine,25,36,23,3,61,92,12
54789_marine,25,36,23,3,61,92,12
54790_marine,25,36,23,3,61,92,12
54791_marine,25,36,23,3,61,92,12
54792_marine,25,36,23,3,61,92,12
54793_marine,25,36,23,3,61,92,12
54794_marine,25,35,23,3,60,92,12
54795_marine,25,35,23,3,60,92,12
54796_marine,25,35,23,3,60,92,12
54797_marine,25,35,23,3,60,92,12
54798_marine,25,35,23,3,60,92,12
54799_marine,25,35,23,3,60,92,12
54800_marine,25,35,23,3,60,92,12
54801_marine,23,35,21,3,58,91.30434782608695,13.043478260869565
54802_marine,23,35,21,3,58,91.30434782608695,13.043478260869565
54803_marine,23,35,21,3,58,91.30434782608695,13.043478260869565
54804_marine,23,35,21,3,58,91.30434782608695,13.043478260869565
54805_marine,23,35,21,3,58,91.30434782608695,13.043478260869565
54806_marine,23,35,21,3,58,91.30434782608695,13.043478260869565
54807_marine,23,35,21,3,58,91.30434782608695,13.043478260869565
54808_marine,23,35,21,3,58,91.30434782608695,13.043478260869565
54809_marine,23,35,21,3,58,91.30434782608695,13.043478260869565
54810_marine,23,36,21,3,59,91.30434782608695,13.043478260869565
54811_marine,23,37,21,3,60,91.30434782608695,13.043478260869565
54812_marine,23,37,21,3,60,91.30434782608695,13.043478260869565
54813_marine,23,37,21,3,60,91.30434782608695,13.043478260869565
54814_marine,23,37,21,3,60,91.30434782608695,13.043478260869565
54815_marine,23,37,21,3,60,91.30434782608695,13.043478260869565
54816_marine,23,35,21,3,58,91.30434782608695,13.043478260869565
54817_marine,23,35,21,3,58,91.30434782608695,13.043478260869565
54818_marine,23,35,21,3,58,91.30434782608695,13.043478260869565
54819_marine,23,35,21,3,58,91.30434782608695,13.043478260869565
54820_marine,24,35,21,4,59,87.5,16.666666666666664
54821_marine,24,35,21,4,59,87.5,16.666666666666664
54822_marine,24,35,21,4,59,87.5,16.666666666666664
54823_marine,23,35,20,4,58,86.95652173913044,17.391304347826086
54824_marine,23,35,20,4,58,86.95652173913044,17.391304347826086
54825_marine,23,34,20,4,57,86.95652173913044,17.391304347826086
54826_marine,23,34,20,4,57,86.95652173913044,17.391304347826086
54827_marine,23,34,20,4,57,86.95652173913044,17.391304347826086
54828_marine,24,42,21,5,66,87.5,20.833333333333336
54829_marine,25,43,22,5,68,88,20
54830_marine,26,43,23,5,69,88.46153846153845,19.230769230769234
54831_marine,29,44,25,7,73,86.20689655172413,24.137931034482758
54832_marine,30,43,26,7,73,86.66666666666667,23.333333333333332
54833_marine,29,44,25,7,73,86.20689655172413,24.137931034482758
54834_marine,30,45,25,8,75,83.33333333333334,26.666666666666668
54835_marine,30,45,25,8,75,83.33333333333334,26.666666666666668
54836_marine,30,44,25,8,74,83.33333333333334,26.666666666666668
54837_marine,30,47,25,8,77,83.33333333333334,26.666666666666668
54838_marine,37,56,28,14,93,75.67567567567568,37.83783783783784
54839_marine,38,62,28,15,100,73.68421052631578,39.473684210526315
54840_marine,37,62,27,15,99,72.97297297297297,40.54054054054054
54841_marine,37,61,27,15,98,72.97297297297297,40.54054054054054
54842_marine,37,61,27,15,98,72.97297297297297,40.54054054054054
54843_marine,37,61,27,15,98,72.97297297297297,40.54054054054054
54844_marine,31,51,24,11,82,77.41935483870968,35.483870967741936
54845_marine,30,50,24,9,80,80,30
54846_marine,29,49,23,9,78,79.3103448275862,31.03448275862069
54847_marine,28,49,23,8,77,82.14285714285714,28.57142857142857
54848_marine,29,47,24,8,76,82.75862068965517,27.586206896551722
54849_marine,28,46,23,8,74,82.14285714285714,28.57142857142857
54850_marine,28,44,23,8,72,82.14285714285714,28.57142857142857
54851_marine,28,45,23,8,73,82.14285714285714,28.57142857142857
54852_marine,27,44,22,7,71,81.48148148148148,25.925925925925924
54853_marine,27,45,22,7,72,81.48148148148148,25.925925925925924
54854_marine,26,44,21,7,70,80.76923076923077,26.923076923076923
54855_marine,25,48,21,6,73,84,24
54856_marine,25,48,21,6,73,84,24
54857_marine,25,42,21,6,67,84,24
54858_marine,25,41,21,6,66,84,24
54859_marine,24,41,20,6,65,83.33333333333334,25
54860_marine,24,41,20,6,65,83.33333333333334,25
54861_marine,24,42,20,6,66,83.33333333333334,25
54862_marine,24,42,20,6,66,83.33333333333334,25
54863_marine,24,42,20,6,66,83.33333333333334,25
54864_marine,24,42,20,6,66,83.33333333333334,25
54865_marine,24,41,20,6,65,83.33333333333334,25
54866_marine,23,41,19,6,64,82.6086956521739,26.08695652173913
54867_marine,23,41,19,6,64,82.6086956521739,26.08695652173913
54868_marine,23,41,19,6,64,82.6086956521739,26.08695652173913
54869_marine,24,41,20,6,65,83.33333333333334,25
54870_marine,24,41,20,6,65,83.33333333333334,25
54871_marine,24,41,20,6,65,83.33333333333334,25
54872_marine,24,41,20,6,65,83.33333333333334,25
54873_marine,24,41,20,6,65,83.33333333333334,25
54874_marine,24,41,20,6,65,83.33333333333334,25
54875_marine,24,41,20,6,65,83.33333333333334,25
54876_marine,25,41,21,6,66,84,24
54877_marine,25,41,21,6,66,84,24
54878_marine,25,41,21,6,66,84,24
54879_marine,25,40,21,6,65,84,24
54880_marine,26,40,22,6,66,84.61538461538461,23.076923076923077
54881_marine,27,40,23,6,67,85.18518518518519,22.22222222222222
54882_marine,28,39,24,6,67,85.71428571428571,21.428571428571427
54883_marine,27,39,23,6,66,85.18518518518519,22.22222222222222
54884_marine,28,39,23,7,67,82.14285714285714,25
54885_marine,28,39,23,7,67,82.14285714285714,25
54886_marine,28,39,23,7,67,82.14285714285714,25
54887_marine,28,39,23,7,67,82.14285714285714,25
54888_marine,28,39,23,7,67,82.14285714285714,25
54889_marine,28,39,23,7,67,82.14285714285714,25
54890_marine,28,39,23,7,67,82.14285714285714,25
54891_marine,27,39,23,6,66,85.18518518518519,22.22222222222222
54892_marine,27,39,23,6,66,85.18518518518519,22.22222222222222
54893_marine,27,39,23,6,66,85.18518518518519,22.22222222222222
54894_marine,27,39,23,6,66,85.18518518518519,22.22222222222222
54895_marine,27,39,23,6,66,85.18518518518519,22.22222222222222
54896_marine,27,39,23,6,66,85.18518518518519,22.22222222222222
54897_marine,27,39,23,6,66,85.18518518518519,22.22222222222222
54898_marine,27,39,23,6,66,85.18518518518519,22.22222222222222
54899_marine,27,39,23,6,66,85.18518518518519,22.22222222222222
54900_marine,28,39,24,6,67,85.71428571428571,21.428571428571427
54901_marine,28,39,24,6,67,85.71428571428571,21.428571428571427
54902_marine,27,39,23,6,66,85.18518518518519,22.22222222222222
54903_marine,27,39,23,6,66,85.18518518518519,22.22222222222222
54904_marine,27,39,23,6,66,85.18518518518519,22.22222222222222
54905_marine,27,39,23,6,66,85.18518518518519,22.22222222222222
54906_marine,27,39,23,6,66,85.18518518518519,22.22222222222222
54907_marine,27,39,23,6,66,85.18518518518519,22.22222222222222
54908_marine,27,38,23,6,65,85.18518518518519,22.22222222222222
54909_marine,26,38,22,6,64,84.61538461538461,23.076923076923077
54910_marine,26,38,22,6,64,84.61538461538461,23.076923076923077
54911_marine,26,38,22,6,64,84.61538461538461,23.076923076923077
54912_marine,26,38,22,6,64,84.61538461538461,23.076923076923077
54913_marine,26,38,22,6,64,84.61538461538461,23.076923076923077
54914_marine,26,38,22,6,64,84.61538461538461,23.076923076923077
54915_marine,26,38,22,6,64,84.61538461538461,23.076923076923077
54916_marine,26,38,22,6,64,84.61538461538461,23.076923076923077
54917_marine,26,38,22,6,64,84.61538461538461,23.076923076923077
54918_marine,26,38,22,6,64,84.61538461538461,23.076923076923077
54919_marine,26,38,22,6,64,84.61538461538461,23.076923076923077
54920_marine,26,38,22,6,64,84.61538461538461,23.076923076923077
54921_marine,26,38,22,6,64,84.61538461538461,23.076923076923077
54922_marine,26,36,22,6,62,84.61538461538461,23.076923076923077
54923_marine,26,36,22,6,62,84.61538461538461,23.076923076923077
54924_marine,26,36,22,6,62,84.61538461538461,23.076923076923077
54925_marine,26,36,22,6,62,84.61538461538461,23.076923076923077
54926_marine,26,36,22,6,62,84.61538461538461,23.076923076923077
54927_marine,26,36,22,6,62,84.61538461538461,23.076923076923077
54928_marine,24,36,20,6,60,83.33333333333334,25
54929_marine,24,36,20,6,60,83.33333333333334,25
54930_marine,24,36,20,6,60,83.33333333333334,25
54931_marine,22,36,18,5,58,81.81818181818183,22.727272727272727
54932_marine,22,38,18,5,60,81.81818181818183,22.727272727272727
54933_marine,22,38,18,5,60,81.81818181818183,22.727272727272727
54934_marine,22,38,18,5,60,81.81818181818183,22.727272727272727
54935_marine,22,38,18,5,60,81.81818181818183,22.727272727272727
54936_marine,22,38,18,5,60,81.81818181818183,22.727272727272727
54937_marine,22,39,18,5,61,81.81818181818183,22.727272727272727
54938_marine,22,39,18,5,61,81.81818181818183,22.727272727272727
54939_marine,22,39,18,5,61,81.81818181818183,22.727272727272727
54940_marine,22,39,18,5,61,81.81818181818183,22.727272727272727
54941_marine,22,39,18,5,61,81.81818181818183,22.727272727272727
54942_marine,22,39,18,5,61,81.81818181818183,22.727272727272727
54943_marine,22,39,18,5,61,81.81818181818183,22.727272727272727
54944_marine,21,39,17,5,60,80.95238095238095,23.809523809523807
54945_marine,21,39,17,5,60,80.95238095238095,23.809523809523807
54946_marine,21,39,17,5,60,80.95238095238095,23.809523809523807
54947_marine,22,39,18,5,61,81.81818181818183,22.727272727272727
54948_marine,21,39,17,4,60,80.95238095238095,19.047619047619047
54949_marine,21,39,17,4,60,80.95238095238095,19.047619047619047
54950_marine,21,39,17,4,60,80.95238095238095,19.047619047619047
54951_marine,20,39,16,4,59,80,20
54952_marine,20,39,16,4,59,80,20
54953_marine,20,39,16,4,59,80,20
54954_marine,20,39,16,4,59,80,20
54955_marine,20,39,16,4,59,80,20
54956_marine,20,39,16,4,59,80,20
54957_marine,20,38,16,4,58,80,20
54958_marine,20,38,16,4,58,80,20
54959_marine,20,37,16,4,57,80,20
54960_marine,19,39,16,3,58,84.21052631578947,15.789473684210526
54961_marine,19,39,16,3,58,84.21052631578947,15.789473684210526
54962_marine,20,39,16,4,59,80,20
54963_marine,21,39,17,5,60,80.95238095238095,23.809523809523807
54964_marine,21,39,17,5,60,80.95238095238095,23.809523809523807
54965_marine,21,40,17,5,61,80.95238095238095,23.809523809523807
54966_marine,21,40,17,5,61,80.95238095238095,23.809523809523807
54967_marine,21,40,17,5,61,80.95238095238095,23.809523809523807
54968_marine,21,40,17,5,61,80.95238095238095,23.809523809523807
54969_marine,21,40,17,5,61,80.95238095238095,23.809523809523807
54970_marine,20,40,16,5,60,80,25
54971_marine,20,40,16,5,60,80,25
54972_marine,20,41,16,5,61,80,25
54973_marine,21,41,17,5,62,80.95238095238095,23.809523809523807
54974_marine,21,41,17,5,62,80.95238095238095,23.809523809523807
54975_marine,21,41,17,5,62,80.95238095238095,23.809523809523807
54976_marine,21,41,17,5,62,80.95238095238095,23.809523809523807
54977_marine,19,41,15,5,60,78.94736842105263,26.31578947368421
54978_marine,19,39,15,5,58,78.94736842105263,26.31578947368421
54979_marine,19,39,15,5,58,78.94736842105263,26.31578947368421
54980_marine,19,39,15,5,58,78.94736842105263,26.31578947368421
54981_marine,19,39,15,5,58,78.94736842105263,26.31578947368421
54982_marine,19,39,15,5,58,78.94736842105263,26.31578947368421
54983_marine,18,39,15,4,57,83.33333333333334,22.22222222222222
54984_marine,18,39,15,4,57,83.33333333333334,22.22222222222222
54985_marine,18,39,15,4,57,83.33333333333334,22.22222222222222
54986_marine,18,38,15,4,56,83.33333333333334,22.22222222222222
54987_marine,19,38,16,4,57,84.21052631578947,21.052631578947366
54988_marine,19,38,16,4,57,84.21052631578947,21.052631578947366
54989_marine,19,38,16,4,57,84.21052631578947,21.052631578947366
54990_marine,18,38,15,4,56,83.33333333333334,22.22222222222222
54991_marine,18,38,15,4,56,83.33333333333334,22.22222222222222
54992_marine,18,38,15,4,56,83.33333333333334,22.22222222222222
54993_marine,18,38,15,4,56,83.33333333333334,22.22222222222222
54994_marine,17,37,14,3,54,82.35294117647058,17.647058823529413
54995_marine,17,37,14,3,54,82.35294117647058,17.647058823529413
54996_marine,16,37,13,3,53,81.25,18.75
54997_marine,16,37,13,3,53,81.25,18.75
54998_marine,16,37,13,3,53,81.25,18.75
54999_marine,16,37,13,3,53,81.25,18.75
55000_marine,17,37,13,4,54,76.47058823529412,23.52941176470588
55001_marine,17,37,13,4,54,76.47058823529412,23.52941176470588
55002_marine,17,37,13,4,54,76.47058823529412,23.52941176470588
55003_marine,17,37,13,4,54,76.47058823529412,23.52941176470588
55004_marine,17,37,13,4,54,76.47058823529412,23.52941176470588
55005_marine,17,36,13,4,53,76.47058823529412,23.52941176470588
55006_marine,17,36,13,4,53,76.47058823529412,23.52941176470588
55007_marine,17,36,13,4,53,76.47058823529412,23.52941176470588
55008_marine,17,36,13,4,53,76.47058823529412,23.52941176470588
55009_marine,17,36,13,4,53,76.47058823529412,23.52941176470588
55010_marine,17,36,13,4,53,76.47058823529412,23.52941176470588
55011_marine,17,36,13,4,53,76.47058823529412,23.52941176470588
55012_marine,17,36,13,4,53,76.47058823529412,23.52941176470588
55013_marine,17,37,13,4,54,76.47058823529412,23.52941176470588
55014_marine,17,37,13,4,54,76.47058823529412,23.52941176470588
55015_marine,17,37,13,4,54,76.47058823529412,23.52941176470588
55016_marine,17,37,13,4,54,76.47058823529412,23.52941176470588
55017_marine,17,37,13,4,54,76.47058823529412,23.52941176470588
55018_marine,17,37,13,4,54,76.47058823529412,23.52941176470588
55019_marine,17,37,13,4,54,76.47058823529412,23.52941176470588
55020_marine,17,37,13,4,54,76.47058823529412,23.52941176470588
55021_marine,17,37,13,4,54,76.47058823529412,23.52941176470588
55022_marine,17,38,13,4,55,76.47058823529412,23.52941176470588
55023_marine,17,37,13,4,54,76.47058823529412,23.52941176470588
55024_marine,17,37,13,4,54,76.47058823529412,23.52941176470588
55025_marine,17,37,13,4,54,76.47058823529412,23.52941176470588
55026_marine,17,37,13,4,54,76.47058823529412,23.52941176470588
55027_marine,18,37,14,4,55,77.77777777777779,22.22222222222222
55028_marine,18,37,14,4,55,77.77777777777779,22.22222222222222
55029_marine,18,37,14,4,55,77.77777777777779,22.22222222222222
55030_marine,18,37,14,4,55,77.77777777777779,22.22222222222222
55031_marine,19,37,15,4,56,78.94736842105263,21.052631578947366
55032_marine,20,37,16,4,57,80,20
55033_marine,20,38,16,4,58,80,20
55034_marine,20,38,16,4,58,80,20
55035_marine,20,38,16,4,58,80,20
55036_marine,22,39,18,4,61,81.81818181818183,18.181818181818183
55037_marine,22,39,18,4,61,81.81818181818183,18.181818181818183
55038_marine,22,31,18,4,53,81.81818181818183,18.181818181818183
55039_marine,23,31,19,5,54,82.6086956521739,21.73913043478261
55040_marine,23,33,19,5,56,82.6086956521739,21.73913043478261
55041_marine,23,33,19,5,56,82.6086956521739,21.73913043478261
55042_marine,23,33,19,5,56,82.6086956521739,21.73913043478261
55043_marine,23,33,19,5,56,82.6086956521739,21.73913043478261
55044_marine,23,41,19,5,64,82.6086956521739,21.73913043478261
55045_marine,23,42,19,5,65,82.6086956521739,21.73913043478261
55046_marine,23,43,19,5,66,82.6086956521739,21.73913043478261
55047_marine,23,36,19,5,59,82.6086956521739,21.73913043478261
55048_marine,23,36,19,5,59,82.6086956521739,21.73913043478261
55049_marine,24,36,20,5,60,83.33333333333334,20.833333333333336
55050_marine,24,36,20,5,60,83.33333333333334,20.833333333333336
55051_marine,24,37,20,5,61,83.33333333333334,20.833333333333336
55052_marine,25,37,21,5,62,84,20
55053_marine,25,37,21,5,62,84,20
55054_marine,25,38,21,5,63,84,20
55055_marine,25,38,21,5,63,84,20
55056_marine,25,38,21,5,63,84,20
55057_marine,25,38,21,5,63,84,20
55058_marine,25,38,21,5,63,84,20
55059_marine,25,39,21,5,64,84,20
55060_marine,25,41,21,5,66,84,20
55061_marine,27,41,23,5,68,85.18518518518519,18.51851851851852
55062_marine,27,41,23,5,68,85.18518518518519,18.51851851851852
55063_marine,27,41,23,5,68,85.18518518518519,18.51851851851852
55064_marine,28,41,24,6,69,85.71428571428571,21.428571428571427
55065_marine,27,41,24,5,68,88.88888888888889,18.51851851851852
55066_marine,27,42,24,5,69,88.88888888888889,18.51851851851852
55067_marine,27,42,24,5,69,88.88888888888889,18.51851851851852
55068_marine,27,42,25,3,69,92.5925925925926,11.11111111111111
55069_marine,27,43,25,3,70,92.5925925925926,11.11111111111111
55070_marine,27,43,25,3,70,92.5925925925926,11.11111111111111
55071_marine,27,43,25,3,70,92.5925925925926,11.11111111111111
55072_marine,27,43,25,3,70,92.5925925925926,11.11111111111111
55073_marine,27,44,25,3,71,92.5925925925926,11.11111111111111
55074_marine,26,44,24,3,70,92.3076923076923,11.538461538461538
55075_marine,26,44,24,3,70,92.3076923076923,11.538461538461538
55076_marine,26,44,24,3,70,92.3076923076923,11.538461538461538
55077_marine,26,44,24,3,70,92.3076923076923,11.538461538461538
55078_marine,26,42,24,3,68,92.3076923076923,11.538461538461538
55079_marine,26,42,24,3,68,92.3076923076923,11.538461538461538
55080_marine,27,41,25,3,68,92.5925925925926,11.11111111111111
55081_marine,23,38,21,3,61,91.30434782608695,13.043478260869565
55082_marine,23,38,21,3,61,91.30434782608695,13.043478260869565
55083_marine,23,38,21,3,61,91.30434782608695,13.043478260869565
55084_marine,23,38,21,3,61,91.30434782608695,13.043478260869565
55085_marine,23,38,21,3,61,91.30434782608695,13.043478260869565
55086_marine,23,38,21,3,61,91.30434782608695,13.043478260869565
55087_marine,23,37,21,3,60,91.30434782608695,13.043478260869565
55088_marine,23,37,21,3,60,91.30434782608695,13.043478260869565
55089_marine,23,37,21,3,60,91.30434782608695,13.043478260869565
55090_marine,23,45,21,3,68,91.30434782608695,13.043478260869565
55091_marine,23,44,21,3,67,91.30434782608695,13.043478260869565
55092_marine,23,44,21,3,67,91.30434782608695,13.043478260869565
55093_marine,23,44,21,3,67,91.30434782608695,13.043478260869565
55094_marine,23,44,21,3,67,91.30434782608695,13.043478260869565
55095_marine,23,44,21,3,67,91.30434782608695,13.043478260869565
55096_marine,23,44,21,3,67,91.30434782608695,13.043478260869565
55097_marine,23,44,21,3,67,91.30434782608695,13.043478260869565
55098_marine,22,44,20,2,66,90.9090909090909,9.090909090909092
55099_marine,22,44,20,2,66,90.9090909090909,9.090909090909092
55100_marine,22,44,20,2,66,90.9090909090909,9.090909090909092
55101_marine,22,44,20,2,66,90.9090909090909,9.090909090909092
55102_marine,22,44,20,2,66,90.9090909090909,9.090909090909092
55103_marine,22,44,20,2,66,90.9090909090909,9.090909090909092
55104_marine,22,44,20,2,66,90.9090909090909,9.090909090909092
55105_marine,22,44,20,2,66,90.9090909090909,9.090909090909092
55106_marine,22,44,20,2,66,90.9090909090909,9.090909090909092
55107_marine,22,44,20,2,66,90.9090909090909,9.090909090909092
55108_marine,22,44,20,2,66,90.9090909090909,9.090909090909092
55109_marine,22,44,20,2,66,90.9090909090909,9.090909090909092
55110_marine,23,44,21,3,67,91.30434782608695,13.043478260869565
55111_marine,23,43,21,3,66,91.30434782608695,13.043478260869565
55112_marine,23,43,21,3,66,91.30434782608695,13.043478260869565
55113_marine,22,43,20,3,65,90.9090909090909,13.636363636363635
55114_marine,22,43,20,3,65,90.9090909090909,13.636363636363635
55115_marine,22,43,20,3,65,90.9090909090909,13.636363636363635
55116_marine,22,43,20,3,65,90.9090909090909,13.636363636363635
55117_marine,22,43,20,3,65,90.9090909090909,13.636363636363635
55118_marine,23,43,21,3,66,91.30434782608695,13.043478260869565
55119_marine,23,43,21,3,66,91.30434782608695,13.043478260869565
55120_marine,22,43,20,3,65,90.9090909090909,13.636363636363635
55121_marine,22,43,20,3,65,90.9090909090909,13.636363636363635
55122_marine,22,43,20,3,65,90.9090909090909,13.636363636363635
55123_marine,22,43,20,3,65,90.9090909090909,13.636363636363635
55124_marine,22,43,20,3,65,90.9090909090909,13.636363636363635
55125_marine,22,44,20,3,66,90.9090909090909,13.636363636363635
55126_marine,22,44,20,3,66,90.9090909090909,13.636363636363635
55127_marine,22,44,20,3,66,90.9090909090909,13.636363636363635
55128_marine,22,44,20,3,66,90.9090909090909,13.636363636363635
55129_marine,22,36,20,3,58,90.9090909090909,13.636363636363635
55130_marine,22,36,20,3,58,90.9090909090909,13.636363636363635
55131_marine,22,36,20,3,58,90.9090909090909,13.636363636363635
55132_marine,22,36,20,3,58,90.9090909090909,13.636363636363635
55133_marine,22,36,20,3,58,90.9090909090909,13.636363636363635
55134_marine,22,36,20,3,58,90.9090909090909,13.636363636363635
55135_marine,22,36,20,3,58,90.9090909090909,13.636363636363635
55136_marine,22,36,20,3,58,90.9090909090909,13.636363636363635
55137_marine,22,36,20,3,58,90.9090909090909,13.636363636363635
55138_marine,22,35,20,3,57,90.9090909090909,13.636363636363635
55139_marine,22,35,20,3,57,90.9090909090909,13.636363636363635
55140_marine,22,35,20,3,57,90.9090909090909,13.636363636363635
55141_marine,22,35,20,3,57,90.9090909090909,13.636363636363635
55142_marine,22,35,20,3,57,90.9090909090909,13.636363636363635
55143_marine,22,35,20,3,57,90.9090909090909,13.636363636363635
55144_marine,22,35,20,3,57,90.9090909090909,13.636363636363635
55145_marine,22,35,20,3,57,90.9090909090909,13.636363636363635
55146_marine,22,35,20,3,57,90.9090909090909,13.636363636363635
55147_marine,22,35,20,3,57,90.9090909090909,13.636363636363635
55148_marine,22,35,20,3,57,90.9090909090909,13.636363636363635
55149_marine,22,34,20,3,56,90.9090909090909,13.636363636363635
55150_marine,22,34,20,3,56,90.9090909090909,13.636363636363635
55151_marine,22,34,20,3,56,90.9090909090909,13.636363636363635
55152_marine,21,34,19,3,55,90.47619047619048,14.285714285714285
55153_marine,21,34,19,3,55,90.47619047619048,14.285714285714285
55154_marine,21,34,19,3,55,90.47619047619048,14.285714285714285
55155_marine,21,34,19,3,55,90.47619047619048,14.285714285714285
55156_marine,21,34,19,3,55,90.47619047619048,14.285714285714285
55157_marine,22,34,20,3,56,90.9090909090909,13.636363636363635
55158_marine,22,34,20,3,56,90.9090909090909,13.636363636363635
55159_marine,22,34,20,3,56,90.9090909090909,13.636363636363635
55160_marine,23,32,21,3,55,91.30434782608695,13.043478260869565
55161_marine,23,32,21,3,55,91.30434782608695,13.043478260869565
55162_marine,23,32,21,3,55,91.30434782608695,13.043478260869565
55163_marine,23,32,21,3,55,91.30434782608695,13.043478260869565
55164_marine,23,32,21,3,55,91.30434782608695,13.043478260869565
55165_marine,23,32,21,3,55,91.30434782608695,13.043478260869565
55166_marine,23,32,21,3,55,91.30434782608695,13.043478260869565
55167_marine,23,32,21,3,55,91.30434782608695,13.043478260869565
55168_marine,23,32,21,3,55,91.30434782608695,13.043478260869565
55169_marine,23,32,21,3,55,91.30434782608695,13.043478260869565
55170_marine,23,32,21,3,55,91.30434782608695,13.043478260869565
55171_marine,23,32,21,3,55,91.30434782608695,13.043478260869565
55172_marine,23,32,21,3,55,91.30434782608695,13.043478260869565
55173_marine,23,32,21,3,55,91.30434782608695,13.043478260869565
55174_marine,23,32,21,3,55,91.30434782608695,13.043478260869565
55175_marine,23,32,21,3,55,91.30434782608695,13.043478260869565
55176_marine,23,33,21,3,56,91.30434782608695,13.043478260869565
55177_marine,23,33,21,3,56,91.30434782608695,13.043478260869565
55178_marine,23,33,21,3,56,91.30434782608695,13.043478260869565
55179_marine,23,33,21,3,56,91.30434782608695,13.043478260869565
55180_marine,23,33,21,3,56,91.30434782608695,13.043478260869565
55181_marine,23,33,21,3,56,91.30434782608695,13.043478260869565
55182_marine,24,33,21,4,57,87.5,16.666666666666664
55183_marine,23,33,20,4,56,86.95652173913044,17.391304347826086
55184_marine,23,33,20,4,56,86.95652173913044,17.391304347826086
55185_marine,23,41,20,4,64,86.95652173913044,17.391304347826086
55186_marine,23,41,20,4,64,86.95652173913044,17.391304347826086
55187_marine,23,41,20,4,64,86.95652173913044,17.391304347826086
55188_marine,24,41,20,5,65,83.33333333333334,20.833333333333336
55189_marine,26,41,21,7,67,80.76923076923077,26.923076923076923
55190_marine,27,41,22,7,68,81.48148148148148,25.925925925925924
55191_marine,29,42,24,7,71,82.75862068965517,24.137931034482758
55192_marine,30,43,25,7,73,83.33333333333334,23.333333333333332
55193_marine,30,44,25,7,74,83.33333333333334,23.333333333333332
55194_marine,30,45,25,8,75,83.33333333333334,26.666666666666668
55195_marine,29,43,24,8,72,82.75862068965517,27.586206896551722
55196_marine,29,47,24,8,76,82.75862068965517,27.586206896551722
55197_marine,30,47,24,9,77,80,30
55198_marine,36,57,27,14,93,75,38.88888888888889
55199_marine,36,60,27,14,96,75,38.88888888888889
55200_marine,35,59,25,15,94,71.42857142857143,42.857142857142854
55201_marine,31,50,23,12,81,74.19354838709677,38.70967741935484
55202_marine,31,50,23,12,81,74.19354838709677,38.70967741935484
55203_marine,30,50,23,11,80,76.66666666666667,36.666666666666664
55204_marine,29,50,22,11,79,75.86206896551724,37.93103448275862
55205_marine,31,51,23,13,82,74.19354838709677,41.935483870967744
55206_marine,30,47,23,11,77,76.66666666666667,36.666666666666664
55207_marine,27,47,22,8,74,81.48148148148148,29.629629629629626
55208_marine,28,43,23,8,71,82.14285714285714,28.57142857142857
55209_marine,26,40,21,7,66,80.76923076923077,26.923076923076923
55210_marine,26,40,21,7,66,80.76923076923077,26.923076923076923
55211_marine,26,38,21,7,64,80.76923076923077,26.923076923076923
55212_marine,26,39,21,7,65,80.76923076923077,26.923076923076923
55213_marine,25,39,20,7,64,80,28.000000000000004
55214_marine,25,41,20,7,66,80,28.000000000000004
55215_marine,25,41,20,7,66,80,28.000000000000004
55216_marine,25,41,20,7,66,80,28.000000000000004
55217_marine,24,41,20,6,65,83.33333333333334,25
55218_marine,24,39,20,6,63,83.33333333333334,25
55219_marine,23,39,19,6,62,82.6086956521739,26.08695652173913
55220_marine,23,39,19,6,62,82.6086956521739,26.08695652173913
55221_marine,23,39,19,6,62,82.6086956521739,26.08695652173913
55222_marine,23,40,19,6,63,82.6086956521739,26.08695652173913
55223_marine,23,40,19,6,63,82.6086956521739,26.08695652173913
55224_marine,23,40,19,6,63,82.6086956521739,26.08695652173913
55225_marine,23,40,19,6,63,82.6086956521739,26.08695652173913
55226_marine,22,40,18,6,62,81.81818181818183,27.27272727272727
55227_marine,22,40,18,6,62,81.81818181818183,27.27272727272727
55228_marine,22,40,18,6,62,81.81818181818183,27.27272727272727
55229_marine,22,40,18,6,62,81.81818181818183,27.27272727272727
55230_marine,22,40,18,6,62,81.81818181818183,27.27272727272727
55231_marine,22,40,18,6,62,81.81818181818183,27.27272727272727
55232_marine,22,40,18,6,62,81.81818181818183,27.27272727272727
55233_marine,22,40,18,6,62,81.81818181818183,27.27272727272727
55234_marine,22,40,18,6,62,81.81818181818183,27.27272727272727
55235_marine,22,40,18,6,62,81.81818181818183,27.27272727272727
55236_marine,22,40,18,6,62,81.81818181818183,27.27272727272727
55237_marine,23,39,19,6,62,82.6086956521739,26.08695652173913
55238_marine,23,39,19,6,62,82.6086956521739,26.08695652173913
55239_marine,24,39,19,7,63,79.16666666666666,29.166666666666668
55240_marine,23,39,19,6,62,82.6086956521739,26.08695652173913
55241_marine,23,39,19,6,62,82.6086956521739,26.08695652173913
55242_marine,24,36,20,6,60,83.33333333333334,25
55243_marine,25,36,21,6,61,84,24
55244_marine,25,36,21,6,61,84,24
55245_marine,26,36,22,6,62,84.61538461538461,23.076923076923077
55246_marine,26,36,22,6,62,84.61538461538461,23.076923076923077
55247_marine,26,36,22,6,62,84.61538461538461,23.076923076923077
55248_marine,26,36,22,6,62,84.61538461538461,23.076923076923077
55249_marine,26,36,22,6,62,84.61538461538461,23.076923076923077
55250_marine,26,36,22,6,62,84.61538461538461,23.076923076923077
55251_marine,26,36,22,6,62,84.61538461538461,23.076923076923077
55252_marine,26,36,22,6,62,84.61538461538461,23.076923076923077
55253_marine,26,36,22,6,62,84.61538461538461,23.076923076923077
55254_marine,26,36,22,6,62,84.61538461538461,23.076923076923077
55255_marine,26,36,22,6,62,84.61538461538461,23.076923076923077
55256_marine,26,36,22,6,62,84.61538461538461,23.076923076923077
55257_marine,26,36,22,6,62,84.61538461538461,23.076923076923077
55258_marine,26,36,22,6,62,84.61538461538461,23.076923076923077
55259_marine,26,36,22,6,62,84.61538461538461,23.076923076923077
55260_marine,26,36,22,6,62,84.61538461538461,23.076923076923077
55261_marine,25,36,21,6,61,84,24
55262_marine,25,36,21,6,61,84,24
55263_marine,25,36,21,6,61,84,24
55264_marine,25,35,21,6,60,84,24
55265_marine,25,35,21,6,60,84,24
55266_marine,25,35,21,6,60,84,24
55267_marine,25,35,21,6,60,84,24
55268_marine,25,35,21,6,60,84,24
55269_marine,25,35,21,6,60,84,24
55270_marine,25,35,21,6,60,84,24
55271_marine,23,35,19,6,58,82.6086956521739,26.08695652173913
55272_marine,23,35,19,6,58,82.6086956521739,26.08695652173913
55273_marine,23,35,19,6,58,82.6086956521739,26.08695652173913
55274_marine,23,35,19,6,58,82.6086956521739,26.08695652173913
55275_marine,23,35,19,6,58,82.6086956521739,26.08695652173913
55276_marine,23,35,19,6,58,82.6086956521739,26.08695652173913
55277_marine,23,36,19,6,59,82.6086956521739,26.08695652173913
55278_marine,23,36,19,6,59,82.6086956521739,26.08695652173913
55279_marine,23,36,19,6,59,82.6086956521739,26.08695652173913
55280_marine,23,36,19,6,59,82.6086956521739,26.08695652173913
55281_marine,23,36,19,6,59,82.6086956521739,26.08695652173913
55282_marine,23,36,19,6,59,82.6086956521739,26.08695652173913
55283_marine,23,36,19,6,59,82.6086956521739,26.08695652173913
55284_marine,23,36,19,6,59,82.6086956521739,26.08695652173913
55285_marine,22,36,18,5,58,81.81818181818183,22.727272727272727
55286_marine,22,36,18,5,58,81.81818181818183,22.727272727272727
55287_marine,22,36,18,5,58,81.81818181818183,22.727272727272727
55288_marine,22,36,18,5,58,81.81818181818183,22.727272727272727
55289_marine,22,36,18,5,58,81.81818181818183,22.727272727272727
55290_marine,20,36,16,5,56,80,25
55291_marine,20,35,16,5,55,80,25
55292_marine,20,35,16,5,55,80,25
55293_marine,20,35,16,5,55,80,25
55294_marine,20,35,16,5,55,80,25
55295_marine,19,35,15,5,54,78.94736842105263,26.31578947368421
55296_marine,19,35,15,5,54,78.94736842105263,26.31578947368421
55297_marine,19,35,15,5,54,78.94736842105263,26.31578947368421
55298_marine,19,35,15,5,54,78.94736842105263,26.31578947368421
55299_marine,18,35,14,5,53,77.77777777777779,27.77777777777778
55300_marine,18,35,14,5,53,77.77777777777779,27.77777777777778
55301_marine,18,35,14,5,53,77.77777777777779,27.77777777777778
55302_marine,18,35,14,5,53,77.77777777777779,27.77777777777778
55303_marine,17,35,13,4,52,76.47058823529412,23.52941176470588
55304_marine,17,35,13,4,52,76.47058823529412,23.52941176470588
55305_marine,17,35,13,4,52,76.47058823529412,23.52941176470588
55306_marine,17,35,13,4,52,76.47058823529412,23.52941176470588
55307_marine,17,35,13,4,52,76.47058823529412,23.52941176470588
55308_marine,17,35,13,4,52,76.47058823529412,23.52941176470588
55309_marine,17,35,13,4,52,76.47058823529412,23.52941176470588
55310_marine,17,36,13,4,53,76.47058823529412,23.52941176470588
55311_marine,17,36,13,4,53,76.47058823529412,23.52941176470588
55312_marine,17,36,13,4,53,76.47058823529412,23.52941176470588
55313_marine,18,36,14,4,54,77.77777777777779,22.22222222222222
55314_marine,18,36,14,4,54,77.77777777777779,22.22222222222222
55315_marine,18,36,14,4,54,77.77777777777779,22.22222222222222
55316_marine,18,36,14,4,54,77.77777777777779,22.22222222222222
55317_marine,18,36,14,4,54,77.77777777777779,22.22222222222222
55318_marine,18,36,14,4,54,77.77777777777779,22.22222222222222
55319_marine,18,36,14,4,54,77.77777777777779,22.22222222222222
55320_marine,18,36,14,4,54,77.77777777777779,22.22222222222222
55321_marine,17,36,13,4,53,76.47058823529412,23.52941176470588
55322_marine,17,36,13,4,53,76.47058823529412,23.52941176470588
55323_marine,17,36,13,4,53,76.47058823529412,23.52941176470588
55324_marine,17,36,13,4,53,76.47058823529412,23.52941176470588
55325_marine,17,36,13,4,53,76.47058823529412,23.52941176470588
55326_marine,17,36,13,4,53,76.47058823529412,23.52941176470588
55327_marine,17,36,13,4,53,76.47058823529412,23.52941176470588
55328_marine,17,36,13,4,53,76.47058823529412,23.52941176470588
55329_marine,17,36,13,4,53,76.47058823529412,23.52941176470588
55330_marine,17,36,13,4,53,76.47058823529412,23.52941176470588
55331_marine,17,36,13,4,53,76.47058823529412,23.52941176470588
55332_marine,17,36,13,4,53,76.47058823529412,23.52941176470588
55333_marine,18,36,14,4,54,77.77777777777779,22.22222222222222
55334_marine,18,36,14,4,54,77.77777777777779,22.22222222222222
55335_marine,18,34,14,4,52,77.77777777777779,22.22222222222222
55336_marine,18,34,14,4,52,77.77777777777779,22.22222222222222
55337_marine,18,34,14,4,52,77.77777777777779,22.22222222222222
55338_marine,18,34,14,4,52,77.77777777777779,22.22222222222222
55339_marine,18,34,14,4,52,77.77777777777779,22.22222222222222
55340_marine,18,34,14,4,52,77.77777777777779,22.22222222222222
55341_marine,18,34,14,4,52,77.77777777777779,22.22222222222222
55342_marine,17,34,13,4,51,76.47058823529412,23.52941176470588
55343_marine,16,34,12,4,50,75,25
55344_marine,16,34,12,4,50,75,25
55345_marine,15,34,11,4,49,73.33333333333333,26.666666666666668
55346_marine,15,34,11,4,49,73.33333333333333,26.666666666666668
55347_marine,15,34,11,4,49,73.33333333333333,26.666666666666668
55348_marine,16,34,12,4,50,75,25
55349_marine,16,34,12,4,50,75,25
55350_marine,16,34,12,4,50,75,25
55351_marine,16,34,12,4,50,75,25
55352_marine,16,32,12,4,48,75,25
55353_marine,16,32,12,4,48,75,25
55354_marine,16,32,12,4,48,75,25
55355_marine,16,32,12,4,48,75,25
55356_marine,16,32,12,4,48,75,25
55357_marine,16,32,12,4,48,75,25
55358_marine,16,32,12,4,48,75,25
55359_marine,16,32,12,4,48,75,25
55360_marine,16,31,12,4,47,75,25
55361_marine,16,31,12,4,47,75,25
55362_marine,16,31,12,4,47,75,25
55363_marine,16,31,12,4,47,75,25
55364_marine,16,31,12,4,47,75,25
55365_marine,16,31,12,4,47,75,25
55366_marine,16,31,12,4,47,75,25
55367_marine,16,31,12,4,47,75,25
55368_marine,16,31,12,4,47,75,25
55369_marine,16,31,12,4,47,75,25
55370_marine,16,31,12,4,47,75,25
55371_marine,16,31,12,4,47,75,25
55372_marine,16,31,12,4,47,75,25
55373_marine,16,29,12,4,45,75,25
55374_marine,16,28,12,4,44,75,25
55375_marine,16,28,12,4,44,75,25
55376_marine,16,28,12,4,44,75,25
55377_marine,16,28,12,4,44,75,25
55378_marine,16,28,12,4,44,75,25
55379_marine,16,28,12,4,44,75,25
55380_marine,16,28,12,4,44,75,25
55381_marine,16,28,12,4,44,75,25
55382_marine,16,30,12,4,46,75,25
55383_marine,16,30,12,4,46,75,25
55384_marine,16,30,12,4,46,75,25
55385_marine,16,30,12,4,46,75,25
55386_marine,16,30,12,4,46,75,25
55387_marine,16,30,12,4,46,75,25
55388_marine,17,31,13,4,48,76.47058823529412,23.52941176470588
55389_marine,17,31,13,4,48,76.47058823529412,23.52941176470588
55390_marine,17,31,13,4,48,76.47058823529412,23.52941176470588
55391_marine,17,31,13,4,48,76.47058823529412,23.52941176470588
55392_marine,17,31,13,4,48,76.47058823529412,23.52941176470588
55393_marine,18,31,14,4,49,77.77777777777779,22.22222222222222
55394_marine,18,32,14,4,50,77.77777777777779,22.22222222222222
55395_marine,18,32,14,4,50,77.77777777777779,22.22222222222222
55396_marine,18,32,14,4,50,77.77777777777779,22.22222222222222
55397_marine,19,35,15,4,54,78.94736842105263,21.052631578947366
55398_marine,19,35,15,4,54,78.94736842105263,21.052631578947366
55399_marine,19,35,15,4,54,78.94736842105263,21.052631578947366
55400_marine,19,35,15,4,54,78.94736842105263,21.052631578947366
55401_marine,19,37,15,4,56,78.94736842105263,21.052631578947366
55402_marine,20,37,16,4,57,80,20
55403_marine,20,37,16,4,57,80,20
55404_marine,20,37,16,4,57,80,20
55405_marine,20,39,16,4,59,80,20
55406_marine,20,39,16,4,59,80,20
55407_marine,20,39,16,4,59,80,20
55408_marine,21,39,17,5,60,80.95238095238095,23.809523809523807
55409_marine,21,40,17,5,61,80.95238095238095,23.809523809523807
55410_marine,20,42,16,5,62,80,25
55411_marine,21,42,17,5,63,80.95238095238095,23.809523809523807
55412_marine,21,43,17,5,64,80.95238095238095,23.809523809523807
55413_marine,23,44,19,5,67,82.6086956521739,21.73913043478261
55414_marine,23,44,19,5,67,82.6086956521739,21.73913043478261
55415_marine,23,44,19,5,67,82.6086956521739,21.73913043478261
55416_marine,23,44,19,5,67,82.6086956521739,21.73913043478261
55417_marine,23,45,19,5,68,82.6086956521739,21.73913043478261
55418_marine,23,45,19,5,68,82.6086956521739,21.73913043478261
55419_marine,23,45,19,5,68,82.6086956521739,21.73913043478261
55420_marine,24,46,20,5,70,83.33333333333334,20.833333333333336
55421_marine,24,46,20,5,70,83.33333333333334,20.833333333333336
55422_marine,24,46,20,5,70,83.33333333333334,20.833333333333336
55423_marine,26,46,22,5,72,84.61538461538461,19.230769230769234
55424_marine,26,46,22,5,72,84.61538461538461,19.230769230769234
55425_marine,26,46,22,5,72,84.61538461538461,19.230769230769234
55426_marine,26,46,22,5,72,84.61538461538461,19.230769230769234
55427_marine,26,46,22,5,72,84.61538461538461,19.230769230769234
55428_marine,26,46,22,5,72,84.61538461538461,19.230769230769234
55429_marine,26,47,22,5,73,84.61538461538461,19.230769230769234
55430_marine,26,47,22,5,73,84.61538461538461,19.230769230769234
55431_marine,25,47,22,4,72,88,16
55432_marine,24,47,22,3,71,91.66666666666666,12.5
55433_marine,24,47,22,3,71,91.66666666666666,12.5
55434_marine,24,47,22,3,71,91.66666666666666,12.5
55435_marine,23,47,21,3,70,91.30434782608695,13.043478260869565
55436_marine,23,47,21,3,70,91.30434782608695,13.043478260869565
55437_marine,23,47,21,3,70,91.30434782608695,13.043478260869565
55438_marine,23,47,21,3,70,91.30434782608695,13.043478260869565
55439_marine,23,47,21,3,70,91.30434782608695,13.043478260869565
55440_marine,23,39,21,3,62,91.30434782608695,13.043478260869565
55441_marine,22,42,20,3,64,90.9090909090909,13.636363636363635
55442_marine,22,42,20,3,64,90.9090909090909,13.636363636363635
55443_marine,22,42,20,3,64,90.9090909090909,13.636363636363635
55444_marine,22,42,20,3,64,90.9090909090909,13.636363636363635
55445_marine,22,41,20,3,63,90.9090909090909,13.636363636363635
55446_marine,23,41,21,3,64,91.30434782608695,13.043478260869565
55447_marine,23,41,21,3,64,91.30434782608695,13.043478260869565
55448_marine,23,41,21,3,64,91.30434782608695,13.043478260869565
55449_marine,23,41,21,3,64,91.30434782608695,13.043478260869565
55450_marine,23,41,21,3,64,91.30434782608695,13.043478260869565
55451_marine,23,42,21,3,65,91.30434782608695,13.043478260869565
55452_marine,23,42,21,3,65,91.30434782608695,13.043478260869565
55453_marine,23,42,21,3,65,91.30434782608695,13.043478260869565
55454_marine,23,42,21,3,65,91.30434782608695,13.043478260869565
55455_marine,23,42,21,3,65,91.30434782608695,13.043478260869565
55456_marine,23,42,21,3,65,91.30434782608695,13.043478260869565
55457_marine,23,42,21,3,65,91.30434782608695,13.043478260869565
55458_marine,23,42,21,3,65,91.30434782608695,13.043478260869565
55459_marine,23,42,21,3,65,91.30434782608695,13.043478260869565
55460_marine,23,42,21,3,65,91.30434782608695,13.043478260869565
55461_marine,23,42,21,3,65,91.30434782608695,13.043478260869565
55462_marine,23,42,21,3,65,91.30434782608695,13.043478260869565
55463_marine,23,42,21,3,65,91.30434782608695,13.043478260869565
55464_marine,23,42,21,3,65,91.30434782608695,13.043478260869565
55465_marine,23,42,21,3,65,91.30434782608695,13.043478260869565
55466_marine,23,42,21,3,65,91.30434782608695,13.043478260869565
55467_marine,23,42,21,3,65,91.30434782608695,13.043478260869565
55468_marine,23,42,21,3,65,91.30434782608695,13.043478260869565
55469_marine,23,42,21,3,65,91.30434782608695,13.043478260869565
55470_marine,23,41,21,3,64,91.30434782608695,13.043478260869565
55471_marine,23,41,21,3,64,91.30434782608695,13.043478260869565
55472_marine,23,41,21,3,64,91.30434782608695,13.043478260869565
55473_marine,23,41,21,3,64,91.30434782608695,13.043478260869565
55474_marine,23,41,21,3,64,91.30434782608695,13.043478260869565
55475_marine,22,41,20,3,63,90.9090909090909,13.636363636363635
55476_marine,22,41,20,3,63,90.9090909090909,13.636363636363635
55477_marine,22,41,20,3,63,90.9090909090909,13.636363636363635
55478_marine,23,41,21,3,64,91.30434782608695,13.043478260869565
55479_marine,22,41,20,3,63,90.9090909090909,13.636363636363635
55480_marine,22,41,20,3,63,90.9090909090909,13.636363636363635
55481_marine,22,41,20,3,63,90.9090909090909,13.636363636363635
55482_marine,22,41,20,3,63,90.9090909090909,13.636363636363635
55483_marine,22,41,20,3,63,90.9090909090909,13.636363636363635
55484_marine,22,41,20,3,63,90.9090909090909,13.636363636363635
55485_marine,22,41,20,3,63,90.9090909090909,13.636363636363635
55486_marine,21,42,19,3,63,90.47619047619048,14.285714285714285
55487_marine,21,42,19,3,63,90.47619047619048,14.285714285714285
55488_marine,21,42,19,3,63,90.47619047619048,14.285714285714285
55489_marine,21,42,19,3,63,90.47619047619048,14.285714285714285
55490_marine,21,42,19,3,63,90.47619047619048,14.285714285714285
55491_marine,21,42,19,3,63,90.47619047619048,14.285714285714285
55492_marine,21,42,19,3,63,90.47619047619048,14.285714285714285
55493_marine,21,41,19,3,62,90.47619047619048,14.285714285714285
55494_marine,21,41,19,3,62,90.47619047619048,14.285714285714285
55495_marine,21,33,19,3,54,90.47619047619048,14.285714285714285
55496_marine,21,33,19,3,54,90.47619047619048,14.285714285714285
55497_marine,21,33,19,3,54,90.47619047619048,14.285714285714285
55498_marine,21,33,19,3,54,90.47619047619048,14.285714285714285
55499_marine,21,33,19,3,54,90.47619047619048,14.285714285714285
55500_marine,21,33,19,3,54,90.47619047619048,14.285714285714285
55501_marine,21,33,19,3,54,90.47619047619048,14.285714285714285
55502_marine,21,33,19,3,54,90.47619047619048,14.285714285714285
55503_marine,21,33,19,3,54,90.47619047619048,14.285714285714285
55504_marine,21,32,19,3,53,90.47619047619048,14.285714285714285
55505_marine,21,32,19,3,53,90.47619047619048,14.285714285714285
55506_marine,21,32,19,3,53,90.47619047619048,14.285714285714285
55507_marine,21,32,19,3,53,90.47619047619048,14.285714285714285
55508_marine,21,32,19,3,53,90.47619047619048,14.285714285714285
55509_marine,21,32,19,3,53,90.47619047619048,14.285714285714285
55510_marine,21,32,19,3,53,90.47619047619048,14.285714285714285
55511_marine,21,32,19,3,53,90.47619047619048,14.285714285714285
55512_marine,21,32,19,3,53,90.47619047619048,14.285714285714285
55513_marine,21,32,19,3,53,90.47619047619048,14.285714285714285
55514_marine,20,32,18,2,52,90,10
55515_marine,20,32,18,2,52,90,10
55516_marine,20,32,18,2,52,90,10
55517_marine,20,32,18,2,52,90,10
55518_marine,20,32,18,2,52,90,10
55519_marine,20,32,18,2,52,90,10
55520_marine,20,32,18,2,52,90,10
55521_marine,20,32,18,2,52,90,10
55522_marine,21,32,19,3,53,90.47619047619048,14.285714285714285
55523_marine,21,32,19,3,53,90.47619047619048,14.285714285714285
55524_marine,22,32,20,3,54,90.9090909090909,13.636363636363635
55525_marine,22,32,20,3,54,90.9090909090909,13.636363636363635
55526_marine,23,32,21,3,55,91.30434782608695,13.043478260869565
55527_marine,23,32,21,3,55,91.30434782608695,13.043478260869565
55528_marine,23,32,21,3,55,91.30434782608695,13.043478260869565
55529_marine,23,32,21,3,55,91.30434782608695,13.043478260869565
55530_marine,23,32,21,3,55,91.30434782608695,13.043478260869565
55531_marine,23,32,21,3,55,91.30434782608695,13.043478260869565
55532_marine,23,32,21,3,55,91.30434782608695,13.043478260869565
55533_marine,23,32,21,3,55,91.30434782608695,13.043478260869565
55534_marine,23,32,21,3,55,91.30434782608695,13.043478260869565
55535_marine,24,32,21,4,56,87.5,16.666666666666664
55536_marine,24,32,21,4,56,87.5,16.666666666666664
55537_marine,24,40,21,4,64,87.5,16.666666666666664
55538_marine,24,40,21,4,64,87.5,16.666666666666664
55539_marine,24,40,21,4,64,87.5,16.666666666666664
55540_marine,24,40,21,4,64,87.5,16.666666666666664
55541_marine,24,40,21,4,64,87.5,16.666666666666664
55542_marine,24,41,21,4,65,87.5,16.666666666666664
55543_marine,23,41,20,4,64,86.95652173913044,17.391304347826086
55544_marine,23,41,19,5,64,82.6086956521739,21.73913043478261
55545_marine,23,41,19,5,64,82.6086956521739,21.73913043478261
55546_marine,24,40,19,6,64,79.16666666666666,25
55547_marine,24,40,19,6,64,79.16666666666666,25
55548_marine,24,39,19,6,63,79.16666666666666,25
55549_marine,24,39,19,6,63,79.16666666666666,25
55550_marine,24,39,19,6,63,79.16666666666666,25
55551_marine,25,39,20,6,64,80,24
55552_marine,27,42,22,7,69,81.48148148148148,25.925925925925924
55553_marine,28,40,23,7,68,82.14285714285714,25
55554_marine,27,41,22,7,68,81.48148148148148,25.925925925925924
55555_marine,27,41,22,8,68,81.48148148148148,29.629629629629626
55556_marine,34,48,24,14,82,70.58823529411765,41.17647058823529
55557_marine,35,49,25,15,84,71.42857142857143,42.857142857142854
55558_marine,33,48,24,13,81,72.72727272727273,39.39393939393939
55559_marine,32,50,24,12,82,75,37.5
55560_marine,32,47,24,12,79,75,37.5
55561_marine,27,44,21,10,71,77.77777777777779,37.03703703703704
55562_marine,29,45,21,13,74,72.41379310344827,44.827586206896555
55563_marine,29,45,21,13,74,72.41379310344827,44.827586206896555
55564_marine,29,45,22,11,74,75.86206896551724,37.93103448275862
55565_marine,26,44,21,8,70,80.76923076923077,30.76923076923077
55566_marine,25,43,20,7,68,80,28.000000000000004
55567_marine,26,41,21,7,67,80.76923076923077,26.923076923076923
55568_marine,27,37,22,7,64,81.48148148148148,25.925925925925924
55569_marine,26,37,21,7,63,80.76923076923077,26.923076923076923
55570_marine,26,37,21,7,63,80.76923076923077,26.923076923076923
55571_marine,26,37,21,7,63,80.76923076923077,26.923076923076923
55572_marine,25,37,20,6,62,80,24
55573_marine,24,37,19,6,61,79.16666666666666,25
55574_marine,24,37,19,6,61,79.16666666666666,25
55575_marine,24,38,19,6,62,79.16666666666666,25
55576_marine,24,38,19,6,62,79.16666666666666,25
55577_marine,24,39,19,6,63,79.16666666666666,25
55578_marine,23,39,18,6,62,78.26086956521739,26.08695652173913
55579_marine,23,39,18,6,62,78.26086956521739,26.08695652173913
55580_marine,22,39,18,5,61,81.81818181818183,22.727272727272727
55581_marine,22,39,18,5,61,81.81818181818183,22.727272727272727
55582_marine,23,39,19,6,62,82.6086956521739,26.08695652173913
55583_marine,23,40,19,6,63,82.6086956521739,26.08695652173913
55584_marine,22,40,18,6,62,81.81818181818183,27.27272727272727
55585_marine,22,40,18,6,62,81.81818181818183,27.27272727272727
55586_marine,22,40,18,6,62,81.81818181818183,27.27272727272727
55587_marine,22,40,18,6,62,81.81818181818183,27.27272727272727
55588_marine,22,40,18,6,62,81.81818181818183,27.27272727272727
55589_marine,22,40,18,6,62,81.81818181818183,27.27272727272727
55590_marine,21,40,18,5,61,85.71428571428571,23.809523809523807
55591_marine,20,40,17,5,60,85,25
55592_marine,20,40,17,5,60,85,25
55593_marine,20,40,17,5,60,85,25
55594_marine,20,40,17,5,60,85,25
55595_marine,21,39,17,6,60,80.95238095238095,28.57142857142857
55596_marine,21,39,17,6,60,80.95238095238095,28.57142857142857
55597_marine,21,39,17,6,60,80.95238095238095,28.57142857142857
55598_marine,21,37,17,6,58,80.95238095238095,28.57142857142857
55599_marine,22,37,18,6,59,81.81818181818183,27.27272727272727
55600_marine,23,37,19,6,60,82.6086956521739,26.08695652173913
55601_marine,23,37,19,6,60,82.6086956521739,26.08695652173913
55602_marine,24,36,20,6,60,83.33333333333334,25
55603_marine,24,36,20,6,60,83.33333333333334,25
55604_marine,24,36,20,6,60,83.33333333333334,25
55605_marine,25,36,21,6,61,84,24
55606_marine,25,36,21,6,61,84,24
55607_marine,25,36,21,6,61,84,24
55608_marine,25,36,21,6,61,84,24
55609_marine,25,36,21,6,61,84,24
55610_marine,25,36,21,6,61,84,24
55611_marine,25,36,21,6,61,84,24
55612_marine,25,36,21,6,61,84,24
55613_marine,25,36,21,6,61,84,24
55614_marine,25,36,21,6,61,84,24
55615_marine,25,36,21,6,61,84,24
55616_marine,25,36,21,6,61,84,24
55617_marine,25,36,21,6,61,84,24
55618_marine,25,36,21,6,61,84,24
55619_marine,23,36,19,6,59,82.6086956521739,26.08695652173913
55620_marine,23,35,19,6,58,82.6086956521739,26.08695652173913
55621_marine,22,35,18,6,57,81.81818181818183,27.27272727272727
55622_marine,20,35,16,6,55,80,30
55623_marine,20,34,16,6,54,80,30
55624_marine,20,34,16,6,54,80,30
55625_marine,20,34,16,6,54,80,30
55626_marine,20,34,16,6,54,80,30
55627_marine,21,34,17,6,55,80.95238095238095,28.57142857142857
55628_marine,20,33,16,6,53,80,30
55629_marine,20,33,16,6,53,80,30
55630_marine,19,33,15,6,52,78.94736842105263,31.57894736842105
55631_marine,19,33,15,6,52,78.94736842105263,31.57894736842105
55632_marine,19,33,15,6,52,78.94736842105263,31.57894736842105
55633_marine,19,33,15,6,52,78.94736842105263,31.57894736842105
55634_marine,20,33,16,6,53,80,30
55635_marine,20,33,16,6,53,80,30
55636_marine,20,33,16,6,53,80,30
55637_marine,20,33,16,6,53,80,30
55638_marine,19,33,15,5,52,78.94736842105263,26.31578947368421
55639_marine,19,33,15,5,52,78.94736842105263,26.31578947368421
55640_marine,19,33,15,5,52,78.94736842105263,26.31578947368421
55641_marine,18,33,14,5,51,77.77777777777779,27.77777777777778
55642_marine,18,33,14,5,51,77.77777777777779,27.77777777777778
55643_marine,18,33,14,5,51,77.77777777777779,27.77777777777778
55644_marine,18,33,14,5,51,77.77777777777779,27.77777777777778
55645_marine,18,33,14,5,51,77.77777777777779,27.77777777777778
55646_marine,18,33,14,5,51,77.77777777777779,27.77777777777778
55647_marine,19,33,15,5,52,78.94736842105263,26.31578947368421
55648_marine,19,33,15,5,52,78.94736842105263,26.31578947368421
55649_marine,19,33,15,5,52,78.94736842105263,26.31578947368421
55650_marine,19,33,15,5,52,78.94736842105263,26.31578947368421
55651_marine,18,33,14,5,51,77.77777777777779,27.77777777777778
55652_marine,18,33,14,5,51,77.77777777777779,27.77777777777778
55653_marine,18,33,14,5,51,77.77777777777779,27.77777777777778
55654_marine,17,33,13,5,50,76.47058823529412,29.411764705882355
55655_marine,17,33,13,5,50,76.47058823529412,29.411764705882355
55656_marine,17,33,13,5,50,76.47058823529412,29.411764705882355
55657_marine,16,33,12,4,49,75,25
55658_marine,16,33,12,4,49,75,25
55659_marine,16,33,12,4,49,75,25
55660_marine,16,32,12,4,48,75,25
55661_marine,16,31,12,4,47,75,25
55662_marine,16,31,12,4,47,75,25
55663_marine,16,31,12,4,47,75,25
55664_marine,16,31,12,4,47,75,25
55665_marine,16,31,12,4,47,75,25
55666_marine,16,31,12,4,47,75,25
55667_marine,16,31,12,4,47,75,25
55668_marine,16,30,12,4,46,75,25
55669_marine,16,30,12,4,46,75,25
55670_marine,16,28,12,4,44,75,25
55671_marine,16,28,12,4,44,75,25
55672_marine,16,28,12,4,44,75,25
55673_marine,16,28,12,4,44,75,25
55674_marine,16,28,12,4,44,75,25
55675_marine,16,28,12,4,44,75,25
55676_marine,16,28,12,4,44,75,25
55677_marine,16,28,12,4,44,75,25
55678_marine,16,28,12,4,44,75,25
55679_marine,16,28,12,4,44,75,25
55680_marine,16,28,12,4,44,75,25
55681_marine,16,28,12,4,44,75,25
55682_marine,16,28,12,4,44,75,25
55683_marine,16,29,12,4,45,75,25
55684_marine,16,31,12,4,47,75,25
55685_marine,16,31,12,4,47,75,25
55686_marine,16,31,12,4,47,75,25
55687_marine,16,31,12,4,47,75,25
55688_marine,16,32,12,4,48,75,25
55689_marine,16,32,12,4,48,75,25
55690_marine,16,32,12,4,48,75,25
55691_marine,16,32,12,4,48,75,25
55692_marine,16,32,12,4,48,75,25
55693_marine,17,32,13,4,49,76.47058823529412,23.52941176470588
55694_marine,17,32,13,4,49,76.47058823529412,23.52941176470588
55695_marine,17,32,13,4,49,76.47058823529412,23.52941176470588
55696_marine,17,32,13,4,49,76.47058823529412,23.52941176470588
55697_marine,16,32,12,4,48,75,25
55698_marine,16,32,12,4,48,75,25
55699_marine,15,32,11,4,47,73.33333333333333,26.666666666666668
55700_marine,15,32,11,4,47,73.33333333333333,26.666666666666668
55701_marine,15,32,11,4,47,73.33333333333333,26.666666666666668
55702_marine,15,32,11,4,47,73.33333333333333,26.666666666666668
55703_marine,15,32,11,4,47,73.33333333333333,26.666666666666668
55704_marine,15,32,11,4,47,73.33333333333333,26.666666666666668
55705_marine,15,32,11,4,47,73.33333333333333,26.666666666666668
55706_marine,15,32,11,4,47,73.33333333333333,26.666666666666668
55707_marine,15,32,11,4,47,73.33333333333333,26.666666666666668
55708_marine,16,32,12,4,48,75,25
55709_marine,16,31,12,4,47,75,25
55710_marine,16,31,12,4,47,75,25
55711_marine,16,31,12,4,47,75,25
55712_marine,16,31,12,4,47,75,25
55713_marine,16,31,12,4,47,75,25
55714_marine,16,31,12,4,47,75,25
55715_marine,16,31,12,4,47,75,25
55716_marine,16,31,12,4,47,75,25
55717_marine,16,31,12,4,47,75,25
55718_marine,16,31,12,4,47,75,25
55719_marine,16,29,12,4,45,75,25
55720_marine,16,29,12,4,45,75,25
55721_marine,16,29,12,4,45,75,25
55722_marine,16,29,12,4,45,75,25
55723_marine,16,29,12,4,45,75,25
55724_marine,16,28,12,4,44,75,25
55725_marine,16,28,12,4,44,75,25
55726_marine,16,28,12,4,44,75,25
55727_marine,16,28,12,4,44,75,25
55728_marine,16,28,12,4,44,75,25
55729_marine,16,28,12,4,44,75,25
55730_marine,16,28,12,4,44,75,25
55731_marine,16,28,12,4,44,75,25
55732_marine,16,28,12,4,44,75,25
55733_marine,16,28,12,4,44,75,25
55734_marine,16,28,12,4,44,75,25
55735_marine,16,28,12,4,44,75,25
55736_marine,16,28,12,4,44,75,25
55737_marine,16,28,12,4,44,75,25
55738_marine,16,28,12,4,44,75,25
55739_marine,16,28,12,4,44,75,25
55740_marine,16,28,12,4,44,75,25
55741_marine,16,28,12,4,44,75,25
55742_marine,16,28,12,4,44,75,25
55743_marine,16,28,12,4,44,75,25
55744_marine,16,28,12,4,44,75,25
55745_marine,16,28,12,4,44,75,25
55746_marine,16,28,12,4,44,75,25
55747_marine,16,28,12,4,44,75,25
55748_marine,16,28,12,4,44,75,25
55749_marine,17,28,13,4,45,76.47058823529412,23.52941176470588
55750_marine,17,28,13,4,45,76.47058823529412,23.52941176470588
55751_marine,17,28,13,4,45,76.47058823529412,23.52941176470588
55752_marine,17,28,13,4,45,76.47058823529412,23.52941176470588
55753_marine,18,28,14,4,46,77.77777777777779,22.22222222222222
55754_marine,18,28,14,4,46,77.77777777777779,22.22222222222222
55755_marine,19,28,14,5,47,73.68421052631578,26.31578947368421
55756_marine,19,28,14,5,47,73.68421052631578,26.31578947368421
55757_marine,18,28,14,4,46,77.77777777777779,22.22222222222222
55758_marine,18,28,14,4,46,77.77777777777779,22.22222222222222
55759_marine,18,28,14,4,46,77.77777777777779,22.22222222222222
55760_marine,18,28,14,4,46,77.77777777777779,22.22222222222222
55761_marine,18,31,14,4,49,77.77777777777779,22.22222222222222
55762_marine,18,33,14,4,51,77.77777777777779,22.22222222222222
55763_marine,18,33,14,4,51,77.77777777777779,22.22222222222222
55764_marine,18,33,14,4,51,77.77777777777779,22.22222222222222
55765_marine,18,33,14,4,51,77.77777777777779,22.22222222222222
55766_marine,18,33,14,4,51,77.77777777777779,22.22222222222222
55767_marine,18,33,14,4,51,77.77777777777779,22.22222222222222
55768_marine,18,34,14,4,52,77.77777777777779,22.22222222222222
55769_marine,17,34,13,4,51,76.47058823529412,23.52941176470588
55770_marine,18,34,14,4,52,77.77777777777779,22.22222222222222
55771_marine,19,35,15,4,54,78.94736842105263,21.052631578947366
55772_marine,20,37,16,4,57,80,20
55773_marine,21,39,17,5,60,80.95238095238095,23.809523809523807
55774_marine,21,40,17,5,61,80.95238095238095,23.809523809523807
55775_marine,21,40,17,5,61,80.95238095238095,23.809523809523807
55776_marine,20,40,16,5,60,80,25
55777_marine,20,41,16,5,61,80,25
55778_marine,20,41,16,5,61,80,25
55779_marine,20,41,16,5,61,80,25
55780_marine,20,44,16,5,64,80,25
55781_marine,21,46,17,5,67,80.95238095238095,23.809523809523807
55782_marine,22,46,18,5,68,81.81818181818183,22.727272727272727
55783_marine,22,46,18,5,68,81.81818181818183,22.727272727272727
55784_marine,24,46,20,5,70,83.33333333333334,20.833333333333336
55785_marine,24,46,20,5,70,83.33333333333334,20.833333333333336
55786_marine,26,46,22,5,72,84.61538461538461,19.230769230769234
55787_marine,26,46,22,5,72,84.61538461538461,19.230769230769234
55788_marine,26,46,22,5,72,84.61538461538461,19.230769230769234
55789_marine,26,46,22,5,72,84.61538461538461,19.230769230769234
55790_marine,26,46,22,5,72,84.61538461538461,19.230769230769234
55791_marine,26,46,22,5,72,84.61538461538461,19.230769230769234
55792_marine,26,46,22,5,72,84.61538461538461,19.230769230769234
55793_marine,26,46,22,5,72,84.61538461538461,19.230769230769234
55794_marine,26,46,22,5,72,84.61538461538461,19.230769230769234
55795_marine,25,46,22,4,71,88,16
55796_marine,24,45,21,4,69,87.5,16.666666666666664
55797_marine,24,44,21,4,68,87.5,16.666666666666664
55798_marine,24,44,21,4,68,87.5,16.666666666666664
55799_marine,23,43,21,3,66,91.30434782608695,13.043478260869565
55800_marine,23,43,21,3,66,91.30434782608695,13.043478260869565
55801_marine,23,42,20,4,65,86.95652173913044,17.391304347826086
55802_marine,23,42,20,4,65,86.95652173913044,17.391304347826086
55803_marine,23,41,20,4,64,86.95652173913044,17.391304347826086
55804_marine,23,41,20,4,64,86.95652173913044,17.391304347826086
55805_marine,23,41,20,4,64,86.95652173913044,17.391304347826086
55806_marine,23,41,20,4,64,86.95652173913044,17.391304347826086
55807_marine,23,41,20,4,64,86.95652173913044,17.391304347826086
55808_marine,22,41,20,3,63,90.9090909090909,13.636363636363635
55809_marine,22,41,20,3,63,90.9090909090909,13.636363636363635
55810_marine,22,41,20,3,63,90.9090909090909,13.636363636363635
55811_marine,22,41,20,3,63,90.9090909090909,13.636363636363635
55812_marine,22,41,20,3,63,90.9090909090909,13.636363636363635
55813_marine,22,41,20,3,63,90.9090909090909,13.636363636363635
55814_marine,22,41,20,3,63,90.9090909090909,13.636363636363635
55815_marine,22,41,20,3,63,90.9090909090909,13.636363636363635
55816_marine,22,41,20,3,63,90.9090909090909,13.636363636363635
55817_marine,22,41,20,3,63,90.9090909090909,13.636363636363635
55818_marine,22,41,20,3,63,90.9090909090909,13.636363636363635
55819_marine,22,41,20,3,63,90.9090909090909,13.636363636363635
55820_marine,22,41,20,3,63,90.9090909090909,13.636363636363635
55821_marine,22,41,20,3,63,90.9090909090909,13.636363636363635
55822_marine,22,41,20,3,63,90.9090909090909,13.636363636363635
55823_marine,22,41,20,3,63,90.9090909090909,13.636363636363635
55824_marine,22,41,20,3,63,90.9090909090909,13.636363636363635
55825_marine,22,41,20,3,63,90.9090909090909,13.636363636363635
55826_marine,22,41,20,3,63,90.9090909090909,13.636363636363635
55827_marine,22,41,20,3,63,90.9090909090909,13.636363636363635
55828_marine,22,41,20,3,63,90.9090909090909,13.636363636363635
55829_marine,22,40,20,3,62,90.9090909090909,13.636363636363635
55830_marine,22,40,20,3,62,90.9090909090909,13.636363636363635
55831_marine,22,40,20,3,62,90.9090909090909,13.636363636363635
55832_marine,22,38,20,3,60,90.9090909090909,13.636363636363635
55833_marine,22,38,20,3,60,90.9090909090909,13.636363636363635
55834_marine,22,38,20,3,60,90.9090909090909,13.636363636363635
55835_marine,22,38,20,3,60,90.9090909090909,13.636363636363635
55836_marine,22,38,20,3,60,90.9090909090909,13.636363636363635
55837_marine,23,38,21,3,61,91.30434782608695,13.043478260869565
55838_marine,22,39,20,3,61,90.9090909090909,13.636363636363635
55839_marine,21,39,19,3,60,90.47619047619048,14.285714285714285
55840_marine,21,39,19,3,60,90.47619047619048,14.285714285714285
55841_marine,21,39,19,3,60,90.47619047619048,14.285714285714285
55842_marine,21,39,19,3,60,90.47619047619048,14.285714285714285
55843_marine,21,39,19,3,60,90.47619047619048,14.285714285714285
55844_marine,21,39,19,3,60,90.47619047619048,14.285714285714285
55845_marine,21,39,19,3,60,90.47619047619048,14.285714285714285
55846_marine,21,40,19,3,61,90.47619047619048,14.285714285714285
55847_marine,21,40,19,3,61,90.47619047619048,14.285714285714285
55848_marine,21,40,19,3,61,90.47619047619048,14.285714285714285
55849_marine,21,39,19,3,60,90.47619047619048,14.285714285714285
55850_marine,21,39,19,3,60,90.47619047619048,14.285714285714285
55851_marine,21,38,19,3,59,90.47619047619048,14.285714285714285
55852_marine,21,38,19,3,59,90.47619047619048,14.285714285714285
55853_marine,21,38,19,3,59,90.47619047619048,14.285714285714285
55854_marine,21,38,19,3,59,90.47619047619048,14.285714285714285
55855_marine,21,38,19,3,59,90.47619047619048,14.285714285714285
55856_marine,21,38,19,3,59,90.47619047619048,14.285714285714285
55857_marine,21,38,19,3,59,90.47619047619048,14.285714285714285
55858_marine,21,38,19,3,59,90.47619047619048,14.285714285714285
55859_marine,21,38,19,3,59,90.47619047619048,14.285714285714285
55860_marine,21,38,19,3,59,90.47619047619048,14.285714285714285
55861_marine,21,38,19,3,59,90.47619047619048,14.285714285714285
55862_marine,21,38,19,3,59,90.47619047619048,14.285714285714285
55863_marine,21,38,19,3,59,90.47619047619048,14.285714285714285
55864_marine,20,38,18,2,58,90,10
55865_marine,20,38,18,2,58,90,10
55866_marine,20,38,18,2,58,90,10
55867_marine,20,30,18,2,50,90,10
55868_marine,20,30,18,2,50,90,10
55869_marine,20,30,18,2,50,90,10
55870_marine,20,30,18,2,50,90,10
55871_marine,20,29,18,2,49,90,10
55872_marine,20,29,18,2,49,90,10
55873_marine,20,29,18,2,49,90,10
55874_marine,19,29,17,2,48,89.47368421052632,10.526315789473683
55875_marine,19,29,17,2,48,89.47368421052632,10.526315789473683
55876_marine,19,31,17,2,50,89.47368421052632,10.526315789473683
55877_marine,19,31,17,2,50,89.47368421052632,10.526315789473683
55878_marine,19,31,17,2,50,89.47368421052632,10.526315789473683
55879_marine,20,31,17,3,51,85,15
55880_marine,20,30,17,3,50,85,15
55881_marine,20,30,17,3,50,85,15
55882_marine,20,30,17,3,50,85,15
55883_marine,20,30,17,3,50,85,15
55884_marine,20,30,17,3,50,85,15
55885_marine,20,30,17,3,50,85,15
55886_marine,20,38,17,3,58,85,15
55887_marine,21,38,18,3,59,85.71428571428571,14.285714285714285
55888_marine,21,38,18,3,59,85.71428571428571,14.285714285714285
55889_marine,22,38,19,4,60,86.36363636363636,18.181818181818183
55890_marine,23,38,20,4,61,86.95652173913044,17.391304347826086
55891_marine,23,38,20,4,61,86.95652173913044,17.391304347826086
55892_marine,23,38,20,4,61,86.95652173913044,17.391304347826086
55893_marine,23,38,20,4,61,86.95652173913044,17.391304347826086
55894_marine,23,38,20,4,61,86.95652173913044,17.391304347826086
55895_marine,23,38,20,4,61,86.95652173913044,17.391304347826086
55896_marine,23,38,20,4,61,86.95652173913044,17.391304347826086
55897_marine,23,38,20,4,61,86.95652173913044,17.391304347826086
55898_marine,23,38,20,4,61,86.95652173913044,17.391304347826086
55899_marine,23,38,20,4,61,86.95652173913044,17.391304347826086
55900_marine,23,38,20,4,61,86.95652173913044,17.391304347826086
55901_marine,23,38,20,4,61,86.95652173913044,17.391304347826086
55902_marine,23,38,20,4,61,86.95652173913044,17.391304347826086
55903_marine,22,38,19,4,60,86.36363636363636,18.181818181818183
55904_marine,23,38,19,5,61,82.6086956521739,21.73913043478261
55905_marine,23,38,19,5,61,82.6086956521739,21.73913043478261
55906_marine,24,38,19,6,62,79.16666666666666,25
55907_marine,24,38,19,6,62,79.16666666666666,25
55908_marine,24,36,19,6,60,79.16666666666666,25
55909_marine,24,36,19,6,60,79.16666666666666,25
55910_marine,24,37,19,6,61,79.16666666666666,25
55911_marine,23,37,18,6,60,78.26086956521739,26.08695652173913
55912_marine,24,37,19,6,61,79.16666666666666,25
55913_marine,25,34,20,6,59,80,24
55914_marine,28,36,23,7,64,82.14285714285714,25
55915_marine,28,38,23,7,66,82.14285714285714,25
55916_marine,29,42,22,10,71,75.86206896551724,34.48275862068966
55917_marine,30,42,22,11,72,73.33333333333333,36.666666666666664
55918_marine,25,35,19,8,60,76,32
55919_marine,26,39,20,9,65,76.92307692307693,34.61538461538461
55920_marine,25,38,20,8,63,80,32
55921_marine,24,38,19,8,62,79.16666666666666,33.33333333333333
55922_marine,22,38,17,6,60,77.27272727272727,27.27272727272727
55923_marine,22,38,17,6,60,77.27272727272727,27.27272727272727
55924_marine,24,38,19,6,62,79.16666666666666,25
55925_marine,24,36,19,6,60,79.16666666666666,25
55926_marine,24,36,19,6,60,79.16666666666666,25
55927_marine,25,36,20,6,61,80,24
55928_marine,24,34,19,6,58,79.16666666666666,25
55929_marine,24,34,19,6,58,79.16666666666666,25
55930_marine,25,34,20,6,59,80,24
55931_marine,25,34,20,6,59,80,24
55932_marine,24,34,19,6,58,79.16666666666666,25
55933_marine,24,34,19,6,58,79.16666666666666,25
55934_marine,23,34,19,5,57,82.6086956521739,21.73913043478261
55935_marine,23,34,19,5,57,82.6086956521739,21.73913043478261
55936_marine,23,34,19,5,57,82.6086956521739,21.73913043478261
55937_marine,22,34,18,5,56,81.81818181818183,22.727272727272727
55938_marine,22,35,18,5,57,81.81818181818183,22.727272727272727
55939_marine,22,35,18,5,57,81.81818181818183,22.727272727272727
55940_marine,21,36,17,5,57,80.95238095238095,23.809523809523807
55941_marine,21,36,17,5,57,80.95238095238095,23.809523809523807
55942_marine,21,36,17,5,57,80.95238095238095,23.809523809523807
55943_marine,21,36,17,5,57,80.95238095238095,23.809523809523807
55944_marine,20,37,16,5,57,80,25
55945_marine,20,37,16,5,57,80,25
55946_marine,20,37,16,5,57,80,25
55947_marine,20,37,16,5,57,80,25
55948_marine,20,37,16,5,57,80,25
55949_marine,20,37,16,5,57,80,25
55950_marine,20,35,16,5,55,80,25
55951_marine,20,35,16,5,55,80,25
55952_marine,20,34,16,5,54,80,25
55953_marine,20,34,16,5,54,80,25
55954_marine,20,34,16,5,54,80,25
55955_marine,20,34,16,5,54,80,25
55956_marine,18,34,14,5,52,77.77777777777779,27.77777777777778
55957_marine,18,34,14,5,52,77.77777777777779,27.77777777777778
55958_marine,18,34,14,5,52,77.77777777777779,27.77777777777778
55959_marine,18,34,14,5,52,77.77777777777779,27.77777777777778
55960_marine,18,33,14,5,51,77.77777777777779,27.77777777777778
55961_marine,20,33,16,6,53,80,30
55962_marine,21,33,17,6,54,80.95238095238095,28.57142857142857
55963_marine,22,33,18,6,55,81.81818181818183,27.27272727272727
55964_marine,22,33,18,6,55,81.81818181818183,27.27272727272727
55965_marine,22,33,18,6,55,81.81818181818183,27.27272727272727
55966_marine,21,33,17,6,54,80.95238095238095,28.57142857142857
55967_marine,21,33,17,6,54,80.95238095238095,28.57142857142857
55968_marine,21,33,17,6,54,80.95238095238095,28.57142857142857
55969_marine,21,33,17,6,54,80.95238095238095,28.57142857142857
55970_marine,21,33,17,6,54,80.95238095238095,28.57142857142857
55971_marine,21,32,17,6,53,80.95238095238095,28.57142857142857
55972_marine,21,32,17,6,53,80.95238095238095,28.57142857142857
55973_marine,21,32,17,6,53,80.95238095238095,28.57142857142857
55974_marine,21,32,17,6,53,80.95238095238095,28.57142857142857
55975_marine,21,32,17,6,53,80.95238095238095,28.57142857142857
55976_marine,21,31,17,6,52,80.95238095238095,28.57142857142857
55977_marine,21,31,17,6,52,80.95238095238095,28.57142857142857
55978_marine,21,31,17,6,52,80.95238095238095,28.57142857142857
55979_marine,21,31,17,6,52,80.95238095238095,28.57142857142857
55980_marine,21,31,17,6,52,80.95238095238095,28.57142857142857
55981_marine,20,31,16,6,51,80,30
55982_marine,20,31,16,6,51,80,30
55983_marine,20,31,16,6,51,80,30
55984_marine,20,31,16,6,51,80,30
55985_marine,20,31,16,6,51,80,30
55986_marine,18,31,14,5,49,77.77777777777779,27.77777777777778
55987_marine,17,31,13,5,48,76.47058823529412,29.411764705882355
55988_marine,17,31,13,5,48,76.47058823529412,29.411764705882355
55989_marine,17,31,13,5,48,76.47058823529412,29.411764705882355
55990_marine,17,31,13,5,48,76.47058823529412,29.411764705882355
55991_marine,17,31,13,5,48,76.47058823529412,29.411764705882355
55992_marine,17,31,13,5,48,76.47058823529412,29.411764705882355
55993_marine,17,31,13,5,48,76.47058823529412,29.411764705882355
55994_marine,17,31,13,5,48,76.47058823529412,29.411764705882355
55995_marine,17,31,13,5,48,76.47058823529412,29.411764705882355
55996_marine,16,31,12,5,47,75,31.25
55997_marine,16,31,12,5,47,75,31.25
55998_marine,17,31,13,5,48,76.47058823529412,29.411764705882355
55999_marine,17,31,13,5,48,76.47058823529412,29.411764705882355
56000_marine,17,31,13,5,48,76.47058823529412,29.411764705882355
56001_marine,17,31,13,5,48,76.47058823529412,29.411764705882355
56002_marine,16,31,12,5,47,75,31.25
56003_marine,16,31,12,5,47,75,31.25
56004_marine,16,31,12,5,47,75,31.25
56005_marine,16,30,12,5,46,75,31.25
56006_marine,16,29,12,5,45,75,31.25
56007_marine,16,29,12,5,45,75,31.25
56008_marine,16,29,12,5,45,75,31.25
56009_marine,17,29,13,5,46,76.47058823529412,29.411764705882355
56010_marine,17,29,13,5,46,76.47058823529412,29.411764705882355
56011_marine,17,29,13,5,46,76.47058823529412,29.411764705882355
56012_marine,16,29,12,4,45,75,25
56013_marine,16,29,12,4,45,75,25
56014_marine,16,29,12,4,45,75,25
56015_marine,16,29,12,4,45,75,25
56016_marine,16,29,12,4,45,75,25
56017_marine,16,28,12,4,44,75,25
56018_marine,16,28,12,4,44,75,25
56019_marine,16,28,12,4,44,75,25
56020_marine,16,28,12,4,44,75,25
56021_marine,16,28,12,4,44,75,25
56022_marine,16,28,12,4,44,75,25
56023_marine,16,28,12,4,44,75,25
56024_marine,16,28,12,4,44,75,25
56025_marine,16,28,12,4,44,75,25
56026_marine,16,28,12,4,44,75,25
56027_marine,16,28,12,4,44,75,25
56028_marine,16,28,12,4,44,75,25
56029_marine,16,28,12,4,44,75,25
56030_marine,16,28,12,4,44,75,25
56031_marine,16,28,12,4,44,75,25
56032_marine,18,28,12,6,46,66.66666666666666,33.33333333333333
56033_marine,19,28,12,7,47,63.1578947368421,36.84210526315789
56034_marine,19,28,12,7,47,63.1578947368421,36.84210526315789
56035_marine,19,28,12,7,47,63.1578947368421,36.84210526315789
56036_marine,16,28,12,4,44,75,25
56037_marine,16,28,12,4,44,75,25
56038_marine,16,28,12,4,44,75,25
56039_marine,16,28,12,4,44,75,25
56040_marine,16,28,12,4,44,75,25
56041_marine,15,28,11,4,43,73.33333333333333,26.666666666666668
56042_marine,15,28,11,4,43,73.33333333333333,26.666666666666668
56043_marine,15,28,11,4,43,73.33333333333333,26.666666666666668
56044_marine,15,28,11,4,43,73.33333333333333,26.666666666666668
56045_marine,15,28,11,4,43,73.33333333333333,26.666666666666668
56046_marine,15,28,11,4,43,73.33333333333333,26.666666666666668
56047_marine,15,28,11,4,43,73.33333333333333,26.666666666666668
56048_marine,15,30,11,4,45,73.33333333333333,26.666666666666668
56049_marine,15,30,11,4,45,73.33333333333333,26.666666666666668
56050_marine,15,31,11,4,46,73.33333333333333,26.666666666666668
56051_marine,15,31,11,4,46,73.33333333333333,26.666666666666668
56052_marine,15,31,11,4,46,73.33333333333333,26.666666666666668
56053_marine,15,31,11,4,46,73.33333333333333,26.666666666666668
56054_marine,16,31,12,4,47,75,25
56055_marine,15,31,11,4,46,73.33333333333333,26.666666666666668
56056_marine,15,32,11,4,47,73.33333333333333,26.666666666666668
56057_marine,15,32,11,4,47,73.33333333333333,26.666666666666668
56058_marine,15,32,11,4,47,73.33333333333333,26.666666666666668
56059_marine,15,32,11,4,47,73.33333333333333,26.666666666666668
56060_marine,15,32,11,4,47,73.33333333333333,26.666666666666668
56061_marine,15,32,11,4,47,73.33333333333333,26.666666666666668
56062_marine,15,32,11,4,47,73.33333333333333,26.666666666666668
56063_marine,15,32,11,4,47,73.33333333333333,26.666666666666668
56064_marine,15,32,11,4,47,73.33333333333333,26.666666666666668
56065_marine,15,32,11,4,47,73.33333333333333,26.666666666666668
56066_marine,15,32,11,4,47,73.33333333333333,26.666666666666668
56067_marine,15,27,11,4,42,73.33333333333333,26.666666666666668
56068_marine,15,27,11,4,42,73.33333333333333,26.666666666666668
56069_marine,15,27,11,4,42,73.33333333333333,26.666666666666668
56070_marine,15,27,11,4,42,73.33333333333333,26.666666666666668
56071_marine,15,26,11,4,41,73.33333333333333,26.666666666666668
56072_marine,15,26,11,4,41,73.33333333333333,26.666666666666668
56073_marine,16,26,11,5,42,68.75,31.25
56074_marine,15,26,11,4,41,73.33333333333333,26.666666666666668
56075_marine,15,26,11,4,41,73.33333333333333,26.666666666666668
56076_marine,15,26,11,4,41,73.33333333333333,26.666666666666668
56077_marine,15,26,11,4,41,73.33333333333333,26.666666666666668
56078_marine,15,26,11,4,41,73.33333333333333,26.666666666666668
56079_marine,15,27,11,4,42,73.33333333333333,26.666666666666668
56080_marine,16,27,11,5,43,68.75,31.25
56081_marine,17,28,11,6,45,64.70588235294117,35.294117647058826
56082_marine,17,28,11,6,45,64.70588235294117,35.294117647058826
56083_marine,18,27,11,7,45,61.111111111111114,38.88888888888889
56084_marine,17,27,11,6,44,64.70588235294117,35.294117647058826
56085_marine,15,27,11,4,42,73.33333333333333,26.666666666666668
56086_marine,15,26,11,4,41,73.33333333333333,26.666666666666668
56087_marine,15,26,11,4,41,73.33333333333333,26.666666666666668
56088_marine,16,26,12,4,42,75,25
56089_marine,16,26,12,4,42,75,25
56090_marine,16,26,12,4,42,75,25
56091_marine,17,26,12,5,43,70.58823529411765,29.411764705882355
56092_marine,19,27,12,7,46,63.1578947368421,36.84210526315789
56093_marine,18,26,12,6,44,66.66666666666666,33.33333333333333
56094_marine,18,26,12,6,44,66.66666666666666,33.33333333333333
56095_marine,16,26,12,4,42,75,25
56096_marine,16,26,12,4,42,75,25
56097_marine,16,26,12,4,42,75,25
56098_marine,16,26,12,4,42,75,25
56099_marine,16,26,12,4,42,75,25
56100_marine,16,26,12,4,42,75,25
56101_marine,17,26,12,5,43,70.58823529411765,29.411764705882355
56102_marine,18,26,12,6,44,66.66666666666666,33.33333333333333
56103_marine,17,26,12,5,43,70.58823529411765,29.411764705882355
56104_marine,16,26,12,4,42,75,25
56105_marine,16,26,12,4,42,75,25
56106_marine,16,26,12,4,42,75,25
56107_marine,16,26,12,4,42,75,25
56108_marine,16,26,12,4,42,75,25
56109_marine,16,26,12,4,42,75,25
56110_marine,16,26,12,4,42,75,25
56111_marine,17,26,13,4,43,76.47058823529412,23.52941176470588
56112_marine,17,26,13,4,43,76.47058823529412,23.52941176470588
56113_marine,17,26,13,4,43,76.47058823529412,23.52941176470588
56114_marine,17,26,13,4,43,76.47058823529412,23.52941176470588
56115_marine,20,26,14,6,46,70,30
56116_marine,20,26,14,6,46,70,30
56117_marine,18,26,14,4,44,77.77777777777779,22.22222222222222
56118_marine,18,26,14,4,44,77.77777777777779,22.22222222222222
56119_marine,18,28,14,4,46,77.77777777777779,22.22222222222222
56120_marine,18,28,14,4,46,77.77777777777779,22.22222222222222
56121_marine,18,28,14,4,46,77.77777777777779,22.22222222222222
56122_marine,18,28,14,4,46,77.77777777777779,22.22222222222222
56123_marine,18,28,14,4,46,77.77777777777779,22.22222222222222
56124_marine,18,29,14,4,47,77.77777777777779,22.22222222222222
56125_marine,18,29,14,4,47,77.77777777777779,22.22222222222222
56126_marine,18,29,14,4,47,77.77777777777779,22.22222222222222
56127_marine,18,29,14,4,47,77.77777777777779,22.22222222222222
56128_marine,17,29,13,4,46,76.47058823529412,23.52941176470588
56129_marine,17,30,13,4,47,76.47058823529412,23.52941176470588
56130_marine,18,30,14,4,48,77.77777777777779,22.22222222222222
56131_marine,18,30,14,4,48,77.77777777777779,22.22222222222222
56132_marine,18,32,14,4,50,77.77777777777779,22.22222222222222
56133_marine,18,33,14,4,51,77.77777777777779,22.22222222222222
56134_marine,18,35,14,4,53,77.77777777777779,22.22222222222222
56135_marine,17,37,13,4,54,76.47058823529412,23.52941176470588
56136_marine,17,37,13,4,54,76.47058823529412,23.52941176470588
56137_marine,18,37,14,4,55,77.77777777777779,22.22222222222222
56138_marine,18,38,14,4,56,77.77777777777779,22.22222222222222
56139_marine,19,39,15,5,58,78.94736842105263,26.31578947368421
56140_marine,20,40,16,5,60,80,25
56141_marine,20,40,16,5,60,80,25
56142_marine,20,40,16,5,60,80,25
56143_marine,20,42,16,5,62,80,25
56144_marine,21,43,17,5,64,80.95238095238095,23.809523809523807
56145_marine,22,43,18,5,65,81.81818181818183,22.727272727272727
56146_marine,22,43,18,5,65,81.81818181818183,22.727272727272727
56147_marine,22,43,18,5,65,81.81818181818183,22.727272727272727
56148_marine,24,43,20,5,67,83.33333333333334,20.833333333333336
56149_marine,24,43,20,5,67,83.33333333333334,20.833333333333336
56150_marine,24,43,20,5,67,83.33333333333334,20.833333333333336
56151_marine,26,43,22,5,69,84.61538461538461,19.230769230769234
56152_marine,26,43,22,5,69,84.61538461538461,19.230769230769234
56153_marine,26,43,22,5,69,84.61538461538461,19.230769230769234
56154_marine,26,42,22,5,68,84.61538461538461,19.230769230769234
56155_marine,26,42,22,5,68,84.61538461538461,19.230769230769234
56156_marine,26,42,22,5,68,84.61538461538461,19.230769230769234
56157_marine,25,41,21,5,66,84,20
56158_marine,24,40,21,4,64,87.5,16.666666666666664
56159_marine,24,40,21,4,64,87.5,16.666666666666664
56160_marine,24,42,21,4,66,87.5,16.666666666666664
56161_marine,23,36,20,4,59,86.95652173913044,17.391304347826086
56162_marine,23,37,20,4,60,86.95652173913044,17.391304347826086
56163_marine,23,37,20,4,60,86.95652173913044,17.391304347826086
56164_marine,23,37,20,4,60,86.95652173913044,17.391304347826086
56165_marine,23,37,20,4,60,86.95652173913044,17.391304347826086
56166_marine,23,37,20,4,60,86.95652173913044,17.391304347826086
56167_marine,23,37,20,4,60,86.95652173913044,17.391304347826086
56168_marine,23,37,20,4,60,86.95652173913044,17.391304347826086
56169_marine,23,37,20,4,60,86.95652173913044,17.391304347826086
56170_marine,23,37,20,4,60,86.95652173913044,17.391304347826086
56171_marine,23,37,20,4,60,86.95652173913044,17.391304347826086
56172_marine,23,37,20,4,60,86.95652173913044,17.391304347826086
56173_marine,23,37,20,4,60,86.95652173913044,17.391304347826086
56174_marine,23,37,20,4,60,86.95652173913044,17.391304347826086
56175_marine,23,37,20,4,60,86.95652173913044,17.391304347826086
56176_marine,23,37,20,4,60,86.95652173913044,17.391304347826086
56177_marine,23,37,20,4,60,86.95652173913044,17.391304347826086
56178_marine,23,37,20,4,60,86.95652173913044,17.391304347826086
56179_marine,22,37,20,3,59,90.9090909090909,13.636363636363635
56180_marine,22,37,20,3,59,90.9090909090909,13.636363636363635
56181_marine,22,37,20,3,59,90.9090909090909,13.636363636363635
56182_marine,22,37,20,3,59,90.9090909090909,13.636363636363635
56183_marine,22,37,20,3,59,90.9090909090909,13.636363636363635
56184_marine,22,37,20,3,59,90.9090909090909,13.636363636363635
56185_marine,22,37,20,3,59,90.9090909090909,13.636363636363635
56186_marine,22,37,20,3,59,90.9090909090909,13.636363636363635
56187_marine,22,36,20,3,58,90.9090909090909,13.636363636363635
56188_marine,22,36,20,3,58,90.9090909090909,13.636363636363635
56189_marine,22,36,20,3,58,90.9090909090909,13.636363636363635
56190_marine,22,36,20,3,58,90.9090909090909,13.636363636363635
56191_marine,22,36,20,3,58,90.9090909090909,13.636363636363635
56192_marine,22,36,20,3,58,90.9090909090909,13.636363636363635
56193_marine,22,36,20,3,58,90.9090909090909,13.636363636363635
56194_marine,22,36,20,3,58,90.9090909090909,13.636363636363635
56195_marine,22,36,20,3,58,90.9090909090909,13.636363636363635
56196_marine,22,36,20,3,58,90.9090909090909,13.636363636363635
56197_marine,23,36,21,3,59,91.30434782608695,13.043478260869565
56198_marine,22,36,20,3,58,90.9090909090909,13.636363636363635
56199_marine,20,36,18,3,56,90,15
56200_marine,20,35,18,3,55,90,15
56201_marine,20,35,18,3,55,90,15
56202_marine,20,35,18,3,55,90,15
56203_marine,20,35,18,3,55,90,15
56204_marine,20,34,18,3,54,90,15
56205_marine,20,34,18,3,54,90,15
56206_marine,20,34,18,3,54,90,15
56207_marine,20,35,18,3,55,90,15
56208_marine,20,35,18,3,55,90,15
56209_marine,20,35,18,3,55,90,15
56210_marine,20,35,18,3,55,90,15
56211_marine,20,35,18,3,55,90,15
56212_marine,20,35,18,3,55,90,15
56213_marine,20,35,18,3,55,90,15
56214_marine,20,35,18,3,55,90,15
56215_marine,20,34,18,3,54,90,15
56216_marine,20,34,18,3,54,90,15
56217_marine,19,34,17,2,53,89.47368421052632,10.526315789473683
56218_marine,19,34,17,2,53,89.47368421052632,10.526315789473683
56219_marine,19,34,17,2,53,89.47368421052632,10.526315789473683
56220_marine,19,34,17,2,53,89.47368421052632,10.526315789473683
56221_marine,19,36,17,2,55,89.47368421052632,10.526315789473683
56222_marine,19,36,17,2,55,89.47368421052632,10.526315789473683
56223_marine,19,36,17,2,55,89.47368421052632,10.526315789473683
56224_marine,19,36,17,2,55,89.47368421052632,10.526315789473683
56225_marine,19,36,17,2,55,89.47368421052632,10.526315789473683
56226_marine,17,36,15,2,53,88.23529411764706,11.76470588235294
56227_marine,17,36,15,2,53,88.23529411764706,11.76470588235294
56228_marine,17,36,15,2,53,88.23529411764706,11.76470588235294
56229_marine,17,35,15,2,52,88.23529411764706,11.76470588235294
56230_marine,17,35,15,2,52,88.23529411764706,11.76470588235294
56231_marine,17,35,15,2,52,88.23529411764706,11.76470588235294
56232_marine,17,35,15,2,52,88.23529411764706,11.76470588235294
56233_marine,17,35,15,2,52,88.23529411764706,11.76470588235294
56234_marine,17,35,15,2,52,88.23529411764706,11.76470588235294
56235_marine,17,35,15,2,52,88.23529411764706,11.76470588235294
56236_marine,18,35,15,3,53,83.33333333333334,16.666666666666664
56237_marine,18,35,15,3,53,83.33333333333334,16.666666666666664
56238_marine,18,35,15,3,53,83.33333333333334,16.666666666666664
56239_marine,18,35,15,3,53,83.33333333333334,16.666666666666664
56240_marine,18,35,15,3,53,83.33333333333334,16.666666666666664
56241_marine,18,35,15,3,53,83.33333333333334,16.666666666666664
56242_marine,18,35,15,3,53,83.33333333333334,16.666666666666664
56243_marine,18,35,15,3,53,83.33333333333334,16.666666666666664
56244_marine,18,35,15,3,53,83.33333333333334,16.666666666666664
56245_marine,18,35,15,3,53,83.33333333333334,16.666666666666664
56246_marine,18,35,15,3,53,83.33333333333334,16.666666666666664
56247_marine,18,35,15,3,53,83.33333333333334,16.666666666666664
56248_marine,18,35,15,3,53,83.33333333333334,16.666666666666664
56249_marine,18,36,15,3,54,83.33333333333334,16.666666666666664
56250_marine,19,36,16,3,55,84.21052631578947,15.789473684210526
56251_marine,19,36,16,3,55,84.21052631578947,15.789473684210526
56252_marine,19,36,16,3,55,84.21052631578947,15.789473684210526
56253_marine,21,36,18,4,57,85.71428571428571,19.047619047619047
56254_marine,21,36,18,4,57,85.71428571428571,19.047619047619047
56255_marine,21,36,18,4,57,85.71428571428571,19.047619047619047
56256_marine,21,36,18,4,57,85.71428571428571,19.047619047619047
56257_marine,21,36,18,4,57,85.71428571428571,19.047619047619047
56258_marine,21,36,18,4,57,85.71428571428571,19.047619047619047
56259_marine,21,36,18,4,57,85.71428571428571,19.047619047619047
56260_marine,21,36,18,4,57,85.71428571428571,19.047619047619047
56261_marine,21,36,18,4,57,85.71428571428571,19.047619047619047
56262_marine,21,36,17,5,57,80.95238095238095,23.809523809523807
56263_marine,21,35,17,5,56,80.95238095238095,23.809523809523807
56264_marine,21,35,17,5,56,80.95238095238095,23.809523809523807
56265_marine,20,33,16,5,53,80,25
56266_marine,20,33,16,5,53,80,25
56267_marine,20,35,16,5,55,80,25
56268_marine,20,34,16,5,54,80,25
56269_marine,21,33,16,6,54,76.19047619047619,28.57142857142857
56270_marine,21,32,16,6,53,76.19047619047619,28.57142857142857
56271_marine,21,32,16,6,53,76.19047619047619,28.57142857142857
56272_marine,22,34,17,6,56,77.27272727272727,27.27272727272727
56273_marine,23,35,18,6,58,78.26086956521739,26.08695652173913
56274_marine,24,35,19,7,59,79.16666666666666,29.166666666666668
56275_marine,24,33,19,7,57,79.16666666666666,29.166666666666668
56276_marine,23,35,18,7,58,78.26086956521739,30.434782608695656
56277_marine,19,32,15,5,51,78.94736842105263,26.31578947368421
56278_marine,20,32,16,6,52,80,30
56279_marine,20,32,16,6,52,80,30
56280_marine,20,35,15,6,55,75,30
56281_marine,19,35,14,5,54,73.68421052631578,26.31578947368421
56282_marine,19,33,14,5,52,73.68421052631578,26.31578947368421
56283_marine,19,33,14,5,52,73.68421052631578,26.31578947368421
56284_marine,21,33,16,5,54,76.19047619047619,23.809523809523807
56285_marine,21,33,16,5,54,76.19047619047619,23.809523809523807
56286_marine,21,33,17,4,54,80.95238095238095,19.047619047619047
56287_marine,21,31,17,4,52,80.95238095238095,19.047619047619047
56288_marine,20,31,16,4,51,80,20
56289_marine,20,31,16,4,51,80,20
56290_marine,20,33,16,4,53,80,20
56291_marine,20,33,16,4,53,80,20
56292_marine,18,33,14,4,51,77.77777777777779,22.22222222222222
56293_marine,18,33,14,4,51,77.77777777777779,22.22222222222222
56294_marine,19,34,15,4,53,78.94736842105263,21.052631578947366
56295_marine,18,34,14,4,52,77.77777777777779,22.22222222222222
56296_marine,18,34,14,4,52,77.77777777777779,22.22222222222222
56297_marine,17,34,13,4,51,76.47058823529412,23.52941176470588
56298_marine,17,34,13,4,51,76.47058823529412,23.52941176470588
56299_marine,17,34,13,4,51,76.47058823529412,23.52941176470588
56300_marine,17,32,13,4,49,76.47058823529412,23.52941176470588
56301_marine,17,32,13,4,49,76.47058823529412,23.52941176470588
56302_marine,17,32,13,4,49,76.47058823529412,23.52941176470588
56303_marine,18,33,14,5,51,77.77777777777779,27.77777777777778
56304_marine,18,33,14,5,51,77.77777777777779,27.77777777777778
56305_marine,18,33,14,5,51,77.77777777777779,27.77777777777778
56306_marine,18,34,14,5,52,77.77777777777779,27.77777777777778
56307_marine,18,34,14,5,52,77.77777777777779,27.77777777777778
56308_marine,18,34,14,5,52,77.77777777777779,27.77777777777778
56309_marine,18,34,14,5,52,77.77777777777779,27.77777777777778
56310_marine,18,34,14,5,52,77.77777777777779,27.77777777777778
56311_marine,18,34,14,5,52,77.77777777777779,27.77777777777778
56312_marine,18,34,14,5,52,77.77777777777779,27.77777777777778
56313_marine,18,34,14,5,52,77.77777777777779,27.77777777777778
56314_marine,18,34,14,5,52,77.77777777777779,27.77777777777778
56315_marine,18,34,14,5,52,77.77777777777779,27.77777777777778
56316_marine,18,34,14,5,52,77.77777777777779,27.77777777777778
56317_marine,18,34,14,5,52,77.77777777777779,27.77777777777778
56318_marine,16,34,12,5,50,75,31.25
56319_marine,16,33,12,5,49,75,31.25
56320_marine,16,33,12,5,49,75,31.25
56321_marine,16,33,12,5,49,75,31.25
56322_marine,16,33,12,5,49,75,31.25
56323_marine,17,32,13,5,49,76.47058823529412,29.411764705882355
56324_marine,18,31,14,5,49,77.77777777777779,27.77777777777778
56325_marine,19,31,15,5,50,78.94736842105263,26.31578947368421
56326_marine,19,31,15,5,50,78.94736842105263,26.31578947368421
56327_marine,20,31,16,5,51,80,25
56328_marine,20,31,16,5,51,80,25
56329_marine,20,31,16,5,51,80,25
56330_marine,20,31,16,5,51,80,25
56331_marine,20,31,16,5,51,80,25
56332_marine,20,31,16,5,51,80,25
56333_marine,20,31,16,5,51,80,25
56334_marine,20,31,16,5,51,80,25
56335_marine,20,31,16,5,51,80,25
56336_marine,20,31,16,5,51,80,25
56337_marine,20,30,16,5,50,80,25
56338_marine,20,30,16,5,50,80,25
56339_marine,20,30,16,5,50,80,25
56340_marine,20,30,16,5,50,80,25
56341_marine,19,30,15,5,49,78.94736842105263,26.31578947368421
56342_marine,19,30,15,5,49,78.94736842105263,26.31578947368421
56343_marine,18,30,14,5,48,77.77777777777779,27.77777777777778
56344_marine,18,30,14,5,48,77.77777777777779,27.77777777777778
56345_marine,18,30,14,5,48,77.77777777777779,27.77777777777778
56346_marine,17,30,13,5,47,76.47058823529412,29.411764705882355
56347_marine,17,30,13,5,47,76.47058823529412,29.411764705882355
56348_marine,17,30,13,5,47,76.47058823529412,29.411764705882355
56349_marine,17,30,13,5,47,76.47058823529412,29.411764705882355
56350_marine,17,30,13,5,47,76.47058823529412,29.411764705882355
56351_marine,17,30,13,5,47,76.47058823529412,29.411764705882355
56352_marine,17,30,13,5,47,76.47058823529412,29.411764705882355
56353_marine,16,30,12,5,46,75,31.25
56354_marine,16,30,12,5,46,75,31.25
56355_marine,16,29,12,5,45,75,31.25
56356_marine,16,28,12,5,44,75,31.25
56357_marine,16,28,12,5,44,75,31.25
56358_marine,15,28,11,5,43,73.33333333333333,33.33333333333333
56359_marine,15,28,11,5,43,73.33333333333333,33.33333333333333
56360_marine,15,28,11,5,43,73.33333333333333,33.33333333333333
56361_marine,15,28,11,5,43,73.33333333333333,33.33333333333333
56362_marine,15,28,11,5,43,73.33333333333333,33.33333333333333
56363_marine,16,28,12,5,44,75,31.25
56364_marine,16,28,12,5,44,75,31.25
56365_marine,15,28,11,4,43,73.33333333333333,26.666666666666668
56366_marine,15,28,11,4,43,73.33333333333333,26.666666666666668
56367_marine,15,28,11,4,43,73.33333333333333,26.666666666666668
56368_marine,15,28,11,4,43,73.33333333333333,26.666666666666668
56369_marine,15,28,11,4,43,73.33333333333333,26.666666666666668
56370_marine,15,28,11,4,43,73.33333333333333,26.666666666666668
56371_marine,15,28,11,4,43,73.33333333333333,26.666666666666668
56372_marine,16,28,12,4,44,75,25
56373_marine,16,28,12,4,44,75,25
56374_marine,16,28,12,4,44,75,25
56375_marine,16,28,12,4,44,75,25
56376_marine,16,28,12,4,44,75,25
56377_marine,16,28,12,4,44,75,25
56378_marine,16,28,12,4,44,75,25
56379_marine,16,28,12,4,44,75,25
56380_marine,16,28,12,4,44,75,25
56381_marine,16,28,12,4,44,75,25
56382_marine,16,28,12,4,44,75,25
56383_marine,16,28,12,4,44,75,25
56384_marine,16,28,12,4,44,75,25
56385_marine,16,28,12,4,44,75,25
56386_marine,16,28,12,4,44,75,25
56387_marine,16,28,12,4,44,75,25
56388_marine,16,28,12,4,44,75,25
56389_marine,16,29,11,5,45,68.75,31.25
56390_marine,16,28,11,5,44,68.75,31.25
56391_marine,16,28,11,5,44,68.75,31.25
56392_marine,17,28,11,6,45,64.70588235294117,35.294117647058826
56393_marine,2,0,1,1,2,50,50
56396_marine,15,28,11,4,43,73.33333333333333,26.666666666666668
56397_marine,15,28,11,4,43,73.33333333333333,26.666666666666668
56398_marine,15,28,11,4,43,73.33333333333333,26.666666666666668
56399_marine,15,28,11,4,43,73.33333333333333,26.666666666666668
56400_marine,15,28,11,4,43,73.33333333333333,26.666666666666668
56401_marine,15,28,11,4,43,73.33333333333333,26.666666666666668
56402_marine,15,28,11,4,43,73.33333333333333,26.666666666666668
56403_marine,15,28,11,4,43,73.33333333333333,26.666666666666668
56404_marine,15,28,11,4,43,73.33333333333333,26.666666666666668
56405_marine,15,28,11,4,43,73.33333333333333,26.666666666666668
56406_marine,15,28,11,4,43,73.33333333333333,26.666666666666668
56407_marine,15,28,11,4,43,73.33333333333333,26.666666666666668
56408_marine,15,28,11,4,43,73.33333333333333,26.666666666666668
56409_marine,15,28,11,4,43,73.33333333333333,26.666666666666668
56410_marine,15,28,11,4,43,73.33333333333333,26.666666666666668
56411_marine,14,28,10,4,42,71.42857142857143,28.57142857142857
56412_marine,14,28,10,4,42,71.42857142857143,28.57142857142857
56413_marine,14,30,10,4,44,71.42857142857143,28.57142857142857
56414_marine,14,30,10,4,44,71.42857142857143,28.57142857142857
56415_marine,14,28,10,4,42,71.42857142857143,28.57142857142857
56416_marine,15,26,11,4,41,73.33333333333333,26.666666666666668
56417_marine,15,26,11,4,41,73.33333333333333,26.666666666666668
56418_marine,15,26,11,4,41,73.33333333333333,26.666666666666668
56419_marine,15,26,11,4,41,73.33333333333333,26.666666666666668
56420_marine,14,26,10,4,40,71.42857142857143,28.57142857142857
56421_marine,14,26,10,4,40,71.42857142857143,28.57142857142857
56422_marine,14,26,10,4,40,71.42857142857143,28.57142857142857
56423_marine,14,26,10,4,40,71.42857142857143,28.57142857142857
56424_marine,14,26,10,4,40,71.42857142857143,28.57142857142857
56425_marine,14,26,10,4,40,71.42857142857143,28.57142857142857
56426_marine,15,27,10,5,42,66.66666666666666,33.33333333333333
56427_marine,15,27,10,5,42,66.66666666666666,33.33333333333333
56428_marine,15,26,10,5,41,66.66666666666666,33.33333333333333
56429_marine,16,26,11,5,42,68.75,31.25
56430_marine,15,26,11,4,41,73.33333333333333,26.666666666666668
56431_marine,16,26,11,5,42,68.75,31.25
56432_marine,17,26,11,6,43,64.70588235294117,35.294117647058826
56433_marine,17,26,11,6,43,64.70588235294117,35.294117647058826
56434_marine,16,26,11,5,42,68.75,31.25
56435_marine,15,26,11,4,41,73.33333333333333,26.666666666666668
56436_marine,15,27,11,4,42,73.33333333333333,26.666666666666668
56437_marine,16,28,11,5,44,68.75,31.25
56438_marine,17,27,11,6,44,64.70588235294117,35.294117647058826
56439_marine,16,27,11,5,43,68.75,31.25
56440_marine,15,27,11,4,42,73.33333333333333,26.666666666666668
56441_marine,16,28,11,5,44,68.75,31.25
56442_marine,17,28,11,6,45,64.70588235294117,35.294117647058826
56445_marine,15,27,11,4,42,73.33333333333333,26.666666666666668
56446_marine,15,27,11,4,42,73.33333333333333,26.666666666666668
56447_marine,15,27,11,4,42,73.33333333333333,26.666666666666668
56448_marine,15,27,11,4,42,73.33333333333333,26.666666666666668
56449_marine,15,27,11,4,42,73.33333333333333,26.666666666666668
56450_marine,15,26,11,4,41,73.33333333333333,26.666666666666668
56451_marine,18,26,11,7,44,61.111111111111114,38.88888888888889
56452_marine,18,26,11,7,44,61.111111111111114,38.88888888888889
56454_marine,15,26,11,4,41,73.33333333333333,26.666666666666668
56455_marine,15,26,11,4,41,73.33333333333333,26.666666666666668
56456_marine,15,26,11,4,41,73.33333333333333,26.666666666666668
56457_marine,15,26,11,4,41,73.33333333333333,26.666666666666668
56458_marine,15,26,11,4,41,73.33333333333333,26.666666666666668
56459_marine,15,26,11,4,41,73.33333333333333,26.666666666666668
56460_marine,15,26,11,4,41,73.33333333333333,26.666666666666668
56461_marine,16,26,11,5,42,68.75,31.25
56462_marine,17,26,11,6,43,64.70588235294117,35.294117647058826
56463_marine,17,26,11,6,43,64.70588235294117,35.294117647058826
56464_marine,15,26,11,4,41,73.33333333333333,26.666666666666668
56465_marine,15,26,11,4,41,73.33333333333333,26.666666666666668
56466_marine,15,26,11,4,41,73.33333333333333,26.666666666666668
56467_marine,15,26,11,4,41,73.33333333333333,26.666666666666668
56468_marine,15,26,11,4,41,73.33333333333333,26.666666666666668
56469_marine,15,26,11,4,41,73.33333333333333,26.666666666666668
56470_marine,15,26,11,4,41,73.33333333333333,26.666666666666668
56471_marine,15,26,11,4,41,73.33333333333333,26.666666666666668
56472_marine,16,26,12,4,42,75,25
56473_marine,16,26,12,4,42,75,25
56474_marine,16,26,12,4,42,75,25
56475_marine,17,26,12,5,43,70.58823529411765,29.411764705882355
56476_marine,18,26,12,6,44,66.66666666666666,33.33333333333333
56477_marine,18,26,12,6,44,66.66666666666666,33.33333333333333
56478_marine,17,27,12,5,44,70.58823529411765,29.411764705882355
56479_marine,16,27,12,4,43,75,25
56480_marine,17,27,12,5,44,70.58823529411765,29.411764705882355
56481_marine,18,27,12,6,45,66.66666666666666,33.33333333333333
56482_marine,17,27,12,5,44,70.58823529411765,29.411764705882355
56483_marine,17,28,12,5,45,70.58823529411765,29.411764705882355
56484_marine,17,27,12,5,44,70.58823529411765,29.411764705882355
56485_marine,16,26,12,4,42,75,25
56486_marine,16,26,12,4,42,75,25
56487_marine,16,26,12,4,42,75,25
56488_marine,17,27,13,4,44,76.47058823529412,23.52941176470588
56489_marine,18,27,14,4,45,77.77777777777779,22.22222222222222
56490_marine,18,27,14,4,45,77.77777777777779,22.22222222222222
56491_marine,18,27,14,4,45,77.77777777777779,22.22222222222222
56492_marine,18,27,14,4,45,77.77777777777779,22.22222222222222
56493_marine,18,27,14,4,45,77.77777777777779,22.22222222222222
56494_marine,17,28,13,4,45,76.47058823529412,23.52941176470588
56495_marine,17,29,13,4,46,76.47058823529412,23.52941176470588
56496_marine,17,30,13,4,47,76.47058823529412,23.52941176470588
56497_marine,17,31,13,4,48,76.47058823529412,23.52941176470588
56498_marine,17,31,13,4,48,76.47058823529412,23.52941176470588
56499_marine,17,31,13,4,48,76.47058823529412,23.52941176470588
56500_marine,17,32,13,4,49,76.47058823529412,23.52941176470588
56501_marine,17,34,13,4,51,76.47058823529412,23.52941176470588
56502_marine,17,37,13,4,54,76.47058823529412,23.52941176470588
56503_marine,21,41,14,7,62,66.66666666666666,33.33333333333333
56504_marine,21,42,14,7,63,66.66666666666666,33.33333333333333
56505_marine,19,40,15,5,59,78.94736842105263,26.31578947368421
56506_marine,21,40,17,5,61,80.95238095238095,23.809523809523807
56507_marine,21,42,17,5,63,80.95238095238095,23.809523809523807
56508_marine,21,42,17,5,63,80.95238095238095,23.809523809523807
56509_marine,21,42,17,5,63,80.95238095238095,23.809523809523807
56510_marine,22,42,18,5,64,81.81818181818183,22.727272727272727
56511_marine,24,42,20,5,66,83.33333333333334,20.833333333333336
56512_marine,24,42,20,5,66,83.33333333333334,20.833333333333336
56513_marine,24,42,20,5,66,83.33333333333334,20.833333333333336
56514_marine,24,42,20,5,66,83.33333333333334,20.833333333333336
56515_marine,24,42,20,5,66,83.33333333333334,20.833333333333336
56516_marine,24,40,20,5,64,83.33333333333334,20.833333333333336
56517_marine,26,40,22,5,66,84.61538461538461,19.230769230769234
56518_marine,25,40,21,5,65,84,20
56519_marine,25,40,21,5,65,84,20
56520_marine,24,39,21,4,63,87.5,16.666666666666664
56521_marine,21,38,17,5,59,80.95238095238095,23.809523809523807
56522_marine,21,35,17,5,56,80.95238095238095,23.809523809523807
56523_marine,20,35,17,4,55,85,20
56524_marine,20,35,17,4,55,85,20
56525_marine,20,36,17,4,56,85,20
56526_marine,20,36,17,4,56,85,20
56527_marine,20,36,17,4,56,85,20
56528_marine,20,36,17,4,56,85,20
56529_marine,20,36,17,4,56,85,20
56530_marine,20,36,17,4,56,85,20
56531_marine,20,36,17,4,56,85,20
56532_marine,20,36,17,4,56,85,20
56533_marine,20,36,17,4,56,85,20
56534_marine,20,36,17,4,56,85,20
56535_marine,20,36,17,4,56,85,20
56536_marine,20,36,17,4,56,85,20
56537_marine,20,36,17,4,56,85,20
56538_marine,20,36,17,4,56,85,20
56539_marine,20,36,17,4,56,85,20
56540_marine,20,36,17,4,56,85,20
56541_marine,20,36,17,4,56,85,20
56542_marine,20,36,17,4,56,85,20
56543_marine,20,36,17,4,56,85,20
56544_marine,20,36,17,4,56,85,20
56545_marine,20,35,17,4,55,85,20
56546_marine,20,35,17,4,55,85,20
56547_marine,20,35,17,4,55,85,20
56548_marine,20,35,17,4,55,85,20
56549_marine,20,35,17,4,55,85,20
56550_marine,20,35,17,4,55,85,20
56551_marine,20,35,17,4,55,85,20
56552_marine,20,35,17,4,55,85,20
56553_marine,20,35,17,4,55,85,20
56554_marine,20,35,17,4,55,85,20
56555_marine,20,35,17,4,55,85,20
56556_marine,21,35,18,4,56,85.71428571428571,19.047619047619047
56557_marine,21,34,18,4,55,85.71428571428571,19.047619047619047
56558_marine,20,33,17,4,53,85,20
56559_marine,19,34,16,4,53,84.21052631578947,21.052631578947366
56560_marine,19,34,16,4,53,84.21052631578947,21.052631578947366
56561_marine,19,34,16,4,53,84.21052631578947,21.052631578947366
56562_marine,19,34,16,4,53,84.21052631578947,21.052631578947366
56563_marine,19,34,16,4,53,84.21052631578947,21.052631578947366
56564_marine,19,34,16,4,53,84.21052631578947,21.052631578947366
56565_marine,19,34,16,4,53,84.21052631578947,21.052631578947366
56566_marine,19,33,16,4,52,84.21052631578947,21.052631578947366
56567_marine,19,33,16,4,52,84.21052631578947,21.052631578947366
56568_marine,19,34,16,4,53,84.21052631578947,21.052631578947366
56569_marine,19,34,16,4,53,84.21052631578947,21.052631578947366
56570_marine,19,34,16,4,53,84.21052631578947,21.052631578947366
56571_marine,19,34,16,4,53,84.21052631578947,21.052631578947366
56572_marine,19,34,16,4,53,84.21052631578947,21.052631578947366
56573_marine,18,34,15,3,52,83.33333333333334,16.666666666666664
56574_marine,18,33,15,3,51,83.33333333333334,16.666666666666664
56575_marine,18,33,15,3,51,83.33333333333334,16.666666666666664
56576_marine,18,33,15,3,51,83.33333333333334,16.666666666666664
56577_marine,18,33,15,3,51,83.33333333333334,16.666666666666664
56578_marine,18,33,15,3,51,83.33333333333334,16.666666666666664
56579_marine,18,33,15,3,51,83.33333333333334,16.666666666666664
56580_marine,18,33,15,3,51,83.33333333333334,16.666666666666664
56581_marine,18,33,15,3,51,83.33333333333334,16.666666666666664
56582_marine,18,33,15,3,51,83.33333333333334,16.666666666666664
56583_marine,18,33,15,3,51,83.33333333333334,16.666666666666664
56584_marine,18,33,15,3,51,83.33333333333334,16.666666666666664
56585_marine,18,33,15,3,51,83.33333333333334,16.666666666666664
56586_marine,18,33,15,3,51,83.33333333333334,16.666666666666664
56587_marine,18,33,15,3,51,83.33333333333334,16.666666666666664
56588_marine,18,33,15,3,51,83.33333333333334,16.666666666666664
56589_marine,18,33,15,3,51,83.33333333333334,16.666666666666664
56590_marine,18,33,15,3,51,83.33333333333334,16.666666666666664
56591_marine,18,33,15,3,51,83.33333333333334,16.666666666666664
56592_marine,18,33,15,3,51,83.33333333333334,16.666666666666664
56593_marine,18,33,15,3,51,83.33333333333334,16.666666666666664
56594_marine,18,33,15,3,51,83.33333333333334,16.666666666666664
56595_marine,18,33,15,3,51,83.33333333333334,16.666666666666664
56596_marine,18,33,15,3,51,83.33333333333334,16.666666666666664
56597_marine,18,33,15,3,51,83.33333333333334,16.666666666666664
56598_marine,18,33,15,3,51,83.33333333333334,16.666666666666664
56599_marine,18,33,15,3,51,83.33333333333334,16.666666666666664
56600_marine,17,33,14,3,50,82.35294117647058,17.647058823529413
56601_marine,17,33,14,3,50,82.35294117647058,17.647058823529413
56602_marine,17,33,14,3,50,82.35294117647058,17.647058823529413
56603_marine,17,33,14,3,50,82.35294117647058,17.647058823529413
56604_marine,17,33,14,3,50,82.35294117647058,17.647058823529413
56605_marine,17,33,14,3,50,82.35294117647058,17.647058823529413
56606_marine,17,33,14,3,50,82.35294117647058,17.647058823529413
56607_marine,17,33,14,3,50,82.35294117647058,17.647058823529413
56608_marine,15,33,12,3,48,80,20
56609_marine,15,33,12,3,48,80,20
56610_marine,16,33,12,4,49,75,25
56611_marine,16,33,12,4,49,75,25
56612_marine,16,34,12,4,50,75,25
56613_marine,16,34,12,4,50,75,25
56614_marine,16,34,12,4,50,75,25
56615_marine,16,33,12,4,49,75,25
56616_marine,16,35,12,4,51,75,25
56617_marine,19,33,15,4,52,78.94736842105263,21.052631578947366
56618_marine,19,33,15,4,52,78.94736842105263,21.052631578947366
56619_marine,20,33,16,5,53,80,25
56620_marine,20,33,16,5,53,80,25
56621_marine,19,33,15,5,52,78.94736842105263,26.31578947368421
56622_marine,19,33,15,5,52,78.94736842105263,26.31578947368421
56623_marine,19,33,15,5,52,78.94736842105263,26.31578947368421
56624_marine,19,32,15,5,51,78.94736842105263,26.31578947368421
56625_marine,19,31,15,5,50,78.94736842105263,26.31578947368421
56626_marine,19,33,15,5,52,78.94736842105263,26.31578947368421
56627_marine,19,33,15,5,52,78.94736842105263,26.31578947368421
56628_marine,19,33,15,5,52,78.94736842105263,26.31578947368421
56629_marine,19,32,15,5,51,78.94736842105263,26.31578947368421
56630_marine,19,32,15,5,51,78.94736842105263,26.31578947368421
56631_marine,20,34,16,5,54,80,25
56632_marine,21,35,17,5,56,80.95238095238095,23.809523809523807
56633_marine,20,35,16,4,55,80,20
56634_marine,18,33,15,3,51,83.33333333333334,16.666666666666664
56635_marine,18,32,15,4,50,83.33333333333334,22.22222222222222
56636_marine,18,32,15,4,50,83.33333333333334,22.22222222222222
56637_marine,17,32,14,3,49,82.35294117647058,17.647058823529413
56638_marine,17,32,14,3,49,82.35294117647058,17.647058823529413
56639_marine,18,32,14,4,50,77.77777777777779,22.22222222222222
56640_marine,18,32,14,4,50,77.77777777777779,22.22222222222222
56641_marine,18,32,14,4,50,77.77777777777779,22.22222222222222
56642_marine,18,32,14,4,50,77.77777777777779,22.22222222222222
56643_marine,20,32,16,4,52,80,20
56644_marine,20,33,16,4,53,80,20
56645_marine,20,33,16,4,53,80,20
56646_marine,20,31,16,4,51,80,20
56647_marine,19,31,15,4,50,78.94736842105263,21.052631578947366
56648_marine,19,31,15,4,50,78.94736842105263,21.052631578947366
56649_marine,19,29,15,4,48,78.94736842105263,21.052631578947366
56650_marine,18,29,14,4,47,77.77777777777779,22.22222222222222
56651_marine,18,29,14,4,47,77.77777777777779,22.22222222222222
56652_marine,16,28,12,4,44,75,25
56653_marine,16,28,12,4,44,75,25
56654_marine,16,28,12,4,44,75,25
56655_marine,16,28,12,4,44,75,25
56656_marine,16,29,12,4,45,75,25
56657_marine,16,31,12,4,47,75,25
56658_marine,17,31,13,4,48,76.47058823529412,23.52941176470588
56659_marine,17,31,13,4,48,76.47058823529412,23.52941176470588
56660_marine,17,31,13,4,48,76.47058823529412,23.52941176470588
56661_marine,17,32,13,4,49,76.47058823529412,23.52941176470588
56662_marine,17,32,13,4,49,76.47058823529412,23.52941176470588
56663_marine,17,32,13,4,49,76.47058823529412,23.52941176470588
56664_marine,17,32,13,4,49,76.47058823529412,23.52941176470588
56665_marine,17,32,13,4,49,76.47058823529412,23.52941176470588
56666_marine,17,32,13,4,49,76.47058823529412,23.52941176470588
56667_marine,17,33,13,4,50,76.47058823529412,23.52941176470588
56668_marine,17,33,13,4,50,76.47058823529412,23.52941176470588
56669_marine,17,33,13,4,50,76.47058823529412,23.52941176470588
56670_marine,17,33,13,4,50,76.47058823529412,23.52941176470588
56671_marine,14,33,11,3,47,78.57142857142857,21.428571428571427
56672_marine,14,33,11,3,47,78.57142857142857,21.428571428571427
56673_marine,14,33,11,3,47,78.57142857142857,21.428571428571427
56674_marine,14,33,11,3,47,78.57142857142857,21.428571428571427
56675_marine,15,33,12,4,48,80,26.666666666666668
56676_marine,15,33,12,4,48,80,26.666666666666668
56677_marine,15,33,12,4,48,80,26.666666666666668
56678_marine,15,32,12,4,47,80,26.666666666666668
56679_marine,15,32,12,4,47,80,26.666666666666668
56680_marine,15,32,12,4,47,80,26.666666666666668
56681_marine,15,32,12,4,47,80,26.666666666666668
56682_marine,15,32,12,4,47,80,26.666666666666668
56683_marine,16,31,13,4,47,81.25,25
56684_marine,16,31,13,4,47,81.25,25
56685_marine,16,31,13,4,47,81.25,25
56686_marine,16,31,13,4,47,81.25,25
56687_marine,16,31,13,4,47,81.25,25
56688_marine,18,31,15,4,49,83.33333333333334,22.22222222222222
56689_marine,19,31,16,4,50,84.21052631578947,21.052631578947366
56690_marine,19,31,16,4,50,84.21052631578947,21.052631578947366
56691_marine,19,31,16,4,50,84.21052631578947,21.052631578947366
56692_marine,19,31,16,4,50,84.21052631578947,21.052631578947366
56693_marine,19,31,16,4,50,84.21052631578947,21.052631578947366
56694_marine,19,30,16,4,49,84.21052631578947,21.052631578947366
56695_marine,19,30,16,4,49,84.21052631578947,21.052631578947366
56696_marine,19,30,16,4,49,84.21052631578947,21.052631578947366
56697_marine,19,30,16,4,49,84.21052631578947,21.052631578947366
56698_marine,19,30,16,4,49,84.21052631578947,21.052631578947366
56699_marine,19,30,16,4,49,84.21052631578947,21.052631578947366
56700_marine,18,29,15,4,47,83.33333333333334,22.22222222222222
56701_marine,17,29,14,4,46,82.35294117647058,23.52941176470588
56702_marine,17,28,14,4,45,82.35294117647058,23.52941176470588
56703_marine,17,28,14,4,45,82.35294117647058,23.52941176470588
56704_marine,17,28,14,4,45,82.35294117647058,23.52941176470588
56705_marine,16,28,13,4,44,81.25,25
56706_marine,16,28,13,4,44,81.25,25
56707_marine,16,28,13,4,44,81.25,25
56708_marine,15,28,12,4,43,80,26.666666666666668
56709_marine,15,28,12,4,43,80,26.666666666666668
56710_marine,15,28,12,4,43,80,26.666666666666668
56711_marine,15,28,12,4,43,80,26.666666666666668
56712_marine,14,28,11,3,42,78.57142857142857,21.428571428571427
56713_marine,14,28,11,3,42,78.57142857142857,21.428571428571427
56714_marine,14,28,11,3,42,78.57142857142857,21.428571428571427
56715_marine,13,28,10,3,41,76.92307692307693,23.076923076923077
56716_marine,13,28,10,3,41,76.92307692307693,23.076923076923077
56717_marine,13,28,10,3,41,76.92307692307693,23.076923076923077
56718_marine,13,28,10,3,41,76.92307692307693,23.076923076923077
56719_marine,13,28,10,3,41,76.92307692307693,23.076923076923077
56720_marine,13,28,10,3,41,76.92307692307693,23.076923076923077
56721_marine,13,28,10,3,41,76.92307692307693,23.076923076923077
56722_marine,13,28,10,3,41,76.92307692307693,23.076923076923077
56723_marine,13,28,10,3,41,76.92307692307693,23.076923076923077
56724_marine,13,28,10,3,41,76.92307692307693,23.076923076923077
56725_marine,13,28,10,3,41,76.92307692307693,23.076923076923077
56726_marine,13,28,10,3,41,76.92307692307693,23.076923076923077
56727_marine,13,28,10,3,41,76.92307692307693,23.076923076923077
56728_marine,13,28,10,3,41,76.92307692307693,23.076923076923077
56729_marine,13,28,10,3,41,76.92307692307693,23.076923076923077
56730_marine,13,28,10,3,41,76.92307692307693,23.076923076923077
56731_marine,13,28,10,3,41,76.92307692307693,23.076923076923077
56732_marine,13,28,10,3,41,76.92307692307693,23.076923076923077
56733_marine,13,28,10,3,41,76.92307692307693,23.076923076923077
56734_marine,13,30,10,3,43,76.92307692307693,23.076923076923077
56735_marine,13,30,10,3,43,76.92307692307693,23.076923076923077
56736_marine,13,28,10,3,41,76.92307692307693,23.076923076923077
56737_marine,13,28,10,3,41,76.92307692307693,23.076923076923077
56738_marine,13,28,10,3,41,76.92307692307693,23.076923076923077
56739_marine,13,28,10,3,41,76.92307692307693,23.076923076923077
56740_marine,13,28,10,3,41,76.92307692307693,23.076923076923077
56741_marine,13,28,10,3,41,76.92307692307693,23.076923076923077
56742_marine,13,28,10,3,41,76.92307692307693,23.076923076923077
56743_marine,13,28,10,3,41,76.92307692307693,23.076923076923077
56744_marine,13,28,10,3,41,76.92307692307693,23.076923076923077
56745_marine,14,28,10,4,42,71.42857142857143,28.57142857142857
56746_marine,14,28,10,4,42,71.42857142857143,28.57142857142857
56747_marine,14,28,10,4,42,71.42857142857143,28.57142857142857
56748_marine,14,28,10,4,42,71.42857142857143,28.57142857142857
56749_marine,14,29,10,4,43,71.42857142857143,28.57142857142857
56750_marine,15,28,11,4,43,73.33333333333333,26.666666666666668
56751_marine,15,28,11,4,43,73.33333333333333,26.666666666666668
56757_marine,12,28,8,4,40,66.66666666666666,33.33333333333333
56758_marine,15,28,10,5,43,66.66666666666666,33.33333333333333
56759_marine,15,26,10,5,41,66.66666666666666,33.33333333333333
56760_marine,15,26,10,5,41,66.66666666666666,33.33333333333333
56761_marine,15,26,10,5,41,66.66666666666666,33.33333333333333
56762_marine,15,26,10,5,41,66.66666666666666,33.33333333333333
56763_marine,16,26,10,6,42,62.5,37.5
56764_marine,17,26,10,7,43,58.82352941176471,41.17647058823529
56765_marine,17,26,10,7,43,58.82352941176471,41.17647058823529
56766_marine,17,26,10,7,43,58.82352941176471,41.17647058823529
56767_marine,16,26,10,6,42,62.5,37.5
56768_marine,14,26,10,4,40,71.42857142857143,28.57142857142857
56769_marine,15,26,10,5,41,66.66666666666666,33.33333333333333
56770_marine,17,26,11,6,43,64.70588235294117,35.294117647058826
56771_marine,14,26,10,4,40,71.42857142857143,28.57142857142857
56772_marine,14,26,10,4,40,71.42857142857143,28.57142857142857
56773_marine,14,26,10,4,40,71.42857142857143,28.57142857142857
56774_marine,14,26,10,4,40,71.42857142857143,28.57142857142857
56775_marine,14,26,10,4,40,71.42857142857143,28.57142857142857
56776_marine,14,26,10,4,40,71.42857142857143,28.57142857142857
56777_marine,14,26,10,4,40,71.42857142857143,28.57142857142857
56778_marine,14,26,10,4,40,71.42857142857143,28.57142857142857
56779_marine,14,26,10,4,40,71.42857142857143,28.57142857142857
56780_marine,14,26,10,4,40,71.42857142857143,28.57142857142857
56781_marine,14,26,10,4,40,71.42857142857143,28.57142857142857
56782_marine,14,26,10,4,40,71.42857142857143,28.57142857142857
56783_marine,14,26,10,4,40,71.42857142857143,28.57142857142857
56784_marine,14,26,10,4,40,71.42857142857143,28.57142857142857
56785_marine,14,26,10,4,40,71.42857142857143,28.57142857142857
56786_marine,14,26,10,4,40,71.42857142857143,28.57142857142857
56787_marine,15,27,10,5,42,66.66666666666666,33.33333333333333
56814_marine,1,0,1,0,1,100,0
56815_marine,1,0,1,0,1,100,0
56816_marine,1,0,1,0,1,100,0
56817_marine,1,0,1,0,1,100,0
56818_marine,1,0,1,0,1,100,0
56819_marine,13,26,9,4,39,69.23076923076923,30.76923076923077
56820_marine,1,0,1,0,1,100,0
56821_marine,1,0,1,0,1,100,0
56822_marine,13,26,9,4,39,69.23076923076923,30.76923076923077
56828_marine,15,26,11,4,41,73.33333333333333,26.666666666666668
56829_marine,15,26,11,4,41,73.33333333333333,26.666666666666668
56830_marine,15,26,11,4,41,73.33333333333333,26.666666666666668
56843_marine,15,27,10,5,42,66.66666666666666,33.33333333333333
56844_marine,16,26,12,4,42,75,25
56845_marine,16,26,12,4,42,75,25
56846_marine,16,26,12,4,42,75,25
56847_marine,17,26,12,5,43,70.58823529411765,29.411764705882355
56848_marine,18,26,13,5,44,72.22222222222221,27.77777777777778
56849_marine,19,26,14,5,45,73.68421052631578,26.31578947368421
56850_marine,17,26,13,4,43,76.47058823529412,23.52941176470588
56851_marine,17,26,13,4,43,76.47058823529412,23.52941176470588
56852_marine,16,27,12,4,43,75,25
56853_marine,16,27,12,4,43,75,25
56854_marine,16,27,12,4,43,75,25
56855_marine,17,27,13,4,44,76.47058823529412,23.52941176470588
56856_marine,17,27,13,4,44,76.47058823529412,23.52941176470588
56857_marine,17,28,13,4,45,76.47058823529412,23.52941176470588
56858_marine,17,29,13,4,46,76.47058823529412,23.52941176470588
56859_marine,17,30,13,4,47,76.47058823529412,23.52941176470588
56860_marine,17,30,13,4,47,76.47058823529412,23.52941176470588
56861_marine,17,31,13,4,48,76.47058823529412,23.52941176470588
56862_marine,17,31,13,4,48,76.47058823529412,23.52941176470588
56863_marine,17,31,13,4,48,76.47058823529412,23.52941176470588
56864_marine,17,32,13,4,49,76.47058823529412,23.52941176470588
56865_marine,20,36,13,7,56,65,35
56866_marine,17,35,13,4,52,76.47058823529412,23.52941176470588
56867_marine,18,36,14,4,54,77.77777777777779,22.22222222222222
56868_marine,19,37,15,4,56,78.94736842105263,21.052631578947366
56869_marine,19,37,15,4,56,78.94736842105263,21.052631578947366
56870_marine,20,39,16,4,59,80,20
56871_marine,21,39,17,5,60,80.95238095238095,23.809523809523807
56872_marine,23,39,19,5,62,82.6086956521739,21.73913043478261
56873_marine,23,38,19,5,61,82.6086956521739,21.73913043478261
56874_marine,23,39,19,5,62,82.6086956521739,21.73913043478261
56875_marine,23,39,19,5,62,82.6086956521739,21.73913043478261
56876_marine,23,37,19,5,60,82.6086956521739,21.73913043478261
56877_marine,23,37,19,5,60,82.6086956521739,21.73913043478261
56878_marine,22,37,18,5,59,81.81818181818183,22.727272727272727
56879_marine,22,38,18,5,60,81.81818181818183,22.727272727272727
56880_marine,22,37,18,5,59,81.81818181818183,22.727272727272727
56881_marine,21,32,17,5,53,80.95238095238095,23.809523809523807
56882_marine,21,32,17,5,53,80.95238095238095,23.809523809523807
56883_marine,21,32,17,5,53,80.95238095238095,23.809523809523807
56884_marine,20,32,17,4,52,85,20
56885_marine,20,32,17,4,52,85,20
56886_marine,20,32,17,4,52,85,20
56887_marine,20,32,17,4,52,85,20
56888_marine,20,32,17,4,52,85,20
56889_marine,20,33,17,4,53,85,20
56890_marine,20,33,17,4,53,85,20
56891_marine,20,33,17,4,53,85,20
56892_marine,20,34,17,4,54,85,20
56893_marine,20,34,17,4,54,85,20
56894_marine,20,34,17,4,54,85,20
56895_marine,20,34,17,4,54,85,20
56896_marine,20,34,17,4,54,85,20
56897_marine,20,34,17,4,54,85,20
56898_marine,20,34,17,4,54,85,20
56899_marine,20,34,17,4,54,85,20
56900_marine,20,34,17,4,54,85,20
56901_marine,20,34,17,4,54,85,20
56902_marine,20,33,17,4,53,85,20
56903_marine,20,33,17,4,53,85,20
56904_marine,20,33,17,4,53,85,20
56905_marine,19,33,17,3,52,89.47368421052632,15.789473684210526
56906_marine,19,33,17,3,52,89.47368421052632,15.789473684210526
56907_marine,19,32,17,3,51,89.47368421052632,15.789473684210526
56908_marine,19,32,17,3,51,89.47368421052632,15.789473684210526
56909_marine,19,32,17,3,51,89.47368421052632,15.789473684210526
56910_marine,19,32,17,3,51,89.47368421052632,15.789473684210526
56911_marine,19,32,17,3,51,89.47368421052632,15.789473684210526
56912_marine,19,32,17,3,51,89.47368421052632,15.789473684210526
56913_marine,19,32,17,3,51,89.47368421052632,15.789473684210526
56914_marine,19,32,17,3,51,89.47368421052632,15.789473684210526
56915_marine,18,31,16,3,49,88.88888888888889,16.666666666666664
56916_marine,18,30,16,3,48,88.88888888888889,16.666666666666664
56917_marine,18,30,16,3,48,88.88888888888889,16.666666666666664
56918_marine,18,30,16,3,48,88.88888888888889,16.666666666666664
56919_marine,17,30,15,3,47,88.23529411764706,17.647058823529413
56920_marine,17,30,15,3,47,88.23529411764706,17.647058823529413
56921_marine,17,30,15,3,47,88.23529411764706,17.647058823529413
56922_marine,17,30,15,3,47,88.23529411764706,17.647058823529413
56923_marine,17,29,15,3,46,88.23529411764706,17.647058823529413
56924_marine,17,29,15,3,46,88.23529411764706,17.647058823529413
56925_marine,17,29,15,3,46,88.23529411764706,17.647058823529413
56926_marine,17,29,15,3,46,88.23529411764706,17.647058823529413
56927_marine,17,29,15,3,46,88.23529411764706,17.647058823529413
56928_marine,16,32,14,2,48,87.5,12.5
56929_marine,16,32,14,2,48,87.5,12.5
56930_marine,16,32,14,2,48,87.5,12.5
56931_marine,16,32,14,2,48,87.5,12.5
56932_marine,16,32,14,2,48,87.5,12.5
56933_marine,16,32,14,2,48,87.5,12.5
56934_marine,16,32,14,2,48,87.5,12.5
56935_marine,16,32,14,2,48,87.5,12.5
56936_marine,16,32,14,2,48,87.5,12.5
56937_marine,16,32,14,2,48,87.5,12.5
56938_marine,16,32,14,2,48,87.5,12.5
56939_marine,16,32,14,2,48,87.5,12.5
56940_marine,16,32,14,2,48,87.5,12.5
56941_marine,16,32,14,2,48,87.5,12.5
56942_marine,16,32,14,2,48,87.5,12.5
56943_marine,16,32,14,2,48,87.5,12.5
56944_marine,16,32,14,2,48,87.5,12.5
56945_marine,16,32,13,3,48,81.25,18.75
56946_marine,16,32,13,3,48,81.25,18.75
56947_marine,15,32,12,3,47,80,20
56948_marine,15,32,12,3,47,80,20
56949_marine,13,32,10,3,45,76.92307692307693,23.076923076923077
56950_marine,14,32,11,3,46,78.57142857142857,21.428571428571427
56951_marine,14,32,11,3,46,78.57142857142857,21.428571428571427
56952_marine,14,32,11,3,46,78.57142857142857,21.428571428571427
56953_marine,14,32,11,3,46,78.57142857142857,21.428571428571427
56954_marine,14,32,11,3,46,78.57142857142857,21.428571428571427
56955_marine,15,32,11,4,47,73.33333333333333,26.666666666666668
56956_marine,15,32,11,4,47,73.33333333333333,26.666666666666668
56957_marine,15,32,11,4,47,73.33333333333333,26.666666666666668
56958_marine,15,32,11,4,47,73.33333333333333,26.666666666666668
56959_marine,15,32,11,4,47,73.33333333333333,26.666666666666668
56960_marine,15,32,11,4,47,73.33333333333333,26.666666666666668
56961_marine,15,32,11,4,47,73.33333333333333,26.666666666666668
56962_marine,15,32,11,4,47,73.33333333333333,26.666666666666668
56963_marine,15,32,11,4,47,73.33333333333333,26.666666666666668
56964_marine,16,32,12,4,48,75,25
56965_marine,16,32,12,4,48,75,25
56966_marine,16,32,12,4,48,75,25
56967_marine,16,32,12,4,48,75,25
56968_marine,16,31,12,4,47,75,25
56969_marine,16,31,12,4,47,75,25
56970_marine,18,33,12,6,51,66.66666666666666,33.33333333333333
56971_marine,16,29,12,4,45,75,25
56972_marine,16,29,12,4,45,75,25
56973_marine,16,30,12,4,46,75,25
56974_marine,16,30,12,4,46,75,25
56975_marine,16,30,12,4,46,75,25
56976_marine,16,30,12,4,46,75,25
56977_marine,16,30,12,4,46,75,25
56978_marine,15,29,11,4,44,73.33333333333333,26.666666666666668
56979_marine,15,29,11,4,44,73.33333333333333,26.666666666666668
56980_marine,15,29,11,4,44,73.33333333333333,26.666666666666668
56981_marine,15,29,11,4,44,73.33333333333333,26.666666666666668
56982_marine,15,31,11,4,46,73.33333333333333,26.666666666666668
56983_marine,15,31,11,4,46,73.33333333333333,26.666666666666668
56984_marine,15,31,11,4,46,73.33333333333333,26.666666666666668
56985_marine,14,31,11,3,45,78.57142857142857,21.428571428571427
56986_marine,14,31,11,3,45,78.57142857142857,21.428571428571427
56987_marine,14,30,11,3,44,78.57142857142857,21.428571428571427
56988_marine,15,30,11,4,45,73.33333333333333,26.666666666666668
56989_marine,15,30,11,4,45,73.33333333333333,26.666666666666668
56990_marine,15,30,11,4,45,73.33333333333333,26.666666666666668
56991_marine,14,30,11,3,44,78.57142857142857,21.428571428571427
56992_marine,15,30,12,3,45,80,20
56993_marine,15,31,12,3,46,80,20
56994_marine,15,31,12,3,46,80,20
56995_marine,17,30,14,3,47,82.35294117647058,17.647058823529413
56996_marine,17,30,14,3,47,82.35294117647058,17.647058823529413
56997_marine,17,30,14,3,47,82.35294117647058,17.647058823529413
56998_marine,18,30,14,4,48,77.77777777777779,22.22222222222222
56999_marine,18,30,14,4,48,77.77777777777779,22.22222222222222
57000_marine,18,30,14,4,48,77.77777777777779,22.22222222222222
57001_marine,17,30,13,4,47,76.47058823529412,23.52941176470588
57002_marine,16,29,12,4,45,75,25
57003_marine,18,29,14,4,47,77.77777777777779,22.22222222222222
57004_marine,19,29,15,4,48,78.94736842105263,21.052631578947366
57005_marine,19,29,15,4,48,78.94736842105263,21.052631578947366
57006_marine,18,27,14,4,45,77.77777777777779,22.22222222222222
57007_marine,18,28,14,4,46,77.77777777777779,22.22222222222222
57008_marine,17,28,13,4,45,76.47058823529412,23.52941176470588
57009_marine,17,28,13,4,45,76.47058823529412,23.52941176470588
57010_marine,17,28,13,4,45,76.47058823529412,23.52941176470588
57011_marine,17,28,13,4,45,76.47058823529412,23.52941176470588
57012_marine,16,28,12,4,44,75,25
57013_marine,16,28,12,4,44,75,25
57014_marine,16,28,12,4,44,75,25
57015_marine,16,28,12,4,44,75,25
57016_marine,16,28,12,4,44,75,25
57017_marine,16,29,12,4,45,75,25
57018_marine,16,29,12,4,45,75,25
57019_marine,16,29,12,4,45,75,25
57020_marine,17,29,13,4,46,76.47058823529412,23.52941176470588
57021_marine,15,29,11,4,44,73.33333333333333,26.666666666666668
57022_marine,15,29,11,4,44,73.33333333333333,26.666666666666668
57023_marine,15,29,11,4,44,73.33333333333333,26.666666666666668
57024_marine,14,29,11,3,43,78.57142857142857,21.428571428571427
57025_marine,14,29,11,3,43,78.57142857142857,21.428571428571427
57026_marine,14,29,11,3,43,78.57142857142857,21.428571428571427
57027_marine,14,29,11,3,43,78.57142857142857,21.428571428571427
57028_marine,14,29,11,3,43,78.57142857142857,21.428571428571427
57029_marine,14,29,11,3,43,78.57142857142857,21.428571428571427
57030_marine,14,29,11,3,43,78.57142857142857,21.428571428571427
57031_marine,14,29,11,3,43,78.57142857142857,21.428571428571427
57032_marine,14,29,11,3,43,78.57142857142857,21.428571428571427
57033_marine,14,29,11,3,43,78.57142857142857,21.428571428571427
57034_marine,14,29,11,3,43,78.57142857142857,21.428571428571427
57035_marine,14,29,11,3,43,78.57142857142857,21.428571428571427
57036_marine,14,29,11,3,43,78.57142857142857,21.428571428571427
57037_marine,14,31,11,3,45,78.57142857142857,21.428571428571427
57038_marine,14,31,11,3,45,78.57142857142857,21.428571428571427
57039_marine,14,31,11,3,45,78.57142857142857,21.428571428571427
57040_marine,14,31,11,3,45,78.57142857142857,21.428571428571427
57041_marine,14,31,11,3,45,78.57142857142857,21.428571428571427
57042_marine,14,30,11,3,44,78.57142857142857,21.428571428571427
57043_marine,15,30,12,3,45,80,20
57044_marine,15,30,12,3,45,80,20
57045_marine,15,30,12,3,45,80,20
57046_marine,15,30,12,3,45,80,20
57047_marine,15,30,12,3,45,80,20
57048_marine,15,30,12,3,45,80,20
57049_marine,15,30,12,3,45,80,20
57050_marine,16,30,13,3,46,81.25,18.75
57051_marine,16,30,13,3,46,81.25,18.75
57052_marine,17,29,14,3,46,82.35294117647058,17.647058823529413
57053_marine,17,28,14,3,45,82.35294117647058,17.647058823529413
57054_marine,17,28,14,3,45,82.35294117647058,17.647058823529413
57055_marine,17,28,14,3,45,82.35294117647058,17.647058823529413
57056_marine,16,28,13,3,44,81.25,18.75
57057_marine,16,28,13,3,44,81.25,18.75
57058_marine,16,28,13,3,44,81.25,18.75
57059_marine,16,28,13,3,44,81.25,18.75
57060_marine,16,28,13,3,44,81.25,18.75
57061_marine,15,28,12,3,43,80,20
57062_marine,15,28,12,3,43,80,20
57063_marine,14,28,11,3,42,78.57142857142857,21.428571428571427
57064_marine,14,28,11,3,42,78.57142857142857,21.428571428571427
57065_marine,14,28,11,3,42,78.57142857142857,21.428571428571427
57066_marine,14,28,11,3,42,78.57142857142857,21.428571428571427
57067_marine,14,28,11,3,42,78.57142857142857,21.428571428571427
57068_marine,14,28,11,3,42,78.57142857142857,21.428571428571427
57069_marine,14,28,11,3,42,78.57142857142857,21.428571428571427
57070_marine,13,28,10,3,41,76.92307692307693,23.076923076923077
57071_marine,13,28,10,3,41,76.92307692307693,23.076923076923077
57072_marine,13,28,10,3,41,76.92307692307693,23.076923076923077
57073_marine,13,28,10,3,41,76.92307692307693,23.076923076923077
57074_marine,13,28,10,3,41,76.92307692307693,23.076923076923077
57075_marine,13,28,10,3,41,76.92307692307693,23.076923076923077
57076_marine,13,28,10,3,41,76.92307692307693,23.076923076923077
57077_marine,13,28,10,3,41,76.92307692307693,23.076923076923077
57078_marine,13,28,10,3,41,76.92307692307693,23.076923076923077
57079_marine,13,28,10,3,41,76.92307692307693,23.076923076923077
57080_marine,13,28,10,3,41,76.92307692307693,23.076923076923077
57081_marine,13,28,10,3,41,76.92307692307693,23.076923076923077
57082_marine,13,28,10,3,41,76.92307692307693,23.076923076923077
57083_marine,13,28,10,3,41,76.92307692307693,23.076923076923077
57084_marine,13,28,10,3,41,76.92307692307693,23.076923076923077
57085_marine,13,26,10,3,39,76.92307692307693,23.076923076923077
57086_marine,13,26,10,3,39,76.92307692307693,23.076923076923077
57087_marine,13,26,10,3,39,76.92307692307693,23.076923076923077
57088_marine,13,26,10,3,39,76.92307692307693,23.076923076923077
57089_marine,13,26,10,3,39,76.92307692307693,23.076923076923077
57090_marine,13,26,10,3,39,76.92307692307693,23.076923076923077
57091_marine,13,26,10,3,39,76.92307692307693,23.076923076923077
57092_marine,13,26,10,3,39,76.92307692307693,23.076923076923077
57093_marine,13,26,10,3,39,76.92307692307693,23.076923076923077
57094_marine,14,28,10,4,42,71.42857142857143,28.57142857142857
57095_marine,14,28,10,4,42,71.42857142857143,28.57142857142857
57096_marine,14,28,10,4,42,71.42857142857143,28.57142857142857
57097_marine,13,26,10,3,39,76.92307692307693,23.076923076923077
57098_marine,13,26,10,3,39,76.92307692307693,23.076923076923077
57099_marine,13,26,10,3,39,76.92307692307693,23.076923076923077
57100_marine,15,26,10,5,41,66.66666666666666,33.33333333333333
57101_marine,15,26,10,5,41,66.66666666666666,33.33333333333333
57102_marine,15,26,10,5,41,66.66666666666666,33.33333333333333
57103_marine,14,26,10,4,40,71.42857142857143,28.57142857142857
57104_marine,14,26,10,4,40,71.42857142857143,28.57142857142857
57130_marine,17,26,11,6,43,64.70588235294117,35.294117647058826
57131_marine,15,27,10,5,42,66.66666666666666,33.33333333333333
57132_marine,14,28,10,4,42,71.42857142857143,28.57142857142857
57133_marine,14,26,10,4,40,71.42857142857143,28.57142857142857
57134_marine,14,26,10,4,40,71.42857142857143,28.57142857142857
57135_marine,14,26,10,4,40,71.42857142857143,28.57142857142857
57136_marine,14,26,10,4,40,71.42857142857143,28.57142857142857
57137_marine,15,26,10,5,41,66.66666666666666,33.33333333333333
57138_marine,15,26,10,5,41,66.66666666666666,33.33333333333333
57139_marine,15,27,10,5,42,66.66666666666666,33.33333333333333
57140_marine,14,26,10,4,40,71.42857142857143,28.57142857142857
57141_marine,12,26,8,4,38,66.66666666666666,33.33333333333333
57207_marine,5,0,4,1,5,80,20
57208_marine,17,26,12,5,43,70.58823529411765,29.411764705882355
57209_marine,18,26,13,5,44,72.22222222222221,27.77777777777778
57210_marine,18,26,12,6,44,66.66666666666666,33.33333333333333
57211_marine,17,26,12,5,43,70.58823529411765,29.411764705882355
57212_marine,17,26,12,5,43,70.58823529411765,29.411764705882355
57213_marine,16,26,12,4,42,75,25
57214_marine,16,26,12,4,42,75,25
57215_marine,16,26,12,4,42,75,25
57216_marine,16,27,12,4,43,75,25
57217_marine,16,27,12,4,43,75,25
57218_marine,16,27,12,4,43,75,25
57219_marine,16,27,12,4,43,75,25
57220_marine,17,27,13,4,44,76.47058823529412,23.52941176470588
57221_marine,17,27,13,4,44,76.47058823529412,23.52941176470588
57222_marine,17,27,13,4,44,76.47058823529412,23.52941176470588
57223_marine,17,27,13,4,44,76.47058823529412,23.52941176470588
57224_marine,17,29,13,4,46,76.47058823529412,23.52941176470588
57225_marine,17,30,13,4,47,76.47058823529412,23.52941176470588
57226_marine,17,29,13,4,46,76.47058823529412,23.52941176470588
57227_marine,17,29,13,4,46,76.47058823529412,23.52941176470588
57228_marine,17,29,13,4,46,76.47058823529412,23.52941176470588
57229_marine,17,31,13,4,48,76.47058823529412,23.52941176470588
57230_marine,18,33,14,4,51,77.77777777777779,22.22222222222222
57231_marine,19,33,15,4,52,78.94736842105263,21.052631578947366
57232_marine,19,33,15,4,52,78.94736842105263,21.052631578947366
57233_marine,21,33,17,4,54,80.95238095238095,19.047619047619047
57234_marine,21,33,17,4,54,80.95238095238095,19.047619047619047
57235_marine,22,33,18,5,55,81.81818181818183,22.727272727272727
57236_marine,22,33,18,5,55,81.81818181818183,22.727272727272727
57237_marine,22,33,18,5,55,81.81818181818183,22.727272727272727
57238_marine,22,34,18,5,56,81.81818181818183,22.727272727272727
57239_marine,21,34,17,5,55,80.95238095238095,23.809523809523807
57240_marine,21,34,17,5,55,80.95238095238095,23.809523809523807
57241_marine,21,30,17,5,51,80.95238095238095,23.809523809523807
57242_marine,21,30,17,5,51,80.95238095238095,23.809523809523807
57243_marine,21,30,17,5,51,80.95238095238095,23.809523809523807
57244_marine,21,30,17,5,51,80.95238095238095,23.809523809523807
57245_marine,20,30,17,4,50,85,20
57246_marine,20,30,17,4,50,85,20
57247_marine,20,30,17,4,50,85,20
57248_marine,20,30,17,4,50,85,20
57249_marine,20,30,17,4,50,85,20
57250_marine,20,30,17,4,50,85,20
57251_marine,20,30,17,4,50,85,20
57252_marine,20,30,17,4,50,85,20
57253_marine,20,31,17,4,51,85,20
57254_marine,20,31,17,4,51,85,20
57255_marine,20,31,17,4,51,85,20
57256_marine,20,31,17,4,51,85,20
57257_marine,20,31,17,4,51,85,20
57258_marine,19,31,17,3,50,89.47368421052632,15.789473684210526
57259_marine,19,31,17,3,50,89.47368421052632,15.789473684210526
57260_marine,19,31,17,3,50,89.47368421052632,15.789473684210526
57261_marine,19,31,17,3,50,89.47368421052632,15.789473684210526
57262_marine,19,31,17,3,50,89.47368421052632,15.789473684210526
57263_marine,19,31,17,3,50,89.47368421052632,15.789473684210526
57264_marine,19,31,17,3,50,89.47368421052632,15.789473684210526
57265_marine,19,31,17,3,50,89.47368421052632,15.789473684210526
57266_marine,19,30,17,3,49,89.47368421052632,15.789473684210526
57267_marine,19,30,17,3,49,89.47368421052632,15.789473684210526
57268_marine,19,30,17,3,49,89.47368421052632,15.789473684210526
57269_marine,19,30,17,3,49,89.47368421052632,15.789473684210526
57270_marine,19,30,17,3,49,89.47368421052632,15.789473684210526
57271_marine,18,29,16,3,47,88.88888888888889,16.666666666666664
57272_marine,18,28,16,3,46,88.88888888888889,16.666666666666664
57273_marine,18,28,16,3,46,88.88888888888889,16.666666666666664
57274_marine,18,28,16,3,46,88.88888888888889,16.666666666666664
57275_marine,18,28,16,3,46,88.88888888888889,16.666666666666664
57276_marine,18,28,16,3,46,88.88888888888889,16.666666666666664
57277_marine,18,28,16,3,46,88.88888888888889,16.666666666666664
57278_marine,18,28,16,3,46,88.88888888888889,16.666666666666664
57279_marine,17,28,15,3,45,88.23529411764706,17.647058823529413
57280_marine,17,28,15,3,45,88.23529411764706,17.647058823529413
57281_marine,17,28,15,3,45,88.23529411764706,17.647058823529413
57282_marine,17,28,15,3,45,88.23529411764706,17.647058823529413
57283_marine,16,28,14,2,44,87.5,12.5
57284_marine,16,28,14,2,44,87.5,12.5
57285_marine,17,28,14,3,45,82.35294117647058,17.647058823529413
57286_marine,17,28,14,3,45,82.35294117647058,17.647058823529413
57287_marine,17,28,14,3,45,82.35294117647058,17.647058823529413
57288_marine,17,28,14,3,45,82.35294117647058,17.647058823529413
57289_marine,17,28,14,3,45,82.35294117647058,17.647058823529413
57290_marine,17,29,14,3,46,82.35294117647058,17.647058823529413
57291_marine,17,29,14,3,46,82.35294117647058,17.647058823529413
57292_marine,17,29,14,3,46,82.35294117647058,17.647058823529413
57293_marine,17,29,14,3,46,82.35294117647058,17.647058823529413
57294_marine,17,29,14,3,46,82.35294117647058,17.647058823529413
57295_marine,16,29,13,3,45,81.25,18.75
57296_marine,16,29,13,3,45,81.25,18.75
57297_marine,15,29,12,3,44,80,20
57298_marine,13,29,10,3,42,76.92307692307693,23.076923076923077
57299_marine,13,29,10,3,42,76.92307692307693,23.076923076923077
57300_marine,13,29,10,3,42,76.92307692307693,23.076923076923077
57301_marine,13,29,10,3,42,76.92307692307693,23.076923076923077
57302_marine,13,29,10,3,42,76.92307692307693,23.076923076923077
57303_marine,13,29,10,3,42,76.92307692307693,23.076923076923077
57304_marine,13,29,10,3,42,76.92307692307693,23.076923076923077
57305_marine,13,28,10,3,41,76.92307692307693,23.076923076923077
57306_marine,13,28,10,3,41,76.92307692307693,23.076923076923077
57307_marine,13,28,10,3,41,76.92307692307693,23.076923076923077
57308_marine,13,28,10,3,41,76.92307692307693,23.076923076923077
57309_marine,13,28,10,3,41,76.92307692307693,23.076923076923077
57310_marine,13,28,10,3,41,76.92307692307693,23.076923076923077
57311_marine,13,28,10,3,41,76.92307692307693,23.076923076923077
57312_marine,13,28,10,3,41,76.92307692307693,23.076923076923077
57313_marine,14,28,10,4,42,71.42857142857143,28.57142857142857
57314_marine,15,28,11,4,43,73.33333333333333,26.666666666666668
57315_marine,15,28,11,4,43,73.33333333333333,26.666666666666668
57316_marine,15,28,11,4,43,73.33333333333333,26.666666666666668
57317_marine,15,28,11,4,43,73.33333333333333,26.666666666666668
57318_marine,15,28,11,4,43,73.33333333333333,26.666666666666668
57319_marine,15,28,11,4,43,73.33333333333333,26.666666666666668
57320_marine,15,28,11,4,43,73.33333333333333,26.666666666666668
57321_marine,15,27,11,4,42,73.33333333333333,26.666666666666668
57322_marine,15,27,11,4,42,73.33333333333333,26.666666666666668
57323_marine,15,27,11,4,42,73.33333333333333,26.666666666666668
57324_marine,15,27,11,4,42,73.33333333333333,26.666666666666668
57325_marine,15,27,11,4,42,73.33333333333333,26.666666666666668
57326_marine,15,27,11,4,42,73.33333333333333,26.666666666666668
57327_marine,15,27,11,4,42,73.33333333333333,26.666666666666668
57328_marine,15,27,11,4,42,73.33333333333333,26.666666666666668
57329_marine,15,27,11,4,42,73.33333333333333,26.666666666666668
57330_marine,15,27,11,4,42,73.33333333333333,26.666666666666668
57331_marine,15,27,11,4,42,73.33333333333333,26.666666666666668
57332_marine,15,27,11,4,42,73.33333333333333,26.666666666666668
57333_marine,15,27,11,4,42,73.33333333333333,26.666666666666668
57334_marine,15,30,11,4,45,73.33333333333333,26.666666666666668
57335_marine,14,30,11,3,44,78.57142857142857,21.428571428571427
57336_marine,14,30,11,3,44,78.57142857142857,21.428571428571427
57337_marine,14,30,11,3,44,78.57142857142857,21.428571428571427
57338_marine,14,30,11,3,44,78.57142857142857,21.428571428571427
57339_marine,14,30,11,3,44,78.57142857142857,21.428571428571427
57340_marine,14,30,11,3,44,78.57142857142857,21.428571428571427
57341_marine,14,30,11,3,44,78.57142857142857,21.428571428571427
57342_marine,14,30,11,3,44,78.57142857142857,21.428571428571427
57343_marine,14,30,11,3,44,78.57142857142857,21.428571428571427
57344_marine,15,30,11,4,45,73.33333333333333,26.666666666666668
57345_marine,15,29,11,4,44,73.33333333333333,26.666666666666668
57346_marine,15,29,11,4,44,73.33333333333333,26.666666666666668
57347_marine,14,29,11,3,43,78.57142857142857,21.428571428571427
57348_marine,15,29,11,4,44,73.33333333333333,26.666666666666668
57349_marine,15,29,11,4,44,73.33333333333333,26.666666666666668
57350_marine,14,29,11,3,43,78.57142857142857,21.428571428571427
57351_marine,14,29,11,3,43,78.57142857142857,21.428571428571427
57352_marine,14,29,11,3,43,78.57142857142857,21.428571428571427
57353_marine,14,29,11,3,43,78.57142857142857,21.428571428571427
57354_marine,14,27,11,3,41,78.57142857142857,21.428571428571427
57357_marine,15,30,12,3,45,80,20
57358_marine,16,29,12,4,45,75,25
57359_marine,16,29,12,4,45,75,25
57360_marine,15,29,11,4,44,73.33333333333333,26.666666666666668
57361_marine,15,29,11,4,44,73.33333333333333,26.666666666666668
57362_marine,15,29,11,4,44,73.33333333333333,26.666666666666668
57363_marine,17,29,13,4,46,76.47058823529412,23.52941176470588
57364_marine,17,29,13,4,46,76.47058823529412,23.52941176470588
57365_marine,17,29,13,4,46,76.47058823529412,23.52941176470588
57366_marine,17,27,13,4,44,76.47058823529412,23.52941176470588
57367_marine,17,27,13,4,44,76.47058823529412,23.52941176470588
57368_marine,17,27,13,4,44,76.47058823529412,23.52941176470588
57369_marine,17,27,13,4,44,76.47058823529412,23.52941176470588
57370_marine,17,28,13,4,45,76.47058823529412,23.52941176470588
57371_marine,17,28,13,4,45,76.47058823529412,23.52941176470588
57372_marine,16,28,12,4,44,75,25
57373_marine,16,28,12,4,44,75,25
57374_marine,16,28,12,4,44,75,25
57375_marine,16,28,12,4,44,75,25
57376_marine,16,28,12,4,44,75,25
57377_marine,16,28,12,4,44,75,25
57378_marine,16,28,12,4,44,75,25
57379_marine,13,29,10,3,42,76.92307692307693,23.076923076923077
57380_marine,13,29,10,3,42,76.92307692307693,23.076923076923077
57381_marine,13,29,10,3,42,76.92307692307693,23.076923076923077
57382_marine,14,29,11,3,43,78.57142857142857,21.428571428571427
57383_marine,14,29,11,3,43,78.57142857142857,21.428571428571427
57384_marine,14,29,11,3,43,78.57142857142857,21.428571428571427
57385_marine,14,29,11,3,43,78.57142857142857,21.428571428571427
57386_marine,14,29,11,3,43,78.57142857142857,21.428571428571427
57387_marine,14,29,11,3,43,78.57142857142857,21.428571428571427
57388_marine,14,29,11,3,43,78.57142857142857,21.428571428571427
57389_marine,14,29,11,3,43,78.57142857142857,21.428571428571427
57390_marine,14,29,11,3,43,78.57142857142857,21.428571428571427
57391_marine,14,29,11,3,43,78.57142857142857,21.428571428571427
57392_marine,14,29,11,3,43,78.57142857142857,21.428571428571427
57393_marine,14,29,11,3,43,78.57142857142857,21.428571428571427
57394_marine,14,29,11,3,43,78.57142857142857,21.428571428571427
57395_marine,14,29,11,3,43,78.57142857142857,21.428571428571427
57396_marine,14,29,11,3,43,78.57142857142857,21.428571428571427
57397_marine,14,29,11,3,43,78.57142857142857,21.428571428571427
57398_marine,14,29,11,3,43,78.57142857142857,21.428571428571427
57399_marine,14,29,11,3,43,78.57142857142857,21.428571428571427
57400_marine,14,28,11,3,42,78.57142857142857,21.428571428571427
57401_marine,14,28,11,3,42,78.57142857142857,21.428571428571427
57402_marine,14,28,11,3,42,78.57142857142857,21.428571428571427
57403_marine,14,28,11,3,42,78.57142857142857,21.428571428571427
57404_marine,15,28,12,3,43,80,20
57405_marine,15,28,12,3,43,80,20
57406_marine,15,27,12,3,42,80,20
57407_marine,15,27,12,3,42,80,20
57408_marine,15,27,12,3,42,80,20
57409_marine,15,27,12,3,42,80,20
57410_marine,15,26,12,3,41,80,20
57411_marine,15,26,12,3,41,80,20
57412_marine,16,26,13,3,42,81.25,18.75
57413_marine,16,28,13,3,44,81.25,18.75
57414_marine,16,26,13,3,42,81.25,18.75
57415_marine,16,26,13,3,42,81.25,18.75
57416_marine,16,26,13,3,42,81.25,18.75
57417_marine,16,26,13,3,42,81.25,18.75
57418_marine,16,26,13,3,42,81.25,18.75
57419_marine,16,26,13,3,42,81.25,18.75
57420_marine,15,26,12,3,41,80,20
57421_marine,15,26,12,3,41,80,20
57422_marine,14,26,11,3,40,78.57142857142857,21.428571428571427
57423_marine,14,26,11,3,40,78.57142857142857,21.428571428571427
57424_marine,14,26,11,3,40,78.57142857142857,21.428571428571427
57425_marine,14,26,11,3,40,78.57142857142857,21.428571428571427
57426_marine,13,26,10,3,39,76.92307692307693,23.076923076923077
57427_marine,13,26,10,3,39,76.92307692307693,23.076923076923077
57428_marine,13,26,10,3,39,76.92307692307693,23.076923076923077
57429_marine,13,26,10,3,39,76.92307692307693,23.076923076923077
57430_marine,13,26,10,3,39,76.92307692307693,23.076923076923077
57431_marine,13,26,10,3,39,76.92307692307693,23.076923076923077
57432_marine,13,26,10,3,39,76.92307692307693,23.076923076923077
57433_marine,13,26,10,3,39,76.92307692307693,23.076923076923077
57434_marine,13,26,10,3,39,76.92307692307693,23.076923076923077
57435_marine,13,26,10,3,39,76.92307692307693,23.076923076923077
57436_marine,13,26,10,3,39,76.92307692307693,23.076923076923077
57437_marine,13,26,10,3,39,76.92307692307693,23.076923076923077
57438_marine,13,26,10,3,39,76.92307692307693,23.076923076923077
57439_marine,13,26,10,3,39,76.92307692307693,23.076923076923077
57440_marine,13,26,10,3,39,76.92307692307693,23.076923076923077
57441_marine,13,26,10,3,39,76.92307692307693,23.076923076923077
57442_marine,13,26,10,3,39,76.92307692307693,23.076923076923077
57443_marine,13,26,10,3,39,76.92307692307693,23.076923076923077
57444_marine,13,26,10,3,39,76.92307692307693,23.076923076923077
57445_marine,13,26,10,3,39,76.92307692307693,23.076923076923077
57446_marine,13,26,10,3,39,76.92307692307693,23.076923076923077
57447_marine,13,26,10,3,39,76.92307692307693,23.076923076923077
57448_marine,13,26,10,3,39,76.92307692307693,23.076923076923077
57449_marine,13,26,10,3,39,76.92307692307693,23.076923076923077
57450_marine,13,26,10,3,39,76.92307692307693,23.076923076923077
57451_marine,13,26,10,3,39,76.92307692307693,23.076923076923077
57452_marine,13,26,10,3,39,76.92307692307693,23.076923076923077
57453_marine,13,26,10,3,39,76.92307692307693,23.076923076923077
57454_marine,1,0,0,1,1,0,100
57455_marine,1,0,0,1,1,0,100
57456_marine,14,28,10,4,42,71.42857142857143,28.57142857142857
57457_marine,13,26,10,3,39,76.92307692307693,23.076923076923077
57458_marine,13,26,10,3,39,76.92307692307693,23.076923076923077
57459_marine,13,26,10,3,39,76.92307692307693,23.076923076923077
57460_marine,14,26,10,4,40,71.42857142857143,28.57142857142857
57489_marine,12,26,10,2,38,83.33333333333334,16.666666666666664
57490_marine,12,26,10,2,38,83.33333333333334,16.666666666666664
57491_marine,12,26,10,2,38,83.33333333333334,16.666666666666664
57492_marine,12,26,10,2,38,83.33333333333334,16.666666666666664
57493_marine,13,26,10,3,39,76.92307692307693,23.076923076923077
57494_marine,14,26,10,4,40,71.42857142857143,28.57142857142857
57495_marine,15,26,10,5,41,66.66666666666666,33.33333333333333
57496_marine,17,26,10,7,43,58.82352941176471,41.17647058823529
57497_marine,18,26,11,7,44,61.111111111111114,38.88888888888889
57498_marine,17,26,11,6,43,64.70588235294117,35.294117647058826
57576_marine,4,0,4,0,4,100,0
57577_marine,16,26,12,4,42,75,25
57578_marine,16,26,12,4,42,75,25
57579_marine,17,26,12,5,43,70.58823529411765,29.411764705882355
57580_marine,17,26,12,5,43,70.58823529411765,29.411764705882355
57581_marine,18,26,12,6,44,66.66666666666666,33.33333333333333
57582_marine,16,27,12,4,43,75,25
57583_marine,16,27,12,4,43,75,25
57584_marine,16,27,12,4,43,75,25
57585_marine,16,27,12,4,43,75,25
57586_marine,16,27,12,4,43,75,25
57587_marine,17,28,13,4,45,76.47058823529412,23.52941176470588
57588_marine,17,28,13,4,45,76.47058823529412,23.52941176470588
57589_marine,17,28,13,4,45,76.47058823529412,23.52941176470588
57590_marine,17,28,13,4,45,76.47058823529412,23.52941176470588
57591_marine,17,29,13,4,46,76.47058823529412,23.52941176470588
57592_marine,17,29,13,4,46,76.47058823529412,23.52941176470588
57593_marine,17,31,13,4,48,76.47058823529412,23.52941176470588
57594_marine,21,31,17,4,52,80.95238095238095,19.047619047619047
57595_marine,21,30,17,4,51,80.95238095238095,19.047619047619047
57596_marine,21,30,17,4,51,80.95238095238095,19.047619047619047
57597_marine,21,30,17,4,51,80.95238095238095,19.047619047619047
57598_marine,21,30,17,4,51,80.95238095238095,19.047619047619047
57599_marine,21,31,17,5,52,80.95238095238095,23.809523809523807
57600_marine,21,31,17,5,52,80.95238095238095,23.809523809523807
57601_marine,20,29,16,4,49,80,20
57602_marine,19,29,15,4,48,78.94736842105263,21.052631578947366
57603_marine,20,30,16,5,50,80,25
57604_marine,20,30,16,5,50,80,25
57605_marine,20,30,16,5,50,80,25
57606_marine,20,30,16,5,50,80,25
57607_marine,20,30,16,5,50,80,25
57608_marine,19,29,16,4,48,84.21052631578947,21.052631578947366
57609_marine,19,29,16,4,48,84.21052631578947,21.052631578947366
57610_marine,19,29,16,4,48,84.21052631578947,21.052631578947366
57611_marine,18,29,16,3,47,88.88888888888889,16.666666666666664
57612_marine,18,29,16,3,47,88.88888888888889,16.666666666666664
57613_marine,18,29,16,3,47,88.88888888888889,16.666666666666664
57614_marine,18,29,16,3,47,88.88888888888889,16.666666666666664
57615_marine,18,29,16,3,47,88.88888888888889,16.666666666666664
57616_marine,18,28,16,3,46,88.88888888888889,16.666666666666664
57617_marine,18,28,16,3,46,88.88888888888889,16.666666666666664
57618_marine,18,28,16,3,46,88.88888888888889,16.666666666666664
57619_marine,18,28,16,3,46,88.88888888888889,16.666666666666664
57620_marine,18,29,16,3,47,88.88888888888889,16.666666666666664
57621_marine,18,29,16,3,47,88.88888888888889,16.666666666666664
57622_marine,18,29,16,3,47,88.88888888888889,16.666666666666664
57623_marine,18,29,16,3,47,88.88888888888889,16.666666666666664
57624_marine,18,29,16,3,47,88.88888888888889,16.666666666666664
57625_marine,17,29,15,3,46,88.23529411764706,17.647058823529413
57626_marine,17,29,15,3,46,88.23529411764706,17.647058823529413
57627_marine,17,29,15,3,46,88.23529411764706,17.647058823529413
57628_marine,17,27,15,3,44,88.23529411764706,17.647058823529413
57629_marine,17,27,15,3,44,88.23529411764706,17.647058823529413
57630_marine,17,27,15,3,44,88.23529411764706,17.647058823529413
57631_marine,17,27,15,3,44,88.23529411764706,17.647058823529413
57632_marine,17,27,15,3,44,88.23529411764706,17.647058823529413
57633_marine,17,27,15,3,44,88.23529411764706,17.647058823529413
57634_marine,18,27,15,4,45,83.33333333333334,22.22222222222222
57635_marine,18,27,15,4,45,83.33333333333334,22.22222222222222
57636_marine,18,27,15,4,45,83.33333333333334,22.22222222222222
57637_marine,18,27,15,4,45,83.33333333333334,22.22222222222222
57638_marine,17,27,14,3,44,82.35294117647058,17.647058823529413
57639_marine,16,27,13,3,43,81.25,18.75
57640_marine,16,27,13,3,43,81.25,18.75
57641_marine,16,27,13,3,43,81.25,18.75
57642_marine,16,27,13,3,43,81.25,18.75
57643_marine,16,27,13,3,43,81.25,18.75
57644_marine,16,27,13,3,43,81.25,18.75
57645_marine,16,27,13,3,43,81.25,18.75
57646_marine,15,27,12,3,42,80,20
57647_marine,15,27,12,3,42,80,20
57648_marine,15,27,12,3,42,80,20
57649_marine,15,27,12,3,42,80,20
57650_marine,15,27,12,3,42,80,20
57651_marine,15,27,12,3,42,80,20
57652_marine,15,27,12,3,42,80,20
57653_marine,13,28,10,3,41,76.92307692307693,23.076923076923077
57654_marine,13,28,10,3,41,76.92307692307693,23.076923076923077
57655_marine,13,28,10,3,41,76.92307692307693,23.076923076923077
57656_marine,13,28,10,3,41,76.92307692307693,23.076923076923077
57657_marine,13,28,10,3,41,76.92307692307693,23.076923076923077
57658_marine,13,28,10,3,41,76.92307692307693,23.076923076923077
57659_marine,13,28,10,3,41,76.92307692307693,23.076923076923077
57660_marine,13,28,10,3,41,76.92307692307693,23.076923076923077
57661_marine,13,28,10,3,41,76.92307692307693,23.076923076923077
57662_marine,13,28,10,3,41,76.92307692307693,23.076923076923077
57663_marine,13,28,10,3,41,76.92307692307693,23.076923076923077
57664_marine,13,28,10,3,41,76.92307692307693,23.076923076923077
57665_marine,13,28,10,3,41,76.92307692307693,23.076923076923077
57666_marine,13,28,10,3,41,76.92307692307693,23.076923076923077
57667_marine,13,28,10,3,41,76.92307692307693,23.076923076923077
57668_marine,13,28,10,3,41,76.92307692307693,23.076923076923077
57669_marine,13,28,10,3,41,76.92307692307693,23.076923076923077
57670_marine,13,28,10,3,41,76.92307692307693,23.076923076923077
57671_marine,13,27,10,3,40,76.92307692307693,23.076923076923077
57672_marine,13,27,10,3,40,76.92307692307693,23.076923076923077
57673_marine,13,27,10,3,40,76.92307692307693,23.076923076923077
57674_marine,13,27,10,3,40,76.92307692307693,23.076923076923077
57675_marine,13,27,10,3,40,76.92307692307693,23.076923076923077
57676_marine,14,27,11,3,41,78.57142857142857,21.428571428571427
57677_marine,14,27,11,3,41,78.57142857142857,21.428571428571427
57678_marine,14,27,11,3,41,78.57142857142857,21.428571428571427
57679_marine,14,27,11,3,41,78.57142857142857,21.428571428571427
57680_marine,14,27,11,3,41,78.57142857142857,21.428571428571427
57681_marine,14,27,11,3,41,78.57142857142857,21.428571428571427
57682_marine,14,29,11,3,43,78.57142857142857,21.428571428571427
57683_marine,14,29,11,3,43,78.57142857142857,21.428571428571427
57684_marine,14,29,11,3,43,78.57142857142857,21.428571428571427
57685_marine,14,29,11,3,43,78.57142857142857,21.428571428571427
57686_marine,14,29,11,3,43,78.57142857142857,21.428571428571427
57687_marine,14,29,11,3,43,78.57142857142857,21.428571428571427
57688_marine,14,29,11,3,43,78.57142857142857,21.428571428571427
57689_marine,14,29,11,3,43,78.57142857142857,21.428571428571427
57690_marine,14,29,11,3,43,78.57142857142857,21.428571428571427
57691_marine,14,29,11,3,43,78.57142857142857,21.428571428571427
57692_marine,14,29,11,3,43,78.57142857142857,21.428571428571427
57693_marine,14,29,11,3,43,78.57142857142857,21.428571428571427
57694_marine,14,29,11,3,43,78.57142857142857,21.428571428571427
57695_marine,14,29,11,3,43,78.57142857142857,21.428571428571427
57696_marine,14,30,11,3,44,78.57142857142857,21.428571428571427
57697_marine,14,30,11,3,44,78.57142857142857,21.428571428571427
57698_marine,14,29,11,3,43,78.57142857142857,21.428571428571427
57699_marine,14,29,11,3,43,78.57142857142857,21.428571428571427
57700_marine,14,29,11,3,43,78.57142857142857,21.428571428571427
57701_marine,14,29,11,3,43,78.57142857142857,21.428571428571427
57702_marine,14,29,11,3,43,78.57142857142857,21.428571428571427
57703_marine,14,29,11,3,43,78.57142857142857,21.428571428571427
57704_marine,14,29,11,3,43,78.57142857142857,21.428571428571427
57705_marine,14,29,11,3,43,78.57142857142857,21.428571428571427
57706_marine,14,29,11,3,43,78.57142857142857,21.428571428571427
57707_marine,14,29,11,3,43,78.57142857142857,21.428571428571427
57708_marine,14,29,11,3,43,78.57142857142857,21.428571428571427
57709_marine,14,29,11,3,43,78.57142857142857,21.428571428571427
57710_marine,14,29,11,3,43,78.57142857142857,21.428571428571427
57711_marine,14,27,11,3,41,78.57142857142857,21.428571428571427
57712_marine,14,29,11,3,43,78.57142857142857,21.428571428571427
57713_marine,14,28,11,3,42,78.57142857142857,21.428571428571427
57718_marine,15,28,11,4,43,73.33333333333333,26.666666666666668
57719_marine,15,29,11,4,44,73.33333333333333,26.666666666666668
57720_marine,15,29,11,4,44,73.33333333333333,26.666666666666668
57721_marine,15,29,11,4,44,73.33333333333333,26.666666666666668
57722_marine,15,29,11,4,44,73.33333333333333,26.666666666666668
57723_marine,17,29,13,4,46,76.47058823529412,23.52941176470588
57724_marine,17,29,13,4,46,76.47058823529412,23.52941176470588
57725_marine,17,29,13,4,46,76.47058823529412,23.52941176470588
57726_marine,17,29,13,4,46,76.47058823529412,23.52941176470588
57727_marine,17,27,13,4,44,76.47058823529412,23.52941176470588
57728_marine,17,27,13,4,44,76.47058823529412,23.52941176470588
57729_marine,17,27,13,4,44,76.47058823529412,23.52941176470588
57730_marine,17,27,13,4,44,76.47058823529412,23.52941176470588
57731_marine,16,27,12,4,43,75,25
57732_marine,16,28,12,4,44,75,25
57733_marine,16,28,12,4,44,75,25
57734_marine,15,28,12,3,43,80,20
57735_marine,15,28,12,3,43,80,20
57736_marine,15,28,12,3,43,80,20
57737_marine,13,28,10,3,41,76.92307692307693,23.076923076923077
57738_marine,13,28,10,3,41,76.92307692307693,23.076923076923077
57739_marine,13,28,10,3,41,76.92307692307693,23.076923076923077
57740_marine,13,29,10,3,42,76.92307692307693,23.076923076923077
57741_marine,13,29,10,3,42,76.92307692307693,23.076923076923077
57742_marine,13,29,10,3,42,76.92307692307693,23.076923076923077
57743_marine,13,29,10,3,42,76.92307692307693,23.076923076923077
57744_marine,14,29,11,3,43,78.57142857142857,21.428571428571427
57745_marine,14,29,11,3,43,78.57142857142857,21.428571428571427
57746_marine,14,29,11,3,43,78.57142857142857,21.428571428571427
57747_marine,14,29,11,3,43,78.57142857142857,21.428571428571427
57748_marine,14,29,11,3,43,78.57142857142857,21.428571428571427
57749_marine,14,29,11,3,43,78.57142857142857,21.428571428571427
57750_marine,14,29,11,3,43,78.57142857142857,21.428571428571427
57751_marine,14,29,11,3,43,78.57142857142857,21.428571428571427
57752_marine,14,29,11,3,43,78.57142857142857,21.428571428571427
57753_marine,14,29,11,3,43,78.57142857142857,21.428571428571427
57754_marine,14,29,11,3,43,78.57142857142857,21.428571428571427
57755_marine,14,29,11,3,43,78.57142857142857,21.428571428571427
57756_marine,14,29,11,3,43,78.57142857142857,21.428571428571427
57757_marine,14,29,11,3,43,78.57142857142857,21.428571428571427
57758_marine,14,29,11,3,43,78.57142857142857,21.428571428571427
57759_marine,14,27,11,3,41,78.57142857142857,21.428571428571427
57760_marine,14,27,11,3,41,78.57142857142857,21.428571428571427
57761_marine,14,27,11,3,41,78.57142857142857,21.428571428571427
57762_marine,14,27,11,3,41,78.57142857142857,21.428571428571427
57763_marine,14,27,11,3,41,78.57142857142857,21.428571428571427
57764_marine,15,26,12,3,41,80,20
57765_marine,15,26,12,3,41,80,20
57766_marine,15,26,12,3,41,80,20
57767_marine,15,26,12,3,41,80,20
57768_marine,15,26,12,3,41,80,20
57769_marine,15,26,12,3,41,80,20
57770_marine,15,26,12,3,41,80,20
57771_marine,15,26,12,3,41,80,20
57772_marine,15,28,12,3,43,80,20
57773_marine,16,28,12,4,44,75,25
57774_marine,16,28,12,4,44,75,25
57775_marine,16,28,12,4,44,75,25
57776_marine,15,28,12,3,43,80,20
57777_marine,16,26,12,4,42,75,25
57778_marine,16,26,12,4,42,75,25
57779_marine,16,26,12,4,42,75,25
57780_marine,14,26,11,3,40,78.57142857142857,21.428571428571427
57781_marine,14,26,11,3,40,78.57142857142857,21.428571428571427
57782_marine,14,27,11,3,41,78.57142857142857,21.428571428571427
57783_marine,13,27,10,3,40,76.92307692307693,23.076923076923077
57784_marine,13,27,10,3,40,76.92307692307693,23.076923076923077
57785_marine,13,27,10,3,40,76.92307692307693,23.076923076923077
57786_marine,13,27,10,3,40,76.92307692307693,23.076923076923077
57787_marine,13,27,10,3,40,76.92307692307693,23.076923076923077
57788_marine,13,27,10,3,40,76.92307692307693,23.076923076923077
57789_marine,13,27,10,3,40,76.92307692307693,23.076923076923077
57790_marine,13,27,10,3,40,76.92307692307693,23.076923076923077
57791_marine,13,27,10,3,40,76.92307692307693,23.076923076923077
57792_marine,13,26,10,3,39,76.92307692307693,23.076923076923077
57793_marine,14,26,10,4,40,71.42857142857143,28.57142857142857
57794_marine,15,26,10,5,41,66.66666666666666,33.33333333333333
57795_marine,15,26,10,5,41,66.66666666666666,33.33333333333333
57796_marine,14,26,10,4,40,71.42857142857143,28.57142857142857
57797_marine,14,26,10,4,40,71.42857142857143,28.57142857142857
57798_marine,14,26,10,4,40,71.42857142857143,28.57142857142857
57799_marine,14,26,10,4,40,71.42857142857143,28.57142857142857
57800_marine,14,27,10,4,41,71.42857142857143,28.57142857142857
57801_marine,13,27,10,3,40,76.92307692307693,23.076923076923077
57802_marine,13,27,10,3,40,76.92307692307693,23.076923076923077
57803_marine,13,27,10,3,40,76.92307692307693,23.076923076923077
57804_marine,13,27,10,3,40,76.92307692307693,23.076923076923077
57805_marine,13,27,10,3,40,76.92307692307693,23.076923076923077
57806_marine,13,26,10,3,39,76.92307692307693,23.076923076923077
57807_marine,13,26,10,3,39,76.92307692307693,23.076923076923077
57808_marine,13,26,10,3,39,76.92307692307693,23.076923076923077
57809_marine,13,26,10,3,39,76.92307692307693,23.076923076923077
57819_marine,11,26,8,3,37,72.72727272727273,27.27272727272727
57849_marine,12,26,10,2,38,83.33333333333334,16.666666666666664
57850_marine,12,26,10,2,38,83.33333333333334,16.666666666666664
57851_marine,12,26,10,2,38,83.33333333333334,16.666666666666664
57852_marine,12,26,10,2,38,83.33333333333334,16.666666666666664
57853_marine,12,26,10,2,38,83.33333333333334,16.666666666666664
57854_marine,10,26,8,2,36,80,20
57941_marine,18,26,12,6,44,66.66666666666666,33.33333333333333
57942_marine,19,26,12,7,45,63.1578947368421,36.84210526315789
57943_marine,17,26,12,5,43,70.58823529411765,29.411764705882355
57944_marine,18,26,12,6,44,66.66666666666666,33.33333333333333
57945_marine,18,26,12,6,44,66.66666666666666,33.33333333333333
57946_marine,16,26,12,4,42,75,25
57947_marine,19,26,12,7,45,63.1578947368421,36.84210526315789
57948_marine,19,26,12,7,45,63.1578947368421,36.84210526315789
57949_marine,16,26,12,4,42,75,25
57950_marine,16,27,12,4,43,75,25
57951_marine,16,27,12,4,43,75,25
57952_marine,16,27,12,4,43,75,25
57953_marine,17,28,13,4,45,76.47058823529412,23.52941176470588
57954_marine,17,28,13,4,45,76.47058823529412,23.52941176470588
57955_marine,19,28,15,4,47,78.94736842105263,21.052631578947366
57956_marine,19,28,15,4,47,78.94736842105263,21.052631578947366
57957_marine,18,28,14,4,46,77.77777777777779,22.22222222222222
57958_marine,18,29,14,4,47,77.77777777777779,22.22222222222222
57959_marine,19,30,15,4,49,78.94736842105263,21.052631578947366
57960_marine,19,30,15,4,49,78.94736842105263,21.052631578947366
57961_marine,18,25,14,4,43,77.77777777777779,22.22222222222222
57962_marine,18,25,14,4,43,77.77777777777779,22.22222222222222
57963_marine,17,25,14,3,42,82.35294117647058,17.647058823529413
57964_marine,17,27,14,3,44,82.35294117647058,17.647058823529413
57965_marine,17,27,14,3,44,82.35294117647058,17.647058823529413
57966_marine,18,26,15,4,44,83.33333333333334,22.22222222222222
57967_marine,18,26,15,4,44,83.33333333333334,22.22222222222222
57968_marine,18,26,15,4,44,83.33333333333334,22.22222222222222
57969_marine,18,26,15,4,44,83.33333333333334,22.22222222222222
57970_marine,18,26,15,4,44,83.33333333333334,22.22222222222222
57971_marine,18,26,15,4,44,83.33333333333334,22.22222222222222
57972_marine,18,26,15,4,44,83.33333333333334,22.22222222222222
57973_marine,18,26,15,4,44,83.33333333333334,22.22222222222222
57974_marine,18,26,15,4,44,83.33333333333334,22.22222222222222
57975_marine,18,26,15,4,44,83.33333333333334,22.22222222222222
57976_marine,18,26,15,4,44,83.33333333333334,22.22222222222222
57977_marine,18,26,15,4,44,83.33333333333334,22.22222222222222
57978_marine,18,26,15,4,44,83.33333333333334,22.22222222222222
57979_marine,18,26,15,4,44,83.33333333333334,22.22222222222222
57980_marine,18,26,15,4,44,83.33333333333334,22.22222222222222
57981_marine,18,26,15,4,44,83.33333333333334,22.22222222222222
57982_marine,18,26,15,4,44,83.33333333333334,22.22222222222222
57983_marine,18,26,15,4,44,83.33333333333334,22.22222222222222
57984_marine,18,26,15,4,44,83.33333333333334,22.22222222222222
57985_marine,18,26,15,4,44,83.33333333333334,22.22222222222222
57986_marine,18,26,15,4,44,83.33333333333334,22.22222222222222
57987_marine,18,26,15,4,44,83.33333333333334,22.22222222222222
57988_marine,18,26,15,4,44,83.33333333333334,22.22222222222222
57989_marine,18,26,15,4,44,83.33333333333334,22.22222222222222
57990_marine,18,26,15,4,44,83.33333333333334,22.22222222222222
57991_marine,17,26,14,3,43,82.35294117647058,17.647058823529413
57992_marine,17,26,14,3,43,82.35294117647058,17.647058823529413
57993_marine,17,26,14,3,43,82.35294117647058,17.647058823529413
57994_marine,17,26,14,3,43,82.35294117647058,17.647058823529413
57995_marine,16,26,13,3,42,81.25,18.75
57996_marine,16,26,13,3,42,81.25,18.75
57997_marine,16,26,13,3,42,81.25,18.75
57998_marine,15,26,12,3,41,80,20
57999_marine,15,26,12,3,41,80,20
58000_marine,15,26,12,3,41,80,20
58001_marine,15,26,12,3,41,80,20
58002_marine,13,26,10,3,39,76.92307692307693,23.076923076923077
58003_marine,13,26,10,3,39,76.92307692307693,23.076923076923077
58004_marine,13,26,10,3,39,76.92307692307693,23.076923076923077
58005_marine,13,26,10,3,39,76.92307692307693,23.076923076923077
58006_marine,13,26,10,3,39,76.92307692307693,23.076923076923077
58007_marine,13,26,10,3,39,76.92307692307693,23.076923076923077
58008_marine,13,26,10,3,39,76.92307692307693,23.076923076923077
58009_marine,13,26,10,3,39,76.92307692307693,23.076923076923077
58010_marine,13,26,10,3,39,76.92307692307693,23.076923076923077
58011_marine,13,26,10,3,39,76.92307692307693,23.076923076923077
58012_marine,13,26,10,3,39,76.92307692307693,23.076923076923077
58013_marine,13,26,10,3,39,76.92307692307693,23.076923076923077
58014_marine,13,26,10,3,39,76.92307692307693,23.076923076923077
58015_marine,13,26,10,3,39,76.92307692307693,23.076923076923077
58016_marine,13,26,10,3,39,76.92307692307693,23.076923076923077
58017_marine,13,26,10,3,39,76.92307692307693,23.076923076923077
58018_marine,13,26,10,3,39,76.92307692307693,23.076923076923077
58019_marine,13,26,10,3,39,76.92307692307693,23.076923076923077
58020_marine,13,26,10,3,39,76.92307692307693,23.076923076923077
58021_marine,13,26,10,3,39,76.92307692307693,23.076923076923077
58022_marine,13,26,10,3,39,76.92307692307693,23.076923076923077
58023_marine,13,26,10,3,39,76.92307692307693,23.076923076923077
58024_marine,13,26,10,3,39,76.92307692307693,23.076923076923077
58025_marine,13,25,10,3,38,76.92307692307693,23.076923076923077
58026_marine,13,25,10,3,38,76.92307692307693,23.076923076923077
58027_marine,13,25,10,3,38,76.92307692307693,23.076923076923077
58028_marine,13,25,10,3,38,76.92307692307693,23.076923076923077
58029_marine,13,25,10,3,38,76.92307692307693,23.076923076923077
58030_marine,13,25,10,3,38,76.92307692307693,23.076923076923077
58031_marine,13,25,10,3,38,76.92307692307693,23.076923076923077
58032_marine,13,25,10,3,38,76.92307692307693,23.076923076923077
58033_marine,13,25,10,3,38,76.92307692307693,23.076923076923077
58034_marine,13,25,10,3,38,76.92307692307693,23.076923076923077
58035_marine,13,25,10,3,38,76.92307692307693,23.076923076923077
58036_marine,13,25,10,3,38,76.92307692307693,23.076923076923077
58037_marine,13,25,10,3,38,76.92307692307693,23.076923076923077
58038_marine,15,25,11,4,40,73.33333333333333,26.666666666666668
58039_marine,15,25,11,4,40,73.33333333333333,26.666666666666668
58040_marine,14,25,11,3,39,78.57142857142857,21.428571428571427
58041_marine,14,25,11,3,39,78.57142857142857,21.428571428571427
58042_marine,14,27,11,3,41,78.57142857142857,21.428571428571427
58043_marine,14,27,11,3,41,78.57142857142857,21.428571428571427
58044_marine,14,27,11,3,41,78.57142857142857,21.428571428571427
58045_marine,14,27,11,3,41,78.57142857142857,21.428571428571427
58046_marine,14,27,11,3,41,78.57142857142857,21.428571428571427
58047_marine,14,27,11,3,41,78.57142857142857,21.428571428571427
58048_marine,14,27,11,3,41,78.57142857142857,21.428571428571427
58049_marine,14,27,11,3,41,78.57142857142857,21.428571428571427
58050_marine,14,27,11,3,41,78.57142857142857,21.428571428571427
58051_marine,14,27,11,3,41,78.57142857142857,21.428571428571427
58052_marine,14,27,11,3,41,78.57142857142857,21.428571428571427
58053_marine,14,27,11,3,41,78.57142857142857,21.428571428571427
58054_marine,14,27,11,3,41,78.57142857142857,21.428571428571427
58055_marine,14,27,11,3,41,78.57142857142857,21.428571428571427
58056_marine,14,27,11,3,41,78.57142857142857,21.428571428571427
58057_marine,14,27,11,3,41,78.57142857142857,21.428571428571427
58058_marine,14,27,11,3,41,78.57142857142857,21.428571428571427
58059_marine,14,28,11,3,42,78.57142857142857,21.428571428571427
58060_marine,14,28,11,3,42,78.57142857142857,21.428571428571427
58061_marine,14,28,11,3,42,78.57142857142857,21.428571428571427
58062_marine,14,28,11,3,42,78.57142857142857,21.428571428571427
58063_marine,14,28,11,3,42,78.57142857142857,21.428571428571427
58064_marine,14,28,11,3,42,78.57142857142857,21.428571428571427
58065_marine,16,28,11,5,44,68.75,31.25
58066_marine,15,28,11,4,43,73.33333333333333,26.666666666666668
58067_marine,14,28,11,3,42,78.57142857142857,21.428571428571427
58068_marine,14,28,11,3,42,78.57142857142857,21.428571428571427
58069_marine,14,28,11,3,42,78.57142857142857,21.428571428571427
58070_marine,14,25,11,3,39,78.57142857142857,21.428571428571427
58071_marine,2,2,2,0,4,100,0
58072_marine,14,27,11,3,41,78.57142857142857,21.428571428571427
58073_marine,14,27,11,3,41,78.57142857142857,21.428571428571427
58074_marine,13,25,10,3,38,76.92307692307693,23.076923076923077
58079_marine,15,27,11,4,42,73.33333333333333,26.666666666666668
58080_marine,15,27,11,4,42,73.33333333333333,26.666666666666668
58081_marine,15,27,11,4,42,73.33333333333333,26.666666666666668
58082_marine,15,28,11,4,43,73.33333333333333,26.666666666666668
58083_marine,17,28,13,4,45,76.47058823529412,23.52941176470588
58084_marine,17,28,13,4,45,76.47058823529412,23.52941176470588
58085_marine,17,28,13,4,45,76.47058823529412,23.52941176470588
58086_marine,16,28,13,3,44,81.25,18.75
58087_marine,16,26,13,3,42,81.25,18.75
58088_marine,16,26,13,3,42,81.25,18.75
58089_marine,16,26,13,3,42,81.25,18.75
58090_marine,16,26,13,3,42,81.25,18.75
58091_marine,15,26,12,3,41,80,20
58092_marine,15,26,12,3,41,80,20
58093_marine,15,26,12,3,41,80,20
58094_marine,15,26,12,3,41,80,20
58095_marine,13,26,10,3,39,76.92307692307693,23.076923076923077
58096_marine,13,26,10,3,39,76.92307692307693,23.076923076923077
58097_marine,13,27,10,3,40,76.92307692307693,23.076923076923077
58098_marine,13,27,10,3,40,76.92307692307693,23.076923076923077
58099_marine,13,27,10,3,40,76.92307692307693,23.076923076923077
58100_marine,13,27,10,3,40,76.92307692307693,23.076923076923077
58101_marine,13,27,10,3,40,76.92307692307693,23.076923076923077
58102_marine,13,27,10,3,40,76.92307692307693,23.076923076923077
58103_marine,13,28,10,3,41,76.92307692307693,23.076923076923077
58104_marine,13,28,10,3,41,76.92307692307693,23.076923076923077
58105_marine,13,28,10,3,41,76.92307692307693,23.076923076923077
58106_marine,13,28,10,3,41,76.92307692307693,23.076923076923077
58107_marine,14,28,11,3,42,78.57142857142857,21.428571428571427
58108_marine,14,28,11,3,42,78.57142857142857,21.428571428571427
58109_marine,14,27,11,3,41,78.57142857142857,21.428571428571427
58110_marine,14,26,11,3,40,78.57142857142857,21.428571428571427
58111_marine,14,26,11,3,40,78.57142857142857,21.428571428571427
58112_marine,14,26,11,3,40,78.57142857142857,21.428571428571427
58113_marine,14,26,11,3,40,78.57142857142857,21.428571428571427
58114_marine,14,26,11,3,40,78.57142857142857,21.428571428571427
58115_marine,14,26,11,3,40,78.57142857142857,21.428571428571427
58116_marine,14,26,11,3,40,78.57142857142857,21.428571428571427
58117_marine,14,26,11,3,40,78.57142857142857,21.428571428571427
58118_marine,14,25,11,3,39,78.57142857142857,21.428571428571427
58119_marine,14,25,11,3,39,78.57142857142857,21.428571428571427
58120_marine,14,25,11,3,39,78.57142857142857,21.428571428571427
58121_marine,14,25,11,3,39,78.57142857142857,21.428571428571427
58122_marine,14,25,11,3,39,78.57142857142857,21.428571428571427
58123_marine,14,25,11,3,39,78.57142857142857,21.428571428571427
58124_marine,14,25,11,3,39,78.57142857142857,21.428571428571427
58125_marine,15,25,12,3,40,80,20
58126_marine,15,25,12,3,40,80,20
58127_marine,15,25,12,3,40,80,20
58128_marine,16,25,12,4,41,75,25
58129_marine,16,25,12,4,41,75,25
58130_marine,15,25,12,3,40,80,20
58131_marine,15,25,12,3,40,80,20
58132_marine,15,25,12,3,40,80,20
58133_marine,15,25,12,3,40,80,20
58134_marine,15,25,12,3,40,80,20
58135_marine,15,25,12,3,40,80,20
58136_marine,15,25,12,3,40,80,20
58137_marine,15,25,12,3,40,80,20
58138_marine,15,25,11,4,40,73.33333333333333,26.666666666666668
58139_marine,14,25,11,3,39,78.57142857142857,21.428571428571427
58140_marine,13,25,10,3,38,76.92307692307693,23.076923076923077
58141_marine,13,26,10,3,39,76.92307692307693,23.076923076923077
58142_marine,13,26,10,3,39,76.92307692307693,23.076923076923077
58210_marine,11,25,10,1,36,90.9090909090909,9.090909090909092
58211_marine,12,25,10,2,37,83.33333333333334,16.666666666666664
58212_marine,12,25,10,2,37,83.33333333333334,16.666666666666664
58303_marine,2,0,2,0,2,100,0
58308_marine,16,25,12,4,41,75,25
58309_marine,16,25,12,4,41,75,25
58310_marine,17,25,12,5,42,70.58823529411765,29.411764705882355
58311_marine,19,27,12,7,46,63.1578947368421,36.84210526315789
58312_marine,17,25,12,5,42,70.58823529411765,29.411764705882355
58313_marine,16,25,12,4,41,75,25
58314_marine,16,26,12,4,42,75,25
58315_marine,16,24,12,4,40,75,25
58316_marine,18,24,14,4,42,77.77777777777779,22.22222222222222
58317_marine,18,24,14,4,42,77.77777777777779,22.22222222222222
58318_marine,18,24,14,4,42,77.77777777777779,22.22222222222222
58319_marine,18,24,14,4,42,77.77777777777779,22.22222222222222
58320_marine,18,25,14,4,43,77.77777777777779,22.22222222222222
58321_marine,15,24,12,3,39,80,20
58322_marine,15,24,12,3,39,80,20
58323_marine,15,24,12,3,39,80,20
58324_marine,15,24,12,3,39,80,20
58325_marine,15,24,12,3,39,80,20
58326_marine,15,24,12,3,39,80,20
58327_marine,15,26,12,3,41,80,20
58328_marine,15,26,12,3,41,80,20
58329_marine,16,26,13,4,42,81.25,25
58330_marine,16,26,13,4,42,81.25,25
58331_marine,18,26,15,4,44,83.33333333333334,22.22222222222222
58332_marine,18,26,15,4,44,83.33333333333334,22.22222222222222
58333_marine,18,26,15,4,44,83.33333333333334,22.22222222222222
58334_marine,18,26,15,4,44,83.33333333333334,22.22222222222222
58335_marine,18,26,15,4,44,83.33333333333334,22.22222222222222
58336_marine,18,26,15,4,44,83.33333333333334,22.22222222222222
58337_marine,18,26,15,4,44,83.33333333333334,22.22222222222222
58338_marine,18,26,15,4,44,83.33333333333334,22.22222222222222
58339_marine,18,26,15,4,44,83.33333333333334,22.22222222222222
58340_marine,18,26,15,4,44,83.33333333333334,22.22222222222222
58341_marine,17,26,14,3,43,82.35294117647058,17.647058823529413
58342_marine,17,26,14,3,43,82.35294117647058,17.647058823529413
58343_marine,17,26,14,3,43,82.35294117647058,17.647058823529413
58344_marine,17,26,14,3,43,82.35294117647058,17.647058823529413
58345_marine,17,26,14,3,43,82.35294117647058,17.647058823529413
58346_marine,17,26,14,3,43,82.35294117647058,17.647058823529413
58347_marine,17,26,14,3,43,82.35294117647058,17.647058823529413
58348_marine,15,26,12,3,41,80,20
58349_marine,14,26,11,3,40,78.57142857142857,21.428571428571427
58350_marine,14,25,11,3,39,78.57142857142857,21.428571428571427
58351_marine,14,25,11,3,39,78.57142857142857,21.428571428571427
58352_marine,14,25,11,3,39,78.57142857142857,21.428571428571427
58353_marine,14,25,11,3,39,78.57142857142857,21.428571428571427
58354_marine,14,25,11,3,39,78.57142857142857,21.428571428571427
58355_marine,14,25,11,3,39,78.57142857142857,21.428571428571427
58356_marine,14,25,11,3,39,78.57142857142857,21.428571428571427
58357_marine,13,25,10,3,38,76.92307692307693,23.076923076923077
58358_marine,13,25,10,3,38,76.92307692307693,23.076923076923077
58359_marine,13,25,10,3,38,76.92307692307693,23.076923076923077
58360_marine,13,25,10,3,38,76.92307692307693,23.076923076923077
58361_marine,13,25,10,3,38,76.92307692307693,23.076923076923077
58362_marine,13,25,10,3,38,76.92307692307693,23.076923076923077
58363_marine,13,25,10,3,38,76.92307692307693,23.076923076923077
58364_marine,13,25,10,3,38,76.92307692307693,23.076923076923077
58365_marine,13,25,10,3,38,76.92307692307693,23.076923076923077
58366_marine,13,25,10,3,38,76.92307692307693,23.076923076923077
58367_marine,13,25,10,3,38,76.92307692307693,23.076923076923077
58368_marine,13,25,10,3,38,76.92307692307693,23.076923076923077
58369_marine,13,25,10,3,38,76.92307692307693,23.076923076923077
58370_marine,13,25,10,3,38,76.92307692307693,23.076923076923077
58371_marine,13,25,10,3,38,76.92307692307693,23.076923076923077
58372_marine,13,25,10,3,38,76.92307692307693,23.076923076923077
58373_marine,13,25,10,3,38,76.92307692307693,23.076923076923077
58374_marine,13,25,10,3,38,76.92307692307693,23.076923076923077
58375_marine,13,25,10,3,38,76.92307692307693,23.076923076923077
58376_marine,13,25,10,3,38,76.92307692307693,23.076923076923077
58377_marine,13,25,10,3,38,76.92307692307693,23.076923076923077
58378_marine,13,25,10,3,38,76.92307692307693,23.076923076923077
58379_marine,13,25,10,3,38,76.92307692307693,23.076923076923077
58380_marine,13,25,10,3,38,76.92307692307693,23.076923076923077
58381_marine,13,25,10,3,38,76.92307692307693,23.076923076923077
58382_marine,13,25,10,3,38,76.92307692307693,23.076923076923077
58383_marine,13,25,10,3,38,76.92307692307693,23.076923076923077
58384_marine,13,25,10,3,38,76.92307692307693,23.076923076923077
58385_marine,13,25,10,3,38,76.92307692307693,23.076923076923077
58386_marine,13,25,10,3,38,76.92307692307693,23.076923076923077
58387_marine,13,25,10,3,38,76.92307692307693,23.076923076923077
58388_marine,13,25,10,3,38,76.92307692307693,23.076923076923077
58389_marine,13,25,10,3,38,76.92307692307693,23.076923076923077
58390_marine,13,25,10,3,38,76.92307692307693,23.076923076923077
58391_marine,13,25,10,3,38,76.92307692307693,23.076923076923077
58392_marine,13,25,10,3,38,76.92307692307693,23.076923076923077
58393_marine,13,25,10,3,38,76.92307692307693,23.076923076923077
58394_marine,13,25,10,3,38,76.92307692307693,23.076923076923077
58395_marine,13,25,10,3,38,76.92307692307693,23.076923076923077
58396_marine,13,25,10,3,38,76.92307692307693,23.076923076923077
58397_marine,13,25,10,3,38,76.92307692307693,23.076923076923077
58398_marine,14,25,10,4,39,71.42857142857143,28.57142857142857
58399_marine,14,25,10,4,39,71.42857142857143,28.57142857142857
58400_marine,13,25,10,3,38,76.92307692307693,23.076923076923077
58401_marine,13,25,10,3,38,76.92307692307693,23.076923076923077
58402_marine,14,25,11,3,39,78.57142857142857,21.428571428571427
58403_marine,14,25,11,3,39,78.57142857142857,21.428571428571427
58404_marine,14,27,11,3,41,78.57142857142857,21.428571428571427
58405_marine,14,27,11,3,41,78.57142857142857,21.428571428571427
58406_marine,14,27,11,3,41,78.57142857142857,21.428571428571427
58407_marine,14,27,11,3,41,78.57142857142857,21.428571428571427
58408_marine,14,27,11,3,41,78.57142857142857,21.428571428571427
58409_marine,14,27,11,3,41,78.57142857142857,21.428571428571427
58410_marine,14,27,11,3,41,78.57142857142857,21.428571428571427
58411_marine,14,27,11,3,41,78.57142857142857,21.428571428571427
58412_marine,14,27,11,3,41,78.57142857142857,21.428571428571427
58413_marine,14,27,11,3,41,78.57142857142857,21.428571428571427
58414_marine,14,27,11,3,41,78.57142857142857,21.428571428571427
58415_marine,14,27,11,3,41,78.57142857142857,21.428571428571427
58416_marine,14,27,11,3,41,78.57142857142857,21.428571428571427
58417_marine,14,27,11,3,41,78.57142857142857,21.428571428571427
58418_marine,14,27,11,3,41,78.57142857142857,21.428571428571427
58419_marine,14,27,11,3,41,78.57142857142857,21.428571428571427
58420_marine,14,27,11,3,41,78.57142857142857,21.428571428571427
58421_marine,14,27,11,3,41,78.57142857142857,21.428571428571427
58422_marine,14,27,11,3,41,78.57142857142857,21.428571428571427
58423_marine,14,27,11,3,41,78.57142857142857,21.428571428571427
58424_marine,14,27,11,3,41,78.57142857142857,21.428571428571427
58425_marine,15,27,11,4,42,73.33333333333333,26.666666666666668
58426_marine,15,25,11,4,40,73.33333333333333,26.666666666666668
58427_marine,14,25,11,3,39,78.57142857142857,21.428571428571427
58428_marine,14,26,11,3,40,78.57142857142857,21.428571428571427
58429_marine,14,26,11,3,40,78.57142857142857,21.428571428571427
58430_marine,14,26,11,3,40,78.57142857142857,21.428571428571427
58431_marine,13,25,10,3,38,76.92307692307693,23.076923076923077
58432_marine,13,25,10,3,38,76.92307692307693,23.076923076923077
58433_marine,13,25,10,3,38,76.92307692307693,23.076923076923077
58434_marine,13,25,10,3,38,76.92307692307693,23.076923076923077
58439_marine,14,25,11,3,39,78.57142857142857,21.428571428571427
58440_marine,13,27,10,3,40,76.92307692307693,23.076923076923077
58441_marine,13,27,10,3,40,76.92307692307693,23.076923076923077
58442_marine,13,27,10,3,40,76.92307692307693,23.076923076923077
58443_marine,13,27,10,3,40,76.92307692307693,23.076923076923077
58444_marine,15,27,12,3,42,80,20
58445_marine,15,27,12,3,42,80,20
58446_marine,15,27,12,3,42,80,20
58447_marine,15,25,12,3,40,80,20
58448_marine,16,25,13,3,41,81.25,18.75
58449_marine,16,25,13,3,41,81.25,18.75
58450_marine,15,25,12,3,40,80,20
58451_marine,15,25,12,3,40,80,20
58452_marine,13,25,10,3,38,76.92307692307693,23.076923076923077
58453_marine,13,25,10,3,38,76.92307692307693,23.076923076923077
58454_marine,13,25,10,3,38,76.92307692307693,23.076923076923077
58455_marine,13,25,10,3,38,76.92307692307693,23.076923076923077
58456_marine,13,25,10,3,38,76.92307692307693,23.076923076923077
58457_marine,13,25,10,3,38,76.92307692307693,23.076923076923077
58458_marine,13,25,10,3,38,76.92307692307693,23.076923076923077
58459_marine,13,25,10,3,38,76.92307692307693,23.076923076923077
58460_marine,13,25,10,3,38,76.92307692307693,23.076923076923077
58461_marine,13,25,10,3,38,76.92307692307693,23.076923076923077
58462_marine,13,25,10,3,38,76.92307692307693,23.076923076923077
58463_marine,13,25,10,3,38,76.92307692307693,23.076923076923077
58464_marine,13,25,10,3,38,76.92307692307693,23.076923076923077
58465_marine,13,25,10,3,38,76.92307692307693,23.076923076923077
58466_marine,13,25,10,3,38,76.92307692307693,23.076923076923077
58467_marine,13,26,10,3,39,76.92307692307693,23.076923076923077
58468_marine,13,26,10,3,39,76.92307692307693,23.076923076923077
58469_marine,13,26,10,3,39,76.92307692307693,23.076923076923077
58470_marine,13,26,10,3,39,76.92307692307693,23.076923076923077
58471_marine,14,26,11,3,40,78.57142857142857,21.428571428571427
58472_marine,14,26,11,3,40,78.57142857142857,21.428571428571427
58473_marine,14,26,11,3,40,78.57142857142857,21.428571428571427
58474_marine,14,26,11,3,40,78.57142857142857,21.428571428571427
58475_marine,14,26,11,3,40,78.57142857142857,21.428571428571427
58476_marine,14,26,11,3,40,78.57142857142857,21.428571428571427
58477_marine,14,26,11,3,40,78.57142857142857,21.428571428571427
58478_marine,14,25,11,3,39,78.57142857142857,21.428571428571427
58479_marine,14,25,11,3,39,78.57142857142857,21.428571428571427
58480_marine,14,25,11,3,39,78.57142857142857,21.428571428571427
58481_marine,14,25,11,3,39,78.57142857142857,21.428571428571427
58482_marine,14,25,11,3,39,78.57142857142857,21.428571428571427
58483_marine,14,25,11,3,39,78.57142857142857,21.428571428571427
58484_marine,14,25,11,3,39,78.57142857142857,21.428571428571427
58485_marine,14,25,11,3,39,78.57142857142857,21.428571428571427
58486_marine,15,25,12,3,40,80,20
58487_marine,15,25,12,3,40,80,20
58488_marine,15,25,12,3,40,80,20
58489_marine,15,25,12,3,40,80,20
58667_marine,1,0,1,0,1,100,0
58669_marine,2,0,1,1,2,50,50
58670_marine,15,23,9,6,38,60,40
58671_marine,19,25,11,8,44,57.89473684210527,42.10526315789473
58672_marine,16,23,11,5,39,68.75,31.25
58673_marine,15,23,12,3,38,80,20
58674_marine,15,24,12,3,39,80,20
58675_marine,15,24,12,3,39,80,20
58676_marine,17,24,14,3,41,82.35294117647058,17.647058823529413
58677_marine,17,24,14,3,41,82.35294117647058,17.647058823529413
58678_marine,17,24,14,3,41,82.35294117647058,17.647058823529413
58679_marine,17,24,14,3,41,82.35294117647058,17.647058823529413
58680_marine,15,24,12,3,39,80,20
58681_marine,15,24,12,3,39,80,20
58682_marine,15,24,12,3,39,80,20
58683_marine,15,24,12,3,39,80,20
58684_marine,15,24,12,3,39,80,20
58685_marine,15,24,12,3,39,80,20
58686_marine,15,24,12,3,39,80,20
58687_marine,15,24,12,3,39,80,20
58688_marine,15,24,12,3,39,80,20
58689_marine,15,24,12,3,39,80,20
58690_marine,15,26,12,3,41,80,20
58691_marine,15,26,12,3,41,80,20
58692_marine,15,26,12,3,41,80,20
58693_marine,15,26,12,3,41,80,20
58694_marine,15,26,12,3,41,80,20
58695_marine,15,26,12,3,41,80,20
58696_marine,15,26,12,3,41,80,20
58697_marine,15,26,12,3,41,80,20
58698_marine,15,26,12,3,41,80,20
58699_marine,15,26,12,3,41,80,20
58700_marine,15,26,12,3,41,80,20
58701_marine,13,26,10,3,39,76.92307692307693,23.076923076923077
58702_marine,13,26,10,3,39,76.92307692307693,23.076923076923077
58703_marine,13,26,10,3,39,76.92307692307693,23.076923076923077
58704_marine,13,25,10,3,38,76.92307692307693,23.076923076923077
58705_marine,13,25,10,3,38,76.92307692307693,23.076923076923077
58706_marine,12,25,9,3,37,75,25
58707_marine,12,25,9,3,37,75,25
58708_marine,14,25,11,3,39,78.57142857142857,21.428571428571427
58709_marine,14,25,11,3,39,78.57142857142857,21.428571428571427
58710_marine,14,25,11,3,39,78.57142857142857,21.428571428571427
58711_marine,14,25,11,3,39,78.57142857142857,21.428571428571427
58712_marine,14,25,11,3,39,78.57142857142857,21.428571428571427
58713_marine,14,25,11,3,39,78.57142857142857,21.428571428571427
58714_marine,14,25,11,3,39,78.57142857142857,21.428571428571427
58715_marine,14,25,11,3,39,78.57142857142857,21.428571428571427
58716_marine,13,25,10,3,38,76.92307692307693,23.076923076923077
58717_marine,13,25,10,3,38,76.92307692307693,23.076923076923077
58718_marine,13,25,10,3,38,76.92307692307693,23.076923076923077
58719_marine,13,25,10,3,38,76.92307692307693,23.076923076923077
58720_marine,13,25,10,3,38,76.92307692307693,23.076923076923077
58721_marine,13,25,10,3,38,76.92307692307693,23.076923076923077
58722_marine,13,25,10,3,38,76.92307692307693,23.076923076923077
58723_marine,13,25,10,3,38,76.92307692307693,23.076923076923077
58724_marine,13,25,10,3,38,76.92307692307693,23.076923076923077
58725_marine,13,25,10,3,38,76.92307692307693,23.076923076923077
58726_marine,13,25,10,3,38,76.92307692307693,23.076923076923077
58727_marine,13,25,10,3,38,76.92307692307693,23.076923076923077
58728_marine,13,25,10,3,38,76.92307692307693,23.076923076923077
58729_marine,13,25,10,3,38,76.92307692307693,23.076923076923077
58730_marine,13,25,10,3,38,76.92307692307693,23.076923076923077
58731_marine,13,25,10,3,38,76.92307692307693,23.076923076923077
58732_marine,13,25,10,3,38,76.92307692307693,23.076923076923077
58733_marine,13,25,10,3,38,76.92307692307693,23.076923076923077
58734_marine,13,25,10,3,38,76.92307692307693,23.076923076923077
58735_marine,13,25,10,3,38,76.92307692307693,23.076923076923077
58736_marine,13,25,10,3,38,76.92307692307693,23.076923076923077
58737_marine,13,25,10,3,38,76.92307692307693,23.076923076923077
58738_marine,13,25,10,3,38,76.92307692307693,23.076923076923077
58739_marine,13,25,10,3,38,76.92307692307693,23.076923076923077
58740_marine,13,25,10,3,38,76.92307692307693,23.076923076923077
58741_marine,13,25,10,3,38,76.92307692307693,23.076923076923077
58742_marine,13,25,10,3,38,76.92307692307693,23.076923076923077
58743_marine,13,25,10,3,38,76.92307692307693,23.076923076923077
58744_marine,13,25,10,3,38,76.92307692307693,23.076923076923077
58745_marine,13,25,10,3,38,76.92307692307693,23.076923076923077
58746_marine,13,25,10,3,38,76.92307692307693,23.076923076923077
58747_marine,13,25,10,3,38,76.92307692307693,23.076923076923077
58748_marine,13,25,10,3,38,76.92307692307693,23.076923076923077
58749_marine,13,25,10,3,38,76.92307692307693,23.076923076923077
58750_marine,13,25,10,3,38,76.92307692307693,23.076923076923077
58751_marine,13,25,10,3,38,76.92307692307693,23.076923076923077
58752_marine,13,25,10,3,38,76.92307692307693,23.076923076923077
58753_marine,13,25,10,3,38,76.92307692307693,23.076923076923077
58754_marine,13,25,10,3,38,76.92307692307693,23.076923076923077
58755_marine,12,25,10,2,37,83.33333333333334,16.666666666666664
58756_marine,12,25,10,2,37,83.33333333333334,16.666666666666664
58757_marine,12,25,10,2,37,83.33333333333334,16.666666666666664
58758_marine,13,25,10,3,38,76.92307692307693,23.076923076923077
58759_marine,13,25,10,3,38,76.92307692307693,23.076923076923077
58760_marine,13,25,10,3,38,76.92307692307693,23.076923076923077
58761_marine,13,25,10,3,38,76.92307692307693,23.076923076923077
58762_marine,13,25,10,3,38,76.92307692307693,23.076923076923077
58763_marine,13,25,10,3,38,76.92307692307693,23.076923076923077
58764_marine,13,25,10,3,38,76.92307692307693,23.076923076923077
58765_marine,13,25,10,3,38,76.92307692307693,23.076923076923077
58766_marine,13,27,10,3,40,76.92307692307693,23.076923076923077
58767_marine,13,27,10,3,40,76.92307692307693,23.076923076923077
58768_marine,13,27,10,3,40,76.92307692307693,23.076923076923077
58769_marine,13,27,10,3,40,76.92307692307693,23.076923076923077
58770_marine,13,27,10,3,40,76.92307692307693,23.076923076923077
58772_marine,14,27,11,3,41,78.57142857142857,21.428571428571427
58773_marine,14,25,11,3,39,78.57142857142857,21.428571428571427
58774_marine,14,27,11,3,41,78.57142857142857,21.428571428571427
58775_marine,14,27,11,3,41,78.57142857142857,21.428571428571427
58776_marine,14,25,11,3,39,78.57142857142857,21.428571428571427
58777_marine,14,25,11,3,39,78.57142857142857,21.428571428571427
58778_marine,14,25,11,3,39,78.57142857142857,21.428571428571427
58779_marine,14,25,11,3,39,78.57142857142857,21.428571428571427
58780_marine,14,25,11,3,39,78.57142857142857,21.428571428571427
58781_marine,14,25,11,3,39,78.57142857142857,21.428571428571427
58782_marine,14,25,11,3,39,78.57142857142857,21.428571428571427
58783_marine,14,25,11,3,39,78.57142857142857,21.428571428571427
58784_marine,13,25,10,3,38,76.92307692307693,23.076923076923077
58785_marine,13,25,10,3,38,76.92307692307693,23.076923076923077
58786_marine,13,25,10,3,38,76.92307692307693,23.076923076923077
58787_marine,13,25,10,3,38,76.92307692307693,23.076923076923077
58788_marine,13,25,10,3,38,76.92307692307693,23.076923076923077
58789_marine,13,25,10,3,38,76.92307692307693,23.076923076923077
58790_marine,13,25,10,3,38,76.92307692307693,23.076923076923077
58791_marine,13,25,10,3,38,76.92307692307693,23.076923076923077
58792_marine,13,25,10,3,38,76.92307692307693,23.076923076923077
58799_marine,8,26,7,1,34,87.5,12.5
58800_marine,11,27,9,2,38,81.81818181818183,18.181818181818183
58801_marine,13,27,10,3,40,76.92307692307693,23.076923076923077
58802_marine,13,27,10,3,40,76.92307692307693,23.076923076923077
58803_marine,13,27,10,3,40,76.92307692307693,23.076923076923077
58804_marine,13,27,10,3,40,76.92307692307693,23.076923076923077
58805_marine,13,27,10,3,40,76.92307692307693,23.076923076923077
58806_marine,13,25,10,3,38,76.92307692307693,23.076923076923077
58807_marine,13,25,10,3,38,76.92307692307693,23.076923076923077
58808_marine,13,25,10,3,38,76.92307692307693,23.076923076923077
58809_marine,12,25,9,3,37,75,25
58810_marine,12,25,9,3,37,75,25
58811_marine,10,25,7,3,35,70,30
58812_marine,11,25,8,3,36,72.72727272727273,27.27272727272727
58813_marine,11,25,8,3,36,72.72727272727273,27.27272727272727
58814_marine,11,25,8,3,36,72.72727272727273,27.27272727272727
58815_marine,11,25,8,3,36,72.72727272727273,27.27272727272727
58816_marine,11,25,8,3,36,72.72727272727273,27.27272727272727
58817_marine,11,25,8,3,36,72.72727272727273,27.27272727272727
58818_marine,11,25,8,3,36,72.72727272727273,27.27272727272727
58819_marine,11,25,8,3,36,72.72727272727273,27.27272727272727
58820_marine,11,25,8,3,36,72.72727272727273,27.27272727272727
58821_marine,11,25,8,3,36,72.72727272727273,27.27272727272727
58822_marine,11,25,8,3,36,72.72727272727273,27.27272727272727
58823_marine,11,25,8,3,36,72.72727272727273,27.27272727272727
58824_marine,11,25,8,3,36,72.72727272727273,27.27272727272727
58825_marine,11,25,8,3,36,72.72727272727273,27.27272727272727
58826_marine,11,25,8,3,36,72.72727272727273,27.27272727272727
58827_marine,11,25,8,3,36,72.72727272727273,27.27272727272727
58828_marine,11,26,8,3,37,72.72727272727273,27.27272727272727
58829_marine,11,26,8,3,37,72.72727272727273,27.27272727272727
58830_marine,11,26,8,3,37,72.72727272727273,27.27272727272727
58831_marine,11,26,8,3,37,72.72727272727273,27.27272727272727
58832_marine,11,26,8,3,37,72.72727272727273,27.27272727272727
58833_marine,11,26,8,3,37,72.72727272727273,27.27272727272727
58834_marine,11,26,8,3,37,72.72727272727273,27.27272727272727
58835_marine,14,26,11,3,40,78.57142857142857,21.428571428571427
58836_marine,14,26,11,3,40,78.57142857142857,21.428571428571427
58837_marine,14,25,11,3,39,78.57142857142857,21.428571428571427
58838_marine,14,25,11,3,39,78.57142857142857,21.428571428571427
58839_marine,14,25,11,3,39,78.57142857142857,21.428571428571427
58840_marine,14,25,11,3,39,78.57142857142857,21.428571428571427
58841_marine,14,25,11,3,39,78.57142857142857,21.428571428571427
58842_marine,14,25,11,3,39,78.57142857142857,21.428571428571427
58843_marine,14,25,11,3,39,78.57142857142857,21.428571428571427
58844_marine,14,25,11,3,39,78.57142857142857,21.428571428571427
58845_marine,14,25,11,3,39,78.57142857142857,21.428571428571427
58846_marine,3,0,3,0,3,100,0
59025_marine,2,0,1,1,2,50,50
59026_marine,11,25,7,4,36,63.63636363636363,36.36363636363637
59027_marine,12,25,7,5,37,58.333333333333336,41.66666666666667
59028_marine,14,25,7,7,39,50,50
59029_marine,16,25,9,7,41,56.25,43.75
59030_marine,15,24,9,6,39,60,40
59031_marine,12,23,9,3,35,75,25
59032_marine,12,23,9,3,35,75,25
59033_marine,12,23,9,3,35,75,25
59034_marine,12,23,9,3,35,75,25
59035_marine,13,24,10,3,37,76.92307692307693,23.076923076923077
59036_marine,13,24,10,3,37,76.92307692307693,23.076923076923077
59037_marine,15,24,12,3,39,80,20
59038_marine,15,24,12,3,39,80,20
59039_marine,15,24,12,3,39,80,20
59040_marine,15,24,12,3,39,80,20
59041_marine,15,24,12,3,39,80,20
59042_marine,15,24,12,3,39,80,20
59043_marine,15,24,12,3,39,80,20
59044_marine,15,24,12,3,39,80,20
59045_marine,15,24,12,3,39,80,20
59046_marine,15,24,12,3,39,80,20
59047_marine,15,24,12,3,39,80,20
59048_marine,15,24,12,3,39,80,20
59049_marine,15,24,12,3,39,80,20
59050_marine,15,24,12,3,39,80,20
59051_marine,15,24,12,3,39,80,20
59052_marine,15,24,12,3,39,80,20
59053_marine,15,24,12,3,39,80,20
59054_marine,15,26,12,3,41,80,20
59055_marine,13,26,10,3,39,76.92307692307693,23.076923076923077
59056_marine,13,26,10,3,39,76.92307692307693,23.076923076923077
59057_marine,13,25,10,3,38,76.92307692307693,23.076923076923077
59058_marine,13,25,10,3,38,76.92307692307693,23.076923076923077
59059_marine,13,25,10,3,38,76.92307692307693,23.076923076923077
59060_marine,13,25,10,3,38,76.92307692307693,23.076923076923077
59061_marine,13,25,10,3,38,76.92307692307693,23.076923076923077
59062_marine,13,25,10,3,38,76.92307692307693,23.076923076923077
59063_marine,13,25,10,3,38,76.92307692307693,23.076923076923077
59064_marine,12,25,9,3,37,75,25
59065_marine,12,25,9,3,37,75,25
59066_marine,12,25,9,3,37,75,25
59067_marine,12,25,9,3,37,75,25
59068_marine,12,25,9,3,37,75,25
59069_marine,12,25,9,3,37,75,25
59070_marine,12,25,9,3,37,75,25
59071_marine,12,25,9,3,37,75,25
59072_marine,12,25,9,3,37,75,25
59073_marine,12,25,9,3,37,75,25
59074_marine,14,25,11,3,39,78.57142857142857,21.428571428571427
59075_marine,13,25,10,3,38,76.92307692307693,23.076923076923077
59076_marine,13,25,10,3,38,76.92307692307693,23.076923076923077
59077_marine,13,25,10,3,38,76.92307692307693,23.076923076923077
59078_marine,13,25,10,3,38,76.92307692307693,23.076923076923077
59079_marine,13,25,10,3,38,76.92307692307693,23.076923076923077
59080_marine,13,25,10,3,38,76.92307692307693,23.076923076923077
59081_marine,13,25,10,3,38,76.92307692307693,23.076923076923077
59082_marine,13,25,10,3,38,76.92307692307693,23.076923076923077
59083_marine,14,25,10,4,39,71.42857142857143,28.57142857142857
59084_marine,14,25,10,4,39,71.42857142857143,28.57142857142857
59085_marine,14,25,10,4,39,71.42857142857143,28.57142857142857
59086_marine,13,25,10,3,38,76.92307692307693,23.076923076923077
59087_marine,13,25,10,3,38,76.92307692307693,23.076923076923077
59088_marine,13,25,10,3,38,76.92307692307693,23.076923076923077
59089_marine,13,25,10,3,38,76.92307692307693,23.076923076923077
59090_marine,13,25,10,3,38,76.92307692307693,23.076923076923077
59091_marine,13,25,10,3,38,76.92307692307693,23.076923076923077
59092_marine,13,25,10,3,38,76.92307692307693,23.076923076923077
59093_marine,13,25,10,3,38,76.92307692307693,23.076923076923077
59094_marine,13,25,10,3,38,76.92307692307693,23.076923076923077
59095_marine,13,25,10,3,38,76.92307692307693,23.076923076923077
59096_marine,13,25,10,3,38,76.92307692307693,23.076923076923077
59097_marine,13,25,10,3,38,76.92307692307693,23.076923076923077
59098_marine,13,25,10,3,38,76.92307692307693,23.076923076923077
59099_marine,13,25,10,3,38,76.92307692307693,23.076923076923077
59100_marine,13,25,10,3,38,76.92307692307693,23.076923076923077
59101_marine,13,25,10,3,38,76.92307692307693,23.076923076923077
59102_marine,13,25,10,3,38,76.92307692307693,23.076923076923077
59103_marine,12,25,10,2,37,83.33333333333334,16.666666666666664
59104_marine,12,25,10,2,37,83.33333333333334,16.666666666666664
59105_marine,12,25,10,2,37,83.33333333333334,16.666666666666664
59106_marine,12,25,10,2,37,83.33333333333334,16.666666666666664
59107_marine,12,25,10,2,37,83.33333333333334,16.666666666666664
59108_marine,12,25,10,2,37,83.33333333333334,16.666666666666664
59109_marine,12,25,10,2,37,83.33333333333334,16.666666666666664
59110_marine,12,25,10,2,37,83.33333333333334,16.666666666666664
59111_marine,12,25,10,2,37,83.33333333333334,16.666666666666664
59112_marine,12,25,10,2,37,83.33333333333334,16.666666666666664
59113_marine,12,25,10,2,37,83.33333333333334,16.666666666666664
59114_marine,12,25,10,2,37,83.33333333333334,16.666666666666664
59115_marine,12,25,10,2,37,83.33333333333334,16.666666666666664
59116_marine,12,25,10,2,37,83.33333333333334,16.666666666666664
59117_marine,12,25,10,2,37,83.33333333333334,16.666666666666664
59118_marine,12,25,10,2,37,83.33333333333334,16.666666666666664
59119_marine,12,25,10,2,37,83.33333333333334,16.666666666666664
59120_marine,12,25,10,2,37,83.33333333333334,16.666666666666664
59158_marine,8,23,7,1,31,87.5,12.5
59159_marine,8,24,7,1,32,87.5,12.5
59160_marine,8,24,7,1,32,87.5,12.5
59161_marine,9,24,7,2,33,77.77777777777779,22.22222222222222
59162_marine,9,24,7,2,33,77.77777777777779,22.22222222222222
59163_marine,10,24,7,3,34,70,30
59164_marine,10,26,7,3,36,70,30
59165_marine,10,24,7,3,34,70,30
59166_marine,10,24,7,3,34,70,30
59167_marine,10,24,7,3,34,70,30
59168_marine,10,24,7,3,34,70,30
59169_marine,10,25,7,3,35,70,30
59170_marine,10,25,7,3,35,70,30
59171_marine,10,25,7,3,35,70,30
59172_marine,10,25,7,3,35,70,30
59173_marine,10,25,7,3,35,70,30
59174_marine,10,25,7,3,35,70,30
59175_marine,10,25,7,3,35,70,30
59176_marine,11,25,8,3,36,72.72727272727273,27.27272727272727
59177_marine,11,25,8,3,36,72.72727272727273,27.27272727272727
59178_marine,11,25,8,3,36,72.72727272727273,27.27272727272727
59179_marine,11,25,8,3,36,72.72727272727273,27.27272727272727
59180_marine,11,25,8,3,36,72.72727272727273,27.27272727272727
59181_marine,11,25,8,3,36,72.72727272727273,27.27272727272727
59182_marine,11,25,8,3,36,72.72727272727273,27.27272727272727
59183_marine,11,25,8,3,36,72.72727272727273,27.27272727272727
59184_marine,11,25,8,3,36,72.72727272727273,27.27272727272727
59185_marine,11,25,8,3,36,72.72727272727273,27.27272727272727
59186_marine,11,25,8,3,36,72.72727272727273,27.27272727272727
59187_marine,11,25,8,3,36,72.72727272727273,27.27272727272727
59188_marine,11,25,8,3,36,72.72727272727273,27.27272727272727
59189_marine,11,26,8,3,37,72.72727272727273,27.27272727272727
59190_marine,11,26,8,3,37,72.72727272727273,27.27272727272727
59191_marine,11,26,8,3,37,72.72727272727273,27.27272727272727
59192_marine,11,26,8,3,37,72.72727272727273,27.27272727272727
59193_marine,11,26,8,3,37,72.72727272727273,27.27272727272727
59194_marine,11,26,8,3,37,72.72727272727273,27.27272727272727
59195_marine,11,26,8,3,37,72.72727272727273,27.27272727272727
59196_marine,11,26,8,3,37,72.72727272727273,27.27272727272727
59197_marine,11,25,8,3,36,72.72727272727273,27.27272727272727
59198_marine,11,25,8,3,36,72.72727272727273,27.27272727272727
59199_marine,12,25,8,4,37,66.66666666666666,33.33333333333333
59200_marine,12,25,8,4,37,66.66666666666666,33.33333333333333
59201_marine,13,25,9,4,38,69.23076923076923,30.76923076923077
59202_marine,4,0,3,1,4,75,25
59203_marine,3,0,3,0,3,100,0
59204_marine,3,0,3,0,3,100,0
59205_marine,3,0,3,0,3,100,0
59206_marine,3,0,3,0,3,100,0
59383_marine,9,24,5,4,33,55.55555555555556,44.44444444444444
59384_marine,12,26,7,5,38,58.333333333333336,41.66666666666667
59385_marine,11,26,7,4,37,63.63636363636363,36.36363636363637
59386_marine,11,25,7,4,36,63.63636363636363,36.36363636363637
59387_marine,11,25,7,4,36,63.63636363636363,36.36363636363637
59388_marine,11,25,7,4,36,63.63636363636363,36.36363636363637
59389_marine,11,25,7,4,36,63.63636363636363,36.36363636363637
59390_marine,10,23,7,3,33,70,30
59391_marine,10,23,7,3,33,70,30
59392_marine,10,23,7,3,33,70,30
59393_marine,10,23,7,3,33,70,30
59394_marine,10,23,7,3,33,70,30
59395_marine,10,23,7,3,33,70,30
59396_marine,10,24,7,3,34,70,30
59397_marine,13,24,10,3,37,76.92307692307693,23.076923076923077
59398_marine,13,24,10,3,37,76.92307692307693,23.076923076923077
59399_marine,13,24,10,3,37,76.92307692307693,23.076923076923077
59400_marine,13,24,10,3,37,76.92307692307693,23.076923076923077
59401_marine,15,24,12,3,39,80,20
59402_marine,15,24,12,3,39,80,20
59403_marine,15,24,12,3,39,80,20
59404_marine,15,24,12,3,39,80,20
59405_marine,15,24,12,3,39,80,20
59406_marine,15,24,12,3,39,80,20
59407_marine,15,24,12,3,39,80,20
59408_marine,15,23,12,3,38,80,20
59409_marine,15,23,12,3,38,80,20
59410_marine,15,23,12,3,38,80,20
59411_marine,15,23,12,3,38,80,20
59412_marine,13,23,10,3,36,76.92307692307693,23.076923076923077
59413_marine,13,23,10,3,36,76.92307692307693,23.076923076923077
59414_marine,13,23,10,3,36,76.92307692307693,23.076923076923077
59415_marine,13,23,10,3,36,76.92307692307693,23.076923076923077
59416_marine,13,23,10,3,36,76.92307692307693,23.076923076923077
59417_marine,13,23,10,3,36,76.92307692307693,23.076923076923077
59418_marine,13,25,10,3,38,76.92307692307693,23.076923076923077
59419_marine,13,25,10,3,38,76.92307692307693,23.076923076923077
59420_marine,13,25,10,3,38,76.92307692307693,23.076923076923077
59421_marine,13,25,10,3,38,76.92307692307693,23.076923076923077
59422_marine,12,25,9,3,37,75,25
59423_marine,12,25,9,3,37,75,25
59424_marine,12,25,9,3,37,75,25
59425_marine,12,25,9,3,37,75,25
59426_marine,12,25,9,3,37,75,25
59427_marine,12,25,9,3,37,75,25
59428_marine,12,25,9,3,37,75,25
59429_marine,12,25,9,3,37,75,25
59430_marine,12,25,9,3,37,75,25
59431_marine,12,25,9,3,37,75,25
59432_marine,12,25,9,3,37,75,25
59433_marine,12,25,9,3,37,75,25
59434_marine,11,25,8,3,36,72.72727272727273,27.27272727272727
59435_marine,11,25,8,3,36,72.72727272727273,27.27272727272727
59436_marine,11,25,8,3,36,72.72727272727273,27.27272727272727
59437_marine,11,25,8,3,36,72.72727272727273,27.27272727272727
59438_marine,11,25,8,3,36,72.72727272727273,27.27272727272727
59439_marine,13,25,10,3,38,76.92307692307693,23.076923076923077
59440_marine,13,25,10,3,38,76.92307692307693,23.076923076923077
59441_marine,13,25,10,3,38,76.92307692307693,23.076923076923077
59442_marine,13,25,10,3,38,76.92307692307693,23.076923076923077
59443_marine,13,25,10,3,38,76.92307692307693,23.076923076923077
59444_marine,14,25,10,4,39,71.42857142857143,28.57142857142857
59474_marine,12,25,10,2,37,83.33333333333334,16.666666666666664
59475_marine,12,25,10,2,37,83.33333333333334,16.666666666666664
59478_marine,12,25,10,2,37,83.33333333333334,16.666666666666664
59479_marine,12,25,10,2,37,83.33333333333334,16.666666666666664
59480_marine,12,25,10,2,37,83.33333333333334,16.666666666666664
59514_marine,7,19,6,1,26,85.71428571428571,14.285714285714285
59515_marine,7,19,6,1,26,85.71428571428571,14.285714285714285
59516_marine,7,19,6,1,26,85.71428571428571,14.285714285714285
59517_marine,7,21,6,1,28,85.71428571428571,14.285714285714285
59518_marine,8,23,7,1,31,87.5,12.5
59519_marine,8,23,7,1,31,87.5,12.5
59520_marine,8,23,7,1,31,87.5,12.5
59521_marine,8,23,7,1,31,87.5,12.5
59522_marine,8,23,7,1,31,87.5,12.5
59523_marine,8,23,7,1,31,87.5,12.5
59524_marine,9,23,7,2,32,77.77777777777779,22.22222222222222
59525_marine,9,23,7,2,32,77.77777777777779,22.22222222222222
59526_marine,10,23,7,3,33,70,30
59527_marine,10,23,7,3,33,70,30
59528_marine,10,23,7,3,33,70,30
59529_marine,10,23,7,3,33,70,30
59530_marine,10,24,7,3,34,70,30
59531_marine,10,24,7,3,34,70,30
59532_marine,10,24,7,3,34,70,30
59533_marine,10,24,7,3,34,70,30
59534_marine,10,24,7,3,34,70,30
59535_marine,10,25,7,3,35,70,30
59536_marine,10,25,7,3,35,70,30
59537_marine,10,25,7,3,35,70,30
59538_marine,10,25,7,3,35,70,30
59539_marine,10,25,7,3,35,70,30
59540_marine,11,25,8,3,36,72.72727272727273,27.27272727272727
59541_marine,11,25,8,3,36,72.72727272727273,27.27272727272727
59542_marine,11,25,8,3,36,72.72727272727273,27.27272727272727
59543_marine,11,25,8,3,36,72.72727272727273,27.27272727272727
59544_marine,11,25,8,3,36,72.72727272727273,27.27272727272727
59545_marine,11,25,8,3,36,72.72727272727273,27.27272727272727
59546_marine,11,25,8,3,36,72.72727272727273,27.27272727272727
59547_marine,11,25,8,3,36,72.72727272727273,27.27272727272727
59548_marine,11,25,8,3,36,72.72727272727273,27.27272727272727
59549_marine,11,25,8,3,36,72.72727272727273,27.27272727272727
59550_marine,11,26,8,3,37,72.72727272727273,27.27272727272727
59551_marine,11,26,8,3,37,72.72727272727273,27.27272727272727
59552_marine,11,26,8,3,37,72.72727272727273,27.27272727272727
59553_marine,11,26,8,3,37,72.72727272727273,27.27272727272727
59554_marine,11,26,8,3,37,72.72727272727273,27.27272727272727
59555_marine,12,26,8,4,38,66.66666666666666,33.33333333333333
59556_marine,12,26,8,4,38,66.66666666666666,33.33333333333333
59557_marine,10,26,7,3,36,70,30
59741_marine,1,0,1,0,1,100,0
59742_marine,2,1,1,1,3,50,50
59743_marine,11,26,7,4,37,63.63636363636363,36.36363636363637
59744_marine,12,26,7,5,38,58.333333333333336,41.66666666666667
59745_marine,11,26,7,4,37,63.63636363636363,36.36363636363637
59746_marine,10,25,7,3,35,70,30
59747_marine,10,25,7,3,35,70,30
59748_marine,10,23,7,3,33,70,30
59749_marine,10,23,7,3,33,70,30
59750_marine,10,23,7,3,33,70,30
59751_marine,10,23,7,3,33,70,30
59752_marine,10,23,7,3,33,70,30
59753_marine,10,23,7,3,33,70,30
59754_marine,10,23,7,3,33,70,30
59755_marine,10,23,7,3,33,70,30
59756_marine,10,23,7,3,33,70,30
59757_marine,10,23,7,3,33,70,30
59758_marine,12,24,9,3,36,75,25
59759_marine,13,24,10,3,37,76.92307692307693,23.076923076923077
59760_marine,13,24,10,3,37,76.92307692307693,23.076923076923077
59761_marine,12,23,9,3,35,75,25
59762_marine,12,23,9,3,35,75,25
59763_marine,12,23,9,3,35,75,25
59764_marine,12,22,9,3,34,75,25
59765_marine,12,22,9,3,34,75,25
59766_marine,12,22,9,3,34,75,25
59767_marine,12,23,9,3,35,75,25
59768_marine,12,23,9,3,35,75,25
59769_marine,10,23,7,3,33,70,30
59770_marine,10,23,7,3,33,70,30
59771_marine,10,23,7,3,33,70,30
59772_marine,11,23,8,3,34,72.72727272727273,27.27272727272727
59773_marine,11,23,8,3,34,72.72727272727273,27.27272727272727
59774_marine,11,23,8,3,34,72.72727272727273,27.27272727272727
59775_marine,11,23,8,3,34,72.72727272727273,27.27272727272727
59776_marine,11,23,8,3,34,72.72727272727273,27.27272727272727
59777_marine,11,23,8,3,34,72.72727272727273,27.27272727272727
59778_marine,11,23,8,3,34,72.72727272727273,27.27272727272727
59779_marine,11,23,8,3,34,72.72727272727273,27.27272727272727
59780_marine,11,23,8,3,34,72.72727272727273,27.27272727272727
59781_marine,10,23,7,3,33,70,30
59782_marine,10,25,7,3,35,70,30
59783_marine,10,25,7,3,35,70,30
59784_marine,10,25,7,3,35,70,30
59785_marine,10,25,7,3,35,70,30
59786_marine,10,25,7,3,35,70,30
59787_marine,10,25,7,3,35,70,30
59788_marine,10,25,7,3,35,70,30
59789_marine,10,25,7,3,35,70,30
59790_marine,10,25,7,3,35,70,30
59791_marine,10,25,7,3,35,70,30
59792_marine,10,25,7,3,35,70,30
59793_marine,8,25,6,2,33,75,25
59794_marine,9,25,6,3,34,66.66666666666666,33.33333333333333
59795_marine,8,25,6,2,33,75,25
59863_marine,3,19,2,1,22,66.66666666666666,33.33333333333333
59864_marine,3,19,2,1,22,66.66666666666666,33.33333333333333
59865_marine,3,19,2,1,22,66.66666666666666,33.33333333333333
59871_marine,5,19,4,1,24,80,20
59872_marine,5,19,4,1,24,80,20
59873_marine,7,19,6,1,26,85.71428571428571,14.285714285714285
59874_marine,7,19,6,1,26,85.71428571428571,14.285714285714285
59875_marine,7,19,6,1,26,85.71428571428571,14.285714285714285
59876_marine,7,19,6,1,26,85.71428571428571,14.285714285714285
59877_marine,7,19,6,1,26,85.71428571428571,14.285714285714285
59878_marine,7,19,6,1,26,85.71428571428571,14.285714285714285
59879_marine,7,19,6,1,26,85.71428571428571,14.285714285714285
59880_marine,7,21,6,1,28,85.71428571428571,14.285714285714285
59881_marine,7,23,6,1,30,85.71428571428571,14.285714285714285
59882_marine,7,23,6,1,30,85.71428571428571,14.285714285714285
59883_marine,7,23,6,1,30,85.71428571428571,14.285714285714285
59884_marine,7,23,6,1,30,85.71428571428571,14.285714285714285
59885_marine,7,23,6,1,30,85.71428571428571,14.285714285714285
59886_marine,7,23,6,1,30,85.71428571428571,14.285714285714285
59887_marine,7,23,6,1,30,85.71428571428571,14.285714285714285
59888_marine,7,23,6,1,30,85.71428571428571,14.285714285714285
59889_marine,8,23,6,2,31,75,25
59890_marine,8,23,6,2,31,75,25
59891_marine,9,23,6,3,32,66.66666666666666,33.33333333333333
59892_marine,9,23,6,3,32,66.66666666666666,33.33333333333333
59893_marine,9,23,6,3,32,66.66666666666666,33.33333333333333
59894_marine,9,23,6,3,32,66.66666666666666,33.33333333333333
59895_marine,9,23,6,3,32,66.66666666666666,33.33333333333333
59896_marine,9,23,6,3,32,66.66666666666666,33.33333333333333
59897_marine,9,23,6,3,32,66.66666666666666,33.33333333333333
59898_marine,9,23,6,3,32,66.66666666666666,33.33333333333333
59899_marine,9,23,6,3,32,66.66666666666666,33.33333333333333
59900_marine,9,24,6,3,33,66.66666666666666,33.33333333333333
59901_marine,9,24,6,3,33,66.66666666666666,33.33333333333333
59902_marine,9,24,6,3,33,66.66666666666666,33.33333333333333
59903_marine,9,24,6,3,33,66.66666666666666,33.33333333333333
59904_marine,10,24,7,3,34,70,30
59905_marine,10,24,7,3,34,70,30
59906_marine,10,25,7,3,35,70,30
59907_marine,10,25,7,3,35,70,30
59908_marine,10,25,7,3,35,70,30
59909_marine,10,25,7,3,35,70,30
59910_marine,9,25,6,3,34,66.66666666666666,33.33333333333333
59911_marine,9,25,6,3,34,66.66666666666666,33.33333333333333
59912_marine,9,26,6,3,35,66.66666666666666,33.33333333333333
59913_marine,9,26,6,3,35,66.66666666666666,33.33333333333333
59914_marine,9,26,6,3,35,66.66666666666666,33.33333333333333
60103_marine,10,24,6,4,34,60,40
60104_marine,10,24,7,3,34,70,30
60105_marine,10,24,7,3,34,70,30
60106_marine,10,24,7,3,34,70,30
60107_marine,11,22,7,4,33,63.63636363636363,36.36363636363637
60108_marine,10,22,7,3,32,70,30
60109_marine,10,22,7,3,32,70,30
60110_marine,9,22,6,3,31,66.66666666666666,33.33333333333333
60111_marine,9,22,6,3,31,66.66666666666666,33.33333333333333
60112_marine,9,22,6,3,31,66.66666666666666,33.33333333333333
60113_marine,9,22,6,3,31,66.66666666666666,33.33333333333333
60114_marine,9,22,6,3,31,66.66666666666666,33.33333333333333
60115_marine,9,22,6,3,31,66.66666666666666,33.33333333333333
60116_marine,9,22,6,3,31,66.66666666666666,33.33333333333333
60117_marine,9,22,6,3,31,66.66666666666666,33.33333333333333
60118_marine,11,22,8,3,33,72.72727272727273,27.27272727272727
60119_marine,11,22,8,3,33,72.72727272727273,27.27272727272727
60120_marine,12,22,9,3,34,75,25
60121_marine,12,21,9,3,33,75,25
60122_marine,12,21,9,3,33,75,25
60123_marine,12,21,9,3,33,75,25
60124_marine,12,21,9,3,33,75,25
60125_marine,12,22,9,3,34,75,25
60126_marine,12,22,9,3,34,75,25
60127_marine,12,22,9,3,34,75,25
60128_marine,10,22,7,3,32,70,30
60129_marine,10,22,7,3,32,70,30
60130_marine,10,22,7,3,32,70,30
60131_marine,10,22,7,3,32,70,30
60132_marine,10,22,7,3,32,70,30
60133_marine,10,22,7,3,32,70,30
60134_marine,10,22,7,3,32,70,30
60135_marine,10,22,7,3,32,70,30
60136_marine,10,22,7,3,32,70,30
60137_marine,10,22,7,3,32,70,30
60138_marine,10,23,7,3,33,70,30
60139_marine,10,23,7,3,33,70,30
60140_marine,10,23,7,3,33,70,30
60141_marine,10,23,7,3,33,70,30
60142_marine,9,23,7,2,32,77.77777777777779,22.22222222222222
60143_marine,9,24,7,2,33,77.77777777777779,22.22222222222222
60144_marine,9,23,7,2,32,77.77777777777779,22.22222222222222
60145_marine,9,25,7,2,34,77.77777777777779,22.22222222222222
60146_marine,10,25,7,3,35,70,30
60147_marine,10,25,7,3,35,70,30
60148_marine,9,25,7,2,34,77.77777777777779,22.22222222222222
60149_marine,9,25,7,2,34,77.77777777777779,22.22222222222222
60150_marine,9,25,7,2,34,77.77777777777779,22.22222222222222
60151_marine,9,25,7,2,34,77.77777777777779,22.22222222222222
60152_marine,9,25,7,2,34,77.77777777777779,22.22222222222222
60153_marine,8,25,6,2,33,75,25
60154_marine,8,25,6,2,33,75,25
60155_marine,8,25,6,2,33,75,25
60219_marine,3,19,2,1,22,66.66666666666666,33.33333333333333
60220_marine,3,19,2,1,22,66.66666666666666,33.33333333333333
60224_marine,3,19,2,1,22,66.66666666666666,33.33333333333333
60225_marine,3,19,2,1,22,66.66666666666666,33.33333333333333
60226_marine,3,18,2,1,21,66.66666666666666,33.33333333333333
60227_marine,3,18,2,1,21,66.66666666666666,33.33333333333333
60228_marine,3,18,2,1,21,66.66666666666666,33.33333333333333
60232_marine,3,18,2,1,21,66.66666666666666,33.33333333333333
60233_marine,3,18,2,1,21,66.66666666666666,33.33333333333333
60234_marine,3,18,2,1,21,66.66666666666666,33.33333333333333
60235_marine,3,18,2,1,21,66.66666666666666,33.33333333333333
60236_marine,3,18,2,1,21,66.66666666666666,33.33333333333333
60237_marine,3,18,2,1,21,66.66666666666666,33.33333333333333
60238_marine,3,18,2,1,21,66.66666666666666,33.33333333333333
60239_marine,3,18,2,1,21,66.66666666666666,33.33333333333333
60240_marine,3,18,2,1,21,66.66666666666666,33.33333333333333
60241_marine,3,18,2,1,21,66.66666666666666,33.33333333333333
60242_marine,3,18,2,1,21,66.66666666666666,33.33333333333333
60243_marine,3,22,2,1,25,66.66666666666666,33.33333333333333
60244_marine,3,22,2,1,25,66.66666666666666,33.33333333333333
60245_marine,3,22,2,1,25,66.66666666666666,33.33333333333333
60246_marine,3,22,2,1,25,66.66666666666666,33.33333333333333
60247_marine,3,22,2,1,25,66.66666666666666,33.33333333333333
60248_marine,3,22,2,1,25,66.66666666666666,33.33333333333333
60249_marine,3,22,2,1,25,66.66666666666666,33.33333333333333
60250_marine,3,22,2,1,25,66.66666666666666,33.33333333333333
60251_marine,4,22,2,2,26,50,50
60252_marine,4,22,2,2,26,50,50
60253_marine,4,22,2,2,26,50,50
60254_marine,3,22,2,1,25,66.66666666666666,33.33333333333333
60255_marine,3,22,2,1,25,66.66666666666666,33.33333333333333
60256_marine,5,22,4,1,27,80,20
60257_marine,5,22,4,1,27,80,20
60258_marine,5,22,4,1,27,80,20
60259_marine,6,22,4,2,28,66.66666666666666,33.33333333333333
60260_marine,6,22,4,2,28,66.66666666666666,33.33333333333333
60261_marine,6,23,4,2,29,66.66666666666666,33.33333333333333
60262_marine,6,23,4,2,29,66.66666666666666,33.33333333333333
60263_marine,6,23,4,2,29,66.66666666666666,33.33333333333333
60264_marine,6,23,4,2,29,66.66666666666666,33.33333333333333
60265_marine,6,23,4,2,29,66.66666666666666,33.33333333333333
60266_marine,4,23,2,2,27,50,50
60267_marine,4,24,2,2,28,50,50
60268_marine,4,24,2,2,28,50,50
60269_marine,4,24,2,2,28,50,50
60463_marine,9,21,6,3,30,66.66666666666666,33.33333333333333
60464_marine,10,21,6,4,31,60,40
60465_marine,10,21,6,4,31,60,40
60466_marine,10,21,5,5,31,50,50
60467_marine,10,21,5,5,31,50,50
60468_marine,10,21,5,5,31,50,50
60469_marine,10,21,5,5,31,50,50
60470_marine,10,21,5,5,31,50,50
60471_marine,8,21,5,3,29,62.5,37.5
60472_marine,8,21,5,3,29,62.5,37.5
60473_marine,8,21,5,3,29,62.5,37.5
60474_marine,8,21,5,3,29,62.5,37.5
60475_marine,8,21,5,3,29,62.5,37.5
60476_marine,8,21,5,3,29,62.5,37.5
60477_marine,8,21,5,3,29,62.5,37.5
60478_marine,8,21,5,3,29,62.5,37.5
60479_marine,8,21,5,3,29,62.5,37.5
60480_marine,11,21,8,3,32,72.72727272727273,27.27272727272727
60481_marine,9,21,6,3,30,66.66666666666666,33.33333333333333
60482_marine,9,21,6,3,30,66.66666666666666,33.33333333333333
60483_marine,9,21,6,3,30,66.66666666666666,33.33333333333333
60484_marine,9,21,6,3,30,66.66666666666666,33.33333333333333
60485_marine,9,21,6,3,30,66.66666666666666,33.33333333333333
60486_marine,9,21,6,3,30,66.66666666666666,33.33333333333333
60487_marine,9,21,6,3,30,66.66666666666666,33.33333333333333
60488_marine,8,21,6,2,29,75,25
60489_marine,8,21,6,2,29,75,25
60490_marine,8,21,6,2,29,75,25
60491_marine,8,21,6,2,29,75,25
60492_marine,8,21,6,2,29,75,25
60493_marine,9,21,7,2,30,77.77777777777779,22.22222222222222
60494_marine,9,21,7,2,30,77.77777777777779,22.22222222222222
60495_marine,9,21,7,2,30,77.77777777777779,22.22222222222222
60496_marine,8,21,6,2,29,75,25
60497_marine,8,21,6,2,29,75,25
60498_marine,8,21,6,2,29,75,25
60499_marine,8,21,6,2,29,75,25
60500_marine,8,21,6,2,29,75,25
60501_marine,8,22,6,2,30,75,25
60502_marine,8,23,6,2,31,75,25
60503_marine,8,23,6,2,31,75,25
60504_marine,8,23,6,2,31,75,25
60505_marine,3,0,3,0,3,100,0
60506_marine,3,0,3,0,3,100,0
60579_marine,3,18,2,1,21,66.66666666666666,33.33333333333333
60580_marine,3,18,2,1,21,66.66666666666666,33.33333333333333
60581_marine,3,18,2,1,21,66.66666666666666,33.33333333333333
60582_marine,3,18,2,1,21,66.66666666666666,33.33333333333333
60583_marine,3,18,2,1,21,66.66666666666666,33.33333333333333
60584_marine,3,18,2,1,21,66.66666666666666,33.33333333333333
60585_marine,3,18,2,1,21,66.66666666666666,33.33333333333333
60586_marine,3,18,2,1,21,66.66666666666666,33.33333333333333
60587_marine,3,18,2,1,21,66.66666666666666,33.33333333333333
60588_marine,3,18,2,1,21,66.66666666666666,33.33333333333333
60589_marine,3,18,2,1,21,66.66666666666666,33.33333333333333
60590_marine,3,18,2,1,21,66.66666666666666,33.33333333333333
60591_marine,3,18,2,1,21,66.66666666666666,33.33333333333333
60592_marine,3,18,2,1,21,66.66666666666666,33.33333333333333
60593_marine,3,18,2,1,21,66.66666666666666,33.33333333333333
60594_marine,3,18,2,1,21,66.66666666666666,33.33333333333333
60595_marine,3,18,2,1,21,66.66666666666666,33.33333333333333
60596_marine,3,18,2,1,21,66.66666666666666,33.33333333333333
60597_marine,3,18,2,1,21,66.66666666666666,33.33333333333333
60598_marine,3,18,2,1,21,66.66666666666666,33.33333333333333
60599_marine,3,18,2,1,21,66.66666666666666,33.33333333333333
60600_marine,3,18,2,1,21,66.66666666666666,33.33333333333333
60601_marine,3,18,2,1,21,66.66666666666666,33.33333333333333
60602_marine,3,18,2,1,21,66.66666666666666,33.33333333333333
60603_marine,3,18,2,1,21,66.66666666666666,33.33333333333333
60604_marine,3,18,2,1,21,66.66666666666666,33.33333333333333
60605_marine,3,18,2,1,21,66.66666666666666,33.33333333333333
60606_marine,3,18,2,1,21,66.66666666666666,33.33333333333333
60607_marine,3,18,2,1,21,66.66666666666666,33.33333333333333
60608_marine,3,18,2,1,21,66.66666666666666,33.33333333333333
60609_marine,3,18,2,1,21,66.66666666666666,33.33333333333333
60610_marine,3,18,2,1,21,66.66666666666666,33.33333333333333
60611_marine,3,2,2,1,5,66.66666666666666,33.33333333333333
60612_marine,3,0,2,1,3,66.66666666666666,33.33333333333333
60615_marine,3,18,2,1,21,66.66666666666666,33.33333333333333
60616_marine,3,20,2,1,23,66.66666666666666,33.33333333333333
60617_marine,3,20,2,1,23,66.66666666666666,33.33333333333333
60618_marine,3,20,2,1,23,66.66666666666666,33.33333333333333
60619_marine,3,20,2,1,23,66.66666666666666,33.33333333333333
60620_marine,3,20,2,1,23,66.66666666666666,33.33333333333333
60621_marine,3,20,2,1,23,66.66666666666666,33.33333333333333
60622_marine,3,20,2,1,23,66.66666666666666,33.33333333333333
60623_marine,3,20,2,1,23,66.66666666666666,33.33333333333333
60624_marine,3,20,2,1,23,66.66666666666666,33.33333333333333
60625_marine,3,20,2,1,23,66.66666666666666,33.33333333333333
60822_marine,3,0,3,0,3,100,0
60823_marine,6,19,5,1,25,83.33333333333334,16.666666666666664
60824_marine,8,21,5,3,29,62.5,37.5
60825_marine,9,21,5,4,30,55.55555555555556,44.44444444444444
60826_marine,8,21,5,3,29,62.5,37.5
60827_marine,8,21,5,3,29,62.5,37.5
60828_marine,9,21,5,4,30,55.55555555555556,44.44444444444444
60829_marine,8,21,5,3,29,62.5,37.5
60830_marine,8,21,5,3,29,62.5,37.5
60831_marine,8,21,5,3,29,62.5,37.5
60832_marine,8,21,5,3,29,62.5,37.5
60833_marine,8,21,5,3,29,62.5,37.5
60834_marine,8,21,5,3,29,62.5,37.5
60835_marine,8,21,5,3,29,62.5,37.5
60836_marine,8,21,5,3,29,62.5,37.5
60837_marine,8,21,5,3,29,62.5,37.5
60838_marine,8,21,5,3,29,62.5,37.5
60839_marine,8,21,5,3,29,62.5,37.5
60840_marine,8,21,5,3,29,62.5,37.5
60841_marine,6,19,5,1,25,83.33333333333334,16.666666666666664
60842_marine,6,19,5,1,25,83.33333333333334,16.666666666666664
60843_marine,7,19,6,1,26,85.71428571428571,14.285714285714285
60844_marine,7,19,6,1,26,85.71428571428571,14.285714285714285
60845_marine,7,19,6,1,26,85.71428571428571,14.285714285714285
60846_marine,7,19,6,1,26,85.71428571428571,14.285714285714285
60847_marine,7,19,6,1,26,85.71428571428571,14.285714285714285
60848_marine,7,19,6,1,26,85.71428571428571,14.285714285714285
60849_marine,7,19,6,1,26,85.71428571428571,14.285714285714285
60850_marine,7,19,6,1,26,85.71428571428571,14.285714285714285
60851_marine,7,19,6,1,26,85.71428571428571,14.285714285714285
60852_marine,7,19,6,1,26,85.71428571428571,14.285714285714285
60853_marine,6,19,5,1,25,83.33333333333334,16.666666666666664
60854_marine,6,19,5,1,25,83.33333333333334,16.666666666666664
60855_marine,6,19,5,1,25,83.33333333333334,16.666666666666664
60856_marine,6,19,5,1,25,83.33333333333334,16.666666666666664
60857_marine,6,19,5,1,25,83.33333333333334,16.666666666666664
60858_marine,6,19,5,1,25,83.33333333333334,16.666666666666664
60859_marine,6,19,5,1,25,83.33333333333334,16.666666666666664
60860_marine,6,19,5,1,25,83.33333333333334,16.666666666666664
60861_marine,6,19,5,1,25,83.33333333333334,16.666666666666664
60862_marine,6,19,5,1,25,83.33333333333334,16.666666666666664
60863_marine,6,19,5,1,25,83.33333333333334,16.666666666666664
60864_marine,6,19,5,1,25,83.33333333333334,16.666666666666664
60865_marine,6,19,5,1,25,83.33333333333334,16.666666666666664
60866_marine,6,17,5,1,23,83.33333333333334,16.666666666666664
60867_marine,6,17,5,1,23,83.33333333333334,16.666666666666664
60868_marine,6,17,5,1,23,83.33333333333334,16.666666666666664
60869_marine,6,17,5,1,23,83.33333333333334,16.666666666666664
60870_marine,3,0,3,0,3,100,0
60871_marine,3,0,3,0,3,100,0
60872_marine,3,0,3,0,3,100,0
60939_marine,3,18,2,1,21,66.66666666666666,33.33333333333333
60940_marine,3,18,2,1,21,66.66666666666666,33.33333333333333
60941_marine,3,18,2,1,21,66.66666666666666,33.33333333333333
60942_marine,3,18,2,1,21,66.66666666666666,33.33333333333333
60943_marine,3,18,2,1,21,66.66666666666666,33.33333333333333
60944_marine,3,18,2,1,21,66.66666666666666,33.33333333333333
60945_marine,3,18,2,1,21,66.66666666666666,33.33333333333333
60946_marine,3,18,2,1,21,66.66666666666666,33.33333333333333
60947_marine,3,18,2,1,21,66.66666666666666,33.33333333333333
60948_marine,3,18,2,1,21,66.66666666666666,33.33333333333333
60949_marine,3,18,2,1,21,66.66666666666666,33.33333333333333
60950_marine,3,18,2,1,21,66.66666666666666,33.33333333333333
60951_marine,3,18,2,1,21,66.66666666666666,33.33333333333333
60952_marine,3,18,2,1,21,66.66666666666666,33.33333333333333
60953_marine,3,18,2,1,21,66.66666666666666,33.33333333333333
60954_marine,3,18,2,1,21,66.66666666666666,33.33333333333333
60955_marine,3,18,2,1,21,66.66666666666666,33.33333333333333
60956_marine,3,18,2,1,21,66.66666666666666,33.33333333333333
60957_marine,3,18,2,1,21,66.66666666666666,33.33333333333333
60958_marine,3,18,2,1,21,66.66666666666666,33.33333333333333
60959_marine,3,18,2,1,21,66.66666666666666,33.33333333333333
60960_marine,3,18,2,1,21,66.66666666666666,33.33333333333333
60961_marine,3,18,2,1,21,66.66666666666666,33.33333333333333
60962_marine,3,18,2,1,21,66.66666666666666,33.33333333333333
60963_marine,3,18,2,1,21,66.66666666666666,33.33333333333333
60964_marine,3,18,2,1,21,66.66666666666666,33.33333333333333
60965_marine,3,18,2,1,21,66.66666666666666,33.33333333333333
60966_marine,3,18,2,1,21,66.66666666666666,33.33333333333333
60967_marine,3,18,2,1,21,66.66666666666666,33.33333333333333
60977_marine,3,18,2,1,21,66.66666666666666,33.33333333333333
60978_marine,3,18,2,1,21,66.66666666666666,33.33333333333333
60979_marine,3,18,2,1,21,66.66666666666666,33.33333333333333
60980_marine,3,18,2,1,21,66.66666666666666,33.33333333333333
60981_marine,3,18,2,1,21,66.66666666666666,33.33333333333333
60982_marine,3,18,2,1,21,66.66666666666666,33.33333333333333
60983_marine,3,18,2,1,21,66.66666666666666,33.33333333333333
60984_marine,3,18,2,1,21,66.66666666666666,33.33333333333333
60985_marine,3,18,2,1,21,66.66666666666666,33.33333333333333
60986_marine,3,18,2,1,21,66.66666666666666,33.33333333333333
60987_marine,3,18,2,1,21,66.66666666666666,33.33333333333333
60988_marine,3,18,2,1,21,66.66666666666666,33.33333333333333
60989_marine,3,18,2,1,21,66.66666666666666,33.33333333333333
60990_marine,3,20,2,1,23,66.66666666666666,33.33333333333333
61180_marine,3,0,3,0,3,100,0
61181_marine,6,17,5,1,23,83.33333333333334,16.666666666666664
61182_marine,6,17,5,1,23,83.33333333333334,16.666666666666664
61183_marine,6,19,5,1,25,83.33333333333334,16.666666666666664
61184_marine,6,19,5,1,25,83.33333333333334,16.666666666666664
61185_marine,6,19,5,1,25,83.33333333333334,16.666666666666664
61186_marine,6,19,5,1,25,83.33333333333334,16.666666666666664
61187_marine,6,19,5,1,25,83.33333333333334,16.666666666666664
61188_marine,6,19,5,1,25,83.33333333333334,16.666666666666664
61189_marine,6,19,5,1,25,83.33333333333334,16.666666666666664
61190_marine,6,19,5,1,25,83.33333333333334,16.666666666666664
61191_marine,7,19,5,2,26,71.42857142857143,28.57142857142857
61192_marine,7,19,5,2,26,71.42857142857143,28.57142857142857
61193_marine,7,19,5,2,26,71.42857142857143,28.57142857142857
61194_marine,7,19,5,2,26,71.42857142857143,28.57142857142857
61195_marine,7,19,5,2,26,71.42857142857143,28.57142857142857
61196_marine,7,19,5,2,26,71.42857142857143,28.57142857142857
61197_marine,7,19,5,2,26,71.42857142857143,28.57142857142857
61198_marine,7,19,5,2,26,71.42857142857143,28.57142857142857
61199_marine,7,19,5,2,26,71.42857142857143,28.57142857142857
61200_marine,7,19,5,2,26,71.42857142857143,28.57142857142857
61201_marine,4,17,3,1,21,75,25
61202_marine,4,17,3,1,21,75,25
61203_marine,4,17,3,1,21,75,25
61204_marine,4,17,3,1,21,75,25
61205_marine,4,17,3,1,21,75,25
61206_marine,4,17,3,1,21,75,25
61207_marine,4,17,3,1,21,75,25
61208_marine,4,17,3,1,21,75,25
61209_marine,4,17,3,1,21,75,25
61210_marine,4,17,3,1,21,75,25
61211_marine,4,17,3,1,21,75,25
61212_marine,4,17,3,1,21,75,25
61213_marine,4,17,3,1,21,75,25
61214_marine,4,17,3,1,21,75,25
61215_marine,4,17,3,1,21,75,25
61216_marine,4,17,3,1,21,75,25
61217_marine,4,17,3,1,21,75,25
61218_marine,4,17,3,1,21,75,25
61219_marine,4,17,3,1,21,75,25
61220_marine,4,17,3,1,21,75,25
61221_marine,4,17,3,1,21,75,25
61222_marine,4,17,3,1,21,75,25
61223_marine,4,17,3,1,21,75,25
61224_marine,4,17,3,1,21,75,25
61225_marine,4,17,3,1,21,75,25
61226_marine,4,17,3,1,21,75,25
61227_marine,4,17,3,1,21,75,25
61228_marine,4,17,3,1,21,75,25
61229_marine,4,17,3,1,21,75,25
61230_marine,4,17,3,1,21,75,25
61231_marine,4,17,3,1,21,75,25
61232_marine,4,17,3,1,21,75,25
61301_marine,3,18,2,1,21,66.66666666666666,33.33333333333333
61302_marine,3,18,2,1,21,66.66666666666666,33.33333333333333
61303_marine,3,18,2,1,21,66.66666666666666,33.33333333333333
61304_marine,3,18,2,1,21,66.66666666666666,33.33333333333333
61305_marine,3,18,2,1,21,66.66666666666666,33.33333333333333
61306_marine,3,18,2,1,21,66.66666666666666,33.33333333333333
61307_marine,3,18,2,1,21,66.66666666666666,33.33333333333333
61308_marine,3,18,2,1,21,66.66666666666666,33.33333333333333
61309_marine,3,18,2,1,21,66.66666666666666,33.33333333333333
61310_marine,3,18,2,1,21,66.66666666666666,33.33333333333333
61311_marine,3,18,2,1,21,66.66666666666666,33.33333333333333
61312_marine,3,18,2,1,21,66.66666666666666,33.33333333333333
61313_marine,3,18,2,1,21,66.66666666666666,33.33333333333333
61314_marine,3,18,2,1,21,66.66666666666666,33.33333333333333
61315_marine,3,18,2,1,21,66.66666666666666,33.33333333333333
61316_marine,3,18,2,1,21,66.66666666666666,33.33333333333333
61317_marine,3,18,2,1,21,66.66666666666666,33.33333333333333
61318_marine,3,18,2,1,21,66.66666666666666,33.33333333333333
61319_marine,3,18,2,1,21,66.66666666666666,33.33333333333333
61320_marine,3,18,2,1,21,66.66666666666666,33.33333333333333
61321_marine,3,18,2,1,21,66.66666666666666,33.33333333333333
61322_marine,3,18,2,1,21,66.66666666666666,33.33333333333333
61323_marine,3,18,2,1,21,66.66666666666666,33.33333333333333
61324_marine,3,18,2,1,21,66.66666666666666,33.33333333333333
61325_marine,3,18,2,1,21,66.66666666666666,33.33333333333333
61326_marine,3,18,2,1,21,66.66666666666666,33.33333333333333
61327_marine,3,18,2,1,21,66.66666666666666,33.33333333333333
61328_marine,3,18,2,1,21,66.66666666666666,33.33333333333333
61329_marine,3,18,2,1,21,66.66666666666666,33.33333333333333
61330_marine,3,18,2,1,21,66.66666666666666,33.33333333333333
61331_marine,3,18,2,1,21,66.66666666666666,33.33333333333333
61332_marine,3,18,2,1,21,66.66666666666666,33.33333333333333
61333_marine,3,18,2,1,21,66.66666666666666,33.33333333333333
61334_marine,3,18,2,1,21,66.66666666666666,33.33333333333333
61335_marine,3,18,2,1,21,66.66666666666666,33.33333333333333
61336_marine,3,18,2,1,21,66.66666666666666,33.33333333333333
61337_marine,3,18,2,1,21,66.66666666666666,33.33333333333333
61338_marine,3,18,2,1,21,66.66666666666666,33.33333333333333
61339_marine,3,18,2,1,21,66.66666666666666,33.33333333333333
61340_marine,3,18,2,1,21,66.66666666666666,33.33333333333333
61341_marine,3,18,2,1,21,66.66666666666666,33.33333333333333
61342_marine,3,18,2,1,21,66.66666666666666,33.33333333333333
61343_marine,3,18,2,1,21,66.66666666666666,33.33333333333333
61344_marine,3,18,2,1,21,66.66666666666666,33.33333333333333
61345_marine,3,18,2,1,21,66.66666666666666,33.33333333333333
61346_marine,3,18,2,1,21,66.66666666666666,33.33333333333333
61347_marine,3,18,2,1,21,66.66666666666666,33.33333333333333
61348_marine,3,18,2,1,21,66.66666666666666,33.33333333333333
61349_marine,3,18,2,1,21,66.66666666666666,33.33333333333333
61350_marine,3,18,2,1,21,66.66666666666666,33.33333333333333
61539_marine,3,0,3,0,3,100,0
61540_marine,4,15,3,1,19,75,25
61541_marine,4,17,3,1,21,75,25
61542_marine,4,17,3,1,21,75,25
61543_marine,4,17,3,1,21,75,25
61544_marine,4,17,3,1,21,75,25
61545_marine,4,17,3,1,21,75,25
61546_marine,4,17,3,1,21,75,25
61547_marine,4,17,3,1,21,75,25
61548_marine,4,17,3,1,21,75,25
61549_marine,4,17,3,1,21,75,25
61550_marine,4,17,3,1,21,75,25
61551_marine,4,17,3,1,21,75,25
61552_marine,4,17,3,1,21,75,25
61553_marine,4,17,3,1,21,75,25
61554_marine,4,17,3,1,21,75,25
61555_marine,4,17,3,1,21,75,25
61556_marine,4,17,3,1,21,75,25
61557_marine,4,17,3,1,21,75,25
61558_marine,4,17,3,1,21,75,25
61559_marine,4,17,3,1,21,75,25
61560_marine,4,17,3,1,21,75,25
61561_marine,4,17,3,1,21,75,25
61562_marine,4,17,3,1,21,75,25
61563_marine,4,17,3,1,21,75,25
61564_marine,4,17,3,1,21,75,25
61565_marine,4,17,3,1,21,75,25
61566_marine,4,17,3,1,21,75,25
61567_marine,4,17,3,1,21,75,25
61568_marine,4,17,3,1,21,75,25
61569_marine,4,17,3,1,21,75,25
61570_marine,4,17,3,1,21,75,25
61571_marine,4,17,3,1,21,75,25
61572_marine,4,17,3,1,21,75,25
61573_marine,4,17,3,1,21,75,25
61574_marine,4,17,3,1,21,75,25
61575_marine,4,17,3,1,21,75,25
61576_marine,4,17,3,1,21,75,25
61577_marine,4,17,3,1,21,75,25
61578_marine,4,17,3,1,21,75,25
61579_marine,4,17,3,1,21,75,25
61580_marine,4,17,3,1,21,75,25
61581_marine,4,17,3,1,21,75,25
61582_marine,4,17,3,1,21,75,25
61583_marine,4,17,3,1,21,75,25
61584_marine,4,17,3,1,21,75,25
61585_marine,4,17,3,1,21,75,25
61586_marine,4,17,3,1,21,75,25
61587_marine,4,17,3,1,21,75,25
61588_marine,4,17,3,1,21,75,25
61589_marine,4,17,3,1,21,75,25
61673_marine,3,18,2,1,21,66.66666666666666,33.33333333333333
61674_marine,3,18,2,1,21,66.66666666666666,33.33333333333333
61675_marine,3,18,2,1,21,66.66666666666666,33.33333333333333
61676_marine,3,18,2,1,21,66.66666666666666,33.33333333333333
61677_marine,3,18,2,1,21,66.66666666666666,33.33333333333333
61678_marine,3,18,2,1,21,66.66666666666666,33.33333333333333
61679_marine,3,18,2,1,21,66.66666666666666,33.33333333333333
61680_marine,3,18,2,1,21,66.66666666666666,33.33333333333333
61681_marine,3,18,2,1,21,66.66666666666666,33.33333333333333
61682_marine,3,18,2,1,21,66.66666666666666,33.33333333333333
61683_marine,3,18,2,1,21,66.66666666666666,33.33333333333333
61684_marine,3,18,2,1,21,66.66666666666666,33.33333333333333
61685_marine,3,18,2,1,21,66.66666666666666,33.33333333333333
61686_marine,3,18,2,1,21,66.66666666666666,33.33333333333333
61687_marine,3,18,2,1,21,66.66666666666666,33.33333333333333
61688_marine,3,18,2,1,21,66.66666666666666,33.33333333333333
61689_marine,3,18,2,1,21,66.66666666666666,33.33333333333333
61690_marine,3,18,2,1,21,66.66666666666666,33.33333333333333
61691_marine,3,18,2,1,21,66.66666666666666,33.33333333333333
61692_marine,3,18,2,1,21,66.66666666666666,33.33333333333333
61693_marine,3,18,2,1,21,66.66666666666666,33.33333333333333
61694_marine,3,18,2,1,21,66.66666666666666,33.33333333333333
61695_marine,3,18,2,1,21,66.66666666666666,33.33333333333333
61696_marine,3,18,2,1,21,66.66666666666666,33.33333333333333
61697_marine,3,18,2,1,21,66.66666666666666,33.33333333333333
61698_marine,3,18,2,1,21,66.66666666666666,33.33333333333333
61699_marine,3,18,2,1,21,66.66666666666666,33.33333333333333
61700_marine,3,18,2,1,21,66.66666666666666,33.33333333333333
61701_marine,3,18,2,1,21,66.66666666666666,33.33333333333333
61901_marine,4,17,3,1,21,75,25
61902_marine,4,17,3,1,21,75,25
61903_marine,4,17,3,1,21,75,25
61904_marine,4,17,3,1,21,75,25
61905_marine,4,17,3,1,21,75,25
61906_marine,4,17,3,1,21,75,25
61907_marine,4,17,3,1,21,75,25
61908_marine,4,17,3,1,21,75,25
61909_marine,4,17,3,1,21,75,25
61910_marine,4,17,3,1,21,75,25
61911_marine,4,17,3,1,21,75,25
61912_marine,4,17,3,1,21,75,25
61913_marine,4,17,3,1,21,75,25
61914_marine,4,17,3,1,21,75,25
61915_marine,4,17,3,1,21,75,25
61916_marine,4,17,3,1,21,75,25
61917_marine,4,17,3,1,21,75,25
61918_marine,4,17,3,1,21,75,25
61919_marine,4,17,3,1,21,75,25
61920_marine,4,17,3,1,21,75,25
61921_marine,4,17,3,1,21,75,25
61922_marine,4,17,3,1,21,75,25
61923_marine,4,17,3,1,21,75,25
61924_marine,4,17,3,1,21,75,25
61925_marine,4,17,3,1,21,75,25
61926_marine,4,17,3,1,21,75,25
61927_marine,4,17,3,1,21,75,25
61928_marine,4,17,3,1,21,75,25
61929_marine,4,17,3,1,21,75,25
61930_marine,4,17,3,1,21,75,25
61931_marine,4,17,3,1,21,75,25
61932_marine,4,17,3,1,21,75,25
61933_marine,4,17,3,1,21,75,25
61934_marine,4,17,3,1,21,75,25
61935_marine,4,17,3,1,21,75,25
61936_marine,4,17,3,1,21,75,25
61937_marine,4,17,3,1,21,75,25
61938_marine,4,17,3,1,21,75,25
61939_marine,4,17,3,1,21,75,25
61940_marine,4,17,3,1,21,75,25
61941_marine,4,17,3,1,21,75,25
61942_marine,4,17,3,1,21,75,25
61943_marine,4,17,3,1,21,75,25
61944_marine,4,17,3,1,21,75,25
61945_marine,4,17,3,1,21,75,25
61946_marine,4,17,3,1,21,75,25
61947_marine,3,0,3,0,3,100,0
62035_marine,1,18,0,1,19,0,100
62036_marine,1,18,0,1,19,0,100
62037_marine,3,18,2,1,21,66.66666666666666,33.33333333333333
62038_marine,3,18,2,1,21,66.66666666666666,33.33333333333333
62039_marine,3,18,2,1,21,66.66666666666666,33.33333333333333
62040_marine,3,18,2,1,21,66.66666666666666,33.33333333333333
62041_marine,3,18,2,1,21,66.66666666666666,33.33333333333333
62042_marine,3,18,2,1,21,66.66666666666666,33.33333333333333
62043_marine,3,18,2,1,21,66.66666666666666,33.33333333333333
62044_marine,3,18,2,1,21,66.66666666666666,33.33333333333333
62045_marine,3,18,2,1,21,66.66666666666666,33.33333333333333
62046_marine,3,18,2,1,21,66.66666666666666,33.33333333333333
62047_marine,3,18,2,1,21,66.66666666666666,33.33333333333333
62048_marine,3,18,2,1,21,66.66666666666666,33.33333333333333
62262_marine,2,17,1,1,19,50,50
62263_marine,2,18,1,1,20,50,50
62264_marine,4,18,3,1,22,75,25
62265_marine,4,17,3,1,21,75,25
62266_marine,4,17,3,1,21,75,25
62267_marine,4,17,3,1,21,75,25
62268_marine,4,17,3,1,21,75,25
62269_marine,4,17,3,1,21,75,25
62270_marine,4,17,3,1,21,75,25
62271_marine,4,17,3,1,21,75,25
62272_marine,4,17,3,1,21,75,25
62273_marine,4,17,3,1,21,75,25
62274_marine,4,17,3,1,21,75,25
62275_marine,4,17,3,1,21,75,25
62276_marine,4,17,3,1,21,75,25
62277_marine,4,17,3,1,21,75,25
62278_marine,4,17,3,1,21,75,25
62279_marine,4,17,3,1,21,75,25
62280_marine,4,17,3,1,21,75,25
62281_marine,4,16,3,1,20,75,25
62282_marine,4,16,3,1,20,75,25
62283_marine,4,16,3,1,20,75,25
62284_marine,4,16,3,1,20,75,25
62285_marine,4,16,3,1,20,75,25
62286_marine,4,16,3,1,20,75,25
62287_marine,4,16,3,1,20,75,25
62288_marine,4,16,3,1,20,75,25
62289_marine,4,16,3,1,20,75,25
62290_marine,4,16,3,1,20,75,25
62291_marine,4,16,3,1,20,75,25
62292_marine,4,16,3,1,20,75,25
62293_marine,4,16,3,1,20,75,25
62294_marine,4,16,3,1,20,75,25
62295_marine,4,16,3,1,20,75,25
62296_marine,4,16,3,1,20,75,25
62297_marine,4,16,3,1,20,75,25
62298_marine,4,16,3,1,20,75,25
62299_marine,4,16,3,1,20,75,25
62300_marine,4,16,3,1,20,75,25
62301_marine,4,16,3,1,20,75,25
62302_marine,4,16,3,1,20,75,25
62303_marine,4,16,3,1,20,75,25
62304_marine,4,16,3,1,20,75,25
62305_marine,4,16,3,1,20,75,25
62401_marine,1,18,0,1,19,0,100
62402_marine,3,18,2,1,21,66.66666666666666,33.33333333333333
62628_marine,4,16,3,1,20,75,25
62629_marine,4,16,3,1,20,75,25
62630_marine,4,16,3,1,20,75,25
62631_marine,4,16,3,1,20,75,25
62632_marine,4,16,3,1,20,75,25
62633_marine,4,16,3,1,20,75,25
62634_marine,4,16,3,1,20,75,25
62635_marine,4,16,3,1,20,75,25
62636_marine,4,16,3,1,20,75,25
62637_marine,4,16,3,1,20,75,25
62638_marine,4,16,3,1,20,75,25
62639_marine,4,16,3,1,20,75,25
62640_marine,4,16,3,1,20,75,25
62641_marine,4,16,3,1,20,75,25
62642_marine,4,16,3,1,20,75,25
62643_marine,4,16,3,1,20,75,25
62644_marine,4,16,3,1,20,75,25
62645_marine,4,16,3,1,20,75,25
62646_marine,4,16,3,1,20,75,25
62647_marine,4,16,3,1,20,75,25
62648_marine,4,16,3,1,20,75,25
62649_marine,4,16,3,1,20,75,25
62650_marine,4,16,3,1,20,75,25
62651_marine,4,16,3,1,20,75,25
62652_marine,4,16,3,1,20,75,25
62653_marine,4,16,3,1,20,75,25
62654_marine,4,16,3,1,20,75,25
62655_marine,4,16,3,1,20,75,25
62656_marine,4,16,3,1,20,75,25
62657_marine,4,16,3,1,20,75,25
62658_marine,4,16,3,1,20,75,25
62659_marine,4,16,3,1,20,75,25
62660_marine,4,16,3,1,20,75,25
62661_marine,4,16,3,1,20,75,25
62662_marine,4,16,3,1,20,75,25
62663_marine,4,16,3,1,20,75,25
62664_marine,4,16,3,1,20,75,25
62997_marine,4,16,3,1,20,75,25
62998_marine,4,16,3,1,20,75,25
62999_marine,4,16,3,1,20,75,25
63000_marine,4,16,3,1,20,75,25
63020_marine,3,16,2,1,19,66.66666666666666,33.33333333333333
63021_marine,3,16,2,1,19,66.66666666666666,33.33333333333333
63022_marine,3,16,2,1,19,66.66666666666666,33.33333333333333
63023_marine,3,16,2,1,19,66.66666666666666,33.33333333333333
63024_marine,3,16,2,1,19,66.66666666666666,33.33333333333333
25111_marine,282,151,224,63,433,79.43262411347519,22.340425531914892
25469_marine,94,38,91,4,132,96.80851063829788,4.25531914893617
25470_marine,88,41,85,2,129,96.5909090909091,2.272727272727273
25471_marine,88,39,85,2,127,96.5909090909091,2.272727272727273
25472_marine,282,128,212,85,410,75.177304964539,30.141843971631204
25828_marine,92,34,89,4,126,96.73913043478261,4.3478260869565215
25829_marine,86,29,83,4,115,96.51162790697676,4.651162790697675
25830_marine,84,30,81,2,114,96.42857142857143,2.380952380952381
25831_marine,84,30,81,2,114,96.42857142857143,2.380952380952381
26187_marine,92,32,89,4,124,96.73913043478261,4.3478260869565215
26188_marine,88,30,85,4,118,96.5909090909091,4.545454545454546
26189_marine,76,30,73,2,106,96.05263157894737,2.631578947368421
26190_marine,74,29,71,2,103,95.94594594594594,2.7027027027027026
26191_marine,82,29,79,2,111,96.34146341463415,2.4390243902439024
26546_marine,92,32,89,4,124,96.73913043478261,4.3478260869565215
26547_marine,90,30,87,4,120,96.66666666666667,4.444444444444445
26548_marine,74,28,71,2,102,95.94594594594594,2.7027027027027026
26549_marine,70,29,67,2,99,95.71428571428572,2.857142857142857
26550_marine,72,28,69,2,100,95.83333333333334,2.7777777777777777
26551_marine,78,29,75,2,107,96.15384615384616,2.564102564102564
26906_marine,82,30,79,4,112,96.34146341463415,4.878048780487805
26907_marine,68,28,65,2,96,95.58823529411765,2.941176470588235
26908_marine,68,28,65,2,96,95.58823529411765,2.941176470588235
26909_marine,66,29,63,0,95,95.45454545454545,0
26910_marine,66,29,63,0,95,95.45454545454545,0
26911_marine,72,29,69,2,101,95.83333333333334,2.7777777777777777
27267_marine,68,28,65,2,96,95.58823529411765,2.941176470588235
27268_marine,68,28,65,2,96,95.58823529411765,2.941176470588235
27269_marine,68,29,65,0,97,95.58823529411765,0
27270_marine,68,29,65,0,97,95.58823529411765,0
27628_marine,68,28,65,0,96,95.58823529411765,0
27629_marine,68,29,65,0,97,95.58823529411765,0
4817_terrestrial,2,3,0,0,5,0,0
4818_terrestrial,2,3,0,0,5,0,0
4819_terrestrial,2,3,0,0,5,0,0
4820_terrestrial,2,3,0,0,5,0,0
5171_terrestrial,3,3,0,0,6,0,0
5172_terrestrial,3,3,0,0,6,0,0
5173_terrestrial,3,3,0,0,6,0,0
5174_terrestrial,2,3,0,0,5,0,0
5175_terrestrial,2,3,0,0,5,0,0
5176_terrestrial,2,3,0,0,5,0,0
5177_terrestrial,2,3,0,0,5,0,0
5178_terrestrial,2,3,0,0,5,0,0
5179_terrestrial,2,3,0,0,5,0,0
5180_terrestrial,2,3,0,0,5,0,0
5181_terrestrial,2,3,0,0,5,0,0
5182_terrestrial,2,3,0,0,5,0,0
5183_terrestrial,2,3,0,0,5,0,0
5184_terrestrial,2,3,0,0,5,0,0
5185_terrestrial,2,3,0,0,5,0,0
5186_terrestrial,2,3,0,0,5,0,0
5187_terrestrial,2,3,0,0,5,0,0
5188_terrestrial,2,3,0,0,5,0,0
5189_terrestrial,2,3,0,0,5,0,0
5190_terrestrial,2,3,0,0,5,0,0
5532_terrestrial,3,3,0,0,6,0,0
5533_terrestrial,3,3,0,0,6,0,0
5534_terrestrial,3,3,0,0,6,0,0
5535_terrestrial,2,3,0,0,5,0,0
5536_terrestrial,2,3,0,0,5,0,0
5537_terrestrial,2,3,0,0,5,0,0
5538_terrestrial,2,3,0,0,5,0,0
5539_terrestrial,2,3,0,0,5,0,0
5540_terrestrial,2,3,0,0,5,0,0
5541_terrestrial,2,3,0,0,5,0,0
5542_terrestrial,2,3,0,0,5,0,0
5543_terrestrial,2,3,0,0,5,0,0
5544_terrestrial,2,3,0,0,5,0,0
5545_terrestrial,2,3,0,0,5,0,0
5546_terrestrial,2,3,0,0,5,0,0
5547_terrestrial,2,3,0,0,5,0,0
5548_terrestrial,2,3,0,0,5,0,0
5549_terrestrial,2,3,0,0,5,0,0
5892_terrestrial,3,4,0,0,7,0,0
5893_terrestrial,3,3,0,0,6,0,0
5894_terrestrial,3,3,0,0,6,0,0
5895_terrestrial,2,3,0,0,5,0,0
5896_terrestrial,2,3,0,0,5,0,0
5897_terrestrial,2,3,0,0,5,0,0
5898_terrestrial,2,3,0,0,5,0,0
5899_terrestrial,2,3,0,0,5,0,0
5900_terrestrial,2,3,0,0,5,0,0
5901_terrestrial,2,3,0,0,5,0,0
5902_terrestrial,2,3,0,0,5,0,0
5903_terrestrial,2,3,0,0,5,0,0
5904_terrestrial,2,3,0,0,5,0,0
5905_terrestrial,2,3,0,0,5,0,0
5906_terrestrial,2,3,0,0,5,0,0
6253_terrestrial,3,4,0,0,7,0,0
6254_terrestrial,3,3,0,0,6,0,0
6255_terrestrial,3,3,0,0,6,0,0
6256_terrestrial,2,3,0,0,5,0,0
6257_terrestrial,2,3,0,0,5,0,0
6258_terrestrial,2,3,0,0,5,0,0
6259_terrestrial,2,3,0,0,5,0,0
6260_terrestrial,2,3,0,0,5,0,0
6261_terrestrial,2,3,0,0,5,0,0
6262_terrestrial,2,3,0,0,5,0,0
6263_terrestrial,2,3,0,0,5,0,0
6264_terrestrial,2,3,0,0,5,0,0
6615_terrestrial,3,3,0,0,6,0,0
6616_terrestrial,2,3,0,0,5,0,0
6617_terrestrial,2,3,0,0,5,0,0
6618_terrestrial,2,3,0,0,5,0,0
6619_terrestrial,2,3,0,0,5,0,0
6620_terrestrial,2,3,0,0,5,0,0
6621_terrestrial,2,3,0,0,5,0,0
6622_terrestrial,2,3,0,0,5,0,0
6980_terrestrial,2,3,0,0,5,0,0
56398_terrestrial,2,0,2,0,2,100,0
57457_terrestrial,2,0,2,0,2,100,0
57770_terrestrial,2,2,2,0,4,100,0
57787_terrestrial,2,1,2,0,3,100,0
57789_terrestrial,2,1,2,0,3,100,0
57790_terrestrial,2,1,2,0,3,100,0
57791_terrestrial,2,1,2,0,3,100,0
57792_terrestrial,2,0,2,0,2,100,0
57848_terrestrial,2,0,2,0,2,100,0
58078_terrestrial,2,0,2,0,2,100,0
58208_terrestrial,2,0,2,0,2,100,0
58209_terrestrial,2,0,2,0,2,100,0
58210_terrestrial,2,0,2,0,2,100,0
58211_terrestrial,2,0,2,0,2,100,0
58438_terrestrial,2,0,2,0,2,100,0
58568_terrestrial,2,0,2,0,2,100,0
58569_terrestrial,2,0,2,0,2,100,0
58570_terrestrial,2,0,2,0,2,100,0
58571_terrestrial,2,0,2,0,2,100,0
58766_terrestrial,2,0,2,0,2,100,0
58773_terrestrial,2,0,2,0,2,100,0
58776_terrestrial,2,0,2,0,2,100,0
58777_terrestrial,2,0,2,0,2,100,0
58799_terrestrial,2,2,2,0,4,100,0
59121_terrestrial,2,0,2,0,2,100,0
59157_terrestrial,2,0,2,0,2,100,0
59202_terrestrial,2,0,2,0,2,100,0
59203_terrestrial,2,0,2,0,2,100,0
59204_terrestrial,2,0,2,0,2,100,0
59205_terrestrial,2,0,2,0,2,100,0
59206_terrestrial,2,0,2,0,2,100,0
59207_terrestrial,2,0,2,0,2,100,0
59470_terrestrial,2,0,2,0,2,100,0
59471_terrestrial,2,0,2,0,2,100,0
59473_terrestrial,2,0,2,0,2,100,0
59474_terrestrial,2,0,2,0,2,100,0
59478_terrestrial,2,0,2,0,2,100,0
59503_terrestrial,2,0,2,0,2,100,0
59558_terrestrial,2,0,2,0,2,100,0
59559_terrestrial,2,0,2,0,2,100,0
59560_terrestrial,2,0,2,0,2,100,0
59561_terrestrial,2,0,2,0,2,100,0
59562_terrestrial,2,0,2,0,2,100,0
59563_terrestrial,2,0,2,0,2,100,0
59865_terrestrial,2,0,2,0,2,100,0
59866_terrestrial,2,0,2,0,2,100,0
59867_terrestrial,2,0,2,0,2,100,0
59868_terrestrial,2,0,2,0,2,100,0
59869_terrestrial,2,0,2,0,2,100,0
59870_terrestrial,2,0,2,0,2,100,0
59872_terrestrial,2,0,2,0,2,100,0
59873_terrestrial,2,0,2,0,2,100,0
59913_terrestrial,2,1,2,0,3,100,0
59917_terrestrial,2,0,2,0,2,100,0
59918_terrestrial,2,0,2,0,2,100,0
60228_terrestrial,2,0,2,0,2,100,0
60265_terrestrial,2,0,2,0,2,100,0
60576_terrestrial,2,0,2,0,2,100,0
60577_terrestrial,2,0,2,0,2,100,0
60584_terrestrial,2,2,2,0,4,100,0
60610_terrestrial,2,0,2,0,2,100,0
60624_terrestrial,2,0,2,0,2,100,0
60625_terrestrial,2,2,2,0,4,100,0
60626_terrestrial,2,0,2,0,2,100,0
60633_terrestrial,2,0,2,0,2,100,0
60858_terrestrial,2,3,2,0,5,100,0
60874_terrestrial,2,0,2,0,2,100,0
60938_terrestrial,2,0,2,0,2,100,0
60970_terrestrial,2,0,2,0,2,100,0
60992_terrestrial,2,0,2,0,2,100,0
60993_terrestrial,2,0,2,0,2,100,0
61311_terrestrial,2,0,2,0,2,100,0
61312_terrestrial,2,0,2,0,2,100,0
61318_terrestrial,2,0,2,0,2,100,0
61343_terrestrial,2,0,2,0,2,100,0
61344_terrestrial,2,0,2,0,2,100,0
61345_terrestrial,2,0,2,0,2,100,0
61346_terrestrial,2,0,2,0,2,100,0
61347_terrestrial,2,0,2,0,2,100,0
61348_terrestrial,2,0,2,0,2,100,0
61351_terrestrial,2,0,2,0,2,100,0
61352_terrestrial,2,0,2,0,2,100,0
61593_terrestrial,2,0,2,0,2,100,0
61698_terrestrial,2,0,2,0,2,100,0
61703_terrestrial,2,0,2,0,2,100,0
61949_terrestrial,2,0,2,0,2,100,0
62043_terrestrial,2,0,2,0,2,100,0
62403_terrestrial,2,0,2,0,2,100,0
62678_terrestrial,2,0,2,0,2,100,0
62679_terrestrial,2,0,2,0,2,100,0
62680_terrestrial,2,0,2,0,2,100,0
62681_terrestrial,2,0,2,0,2,100,0
62682_terrestrial,2,0,2,0,2,100,0
1_marine,2,2,2,0,4,100,0
2_marine,2,2,2,0,4,100,0
3_marine,2,2,2,0,4,100,0
4_marine,2,2,2,0,4,100,0
5_marine,2,2,2,0,4,100,0
6_marine,2,2,2,0,4,100,0
7_marine,2,2,2,0,4,100,0
8_marine,2,2,2,0,4,100,0
9_marine,2,2,2,0,4,100,0
10_marine,2,2,2,0,4,100,0
11_marine,2,2,2,0,4,100,0
12_marine,2,2,2,0,4,100,0
13_marine,2,2,2,0,4,100,0
14_marine,2,2,2,0,4,100,0
15_marine,2,2,2,0,4,100,0
16_marine,2,2,2,0,4,100,0
17_marine,2,2,2,0,4,100,0
18_marine,2,2,2,0,4,100,0
19_marine,2,2,2,0,4,100,0
20_marine,2,2,2,0,4,100,0
21_marine,2,2,2,0,4,100,0
22_marine,2,2,2,0,4,100,0
23_marine,2,2,2,0,4,100,0
24_marine,2,2,2,0,4,100,0
25_marine,2,2,2,0,4,100,0
26_marine,2,2,2,0,4,100,0
27_marine,2,2,2,0,4,100,0
28_marine,2,2,2,0,4,100,0
29_marine,2,2,2,0,4,100,0
30_marine,2,2,2,0,4,100,0
31_marine,2,2,2,0,4,100,0
32_marine,2,2,2,0,4,100,0
33_marine,2,2,2,0,4,100,0
34_marine,2,2,2,0,4,100,0
35_marine,2,2,2,0,4,100,0
36_marine,2,2,2,0,4,100,0
37_marine,2,2,2,0,4,100,0
38_marine,2,2,2,0,4,100,0
39_marine,2,2,2,0,4,100,0
40_marine,2,2,2,0,4,100,0
41_marine,2,2,2,0,4,100,0
42_marine,2,2,2,0,4,100,0
43_marine,2,2,2,0,4,100,0
44_marine,2,2,2,0,4,100,0
45_marine,2,2,2,0,4,100,0
46_marine,2,2,2,0,4,100,0
47_marine,2,2,2,0,4,100,0
48_marine,2,2,2,0,4,100,0
49_marine,2,2,2,0,4,100,0
50_marine,2,2,2,0,4,100,0
51_marine,2,2,2,0,4,100,0
52_marine,2,2,2,0,4,100,0
53_marine,2,2,2,0,4,100,0
54_marine,2,2,2,0,4,100,0
55_marine,2,2,2,0,4,100,0
56_marine,2,2,2,0,4,100,0
57_marine,2,2,2,0,4,100,0
58_marine,2,2,2,0,4,100,0
59_marine,2,2,2,0,4,100,0
60_marine,2,2,2,0,4,100,0
61_marine,2,2,2,0,4,100,0
62_marine,2,2,2,0,4,100,0
63_marine,2,2,2,0,4,100,0
64_marine,2,2,2,0,4,100,0
65_marine,2,2,2,0,4,100,0
66_marine,2,2,2,0,4,100,0
67_marine,2,2,2,0,4,100,0
68_marine,2,2,2,0,4,100,0
69_marine,2,2,2,0,4,100,0
70_marine,2,2,2,0,4,100,0
71_marine,2,2,2,0,4,100,0
72_marine,2,2,2,0,4,100,0
73_marine,2,2,2,0,4,100,0
74_marine,2,2,2,0,4,100,0
75_marine,2,2,2,0,4,100,0
76_marine,2,2,2,0,4,100,0
77_marine,2,2,2,0,4,100,0
78_marine,2,2,2,0,4,100,0
79_marine,2,2,2,0,4,100,0
80_marine,2,2,2,0,4,100,0
81_marine,2,2,2,0,4,100,0
82_marine,2,2,2,0,4,100,0
83_marine,2,2,2,0,4,100,0
84_marine,2,2,2,0,4,100,0
85_marine,2,2,2,0,4,100,0
86_marine,2,2,2,0,4,100,0
87_marine,2,2,2,0,4,100,0
88_marine,2,2,2,0,4,100,0
89_marine,2,2,2,0,4,100,0
90_marine,2,2,2,0,4,100,0
91_marine,2,2,2,0,4,100,0
92_marine,2,2,2,0,4,100,0
93_marine,2,2,2,0,4,100,0
94_marine,2,2,2,0,4,100,0
95_marine,2,2,2,0,4,100,0
96_marine,2,2,2,0,4,100,0
97_marine,2,2,2,0,4,100,0
98_marine,2,2,2,0,4,100,0
99_marine,2,2,2,0,4,100,0
100_marine,2,2,2,0,4,100,0
101_marine,2,2,2,0,4,100,0
102_marine,2,2,2,0,4,100,0
103_marine,2,2,2,0,4,100,0
104_marine,2,2,2,0,4,100,0
105_marine,2,2,2,0,4,100,0
106_marine,2,2,2,0,4,100,0
107_marine,2,2,2,0,4,100,0
108_marine,2,2,2,0,4,100,0
109_marine,2,2,2,0,4,100,0
110_marine,2,2,2,0,4,100,0
111_marine,2,2,2,0,4,100,0
112_marine,2,2,2,0,4,100,0
113_marine,2,2,2,0,4,100,0
114_marine,2,2,2,0,4,100,0
115_marine,2,2,2,0,4,100,0
116_marine,2,2,2,0,4,100,0
117_marine,2,2,2,0,4,100,0
118_marine,2,2,2,0,4,100,0
119_marine,2,2,2,0,4,100,0
120_marine,2,2,2,0,4,100,0
121_marine,2,2,2,0,4,100,0
122_marine,2,2,2,0,4,100,0
123_marine,2,2,2,0,4,100,0
124_marine,2,2,2,0,4,100,0
125_marine,2,2,2,0,4,100,0
126_marine,2,2,2,0,4,100,0
127_marine,2,2,2,0,4,100,0
128_marine,2,2,2,0,4,100,0
129_marine,2,2,2,0,4,100,0
130_marine,2,2,2,0,4,100,0
131_marine,2,2,2,0,4,100,0
132_marine,2,2,2,0,4,100,0
133_marine,2,2,2,0,4,100,0
134_marine,2,2,2,0,4,100,0
135_marine,2,2,2,0,4,100,0
136_marine,2,2,2,0,4,100,0
137_marine,2,2,2,0,4,100,0
138_marine,2,2,2,0,4,100,0
139_marine,2,2,2,0,4,100,0
140_marine,2,2,2,0,4,100,0
141_marine,2,2,2,0,4,100,0
142_marine,2,2,2,0,4,100,0
143_marine,2,2,2,0,4,100,0
144_marine,2,2,2,0,4,100,0
145_marine,2,2,2,0,4,100,0
146_marine,2,2,2,0,4,100,0
147_marine,2,2,2,0,4,100,0
148_marine,2,2,2,0,4,100,0
149_marine,2,2,2,0,4,100,0
150_marine,2,2,2,0,4,100,0
151_marine,2,2,2,0,4,100,0
152_marine,2,2,2,0,4,100,0
153_marine,2,2,2,0,4,100,0
154_marine,2,2,2,0,4,100,0
155_marine,2,2,2,0,4,100,0
156_marine,2,2,2,0,4,100,0
157_marine,2,2,2,0,4,100,0
158_marine,2,2,2,0,4,100,0
159_marine,2,2,2,0,4,100,0
160_marine,2,2,2,0,4,100,0
161_marine,2,2,2,0,4,100,0
162_marine,2,2,2,0,4,100,0
163_marine,2,2,2,0,4,100,0
164_marine,2,2,2,0,4,100,0
165_marine,2,2,2,0,4,100,0
166_marine,2,2,2,0,4,100,0
167_marine,2,2,2,0,4,100,0
168_marine,2,2,2,0,4,100,0
169_marine,2,2,2,0,4,100,0
170_marine,2,2,2,0,4,100,0
171_marine,2,2,2,0,4,100,0
172_marine,2,2,2,0,4,100,0
173_marine,2,2,2,0,4,100,0
174_marine,2,2,2,0,4,100,0
175_marine,2,2,2,0,4,100,0
176_marine,2,2,2,0,4,100,0
177_marine,2,2,2,0,4,100,0
178_marine,2,2,2,0,4,100,0
179_marine,2,2,2,0,4,100,0
180_marine,2,2,2,0,4,100,0
181_marine,2,2,2,0,4,100,0
182_marine,2,2,2,0,4,100,0
183_marine,2,2,2,0,4,100,0
184_marine,2,2,2,0,4,100,0
185_marine,2,2,2,0,4,100,0
186_marine,2,2,2,0,4,100,0
187_marine,2,2,2,0,4,100,0
188_marine,2,2,2,0,4,100,0
189_marine,2,2,2,0,4,100,0
190_marine,2,2,2,0,4,100,0
191_marine,2,2,2,0,4,100,0
192_marine,2,2,2,0,4,100,0
193_marine,2,2,2,0,4,100,0
194_marine,2,2,2,0,4,100,0
195_marine,2,2,2,0,4,100,0
196_marine,2,2,2,0,4,100,0
197_marine,2,2,2,0,4,100,0
198_marine,2,2,2,0,4,100,0
199_marine,2,2,2,0,4,100,0
200_marine,2,2,2,0,4,100,0
201_marine,2,2,2,0,4,100,0
202_marine,2,2,2,0,4,100,0
203_marine,2,2,2,0,4,100,0
204_marine,2,2,2,0,4,100,0
205_marine,2,2,2,0,4,100,0
206_marine,2,2,2,0,4,100,0
207_marine,2,2,2,0,4,100,0
208_marine,2,2,2,0,4,100,0
209_marine,2,2,2,0,4,100,0
210_marine,2,2,2,0,4,100,0
211_marine,2,2,2,0,4,100,0
212_marine,2,2,2,0,4,100,0
213_marine,2,2,2,0,4,100,0
214_marine,2,2,2,0,4,100,0
215_marine,2,2,2,0,4,100,0
216_marine,2,2,2,0,4,100,0
217_marine,2,2,2,0,4,100,0
218_marine,2,2,2,0,4,100,0
219_marine,2,2,2,0,4,100,0
220_marine,2,2,2,0,4,100,0
221_marine,2,2,2,0,4,100,0
222_marine,2,2,2,0,4,100,0
223_marine,2,2,2,0,4,100,0
224_marine,2,2,2,0,4,100,0
225_marine,2,2,2,0,4,100,0
226_marine,2,2,2,0,4,100,0
227_marine,2,2,2,0,4,100,0
228_marine,2,2,2,0,4,100,0
229_marine,2,2,2,0,4,100,0
230_marine,2,2,2,0,4,100,0
231_marine,2,2,2,0,4,100,0
232_marine,2,2,2,0,4,100,0
233_marine,2,2,2,0,4,100,0
234_marine,2,2,2,0,4,100,0
235_marine,2,2,2,0,4,100,0
236_marine,2,2,2,0,4,100,0
237_marine,2,2,2,0,4,100,0
238_marine,2,2,2,0,4,100,0
239_marine,2,2,2,0,4,100,0
240_marine,2,2,2,0,4,100,0
241_marine,2,2,2,0,4,100,0
242_marine,2,2,2,0,4,100,0
243_marine,2,2,2,0,4,100,0
244_marine,2,2,2,0,4,100,0
245_marine,2,2,2,0,4,100,0
246_marine,2,2,2,0,4,100,0
247_marine,2,2,2,0,4,100,0
248_marine,2,2,2,0,4,100,0
249_marine,2,2,2,0,4,100,0
250_marine,2,2,2,0,4,100,0
251_marine,2,2,2,0,4,100,0
252_marine,2,2,2,0,4,100,0
253_marine,2,2,2,0,4,100,0
254_marine,2,2,2,0,4,100,0
255_marine,2,2,2,0,4,100,0
256_marine,2,2,2,0,4,100,0
257_marine,2,2,2,0,4,100,0
258_marine,2,2,2,0,4,100,0
259_marine,2,2,2,0,4,100,0
260_marine,2,2,2,0,4,100,0
261_marine,2,2,2,0,4,100,0
262_marine,2,2,2,0,4,100,0
263_marine,2,2,2,0,4,100,0
264_marine,2,2,2,0,4,100,0
265_marine,2,2,2,0,4,100,0
266_marine,2,2,2,0,4,100,0
267_marine,2,2,2,0,4,100,0
268_marine,2,2,2,0,4,100,0
269_marine,2,2,2,0,4,100,0
270_marine,2,2,2,0,4,100,0
271_marine,2,2,2,0,4,100,0
272_marine,2,2,2,0,4,100,0
273_marine,2,2,2,0,4,100,0
274_marine,2,2,2,0,4,100,0
275_marine,2,2,2,0,4,100,0
276_marine,2,2,2,0,4,100,0
277_marine,2,2,2,0,4,100,0
278_marine,2,2,2,0,4,100,0
279_marine,2,2,2,0,4,100,0
280_marine,2,2,2,0,4,100,0
281_marine,2,2,2,0,4,100,0
282_marine,2,2,2,0,4,100,0
283_marine,2,2,2,0,4,100,0
284_marine,2,2,2,0,4,100,0
285_marine,2,2,2,0,4,100,0
286_marine,2,2,2,0,4,100,0
287_marine,2,2,2,0,4,100,0
288_marine,2,2,2,0,4,100,0
289_marine,2,2,2,0,4,100,0
290_marine,2,2,2,0,4,100,0
291_marine,2,2,2,0,4,100,0
292_marine,2,2,2,0,4,100,0
293_marine,2,2,2,0,4,100,0
294_marine,2,2,2,0,4,100,0
295_marine,2,2,2,0,4,100,0
296_marine,2,2,2,0,4,100,0
297_marine,2,2,2,0,4,100,0
298_marine,2,2,2,0,4,100,0
299_marine,2,2,2,0,4,100,0
300_marine,2,2,2,0,4,100,0
301_marine,2,2,2,0,4,100,0
302_marine,2,2,2,0,4,100,0
303_marine,2,2,2,0,4,100,0
304_marine,2,2,2,0,4,100,0
305_marine,2,2,2,0,4,100,0
306_marine,2,2,2,0,4,100,0
307_marine,2,2,2,0,4,100,0
308_marine,2,2,2,0,4,100,0
309_marine,2,2,2,0,4,100,0
310_marine,2,2,2,0,4,100,0
311_marine,2,2,2,0,4,100,0
312_marine,2,2,2,0,4,100,0
313_marine,2,2,2,0,4,100,0
314_marine,2,2,2,0,4,100,0
315_marine,2,2,2,0,4,100,0
316_marine,2,2,2,0,4,100,0
317_marine,2,2,2,0,4,100,0
318_marine,2,2,2,0,4,100,0
319_marine,2,2,2,0,4,100,0
320_marine,2,2,2,0,4,100,0
321_marine,2,2,2,0,4,100,0
322_marine,2,2,2,0,4,100,0
323_marine,2,2,2,0,4,100,0
324_marine,2,2,2,0,4,100,0
325_marine,2,2,2,0,4,100,0
326_marine,2,2,2,0,4,100,0
327_marine,2,2,2,0,4,100,0
328_marine,2,2,2,0,4,100,0
329_marine,2,2,2,0,4,100,0
330_marine,2,2,2,0,4,100,0
331_marine,2,2,2,0,4,100,0
332_marine,2,2,2,0,4,100,0
333_marine,2,2,2,0,4,100,0
334_marine,2,2,2,0,4,100,0
335_marine,2,2,2,0,4,100,0
336_marine,2,2,2,0,4,100,0
337_marine,2,2,2,0,4,100,0
338_marine,2,2,2,0,4,100,0
339_marine,2,2,2,0,4,100,0
340_marine,2,2,2,0,4,100,0
341_marine,2,2,2,0,4,100,0
342_marine,2,2,2,0,4,100,0
343_marine,2,2,2,0,4,100,0
344_marine,2,2,2,0,4,100,0
345_marine,2,2,2,0,4,100,0
346_marine,2,2,2,0,4,100,0
347_marine,2,2,2,0,4,100,0
348_marine,2,2,2,0,4,100,0
349_marine,2,2,2,0,4,100,0
350_marine,2,2,2,0,4,100,0
351_marine,2,2,2,0,4,100,0
352_marine,2,2,2,0,4,100,0
353_marine,2,2,2,0,4,100,0
354_marine,2,2,2,0,4,100,0
355_marine,2,2,2,0,4,100,0
356_marine,2,2,2,0,4,100,0
357_marine,2,2,2,0,4,100,0
358_marine,2,2,2,0,4,100,0
359_marine,2,2,2,0,4,100,0
360_marine,2,2,2,0,4,100,0
361_marine,2,2,2,0,4,100,0
362_marine,2,2,2,0,4,100,0
363_marine,2,2,2,0,4,100,0
364_marine,2,2,2,0,4,100,0
365_marine,2,2,2,0,4,100,0
366_marine,2,2,2,0,4,100,0
367_marine,2,2,2,0,4,100,0
368_marine,2,2,2,0,4,100,0
369_marine,2,2,2,0,4,100,0
370_marine,2,2,2,0,4,100,0
371_marine,2,2,2,0,4,100,0
372_marine,2,2,2,0,4,100,0
373_marine,2,2,2,0,4,100,0
374_marine,2,2,2,0,4,100,0
375_marine,2,2,2,0,4,100,0
376_marine,2,2,2,0,4,100,0
377_marine,2,2,2,0,4,100,0
378_marine,2,2,2,0,4,100,0
379_marine,2,2,2,0,4,100,0
380_marine,2,2,2,0,4,100,0
381_marine,2,2,2,0,4,100,0
382_marine,2,2,2,0,4,100,0
383_marine,2,2,2,0,4,100,0
384_marine,2,2,2,0,4,100,0
385_marine,2,2,2,0,4,100,0
386_marine,2,2,2,0,4,100,0
387_marine,2,2,2,0,4,100,0
388_marine,2,2,2,0,4,100,0
389_marine,2,2,2,0,4,100,0
390_marine,2,2,2,0,4,100,0
391_marine,2,2,2,0,4,100,0
392_marine,2,2,2,0,4,100,0
393_marine,2,2,2,0,4,100,0
394_marine,2,2,2,0,4,100,0
395_marine,2,2,2,0,4,100,0
396_marine,2,2,2,0,4,100,0
397_marine,2,2,2,0,4,100,0
398_marine,2,2,2,0,4,100,0
399_marine,2,2,2,0,4,100,0
400_marine,2,2,2,0,4,100,0
401_marine,2,2,2,0,4,100,0
402_marine,2,2,2,0,4,100,0
403_marine,2,2,2,0,4,100,0
404_marine,2,2,2,0,4,100,0
405_marine,2,2,2,0,4,100,0
406_marine,2,2,2,0,4,100,0
407_marine,2,2,2,0,4,100,0
408_marine,2,2,2,0,4,100,0
409_marine,2,2,2,0,4,100,0
410_marine,2,2,2,0,4,100,0
411_marine,2,2,2,0,4,100,0
412_marine,2,2,2,0,4,100,0
413_marine,2,2,2,0,4,100,0
414_marine,2,2,2,0,4,100,0
415_marine,2,2,2,0,4,100,0
416_marine,2,2,2,0,4,100,0
417_marine,2,2,2,0,4,100,0
418_marine,2,2,2,0,4,100,0
419_marine,2,2,2,0,4,100,0
420_marine,2,2,2,0,4,100,0
421_marine,2,2,2,0,4,100,0
422_marine,2,2,2,0,4,100,0
423_marine,2,2,2,0,4,100,0
424_marine,2,2,2,0,4,100,0
425_marine,2,2,2,0,4,100,0
426_marine,2,2,2,0,4,100,0
427_marine,2,2,2,0,4,100,0
428_marine,2,2,2,0,4,100,0
429_marine,2,2,2,0,4,100,0
430_marine,2,2,2,0,4,100,0
431_marine,2,2,2,0,4,100,0
432_marine,2,2,2,0,4,100,0
433_marine,2,2,2,0,4,100,0
434_marine,2,2,2,0,4,100,0
435_marine,2,2,2,0,4,100,0
436_marine,2,2,2,0,4,100,0
437_marine,2,2,2,0,4,100,0
438_marine,2,2,2,0,4,100,0
439_marine,2,2,2,0,4,100,0
440_marine,2,2,2,0,4,100,0
441_marine,2,2,2,0,4,100,0
442_marine,2,2,2,0,4,100,0
443_marine,2,2,2,0,4,100,0
444_marine,2,2,2,0,4,100,0
445_marine,2,2,2,0,4,100,0
446_marine,2,2,2,0,4,100,0
447_marine,2,2,2,0,4,100,0
448_marine,2,2,2,0,4,100,0
449_marine,2,2,2,0,4,100,0
450_marine,2,2,2,0,4,100,0
451_marine,2,2,2,0,4,100,0
452_marine,2,2,2,0,4,100,0
453_marine,2,2,2,0,4,100,0
454_marine,2,2,2,0,4,100,0
455_marine,2,2,2,0,4,100,0
456_marine,2,2,2,0,4,100,0
457_marine,2,2,2,0,4,100,0
458_marine,2,2,2,0,4,100,0
459_marine,2,2,2,0,4,100,0
460_marine,2,2,2,0,4,100,0
461_marine,2,2,2,0,4,100,0
462_marine,2,2,2,0,4,100,0
463_marine,2,2,2,0,4,100,0
464_marine,2,2,2,0,4,100,0
465_marine,2,2,2,0,4,100,0
466_marine,2,2,2,0,4,100,0
467_marine,2,2,2,0,4,100,0
468_marine,2,2,2,0,4,100,0
469_marine,2,2,2,0,4,100,0
470_marine,2,2,2,0,4,100,0
471_marine,2,2,2,0,4,100,0
472_marine,2,2,2,0,4,100,0
473_marine,2,2,2,0,4,100,0
474_marine,2,2,2,0,4,100,0
475_marine,2,2,2,0,4,100,0
476_marine,2,2,2,0,4,100,0
477_marine,2,2,2,0,4,100,0
478_marine,2,2,2,0,4,100,0
479_marine,2,2,2,0,4,100,0
480_marine,2,2,2,0,4,100,0
481_marine,2,2,2,0,4,100,0
482_marine,2,2,2,0,4,100,0
483_marine,2,2,2,0,4,100,0
484_marine,2,2,2,0,4,100,0
485_marine,2,2,2,0,4,100,0
486_marine,2,2,2,0,4,100,0
487_marine,2,2,2,0,4,100,0
488_marine,2,2,2,0,4,100,0
489_marine,2,2,2,0,4,100,0
490_marine,2,2,2,0,4,100,0
491_marine,2,2,2,0,4,100,0
492_marine,2,2,2,0,4,100,0
493_marine,2,2,2,0,4,100,0
494_marine,2,2,2,0,4,100,0
495_marine,2,2,2,0,4,100,0
496_marine,2,2,2,0,4,100,0
497_marine,2,2,2,0,4,100,0
498_marine,2,2,2,0,4,100,0
499_marine,2,2,2,0,4,100,0
500_marine,2,2,2,0,4,100,0
501_marine,2,2,2,0,4,100,0
502_marine,2,2,2,0,4,100,0
503_marine,2,2,2,0,4,100,0
504_marine,2,2,2,0,4,100,0
505_marine,2,2,2,0,4,100,0
506_marine,2,2,2,0,4,100,0
507_marine,2,2,2,0,4,100,0
508_marine,2,2,2,0,4,100,0
509_marine,2,2,2,0,4,100,0
510_marine,2,2,2,0,4,100,0
511_marine,2,2,2,0,4,100,0
512_marine,2,2,2,0,4,100,0
513_marine,2,2,2,0,4,100,0
514_marine,2,2,2,0,4,100,0
515_marine,2,2,2,0,4,100,0
516_marine,2,2,2,0,4,100,0
517_marine,2,2,2,0,4,100,0
518_marine,2,2,2,0,4,100,0
519_marine,2,2,2,0,4,100,0
520_marine,2,2,2,0,4,100,0
521_marine,2,2,2,0,4,100,0
522_marine,2,2,2,0,4,100,0
523_marine,2,2,2,0,4,100,0
524_marine,2,2,2,0,4,100,0
525_marine,2,2,2,0,4,100,0
526_marine,2,2,2,0,4,100,0
527_marine,2,2,2,0,4,100,0
528_marine,2,2,2,0,4,100,0
529_marine,2,2,2,0,4,100,0
530_marine,2,2,2,0,4,100,0
531_marine,2,2,2,0,4,100,0
532_marine,2,2,2,0,4,100,0
533_marine,2,2,2,0,4,100,0
534_marine,2,2,2,0,4,100,0
535_marine,2,2,2,0,4,100,0
536_marine,2,2,2,0,4,100,0
537_marine,2,2,2,0,4,100,0
538_marine,2,2,2,0,4,100,0
539_marine,2,2,2,0,4,100,0
540_marine,2,2,2,0,4,100,0
541_marine,2,2,2,0,4,100,0
542_marine,2,2,2,0,4,100,0
543_marine,2,2,2,0,4,100,0
544_marine,2,2,2,0,4,100,0
545_marine,2,2,2,0,4,100,0
546_marine,2,2,2,0,4,100,0
547_marine,2,2,2,0,4,100,0
548_marine,2,2,2,0,4,100,0
549_marine,2,2,2,0,4,100,0
550_marine,2,2,2,0,4,100,0
551_marine,2,2,2,0,4,100,0
552_marine,2,2,2,0,4,100,0
553_marine,2,2,2,0,4,100,0
554_marine,2,2,2,0,4,100,0
555_marine,2,2,2,0,4,100,0
556_marine,2,2,2,0,4,100,0
557_marine,2,2,2,0,4,100,0
558_marine,2,2,2,0,4,100,0
559_marine,2,2,2,0,4,100,0
560_marine,2,2,2,0,4,100,0
561_marine,2,2,2,0,4,100,0
562_marine,2,2,2,0,4,100,0
563_marine,2,2,2,0,4,100,0
564_marine,2,2,2,0,4,100,0
565_marine,2,2,2,0,4,100,0
566_marine,2,2,2,0,4,100,0
567_marine,2,2,2,0,4,100,0
568_marine,2,2,2,0,4,100,0
569_marine,2,2,2,0,4,100,0
570_marine,2,2,2,0,4,100,0
571_marine,2,2,2,0,4,100,0
572_marine,2,2,2,0,4,100,0
573_marine,2,2,2,0,4,100,0
574_marine,2,2,2,0,4,100,0
575_marine,2,2,2,0,4,100,0
576_marine,2,2,2,0,4,100,0
577_marine,2,2,2,0,4,100,0
578_marine,2,2,2,0,4,100,0
579_marine,2,2,2,0,4,100,0
580_marine,2,2,2,0,4,100,0
581_marine,2,2,2,0,4,100,0
582_marine,2,2,2,0,4,100,0
583_marine,2,2,2,0,4,100,0
584_marine,2,2,2,0,4,100,0
585_marine,2,2,2,0,4,100,0
586_marine,2,2,2,0,4,100,0
587_marine,2,2,2,0,4,100,0
588_marine,2,2,2,0,4,100,0
589_marine,2,2,2,0,4,100,0
590_marine,2,2,2,0,4,100,0
591_marine,2,2,2,0,4,100,0
592_marine,2,2,2,0,4,100,0
593_marine,2,2,2,0,4,100,0
594_marine,2,2,2,0,4,100,0
595_marine,2,2,2,0,4,100,0
596_marine,2,2,2,0,4,100,0
597_marine,2,2,2,0,4,100,0
598_marine,2,2,2,0,4,100,0
599_marine,2,2,2,0,4,100,0
600_marine,2,2,2,0,4,100,0
601_marine,2,2,2,0,4,100,0
602_marine,2,2,2,0,4,100,0
603_marine,2,2,2,0,4,100,0
604_marine,2,2,2,0,4,100,0
605_marine,2,2,2,0,4,100,0
606_marine,2,2,2,0,4,100,0
607_marine,2,2,2,0,4,100,0
608_marine,2,2,2,0,4,100,0
609_marine,2,2,2,0,4,100,0
610_marine,2,2,2,0,4,100,0
611_marine,2,2,2,0,4,100,0
612_marine,2,2,2,0,4,100,0
613_marine,2,2,2,0,4,100,0
614_marine,2,2,2,0,4,100,0
615_marine,2,2,2,0,4,100,0
616_marine,2,2,2,0,4,100,0
617_marine,2,2,2,0,4,100,0
618_marine,2,2,2,0,4,100,0
619_marine,2,2,2,0,4,100,0
620_marine,2,2,2,0,4,100,0
621_marine,2,2,2,0,4,100,0
622_marine,2,2,2,0,4,100,0
623_marine,2,2,2,0,4,100,0
624_marine,2,2,2,0,4,100,0
625_marine,2,2,2,0,4,100,0
626_marine,2,2,2,0,4,100,0
627_marine,2,2,2,0,4,100,0
628_marine,2,2,2,0,4,100,0
629_marine,2,2,2,0,4,100,0
630_marine,2,2,2,0,4,100,0
631_marine,2,2,2,0,4,100,0
632_marine,2,2,2,0,4,100,0
633_marine,2,2,2,0,4,100,0
634_marine,2,2,2,0,4,100,0
635_marine,2,2,2,0,4,100,0
636_marine,2,2,2,0,4,100,0
637_marine,2,2,2,0,4,100,0
638_marine,2,2,2,0,4,100,0
639_marine,2,2,2,0,4,100,0
640_marine,2,2,2,0,4,100,0
641_marine,2,2,2,0,4,100,0
642_marine,2,2,2,0,4,100,0
643_marine,2,2,2,0,4,100,0
644_marine,2,2,2,0,4,100,0
645_marine,2,2,2,0,4,100,0
646_marine,2,2,2,0,4,100,0
647_marine,2,2,2,0,4,100,0
648_marine,2,2,2,0,4,100,0
649_marine,2,2,2,0,4,100,0
650_marine,2,2,2,0,4,100,0
651_marine,2,2,2,0,4,100,0
652_marine,2,2,2,0,4,100,0
653_marine,2,2,2,0,4,100,0
654_marine,2,2,2,0,4,100,0
655_marine,2,2,2,0,4,100,0
656_marine,2,2,2,0,4,100,0
657_marine,2,2,2,0,4,100,0
658_marine,2,2,2,0,4,100,0
659_marine,2,2,2,0,4,100,0
660_marine,2,2,2,0,4,100,0
661_marine,2,2,2,0,4,100,0
662_marine,2,2,2,0,4,100,0
663_marine,2,2,2,0,4,100,0
664_marine,2,2,2,0,4,100,0
665_marine,2,2,2,0,4,100,0
666_marine,2,2,2,0,4,100,0
667_marine,2,2,2,0,4,100,0
668_marine,2,2,2,0,4,100,0
669_marine,2,2,2,0,4,100,0
670_marine,2,2,2,0,4,100,0
671_marine,2,2,2,0,4,100,0
672_marine,2,2,2,0,4,100,0
673_marine,2,2,2,0,4,100,0
674_marine,2,2,2,0,4,100,0
675_marine,2,2,2,0,4,100,0
676_marine,2,2,2,0,4,100,0
677_marine,2,2,2,0,4,100,0
678_marine,2,2,2,0,4,100,0
679_marine,2,2,2,0,4,100,0
680_marine,2,2,2,0,4,100,0
681_marine,2,2,2,0,4,100,0
682_marine,2,2,2,0,4,100,0
683_marine,2,2,2,0,4,100,0
684_marine,2,2,2,0,4,100,0
685_marine,2,2,2,0,4,100,0
686_marine,2,2,2,0,4,100,0
687_marine,2,2,2,0,4,100,0
688_marine,2,2,2,0,4,100,0
689_marine,2,2,2,0,4,100,0
690_marine,2,2,2,0,4,100,0
691_marine,2,2,2,0,4,100,0
692_marine,2,2,2,0,4,100,0
693_marine,2,2,2,0,4,100,0
694_marine,2,2,2,0,4,100,0
695_marine,2,2,2,0,4,100,0
696_marine,2,2,2,0,4,100,0
697_marine,2,2,2,0,4,100,0
698_marine,2,2,2,0,4,100,0
699_marine,2,2,2,0,4,100,0
700_marine,2,2,2,0,4,100,0
701_marine,2,2,2,0,4,100,0
702_marine,2,2,2,0,4,100,0
703_marine,2,2,2,0,4,100,0
704_marine,2,2,2,0,4,100,0
705_marine,2,2,2,0,4,100,0
706_marine,2,2,2,0,4,100,0
707_marine,2,2,2,0,4,100,0
708_marine,2,2,2,0,4,100,0
709_marine,2,2,2,0,4,100,0
710_marine,2,2,2,0,4,100,0
711_marine,2,2,2,0,4,100,0
712_marine,2,2,2,0,4,100,0
713_marine,2,2,2,0,4,100,0
714_marine,2,2,2,0,4,100,0
715_marine,2,2,2,0,4,100,0
716_marine,2,2,2,0,4,100,0
717_marine,2,2,2,0,4,100,0
718_marine,2,2,2,0,4,100,0
719_marine,2,2,2,0,4,100,0
720_marine,2,2,2,0,4,100,0
721_marine,2,2,2,0,4,100,0
722_marine,2,2,2,0,4,100,0
723_marine,2,2,2,0,4,100,0
724_marine,2,2,2,0,4,100,0
725_marine,2,2,2,0,4,100,0
726_marine,2,2,2,0,4,100,0
727_marine,2,2,2,0,4,100,0
728_marine,2,2,2,0,4,100,0
729_marine,2,2,2,0,4,100,0
730_marine,2,2,2,0,4,100,0
731_marine,2,2,2,0,4,100,0
732_marine,2,2,2,0,4,100,0
733_marine,2,2,2,0,4,100,0
734_marine,2,2,2,0,4,100,0
735_marine,2,2,2,0,4,100,0
736_marine,2,2,2,0,4,100,0
737_marine,2,2,2,0,4,100,0
738_marine,2,2,2,0,4,100,0
739_marine,2,2,2,0,4,100,0
740_marine,2,2,2,0,4,100,0
741_marine,2,2,2,0,4,100,0
742_marine,2,2,2,0,4,100,0
743_marine,2,2,2,0,4,100,0
744_marine,2,2,2,0,4,100,0
745_marine,2,2,2,0,4,100,0
746_marine,2,2,2,0,4,100,0
747_marine,2,2,2,0,4,100,0
748_marine,2,2,2,0,4,100,0
749_marine,2,2,2,0,4,100,0
750_marine,2,2,2,0,4,100,0
751_marine,2,2,2,0,4,100,0
752_marine,2,2,2,0,4,100,0
753_marine,2,2,2,0,4,100,0
754_marine,2,2,2,0,4,100,0
755_marine,2,2,2,0,4,100,0
756_marine,2,2,2,0,4,100,0
757_marine,2,2,2,0,4,100,0
758_marine,2,2,2,0,4,100,0
759_marine,2,2,2,0,4,100,0
760_marine,2,2,2,0,4,100,0
761_marine,2,2,2,0,4,100,0
762_marine,2,2,2,0,4,100,0
763_marine,2,2,2,0,4,100,0
764_marine,2,2,2,0,4,100,0
765_marine,2,2,2,0,4,100,0
766_marine,2,2,2,0,4,100,0
767_marine,2,2,2,0,4,100,0
768_marine,2,2,2,0,4,100,0
769_marine,2,2,2,0,4,100,0
770_marine,2,2,2,0,4,100,0
771_marine,2,2,2,0,4,100,0
772_marine,2,2,2,0,4,100,0
773_marine,2,2,2,0,4,100,0
774_marine,2,2,2,0,4,100,0
775_marine,2,2,2,0,4,100,0
776_marine,2,2,2,0,4,100,0
777_marine,2,2,2,0,4,100,0
778_marine,2,2,2,0,4,100,0
779_marine,2,2,2,0,4,100,0
780_marine,2,2,2,0,4,100,0
781_marine,2,2,2,0,4,100,0
782_marine,2,2,2,0,4,100,0
783_marine,2,2,2,0,4,100,0
784_marine,2,2,2,0,4,100,0
785_marine,2,2,2,0,4,100,0
786_marine,2,2,2,0,4,100,0
787_marine,2,2,2,0,4,100,0
788_marine,2,2,2,0,4,100,0
789_marine,2,2,2,0,4,100,0
790_marine,2,2,2,0,4,100,0
791_marine,2,2,2,0,4,100,0
792_marine,2,2,2,0,4,100,0
793_marine,2,2,2,0,4,100,0
794_marine,2,2,2,0,4,100,0
795_marine,2,2,2,0,4,100,0
796_marine,2,2,2,0,4,100,0
797_marine,2,2,2,0,4,100,0
798_marine,2,2,2,0,4,100,0
799_marine,2,2,2,0,4,100,0
800_marine,2,2,2,0,4,100,0
801_marine,2,2,2,0,4,100,0
802_marine,2,2,2,0,4,100,0
803_marine,2,2,2,0,4,100,0
804_marine,2,2,2,0,4,100,0
805_marine,2,2,2,0,4,100,0
806_marine,2,2,2,0,4,100,0
807_marine,2,2,2,0,4,100,0
808_marine,2,2,2,0,4,100,0
809_marine,2,2,2,0,4,100,0
810_marine,2,2,2,0,4,100,0
811_marine,2,2,2,0,4,100,0
812_marine,2,2,2,0,4,100,0
813_marine,2,2,2,0,4,100,0
814_marine,2,2,2,0,4,100,0
815_marine,2,2,2,0,4,100,0
816_marine,2,2,2,0,4,100,0
817_marine,2,2,2,0,4,100,0
818_marine,2,2,2,0,4,100,0
819_marine,2,2,2,0,4,100,0
820_marine,2,2,2,0,4,100,0
821_marine,2,2,2,0,4,100,0
822_marine,2,2,2,0,4,100,0
823_marine,2,2,2,0,4,100,0
824_marine,2,2,2,0,4,100,0
825_marine,2,2,2,0,4,100,0
826_marine,2,2,2,0,4,100,0
827_marine,2,2,2,0,4,100,0
828_marine,2,2,2,0,4,100,0
829_marine,2,2,2,0,4,100,0
830_marine,2,2,2,0,4,100,0
831_marine,2,2,2,0,4,100,0
832_marine,2,2,2,0,4,100,0
833_marine,2,2,2,0,4,100,0
834_marine,2,2,2,0,4,100,0
835_marine,2,2,2,0,4,100,0
836_marine,2,2,2,0,4,100,0
837_marine,2,2,2,0,4,100,0
838_marine,2,2,2,0,4,100,0
839_marine,2,2,2,0,4,100,0
840_marine,2,2,2,0,4,100,0
841_marine,2,2,2,0,4,100,0
842_marine,2,2,2,0,4,100,0
843_marine,2,2,2,0,4,100,0
844_marine,2,2,2,0,4,100,0
845_marine,2,2,2,0,4,100,0
846_marine,2,2,2,0,4,100,0
847_marine,2,2,2,0,4,100,0
848_marine,2,2,2,0,4,100,0
849_marine,2,2,2,0,4,100,0
850_marine,2,2,2,0,4,100,0
851_marine,2,2,2,0,4,100,0
852_marine,2,2,2,0,4,100,0
853_marine,2,2,2,0,4,100,0
854_marine,2,2,2,0,4,100,0
855_marine,2,2,2,0,4,100,0
856_marine,2,2,2,0,4,100,0
857_marine,2,2,2,0,4,100,0
858_marine,2,2,2,0,4,100,0
859_marine,2,2,2,0,4,100,0
860_marine,2,2,2,0,4,100,0
861_marine,2,2,2,0,4,100,0
862_marine,2,2,2,0,4,100,0
863_marine,2,2,2,0,4,100,0
864_marine,2,2,2,0,4,100,0
865_marine,2,2,2,0,4,100,0
866_marine,2,2,2,0,4,100,0
867_marine,2,2,2,0,4,100,0
868_marine,2,2,2,0,4,100,0
869_marine,2,2,2,0,4,100,0
870_marine,2,2,2,0,4,100,0
871_marine,2,2,2,0,4,100,0
872_marine,2,2,2,0,4,100,0
873_marine,2,2,2,0,4,100,0
874_marine,2,2,2,0,4,100,0
875_marine,2,2,2,0,4,100,0
876_marine,2,2,2,0,4,100,0
877_marine,2,2,2,0,4,100,0
878_marine,2,2,2,0,4,100,0
879_marine,2,2,2,0,4,100,0
880_marine,2,2,2,0,4,100,0
881_marine,2,2,2,0,4,100,0
882_marine,2,2,2,0,4,100,0
883_marine,2,2,2,0,4,100,0
884_marine,2,2,2,0,4,100,0
885_marine,2,2,2,0,4,100,0
886_marine,2,2,2,0,4,100,0
887_marine,2,2,2,0,4,100,0
888_marine,2,2,2,0,4,100,0
889_marine,2,2,2,0,4,100,0
890_marine,2,2,2,0,4,100,0
891_marine,2,2,2,0,4,100,0
892_marine,2,2,2,0,4,100,0
893_marine,2,2,2,0,4,100,0
894_marine,2,2,2,0,4,100,0
895_marine,2,2,2,0,4,100,0
896_marine,2,2,2,0,4,100,0
897_marine,2,2,2,0,4,100,0
898_marine,2,2,2,0,4,100,0
899_marine,2,2,2,0,4,100,0
900_marine,2,2,2,0,4,100,0
901_marine,2,2,2,0,4,100,0
902_marine,2,2,2,0,4,100,0
903_marine,2,2,2,0,4,100,0
904_marine,2,2,2,0,4,100,0
905_marine,2,2,2,0,4,100,0
906_marine,2,2,2,0,4,100,0
907_marine,2,2,2,0,4,100,0
908_marine,2,2,2,0,4,100,0
909_marine,2,2,2,0,4,100,0
910_marine,2,2,2,0,4,100,0
911_marine,2,2,2,0,4,100,0
912_marine,2,2,2,0,4,100,0
913_marine,2,2,2,0,4,100,0
914_marine,2,2,2,0,4,100,0
915_marine,2,2,2,0,4,100,0
916_marine,2,2,2,0,4,100,0
917_marine,2,2,2,0,4,100,0
918_marine,2,2,2,0,4,100,0
919_marine,2,2,2,0,4,100,0
920_marine,2,2,2,0,4,100,0
921_marine,2,2,2,0,4,100,0
922_marine,2,2,2,0,4,100,0
923_marine,2,2,2,0,4,100,0
924_marine,2,2,2,0,4,100,0
925_marine,2,2,2,0,4,100,0
926_marine,2,2,2,0,4,100,0
927_marine,2,2,2,0,4,100,0
928_marine,2,2,2,0,4,100,0
929_marine,2,2,2,0,4,100,0
930_marine,2,2,2,0,4,100,0
931_marine,2,2,2,0,4,100,0
932_marine,2,2,2,0,4,100,0
933_marine,2,2,2,0,4,100,0
934_marine,2,2,2,0,4,100,0
935_marine,2,2,2,0,4,100,0
936_marine,2,2,2,0,4,100,0
937_marine,2,2,2,0,4,100,0
938_marine,2,2,2,0,4,100,0
939_marine,2,2,2,0,4,100,0
940_marine,2,2,2,0,4,100,0
941_marine,2,2,2,0,4,100,0
942_marine,2,2,2,0,4,100,0
943_marine,2,2,2,0,4,100,0
944_marine,2,2,2,0,4,100,0
945_marine,2,2,2,0,4,100,0
946_marine,2,2,2,0,4,100,0
947_marine,2,2,2,0,4,100,0
948_marine,2,2,2,0,4,100,0
949_marine,2,2,2,0,4,100,0
950_marine,2,2,2,0,4,100,0
951_marine,2,2,2,0,4,100,0
952_marine,2,2,2,0,4,100,0
953_marine,2,2,2,0,4,100,0
954_marine,2,2,2,0,4,100,0
955_marine,2,2,2,0,4,100,0
956_marine,2,2,2,0,4,100,0
957_marine,2,2,2,0,4,100,0
958_marine,2,2,2,0,4,100,0
959_marine,2,2,2,0,4,100,0
960_marine,2,2,2,0,4,100,0
961_marine,2,2,2,0,4,100,0
962_marine,2,2,2,0,4,100,0
963_marine,2,2,2,0,4,100,0
964_marine,2,2,2,0,4,100,0
965_marine,2,2,2,0,4,100,0
966_marine,2,2,2,0,4,100,0
967_marine,2,2,2,0,4,100,0
968_marine,2,2,2,0,4,100,0
969_marine,2,2,2,0,4,100,0
970_marine,2,2,2,0,4,100,0
971_marine,2,2,2,0,4,100,0
972_marine,2,2,2,0,4,100,0
973_marine,2,2,2,0,4,100,0
974_marine,2,2,2,0,4,100,0
975_marine,2,2,2,0,4,100,0
976_marine,2,2,2,0,4,100,0
977_marine,2,2,2,0,4,100,0
978_marine,2,2,2,0,4,100,0
979_marine,2,2,2,0,4,100,0
980_marine,2,2,2,0,4,100,0
981_marine,2,2,2,0,4,100,0
982_marine,2,2,2,0,4,100,0
983_marine,2,2,2,0,4,100,0
984_marine,2,2,2,0,4,100,0
985_marine,2,2,2,0,4,100,0
986_marine,2,2,2,0,4,100,0
987_marine,2,2,2,0,4,100,0
988_marine,2,2,2,0,4,100,0
989_marine,2,2,2,0,4,100,0
990_marine,2,2,2,0,4,100,0
991_marine,2,2,2,0,4,100,0
992_marine,2,2,2,0,4,100,0
993_marine,2,2,2,0,4,100,0
994_marine,2,2,2,0,4,100,0
995_marine,2,2,2,0,4,100,0
996_marine,2,2,2,0,4,100,0
997_marine,2,2,2,0,4,100,0
998_marine,2,2,2,0,4,100,0
999_marine,2,2,2,0,4,100,0
1000_marine,2,2,2,0,4,100,0
1001_marine,2,2,2,0,4,100,0
1002_marine,2,2,2,0,4,100,0
1003_marine,2,2,2,0,4,100,0
1004_marine,2,2,2,0,4,100,0
1005_marine,2,2,2,0,4,100,0
1006_marine,2,2,2,0,4,100,0
1007_marine,2,2,2,0,4,100,0
1008_marine,2,2,2,0,4,100,0
1009_marine,2,2,2,0,4,100,0
1010_marine,2,2,2,0,4,100,0
1011_marine,2,2,2,0,4,100,0
1012_marine,2,2,2,0,4,100,0
1013_marine,2,2,2,0,4,100,0
1014_marine,2,2,2,0,4,100,0
1015_marine,2,2,2,0,4,100,0
1016_marine,2,2,2,0,4,100,0
1017_marine,2,2,2,0,4,100,0
1018_marine,2,2,2,0,4,100,0
1019_marine,2,2,2,0,4,100,0
1020_marine,2,2,2,0,4,100,0
1021_marine,2,2,2,0,4,100,0
1022_marine,2,2,2,0,4,100,0
1023_marine,2,2,2,0,4,100,0
1024_marine,2,2,2,0,4,100,0
1025_marine,2,2,2,0,4,100,0
1026_marine,2,2,2,0,4,100,0
1027_marine,2,2,2,0,4,100,0
1028_marine,2,2,2,0,4,100,0
1029_marine,2,2,2,0,4,100,0
1030_marine,2,2,2,0,4,100,0
1031_marine,2,2,2,0,4,100,0
1032_marine,2,2,2,0,4,100,0
1033_marine,2,2,2,0,4,100,0
1034_marine,2,2,2,0,4,100,0
1035_marine,2,2,2,0,4,100,0
1036_marine,2,2,2,0,4,100,0
1037_marine,2,2,2,0,4,100,0
1038_marine,2,2,2,0,4,100,0
1039_marine,2,2,2,0,4,100,0
1040_marine,2,2,2,0,4,100,0
1041_marine,2,2,2,0,4,100,0
1042_marine,2,2,2,0,4,100,0
1043_marine,2,2,2,0,4,100,0
1044_marine,2,2,2,0,4,100,0
1045_marine,2,2,2,0,4,100,0
1046_marine,2,2,2,0,4,100,0
1047_marine,2,2,2,0,4,100,0
1048_marine,2,2,2,0,4,100,0
1049_marine,2,2,2,0,4,100,0
1050_marine,2,2,2,0,4,100,0
1051_marine,2,2,2,0,4,100,0
1052_marine,2,2,2,0,4,100,0
1053_marine,2,2,2,0,4,100,0
1054_marine,2,2,2,0,4,100,0
1055_marine,2,2,2,0,4,100,0
1056_marine,2,2,2,0,4,100,0
1057_marine,2,2,2,0,4,100,0
1058_marine,2,2,2,0,4,100,0
1059_marine,2,2,2,0,4,100,0
1060_marine,2,2,2,0,4,100,0
1061_marine,2,2,2,0,4,100,0
1062_marine,2,2,2,0,4,100,0
1063_marine,2,2,2,0,4,100,0
1064_marine,2,2,2,0,4,100,0
1065_marine,2,2,2,0,4,100,0
1066_marine,2,2,2,0,4,100,0
1067_marine,2,2,2,0,4,100,0
1068_marine,2,2,2,0,4,100,0
1069_marine,2,2,2,0,4,100,0
1070_marine,2,2,2,0,4,100,0
1071_marine,2,2,2,0,4,100,0
1072_marine,2,2,2,0,4,100,0
1073_marine,2,2,2,0,4,100,0
1074_marine,2,2,2,0,4,100,0
1075_marine,2,2,2,0,4,100,0
1076_marine,2,2,2,0,4,100,0
1077_marine,2,2,2,0,4,100,0
1078_marine,2,2,2,0,4,100,0
1079_marine,2,2,2,0,4,100,0
1080_marine,2,2,2,0,4,100,0
1081_marine,2,2,2,0,4,100,0
1082_marine,2,2,2,0,4,100,0
1083_marine,2,2,2,0,4,100,0
1084_marine,2,2,2,0,4,100,0
1085_marine,2,2,2,0,4,100,0
1086_marine,2,2,2,0,4,100,0
1087_marine,2,2,2,0,4,100,0
1088_marine,2,2,2,0,4,100,0
1089_marine,2,2,2,0,4,100,0
1090_marine,2,2,2,0,4,100,0
1091_marine,2,2,2,0,4,100,0
1092_marine,2,2,2,0,4,100,0
1093_marine,2,2,2,0,4,100,0
1094_marine,2,2,2,0,4,100,0
1095_marine,2,2,2,0,4,100,0
1096_marine,2,2,2,0,4,100,0
1097_marine,2,2,2,0,4,100,0
1098_marine,2,2,2,0,4,100,0
1099_marine,2,2,2,0,4,100,0
1100_marine,2,2,2,0,4,100,0
1101_marine,2,2,2,0,4,100,0
1102_marine,2,2,2,0,4,100,0
1103_marine,2,2,2,0,4,100,0
1104_marine,2,2,2,0,4,100,0
1105_marine,2,2,2,0,4,100,0
1106_marine,2,2,2,0,4,100,0
1107_marine,2,2,2,0,4,100,0
1108_marine,2,2,2,0,4,100,0
1109_marine,2,2,2,0,4,100,0
1110_marine,2,2,2,0,4,100,0
1111_marine,2,2,2,0,4,100,0
1112_marine,2,2,2,0,4,100,0
1113_marine,2,2,2,0,4,100,0
1114_marine,2,2,2,0,4,100,0
1115_marine,2,2,2,0,4,100,0
1116_marine,2,2,2,0,4,100,0
1117_marine,2,2,2,0,4,100,0
1118_marine,2,2,2,0,4,100,0
1119_marine,2,2,2,0,4,100,0
1120_marine,2,2,2,0,4,100,0
1121_marine,2,2,2,0,4,100,0
1122_marine,2,2,2,0,4,100,0
1123_marine,2,2,2,0,4,100,0
1124_marine,2,2,2,0,4,100,0
1125_marine,2,2,2,0,4,100,0
1126_marine,2,2,2,0,4,100,0
1127_marine,2,2,2,0,4,100,0
1128_marine,2,2,2,0,4,100,0
1129_marine,2,2,2,0,4,100,0
1130_marine,2,2,2,0,4,100,0
1131_marine,2,2,2,0,4,100,0
1132_marine,2,2,2,0,4,100,0
1133_marine,2,2,2,0,4,100,0
1134_marine,2,2,2,0,4,100,0
1135_marine,2,2,2,0,4,100,0
1136_marine,2,2,2,0,4,100,0
1137_marine,2,2,2,0,4,100,0
1138_marine,2,2,2,0,4,100,0
1139_marine,2,2,2,0,4,100,0
1140_marine,2,2,2,0,4,100,0
1141_marine,2,2,2,0,4,100,0
1142_marine,2,2,2,0,4,100,0
1143_marine,2,2,2,0,4,100,0
1144_marine,2,2,2,0,4,100,0
1145_marine,2,2,2,0,4,100,0
1146_marine,2,2,2,0,4,100,0
1147_marine,2,2,2,0,4,100,0
1148_marine,2,2,2,0,4,100,0
1149_marine,2,2,2,0,4,100,0
1150_marine,2,2,2,0,4,100,0
1151_marine,2,2,2,0,4,100,0
1152_marine,2,2,2,0,4,100,0
1153_marine,2,2,2,0,4,100,0
1154_marine,2,2,2,0,4,100,0
1155_marine,2,2,2,0,4,100,0
1156_marine,2,2,2,0,4,100,0
1157_marine,2,2,2,0,4,100,0
1158_marine,2,2,2,0,4,100,0
1159_marine,2,2,2,0,4,100,0
1160_marine,2,2,2,0,4,100,0
1161_marine,2,2,2,0,4,100,0
1162_marine,2,2,2,0,4,100,0
1163_marine,2,2,2,0,4,100,0
1164_marine,2,2,2,0,4,100,0
1165_marine,2,2,2,0,4,100,0
1166_marine,2,2,2,0,4,100,0
1167_marine,2,2,2,0,4,100,0
1168_marine,2,2,2,0,4,100,0
1169_marine,2,2,2,0,4,100,0
1170_marine,2,2,2,0,4,100,0
1171_marine,2,2,2,0,4,100,0
1172_marine,2,2,2,0,4,100,0
1173_marine,2,2,2,0,4,100,0
1174_marine,2,2,2,0,4,100,0
1175_marine,2,2,2,0,4,100,0
1176_marine,2,2,2,0,4,100,0
1177_marine,2,2,2,0,4,100,0
1178_marine,2,2,2,0,4,100,0
1179_marine,2,2,2,0,4,100,0
1180_marine,2,2,2,0,4,100,0
1181_marine,2,2,2,0,4,100,0
1182_marine,2,2,2,0,4,100,0
1183_marine,2,2,2,0,4,100,0
1184_marine,2,2,2,0,4,100,0
1185_marine,2,2,2,0,4,100,0
1186_marine,2,2,2,0,4,100,0
1187_marine,2,2,2,0,4,100,0
1188_marine,2,2,2,0,4,100,0
1189_marine,2,2,2,0,4,100,0
1190_marine,2,2,2,0,4,100,0
1191_marine,2,2,2,0,4,100,0
1192_marine,2,2,2,0,4,100,0
1193_marine,2,2,2,0,4,100,0
1194_marine,2,2,2,0,4,100,0
1195_marine,2,2,2,0,4,100,0
1196_marine,2,2,2,0,4,100,0
1197_marine,2,2,2,0,4,100,0
1198_marine,2,2,2,0,4,100,0
1199_marine,2,2,2,0,4,100,0
1200_marine,2,2,2,0,4,100,0
1201_marine,2,2,2,0,4,100,0
1202_marine,2,2,2,0,4,100,0
1203_marine,2,2,2,0,4,100,0
1204_marine,2,2,2,0,4,100,0
1205_marine,2,2,2,0,4,100,0
1206_marine,2,2,2,0,4,100,0
1207_marine,2,2,2,0,4,100,0
1208_marine,2,2,2,0,4,100,0
1209_marine,2,2,2,0,4,100,0
1210_marine,2,2,2,0,4,100,0
1211_marine,2,2,2,0,4,100,0
1212_marine,2,2,2,0,4,100,0
1213_marine,2,2,2,0,4,100,0
1214_marine,2,2,2,0,4,100,0
1215_marine,2,2,2,0,4,100,0
1216_marine,2,2,2,0,4,100,0
1217_marine,2,2,2,0,4,100,0
1218_marine,2,2,2,0,4,100,0
1219_marine,2,2,2,0,4,100,0
1220_marine,2,2,2,0,4,100,0
1221_marine,2,2,2,0,4,100,0
1222_marine,2,2,2,0,4,100,0
1223_marine,2,2,2,0,4,100,0
1224_marine,2,2,2,0,4,100,0
1225_marine,2,2,2,0,4,100,0
1226_marine,2,2,2,0,4,100,0
1227_marine,2,2,2,0,4,100,0
1228_marine,2,2,2,0,4,100,0
1229_marine,2,2,2,0,4,100,0
1230_marine,2,2,2,0,4,100,0
1231_marine,2,2,2,0,4,100,0
1232_marine,2,2,2,0,4,100,0
1233_marine,2,2,2,0,4,100,0
1234_marine,2,2,2,0,4,100,0
1235_marine,2,2,2,0,4,100,0
1236_marine,2,2,2,0,4,100,0
1237_marine,2,2,2,0,4,100,0
1238_marine,2,2,2,0,4,100,0
1239_marine,2,2,2,0,4,100,0
1240_marine,2,2,2,0,4,100,0
1241_marine,2,2,2,0,4,100,0
1242_marine,2,2,2,0,4,100,0
1243_marine,2,2,2,0,4,100,0
1244_marine,2,2,2,0,4,100,0
1245_marine,2,2,2,0,4,100,0
1246_marine,2,2,2,0,4,100,0
1247_marine,2,2,2,0,4,100,0
1248_marine,2,2,2,0,4,100,0
1249_marine,2,2,2,0,4,100,0
1250_marine,2,2,2,0,4,100,0
1251_marine,2,2,2,0,4,100,0
1252_marine,2,2,2,0,4,100,0
1253_marine,2,2,2,0,4,100,0
1254_marine,2,2,2,0,4,100,0
1255_marine,2,2,2,0,4,100,0
1256_marine,2,2,2,0,4,100,0
1257_marine,2,2,2,0,4,100,0
1258_marine,2,2,2,0,4,100,0
1259_marine,2,2,2,0,4,100,0
1260_marine,2,2,2,0,4,100,0
1261_marine,2,2,2,0,4,100,0
1262_marine,2,2,2,0,4,100,0
1263_marine,2,2,2,0,4,100,0
1264_marine,2,2,2,0,4,100,0
1265_marine,2,2,2,0,4,100,0
1266_marine,2,2,2,0,4,100,0
1267_marine,2,2,2,0,4,100,0
1268_marine,2,2,2,0,4,100,0
1269_marine,2,2,2,0,4,100,0
1270_marine,2,2,2,0,4,100,0
1271_marine,2,2,2,0,4,100,0
1272_marine,2,2,2,0,4,100,0
1273_marine,2,2,2,0,4,100,0
1274_marine,2,2,2,0,4,100,0
1275_marine,2,2,2,0,4,100,0
1276_marine,2,2,2,0,4,100,0
1277_marine,2,2,2,0,4,100,0
1278_marine,2,2,2,0,4,100,0
1279_marine,2,2,2,0,4,100,0
1280_marine,2,2,2,0,4,100,0
1281_marine,2,2,2,0,4,100,0
1282_marine,2,2,2,0,4,100,0
1283_marine,2,2,2,0,4,100,0
1284_marine,2,2,2,0,4,100,0
1285_marine,2,2,2,0,4,100,0
1286_marine,2,2,2,0,4,100,0
1287_marine,2,2,2,0,4,100,0
1288_marine,2,2,2,0,4,100,0
1289_marine,2,4,2,0,6,100,0
1290_marine,2,4,2,0,6,100,0
1291_marine,2,4,2,0,6,100,0
1292_marine,2,2,2,0,4,100,0
1293_marine,2,2,2,0,4,100,0
1294_marine,2,2,2,0,4,100,0
1295_marine,2,2,2,0,4,100,0
1296_marine,2,2,2,0,4,100,0
1297_marine,2,2,2,0,4,100,0
1298_marine,2,2,2,0,4,100,0
1299_marine,2,2,2,0,4,100,0
1300_marine,2,2,2,0,4,100,0
1301_marine,2,2,2,0,4,100,0
1302_marine,2,2,2,0,4,100,0
1303_marine,2,2,2,0,4,100,0
1304_marine,2,2,2,0,4,100,0
1305_marine,2,2,2,0,4,100,0
1306_marine,2,2,2,0,4,100,0
1307_marine,2,2,2,0,4,100,0
1308_marine,2,2,2,0,4,100,0
1309_marine,2,2,2,0,4,100,0
1310_marine,2,2,2,0,4,100,0
1311_marine,2,2,2,0,4,100,0
1312_marine,2,2,2,0,4,100,0
1313_marine,2,2,2,0,4,100,0
1314_marine,2,2,2,0,4,100,0
1315_marine,2,2,2,0,4,100,0
1316_marine,2,2,2,0,4,100,0
1317_marine,2,2,2,0,4,100,0
1318_marine,2,2,2,0,4,100,0
1319_marine,2,2,2,0,4,100,0
1320_marine,2,2,2,0,4,100,0
1321_marine,2,2,2,0,4,100,0
1322_marine,2,2,2,0,4,100,0
1323_marine,2,2,2,0,4,100,0
1324_marine,2,2,2,0,4,100,0
1325_marine,2,2,2,0,4,100,0
1326_marine,2,2,2,0,4,100,0
1327_marine,2,2,2,0,4,100,0
1328_marine,2,2,2,0,4,100,0
1329_marine,2,2,2,0,4,100,0
1330_marine,2,2,2,0,4,100,0
1331_marine,2,2,2,0,4,100,0
1332_marine,2,2,2,0,4,100,0
1333_marine,2,2,2,0,4,100,0
1334_marine,2,2,2,0,4,100,0
1335_marine,2,2,2,0,4,100,0
1336_marine,2,2,2,0,4,100,0
1337_marine,2,2,2,0,4,100,0
1338_marine,2,2,2,0,4,100,0
1339_marine,2,2,2,0,4,100,0
1340_marine,2,2,2,0,4,100,0
1341_marine,2,2,2,0,4,100,0
1342_marine,2,2,2,0,4,100,0
1343_marine,2,2,2,0,4,100,0
1344_marine,2,2,2,0,4,100,0
1345_marine,2,2,2,0,4,100,0
1346_marine,2,2,2,0,4,100,0
1347_marine,2,2,2,0,4,100,0
1348_marine,2,2,2,0,4,100,0
1349_marine,2,2,2,0,4,100,0
1350_marine,2,2,2,0,4,100,0
1351_marine,2,2,2,0,4,100,0
1352_marine,2,2,2,0,4,100,0
1353_marine,2,2,2,0,4,100,0
1354_marine,2,2,2,0,4,100,0
1355_marine,2,2,2,0,4,100,0
1356_marine,2,2,2,0,4,100,0
1357_marine,2,2,2,0,4,100,0
1358_marine,2,2,2,0,4,100,0
1359_marine,2,2,2,0,4,100,0
1360_marine,2,2,2,0,4,100,0
1361_marine,2,2,2,0,4,100,0
1362_marine,2,2,2,0,4,100,0
1363_marine,2,2,2,0,4,100,0
1364_marine,2,2,2,0,4,100,0
1365_marine,2,2,2,0,4,100,0
1366_marine,2,2,2,0,4,100,0
1367_marine,2,2,2,0,4,100,0
1368_marine,2,2,2,0,4,100,0
1369_marine,2,2,2,0,4,100,0
1370_marine,2,2,2,0,4,100,0
1371_marine,2,2,2,0,4,100,0
1372_marine,2,2,2,0,4,100,0
1373_marine,2,2,2,0,4,100,0
1374_marine,2,2,2,0,4,100,0
1375_marine,2,2,2,0,4,100,0
1376_marine,2,2,2,0,4,100,0
1377_marine,2,2,2,0,4,100,0
1378_marine,2,2,2,0,4,100,0
1379_marine,2,2,2,0,4,100,0
1380_marine,2,2,2,0,4,100,0
1381_marine,2,2,2,0,4,100,0
1382_marine,2,2,2,0,4,100,0
1383_marine,2,2,2,0,4,100,0
1384_marine,2,2,2,0,4,100,0
1385_marine,2,2,2,0,4,100,0
1386_marine,2,2,2,0,4,100,0
1387_marine,2,2,2,0,4,100,0
1388_marine,2,2,2,0,4,100,0
1389_marine,2,2,2,0,4,100,0
1390_marine,2,2,2,0,4,100,0
1391_marine,2,2,2,0,4,100,0
1392_marine,2,2,2,0,4,100,0
1393_marine,2,2,2,0,4,100,0
1394_marine,2,2,2,0,4,100,0
1395_marine,2,2,2,0,4,100,0
1396_marine,2,2,2,0,4,100,0
1397_marine,2,2,2,0,4,100,0
1398_marine,2,2,2,0,4,100,0
1399_marine,2,2,2,0,4,100,0
1400_marine,2,2,2,0,4,100,0
1401_marine,2,2,2,0,4,100,0
1402_marine,2,2,2,0,4,100,0
1403_marine,2,2,2,0,4,100,0
1404_marine,2,2,2,0,4,100,0
1405_marine,2,2,2,0,4,100,0
1406_marine,2,2,2,0,4,100,0
1407_marine,2,2,2,0,4,100,0
1408_marine,2,2,2,0,4,100,0
1409_marine,2,2,2,0,4,100,0
1410_marine,2,2,2,0,4,100,0
1411_marine,2,2,2,0,4,100,0
1412_marine,2,2,2,0,4,100,0
1413_marine,2,2,2,0,4,100,0
1414_marine,2,2,2,0,4,100,0
1415_marine,2,2,2,0,4,100,0
1416_marine,2,2,2,0,4,100,0
1417_marine,2,2,2,0,4,100,0
1418_marine,2,2,2,0,4,100,0
1419_marine,2,2,2,0,4,100,0
1420_marine,2,2,2,0,4,100,0
1421_marine,2,2,2,0,4,100,0
1422_marine,2,2,2,0,4,100,0
1423_marine,2,2,2,0,4,100,0
1424_marine,2,2,2,0,4,100,0
1425_marine,2,2,2,0,4,100,0
1426_marine,2,2,2,0,4,100,0
1427_marine,2,2,2,0,4,100,0
1428_marine,2,2,2,0,4,100,0
1429_marine,2,2,2,0,4,100,0
1430_marine,2,2,2,0,4,100,0
1431_marine,2,2,2,0,4,100,0
1432_marine,2,2,2,0,4,100,0
1433_marine,2,2,2,0,4,100,0
1434_marine,2,2,2,0,4,100,0
1435_marine,2,2,2,0,4,100,0
1436_marine,2,2,2,0,4,100,0
1437_marine,2,2,2,0,4,100,0
1438_marine,2,2,2,0,4,100,0
1439_marine,2,2,2,0,4,100,0
1440_marine,2,2,2,0,4,100,0
1444_marine,2,2,2,0,4,100,0
1445_marine,2,2,2,0,4,100,0
1446_marine,2,2,2,0,4,100,0
1447_marine,2,2,2,0,4,100,0
1448_marine,2,2,2,0,4,100,0
1449_marine,2,2,2,0,4,100,0
1450_marine,2,2,2,0,4,100,0
1451_marine,2,2,2,0,4,100,0
1452_marine,2,2,2,0,4,100,0
1453_marine,2,2,2,0,4,100,0
1454_marine,2,2,2,0,4,100,0
1455_marine,2,2,2,0,4,100,0
1456_marine,2,2,2,0,4,100,0
1457_marine,2,2,2,0,4,100,0
1458_marine,2,2,2,0,4,100,0
1459_marine,2,2,2,0,4,100,0
1460_marine,2,2,2,0,4,100,0
1461_marine,2,2,2,0,4,100,0
1462_marine,2,2,2,0,4,100,0
1463_marine,2,2,2,0,4,100,0
1464_marine,2,2,2,0,4,100,0
1465_marine,2,2,2,0,4,100,0
1466_marine,2,2,2,0,4,100,0
1467_marine,2,2,2,0,4,100,0
1468_marine,2,2,2,0,4,100,0
1469_marine,2,2,2,0,4,100,0
1470_marine,2,2,2,0,4,100,0
1471_marine,2,2,2,0,4,100,0
1472_marine,2,2,2,0,4,100,0
1473_marine,2,2,2,0,4,100,0
1474_marine,2,2,2,0,4,100,0
1475_marine,2,2,2,0,4,100,0
1476_marine,2,2,2,0,4,100,0
1477_marine,2,2,2,0,4,100,0
1478_marine,2,2,2,0,4,100,0
1479_marine,2,2,2,0,4,100,0
1480_marine,2,2,2,0,4,100,0
1481_marine,2,2,2,0,4,100,0
1482_marine,2,2,2,0,4,100,0
1483_marine,2,2,2,0,4,100,0
1484_marine,2,2,2,0,4,100,0
1485_marine,2,2,2,0,4,100,0
1486_marine,2,2,2,0,4,100,0
1487_marine,2,2,2,0,4,100,0
1488_marine,2,2,2,0,4,100,0
1489_marine,2,2,2,0,4,100,0
1490_marine,2,2,2,0,4,100,0
1491_marine,2,2,2,0,4,100,0
1492_marine,2,2,2,0,4,100,0
1493_marine,2,2,2,0,4,100,0
1494_marine,2,2,2,0,4,100,0
1495_marine,2,2,2,0,4,100,0
1496_marine,2,2,2,0,4,100,0
1497_marine,2,2,2,0,4,100,0
1498_marine,2,2,2,0,4,100,0
1499_marine,2,2,2,0,4,100,0
1500_marine,2,2,2,0,4,100,0
1501_marine,2,2,2,0,4,100,0
1502_marine,2,2,2,0,4,100,0
1503_marine,2,2,2,0,4,100,0
1504_marine,2,2,2,0,4,100,0
1505_marine,2,2,2,0,4,100,0
1506_marine,2,2,2,0,4,100,0
1507_marine,2,2,2,0,4,100,0
1508_marine,2,2,2,0,4,100,0
1509_marine,2,2,2,0,4,100,0
1510_marine,2,2,2,0,4,100,0
1511_marine,2,2,2,0,4,100,0
1512_marine,2,2,2,0,4,100,0
1513_marine,2,2,2,0,4,100,0
1514_marine,2,2,2,0,4,100,0
1515_marine,2,2,2,0,4,100,0
1516_marine,2,2,2,0,4,100,0
1517_marine,2,2,2,0,4,100,0
1518_marine,2,2,2,0,4,100,0
1519_marine,2,2,2,0,4,100,0
1520_marine,2,2,2,0,4,100,0
1521_marine,2,2,2,0,4,100,0
1522_marine,2,2,2,0,4,100,0
1523_marine,2,2,2,0,4,100,0
1524_marine,2,2,2,0,4,100,0
1525_marine,2,2,2,0,4,100,0
1526_marine,2,2,2,0,4,100,0
1527_marine,2,2,2,0,4,100,0
1528_marine,2,2,2,0,4,100,0
1529_marine,2,2,2,0,4,100,0
1530_marine,2,2,2,0,4,100,0
1531_marine,2,2,2,0,4,100,0
1532_marine,2,2,2,0,4,100,0
1533_marine,2,2,2,0,4,100,0
1534_marine,2,2,2,0,4,100,0
1535_marine,2,2,2,0,4,100,0
1536_marine,2,2,2,0,4,100,0
1537_marine,2,2,2,0,4,100,0
1538_marine,2,2,2,0,4,100,0
1539_marine,2,2,2,0,4,100,0
1540_marine,2,2,2,0,4,100,0
1541_marine,2,2,2,0,4,100,0
1542_marine,2,2,2,0,4,100,0
1543_marine,2,2,2,0,4,100,0
1544_marine,2,4,2,0,6,100,0
1545_marine,2,4,2,0,6,100,0
1546_marine,2,4,2,0,6,100,0
1547_marine,2,4,2,0,6,100,0
1548_marine,2,4,2,0,6,100,0
1549_marine,2,4,2,0,6,100,0
1550_marine,2,4,2,0,6,100,0
1551_marine,2,4,2,0,6,100,0
1552_marine,2,4,2,0,6,100,0
1553_marine,2,4,2,0,6,100,0
1554_marine,2,4,2,0,6,100,0
1555_marine,2,4,2,0,6,100,0
1556_marine,2,4,2,0,6,100,0
1557_marine,2,4,2,0,6,100,0
1558_marine,2,4,2,0,6,100,0
1559_marine,2,4,2,0,6,100,0
1560_marine,2,4,2,0,6,100,0
1561_marine,2,4,2,0,6,100,0
1562_marine,2,4,2,0,6,100,0
1563_marine,2,4,2,0,6,100,0
1564_marine,2,4,2,0,6,100,0
1565_marine,2,4,2,0,6,100,0
1566_marine,2,4,2,0,6,100,0
1567_marine,2,4,2,0,6,100,0
1568_marine,2,4,2,0,6,100,0
1569_marine,2,4,2,0,6,100,0
1570_marine,2,4,2,0,6,100,0
1571_marine,2,4,2,0,6,100,0
1572_marine,2,4,2,0,6,100,0
1573_marine,2,4,2,0,6,100,0
1574_marine,2,2,2,0,4,100,0
1575_marine,2,2,2,0,4,100,0
1576_marine,2,4,2,0,6,100,0
1577_marine,2,4,2,0,6,100,0
1578_marine,2,4,2,0,6,100,0
1579_marine,2,4,2,0,6,100,0
1580_marine,2,4,2,0,6,100,0
1581_marine,2,4,2,0,6,100,0
1582_marine,2,4,2,0,6,100,0
1583_marine,2,4,2,0,6,100,0
1584_marine,2,4,2,0,6,100,0
1585_marine,2,4,2,0,6,100,0
1586_marine,2,4,2,0,6,100,0
1587_marine,2,4,2,0,6,100,0
1588_marine,2,4,2,0,6,100,0
1589_marine,2,4,2,0,6,100,0
1590_marine,2,4,2,0,6,100,0
1591_marine,2,4,2,0,6,100,0
1592_marine,2,4,2,0,6,100,0
1593_marine,2,4,2,0,6,100,0
1594_marine,2,4,2,0,6,100,0
1595_marine,2,4,2,0,6,100,0
1596_marine,2,4,2,0,6,100,0
1597_marine,2,4,2,0,6,100,0
1598_marine,2,4,2,0,6,100,0
1599_marine,2,4,2,0,6,100,0
1600_marine,2,4,2,0,6,100,0
1601_marine,2,4,2,0,6,100,0
1602_marine,2,4,2,0,6,100,0
1603_marine,2,4,2,0,6,100,0
1604_marine,2,4,2,0,6,100,0
1605_marine,2,4,2,0,6,100,0
1606_marine,2,4,2,0,6,100,0
1607_marine,2,4,2,0,6,100,0
1608_marine,2,2,2,0,4,100,0
1609_marine,2,2,2,0,4,100,0
1610_marine,2,2,2,0,4,100,0
1611_marine,2,2,2,0,4,100,0
1612_marine,2,2,2,0,4,100,0
1613_marine,2,2,2,0,4,100,0
1614_marine,2,2,2,0,4,100,0
1615_marine,2,2,2,0,4,100,0
1616_marine,2,2,2,0,4,100,0
1617_marine,2,2,2,0,4,100,0
1618_marine,2,2,2,0,4,100,0
1619_marine,2,2,2,0,4,100,0
1620_marine,2,2,2,0,4,100,0
1621_marine,2,2,2,0,4,100,0
1622_marine,2,2,2,0,4,100,0
1623_marine,2,2,2,0,4,100,0
1624_marine,2,2,2,0,4,100,0
1625_marine,2,2,2,0,4,100,0
1626_marine,2,2,2,0,4,100,0
1627_marine,2,2,2,0,4,100,0
1628_marine,2,2,2,0,4,100,0
1629_marine,2,2,2,0,4,100,0
1630_marine,2,2,2,0,4,100,0
1631_marine,2,2,2,0,4,100,0
1632_marine,2,2,2,0,4,100,0
1633_marine,2,2,2,0,4,100,0
1634_marine,2,4,2,0,6,100,0
1635_marine,2,4,2,0,6,100,0
1636_marine,2,4,2,0,6,100,0
1637_marine,2,2,2,0,4,100,0
1638_marine,2,2,2,0,4,100,0
1639_marine,2,4,2,0,6,100,0
1640_marine,2,2,2,0,4,100,0
1641_marine,2,4,2,0,6,100,0
1642_marine,2,4,2,0,6,100,0
1643_marine,2,4,2,0,6,100,0
1644_marine,2,4,2,0,6,100,0
1645_marine,2,4,2,0,6,100,0
1646_marine,2,4,2,0,6,100,0
1647_marine,2,2,2,0,4,100,0
1648_marine,2,2,2,0,4,100,0
1649_marine,2,2,2,0,4,100,0
1650_marine,2,2,2,0,4,100,0
1651_marine,2,2,2,0,4,100,0
1652_marine,2,2,2,0,4,100,0
1653_marine,2,2,2,0,4,100,0
1654_marine,2,2,2,0,4,100,0
1655_marine,2,2,2,0,4,100,0
1656_marine,2,2,2,0,4,100,0
1657_marine,2,2,2,0,4,100,0
1658_marine,2,2,2,0,4,100,0
1659_marine,2,2,2,0,4,100,0
1660_marine,2,2,2,0,4,100,0
1661_marine,2,2,2,0,4,100,0
1662_marine,2,2,2,0,4,100,0
1663_marine,2,2,2,0,4,100,0
1664_marine,2,2,2,0,4,100,0
1665_marine,2,2,2,0,4,100,0
1666_marine,2,2,2,0,4,100,0
1667_marine,2,2,2,0,4,100,0
1668_marine,2,2,2,0,4,100,0
1669_marine,2,2,2,0,4,100,0
1670_marine,4,2,4,0,6,100,0
1671_marine,4,2,4,0,6,100,0
1672_marine,2,2,2,0,4,100,0
1673_marine,2,2,2,0,4,100,0
1674_marine,2,2,2,0,4,100,0
1675_marine,2,2,2,0,4,100,0
1676_marine,2,2,2,0,4,100,0
1677_marine,2,2,2,0,4,100,0
1678_marine,2,2,2,0,4,100,0
1679_marine,2,2,2,0,4,100,0
1680_marine,2,2,2,0,4,100,0
1681_marine,2,2,2,0,4,100,0
1682_marine,2,2,2,0,4,100,0
1683_marine,2,2,2,0,4,100,0
1684_marine,2,2,2,0,4,100,0
1685_marine,2,2,2,0,4,100,0
1686_marine,2,2,2,0,4,100,0
1687_marine,2,2,2,0,4,100,0
1688_marine,2,2,2,0,4,100,0
1689_marine,2,2,2,0,4,100,0
1690_marine,2,2,2,0,4,100,0
1691_marine,2,2,2,0,4,100,0
1692_marine,2,2,2,0,4,100,0
1693_marine,2,2,2,0,4,100,0
1694_marine,2,2,2,0,4,100,0
1695_marine,2,2,2,0,4,100,0
1696_marine,2,2,2,0,4,100,0
1697_marine,2,2,2,0,4,100,0
1698_marine,2,2,2,0,4,100,0
1699_marine,2,2,2,0,4,100,0
1700_marine,2,2,2,0,4,100,0
1701_marine,2,2,2,0,4,100,0
1702_marine,2,2,2,0,4,100,0
1703_marine,2,2,2,0,4,100,0
1704_marine,2,2,2,0,4,100,0
1705_marine,2,2,2,0,4,100,0
1706_marine,2,2,2,0,4,100,0
1707_marine,2,2,2,0,4,100,0
1708_marine,2,2,2,0,4,100,0
1709_marine,2,2,2,0,4,100,0
1710_marine,2,2,2,0,4,100,0
1711_marine,2,2,2,0,4,100,0
1712_marine,2,2,2,0,4,100,0
1713_marine,2,2,2,0,4,100,0
1714_marine,2,2,2,0,4,100,0
1715_marine,2,2,2,0,4,100,0
1716_marine,2,2,2,0,4,100,0
1717_marine,2,2,2,0,4,100,0
1718_marine,2,2,2,0,4,100,0
1719_marine,2,2,2,0,4,100,0
1720_marine,2,2,2,0,4,100,0
1721_marine,2,2,2,0,4,100,0
1722_marine,2,2,2,0,4,100,0
1723_marine,2,2,2,0,4,100,0
1724_marine,2,2,2,0,4,100,0
1725_marine,2,2,2,0,4,100,0
1726_marine,2,2,2,0,4,100,0
1727_marine,2,2,2,0,4,100,0
1728_marine,2,2,2,0,4,100,0
1729_marine,2,2,2,0,4,100,0
1730_marine,2,2,2,0,4,100,0
1731_marine,2,2,2,0,4,100,0
1732_marine,2,2,2,0,4,100,0
1733_marine,2,2,2,0,4,100,0
1734_marine,2,2,2,0,4,100,0
1735_marine,2,2,2,0,4,100,0
1736_marine,2,2,2,0,4,100,0
1737_marine,2,2,2,0,4,100,0
1738_marine,2,2,2,0,4,100,0
1739_marine,2,2,2,0,4,100,0
1740_marine,2,2,2,0,4,100,0
1741_marine,2,2,2,0,4,100,0
1742_marine,2,2,2,0,4,100,0
1743_marine,2,2,2,0,4,100,0
1744_marine,2,2,2,0,4,100,0
1745_marine,2,2,2,0,4,100,0
1746_marine,2,2,2,0,4,100,0
1747_marine,2,2,2,0,4,100,0
1748_marine,2,2,2,0,4,100,0
1749_marine,2,2,2,0,4,100,0
1750_marine,2,2,2,0,4,100,0
1751_marine,2,2,2,0,4,100,0
1752_marine,2,2,2,0,4,100,0
1753_marine,2,2,2,0,4,100,0
1754_marine,2,2,2,0,4,100,0
1755_marine,2,2,2,0,4,100,0
1756_marine,2,2,2,0,4,100,0
1757_marine,2,2,2,0,4,100,0
1758_marine,2,2,2,0,4,100,0
1759_marine,2,2,2,0,4,100,0
1760_marine,2,2,2,0,4,100,0
1761_marine,2,2,2,0,4,100,0
1762_marine,2,2,2,0,4,100,0
1763_marine,2,2,2,0,4,100,0
1764_marine,2,2,2,0,4,100,0
1765_marine,2,2,2,0,4,100,0
1766_marine,2,2,2,0,4,100,0
1767_marine,2,2,2,0,4,100,0
1768_marine,2,2,2,0,4,100,0
1769_marine,2,2,2,0,4,100,0
1770_marine,2,2,2,0,4,100,0
1771_marine,2,2,2,0,4,100,0
1772_marine,2,2,2,0,4,100,0
1773_marine,2,2,2,0,4,100,0
1774_marine,2,2,2,0,4,100,0
1775_marine,2,2,2,0,4,100,0
1776_marine,2,2,2,0,4,100,0
1777_marine,2,2,2,0,4,100,0
1778_marine,2,2,2,0,4,100,0
1779_marine,2,2,2,0,4,100,0
1780_marine,2,2,2,0,4,100,0
1781_marine,2,2,2,0,4,100,0
1782_marine,2,2,2,0,4,100,0
1783_marine,2,2,2,0,4,100,0
1784_marine,2,2,2,0,4,100,0
1785_marine,2,2,2,0,4,100,0
1786_marine,2,2,2,0,4,100,0
1787_marine,2,2,2,0,4,100,0
1788_marine,2,2,2,0,4,100,0
1789_marine,2,2,2,0,4,100,0
1790_marine,2,2,2,0,4,100,0
1791_marine,2,2,2,0,4,100,0
1792_marine,2,2,2,0,4,100,0
1793_marine,2,2,2,0,4,100,0
1794_marine,2,2,2,0,4,100,0
1795_marine,2,2,2,0,4,100,0
1796_marine,2,2,2,0,4,100,0
1797_marine,2,2,2,0,4,100,0
1798_marine,2,2,2,0,4,100,0
1799_marine,2,2,2,0,4,100,0
1818_marine,2,3,2,0,5,100,0
1819_marine,2,3,2,0,5,100,0
1820_marine,2,3,2,0,5,100,0
1821_marine,2,3,2,0,5,100,0
1822_marine,2,3,2,0,5,100,0
1823_marine,2,3,2,0,5,100,0
1824_marine,2,3,2,0,5,100,0
1825_marine,2,3,2,0,5,100,0
1826_marine,2,3,2,0,5,100,0
1827_marine,2,3,2,0,5,100,0
1828_marine,2,3,2,0,5,100,0
1829_marine,2,3,2,0,5,100,0
1830_marine,2,3,2,0,5,100,0
1831_marine,2,3,2,0,5,100,0
1832_marine,2,3,2,0,5,100,0
1833_marine,2,3,2,0,5,100,0
1834_marine,2,3,2,0,5,100,0
1835_marine,2,3,2,0,5,100,0
1836_marine,2,3,2,0,5,100,0
1837_marine,2,3,2,0,5,100,0
1838_marine,2,3,2,0,5,100,0
1839_marine,2,3,2,0,5,100,0
1840_marine,2,3,2,0,5,100,0
1841_marine,2,3,2,0,5,100,0
1842_marine,2,3,2,0,5,100,0
1843_marine,2,3,2,0,5,100,0
1844_marine,2,3,2,0,5,100,0
1845_marine,2,3,2,0,5,100,0
1846_marine,2,3,2,0,5,100,0
1847_marine,2,3,2,0,5,100,0
1848_marine,2,3,2,0,5,100,0
1849_marine,2,3,2,0,5,100,0
1850_marine,2,3,2,0,5,100,0
1851_marine,2,3,2,0,5,100,0
1852_marine,2,3,2,0,5,100,0
1853_marine,2,3,2,0,5,100,0
1854_marine,2,3,2,0,5,100,0
1855_marine,2,3,2,0,5,100,0
1856_marine,2,3,2,0,5,100,0
1857_marine,2,3,2,0,5,100,0
1858_marine,2,3,2,0,5,100,0
1859_marine,2,3,2,0,5,100,0
1860_marine,2,3,2,0,5,100,0
1861_marine,2,3,2,0,5,100,0
1862_marine,2,3,2,0,5,100,0
1863_marine,2,3,2,0,5,100,0
1864_marine,2,3,2,0,5,100,0
1865_marine,2,3,2,0,5,100,0
1866_marine,2,3,2,0,5,100,0
1867_marine,2,3,2,0,5,100,0
1868_marine,2,3,2,0,5,100,0
1869_marine,2,3,2,0,5,100,0
1870_marine,2,3,2,0,5,100,0
1871_marine,2,3,2,0,5,100,0
1872_marine,2,3,2,0,5,100,0
1873_marine,2,3,2,0,5,100,0
1874_marine,2,3,2,0,5,100,0
1875_marine,2,3,2,0,5,100,0
1876_marine,2,3,2,0,5,100,0
1877_marine,2,3,2,0,5,100,0
1878_marine,2,3,2,0,5,100,0
1879_marine,2,3,2,0,5,100,0
1880_marine,2,3,2,0,5,100,0
1881_marine,2,3,2,0,5,100,0
1882_marine,2,3,2,0,5,100,0
1883_marine,2,3,2,0,5,100,0
1884_marine,2,3,2,0,5,100,0
1885_marine,2,3,2,0,5,100,0
1886_marine,2,3,2,0,5,100,0
1887_marine,2,3,2,0,5,100,0
1888_marine,2,3,2,0,5,100,0
1889_marine,2,3,2,0,5,100,0
1890_marine,2,3,2,0,5,100,0
1891_marine,2,3,2,0,5,100,0
1892_marine,2,3,2,0,5,100,0
1893_marine,2,3,2,0,5,100,0
1894_marine,2,3,2,0,5,100,0
1895_marine,2,3,2,0,5,100,0
1896_marine,2,3,2,0,5,100,0
1897_marine,2,3,2,0,5,100,0
1898_marine,2,3,2,0,5,100,0
1899_marine,2,3,2,0,5,100,0
1900_marine,2,3,2,0,5,100,0
1901_marine,2,3,2,0,5,100,0
1902_marine,2,3,2,0,5,100,0
1903_marine,2,3,2,0,5,100,0
1904_marine,2,5,2,0,7,100,0
1905_marine,2,5,2,0,7,100,0
1906_marine,2,5,2,0,7,100,0
1907_marine,2,5,2,0,7,100,0
1908_marine,2,5,2,0,7,100,0
1909_marine,2,5,2,0,7,100,0
1910_marine,2,5,2,0,7,100,0
1911_marine,2,5,2,0,7,100,0
1912_marine,2,5,2,0,7,100,0
1913_marine,2,5,2,0,7,100,0
1914_marine,2,5,2,0,7,100,0
1915_marine,2,5,2,0,7,100,0
1916_marine,2,5,2,0,7,100,0
1917_marine,2,5,2,0,7,100,0
1918_marine,2,5,2,0,7,100,0
1919_marine,2,5,2,0,7,100,0
1920_marine,2,5,2,0,7,100,0
1921_marine,2,5,2,0,7,100,0
1922_marine,2,5,2,0,7,100,0
1923_marine,2,5,2,0,7,100,0
1924_marine,2,5,2,0,7,100,0
1969_marine,2,3,2,0,5,100,0
1970_marine,2,3,2,0,5,100,0
1971_marine,2,3,2,0,5,100,0
1972_marine,2,3,2,0,5,100,0
1973_marine,2,3,2,0,5,100,0
1974_marine,2,3,2,0,5,100,0
1975_marine,2,5,2,0,7,100,0
1976_marine,2,5,2,0,7,100,0
1977_marine,2,5,2,0,7,100,0
1978_marine,2,5,2,0,7,100,0
1979_marine,2,5,2,0,7,100,0
1980_marine,2,5,2,0,7,100,0
1981_marine,2,5,2,0,7,100,0
1982_marine,2,5,2,0,7,100,0
1983_marine,2,5,2,0,7,100,0
1984_marine,2,3,2,0,5,100,0
1985_marine,4,3,4,0,7,100,0
1986_marine,4,5,4,0,9,100,0
1987_marine,4,3,4,0,7,100,0
1988_marine,4,3,4,0,7,100,0
1989_marine,4,3,4,0,7,100,0
1990_marine,4,3,4,0,7,100,0
1991_marine,4,3,4,0,7,100,0
1992_marine,4,3,4,0,7,100,0
1993_marine,4,3,4,0,7,100,0
1994_marine,4,3,4,0,7,100,0
1995_marine,4,3,4,0,7,100,0
1996_marine,4,3,4,0,7,100,0
1997_marine,4,3,4,0,7,100,0
1998_marine,4,3,4,0,7,100,0
1999_marine,4,3,4,0,7,100,0
2000_marine,4,3,4,0,7,100,0
2001_marine,4,3,4,0,7,100,0
2002_marine,4,3,4,0,7,100,0
2003_marine,6,3,6,0,9,100,0
2004_marine,6,3,6,0,9,100,0
2005_marine,6,3,6,0,9,100,0
2006_marine,6,3,6,0,9,100,0
2007_marine,4,3,4,0,7,100,0
2008_marine,4,2,4,0,6,100,0
2009_marine,4,2,4,0,6,100,0
2010_marine,4,2,4,0,6,100,0
2011_marine,4,2,4,0,6,100,0
2012_marine,4,2,4,0,6,100,0
2013_marine,4,2,4,0,6,100,0
2014_marine,4,2,4,0,6,100,0
2015_marine,4,2,4,0,6,100,0
2016_marine,4,2,4,0,6,100,0
2017_marine,4,2,4,0,6,100,0
2018_marine,4,2,4,0,6,100,0
2019_marine,4,2,4,0,6,100,0
2020_marine,4,2,4,0,6,100,0
2021_marine,4,2,4,0,6,100,0
2022_marine,4,2,4,0,6,100,0
2023_marine,4,2,4,0,6,100,0
2024_marine,4,2,4,0,6,100,0
2025_marine,4,2,4,0,6,100,0
2026_marine,4,2,4,0,6,100,0
2027_marine,4,2,4,0,6,100,0
2028_marine,4,2,4,0,6,100,0
2029_marine,4,2,4,0,6,100,0
2030_marine,4,2,4,0,6,100,0
2031_marine,4,2,4,0,6,100,0
2032_marine,4,2,4,0,6,100,0
2033_marine,4,2,4,0,6,100,0
2034_marine,4,2,4,0,6,100,0
2035_marine,4,2,4,0,6,100,0
2036_marine,4,2,4,0,6,100,0
2037_marine,4,2,4,0,6,100,0
2038_marine,4,2,4,0,6,100,0
2039_marine,4,2,4,0,6,100,0
2040_marine,4,2,4,0,6,100,0
2041_marine,4,2,4,0,6,100,0
2042_marine,4,2,4,0,6,100,0
2043_marine,4,2,4,0,6,100,0
2044_marine,4,2,4,0,6,100,0
2045_marine,4,2,4,0,6,100,0
2046_marine,4,2,4,0,6,100,0
2047_marine,4,2,4,0,6,100,0
2048_marine,4,2,4,0,6,100,0
2049_marine,4,2,4,0,6,100,0
2050_marine,4,2,4,0,6,100,0
2051_marine,4,2,4,0,6,100,0
2052_marine,4,2,4,0,6,100,0
2053_marine,4,2,4,0,6,100,0
2054_marine,4,2,4,0,6,100,0
2055_marine,4,2,4,0,6,100,0
2056_marine,4,2,4,0,6,100,0
2057_marine,4,2,4,0,6,100,0
2058_marine,4,2,4,0,6,100,0
2059_marine,4,2,4,0,6,100,0
2060_marine,4,2,4,0,6,100,0
2061_marine,4,2,4,0,6,100,0
2062_marine,4,2,4,0,6,100,0
2063_marine,4,2,4,0,6,100,0
2064_marine,4,2,4,0,6,100,0
2065_marine,2,2,2,0,4,100,0
2066_marine,2,2,2,0,4,100,0
2067_marine,2,2,2,0,4,100,0
2068_marine,2,2,2,0,4,100,0
2069_marine,2,2,2,0,4,100,0
2070_marine,2,2,2,0,4,100,0
2071_marine,2,2,2,0,4,100,0
2072_marine,2,2,2,0,4,100,0
2073_marine,2,2,2,0,4,100,0
2074_marine,2,2,2,0,4,100,0
2075_marine,2,2,2,0,4,100,0
2076_marine,2,2,2,0,4,100,0
2077_marine,2,2,2,0,4,100,0
2078_marine,2,2,2,0,4,100,0
2079_marine,2,2,2,0,4,100,0
2080_marine,2,2,2,0,4,100,0
2081_marine,2,2,2,0,4,100,0
2082_marine,2,2,2,0,4,100,0
2083_marine,2,2,2,0,4,100,0
2084_marine,2,2,2,0,4,100,0
2085_marine,2,2,2,0,4,100,0
2086_marine,2,2,2,0,4,100,0
2087_marine,2,2,2,0,4,100,0
2088_marine,2,2,2,0,4,100,0
2089_marine,2,2,2,0,4,100,0
2090_marine,2,2,2,0,4,100,0
2091_marine,2,2,2,0,4,100,0
2092_marine,2,2,2,0,4,100,0
2093_marine,2,2,2,0,4,100,0
2094_marine,2,2,2,0,4,100,0
2095_marine,2,2,2,0,4,100,0
2096_marine,2,2,2,0,4,100,0
2097_marine,2,2,2,0,4,100,0
2098_marine,2,2,2,0,4,100,0
2099_marine,2,2,2,0,4,100,0
2100_marine,2,2,2,0,4,100,0
2101_marine,2,2,2,0,4,100,0
2102_marine,2,2,2,0,4,100,0
2103_marine,2,2,2,0,4,100,0
2104_marine,2,2,2,0,4,100,0
2105_marine,2,2,2,0,4,100,0
2106_marine,2,2,2,0,4,100,0
2107_marine,2,2,2,0,4,100,0
2108_marine,2,2,2,0,4,100,0
2109_marine,2,2,2,0,4,100,0
2110_marine,2,2,2,0,4,100,0
2111_marine,2,2,2,0,4,100,0
2112_marine,2,2,2,0,4,100,0
2113_marine,2,2,2,0,4,100,0
2114_marine,2,2,2,0,4,100,0
2115_marine,2,2,2,0,4,100,0
2116_marine,2,2,2,0,4,100,0
2117_marine,2,2,2,0,4,100,0
2118_marine,2,2,2,0,4,100,0
2119_marine,2,2,2,0,4,100,0
2120_marine,2,2,2,0,4,100,0
2121_marine,2,2,2,0,4,100,0
2122_marine,2,2,2,0,4,100,0
2123_marine,2,2,2,0,4,100,0
2124_marine,2,2,2,0,4,100,0
2125_marine,2,2,2,0,4,100,0
2126_marine,2,2,2,0,4,100,0
2127_marine,2,2,2,0,4,100,0
2128_marine,2,2,2,0,4,100,0
2129_marine,2,2,2,0,4,100,0
2130_marine,2,2,2,0,4,100,0
2131_marine,2,2,2,0,4,100,0
2132_marine,2,2,2,0,4,100,0
2184_marine,2,3,2,0,5,100,0
2185_marine,2,3,2,0,5,100,0
2186_marine,2,3,2,0,5,100,0
2187_marine,2,3,2,0,5,100,0
2188_marine,2,3,2,0,5,100,0
2189_marine,2,3,2,0,5,100,0
2190_marine,2,3,2,0,5,100,0
2191_marine,2,3,2,0,5,100,0
2192_marine,2,3,2,0,5,100,0
2193_marine,2,3,2,0,5,100,0
2194_marine,2,3,2,0,5,100,0
2195_marine,2,3,2,0,5,100,0
2196_marine,2,5,2,0,7,100,0
2197_marine,2,5,2,0,7,100,0
2198_marine,2,5,2,0,7,100,0
2199_marine,2,5,2,0,7,100,0
2200_marine,2,5,2,0,7,100,0
2201_marine,2,5,2,0,7,100,0
2202_marine,2,5,2,0,7,100,0
2203_marine,2,3,2,0,5,100,0
2204_marine,2,3,2,0,5,100,0
2205_marine,2,3,2,0,5,100,0
2206_marine,2,3,2,0,5,100,0
2207_marine,2,3,2,0,5,100,0
2208_marine,2,3,2,0,5,100,0
2209_marine,2,3,2,0,5,100,0
2210_marine,2,3,2,0,5,100,0
2211_marine,2,3,2,0,5,100,0
2212_marine,2,3,2,0,5,100,0
2213_marine,2,3,2,0,5,100,0
2214_marine,2,3,2,0,5,100,0
2215_marine,2,3,2,0,5,100,0
2216_marine,2,3,2,0,5,100,0
2217_marine,2,3,2,0,5,100,0
2218_marine,2,3,2,0,5,100,0
2219_marine,2,3,2,0,5,100,0
2220_marine,2,3,2,0,5,100,0
2221_marine,2,3,2,0,5,100,0
2222_marine,2,3,2,0,5,100,0
2223_marine,2,3,2,0,5,100,0
2224_marine,2,3,2,0,5,100,0
2225_marine,2,3,2,0,5,100,0
2226_marine,2,3,2,0,5,100,0
2227_marine,2,3,2,0,5,100,0
2228_marine,2,3,2,0,5,100,0
2229_marine,2,3,2,0,5,100,0
2230_marine,2,3,2,0,5,100,0
2231_marine,2,3,2,0,5,100,0
2232_marine,2,3,2,0,5,100,0
2233_marine,2,3,2,0,5,100,0
2234_marine,2,3,2,0,5,100,0
2235_marine,2,3,2,0,5,100,0
2236_marine,2,3,2,0,5,100,0
2237_marine,2,3,2,0,5,100,0
2238_marine,2,3,2,0,5,100,0
2239_marine,2,3,2,0,5,100,0
2240_marine,2,3,2,0,5,100,0
2241_marine,2,3,2,0,5,100,0
2242_marine,2,3,2,0,5,100,0
2243_marine,2,3,2,0,5,100,0
2244_marine,2,3,2,0,5,100,0
2245_marine,2,3,2,0,5,100,0
2246_marine,2,3,2,0,5,100,0
2247_marine,2,3,2,0,5,100,0
2248_marine,2,3,2,0,5,100,0
2249_marine,2,3,2,0,5,100,0
2250_marine,2,3,2,0,5,100,0
2251_marine,2,3,2,0,5,100,0
2252_marine,2,3,2,0,5,100,0
2253_marine,2,3,2,0,5,100,0
2254_marine,2,3,2,0,5,100,0
2255_marine,2,3,2,0,5,100,0
2256_marine,2,3,2,0,5,100,0
2257_marine,2,3,2,0,5,100,0
2258_marine,2,4,2,0,6,100,0
2259_marine,2,4,2,0,6,100,0
2260_marine,2,4,2,0,6,100,0
2261_marine,2,4,2,0,6,100,0
2262_marine,2,4,2,0,6,100,0
2273_marine,4,6,4,0,10,100,0
2274_marine,4,6,4,0,10,100,0
2355_marine,8,5,8,0,13,100,0
2356_marine,8,7,8,0,15,100,0
2357_marine,8,7,8,0,15,100,0
2358_marine,8,7,8,0,15,100,0
2359_marine,8,5,8,0,13,100,0
2360_marine,8,5,8,0,13,100,0
2361_marine,8,5,8,0,13,100,0
2362_marine,8,5,8,0,13,100,0
2363_marine,8,5,8,0,13,100,0
2364_marine,8,5,8,0,13,100,0
2365_marine,8,5,8,0,13,100,0
2366_marine,8,5,8,0,13,100,0
2367_marine,8,5,8,0,13,100,0
2368_marine,8,5,8,0,13,100,0
2369_marine,8,5,8,0,13,100,0
2370_marine,8,5,8,0,13,100,0
2371_marine,8,5,8,0,13,100,0
2372_marine,8,5,8,0,13,100,0
2373_marine,8,5,8,0,13,100,0
2374_marine,8,5,8,0,13,100,0
2375_marine,8,5,8,0,13,100,0
2376_marine,10,5,10,0,15,100,0
2377_marine,10,5,10,0,15,100,0
2378_marine,10,5,10,0,15,100,0
2379_marine,10,5,10,0,15,100,0
2380_marine,10,5,10,0,15,100,0
2408_marine,6,5,6,0,11,100,0
2409_marine,6,5,6,0,11,100,0
2410_marine,6,3,6,0,9,100,0
2411_marine,6,3,6,0,9,100,0
2412_marine,6,3,6,0,9,100,0
2413_marine,6,3,6,0,9,100,0
2414_marine,6,3,6,0,9,100,0
2415_marine,6,3,6,0,9,100,0
2416_marine,6,3,6,0,9,100,0
2417_marine,6,3,6,0,9,100,0
2418_marine,6,3,6,0,9,100,0
2419_marine,6,3,6,0,9,100,0
2420_marine,6,3,6,0,9,100,0
2421_marine,6,3,6,0,9,100,0
2422_marine,4,3,4,0,7,100,0
2423_marine,4,3,4,0,7,100,0
2424_marine,4,3,4,0,7,100,0
2425_marine,4,3,4,0,7,100,0
2426_marine,4,3,4,0,7,100,0
2427_marine,4,3,4,0,7,100,0
2428_marine,4,3,4,0,7,100,0
2429_marine,4,3,4,0,7,100,0
2430_marine,4,3,4,0,7,100,0
2431_marine,4,3,4,0,7,100,0
2432_marine,4,3,4,0,7,100,0
2433_marine,6,3,6,0,9,100,0
2434_marine,6,3,6,0,9,100,0
2435_marine,6,3,6,0,9,100,0
2436_marine,6,3,6,0,9,100,0
2437_marine,6,3,6,0,9,100,0
2438_marine,4,3,4,0,7,100,0
2439_marine,4,3,4,0,7,100,0
2440_marine,4,3,4,0,7,100,0
2441_marine,4,3,4,0,7,100,0
2442_marine,2,3,2,0,5,100,0
2443_marine,2,3,2,0,5,100,0
2444_marine,2,3,2,0,5,100,0
2445_marine,2,3,2,0,5,100,0
2446_marine,2,3,2,0,5,100,0
2447_marine,2,3,2,0,5,100,0
2448_marine,2,3,2,0,5,100,0
2449_marine,2,3,2,0,5,100,0
2450_marine,2,3,2,0,5,100,0
2451_marine,2,3,2,0,5,100,0
2452_marine,2,3,2,0,5,100,0
2453_marine,2,3,2,0,5,100,0
2454_marine,2,3,2,0,5,100,0
2455_marine,2,3,2,0,5,100,0
2456_marine,2,3,2,0,5,100,0
2457_marine,2,3,2,0,5,100,0
2458_marine,2,3,2,0,5,100,0
2459_marine,2,3,2,0,5,100,0
2460_marine,2,3,2,0,5,100,0
2461_marine,2,3,2,0,5,100,0
2462_marine,2,3,2,0,5,100,0
2463_marine,2,3,2,0,5,100,0
2464_marine,2,3,2,0,5,100,0
2465_marine,2,3,2,0,5,100,0
2466_marine,2,3,2,0,5,100,0
2467_marine,2,3,2,0,5,100,0
2468_marine,2,3,2,0,5,100,0
2469_marine,2,3,2,0,5,100,0
2470_marine,2,3,2,0,5,100,0
2471_marine,2,3,2,0,5,100,0
2472_marine,2,3,2,0,5,100,0
2473_marine,2,3,2,0,5,100,0
2474_marine,2,3,2,0,5,100,0
2475_marine,2,3,2,0,5,100,0
2476_marine,2,3,2,0,5,100,0
2477_marine,2,3,2,0,5,100,0
2478_marine,2,3,2,0,5,100,0
2479_marine,2,3,2,0,5,100,0
2480_marine,2,3,2,0,5,100,0
2481_marine,2,3,2,0,5,100,0
2482_marine,2,3,2,0,5,100,0
2483_marine,2,3,2,0,5,100,0
2484_marine,2,3,2,0,5,100,0
2547_marine,2,5,2,0,7,100,0
2548_marine,2,5,2,0,7,100,0
2549_marine,2,5,2,0,7,100,0
2550_marine,2,5,2,0,7,100,0
2551_marine,2,5,2,0,7,100,0
2552_marine,2,5,2,0,7,100,0
2553_marine,2,5,2,0,7,100,0
2554_marine,2,5,2,0,7,100,0
2555_marine,2,5,2,0,7,100,0
2556_marine,2,5,2,0,7,100,0
2557_marine,2,5,2,0,7,100,0
2558_marine,2,5,2,0,7,100,0
2559_marine,2,5,2,0,7,100,0
2560_marine,2,5,2,0,7,100,0
2561_marine,2,5,2,0,7,100,0
2562_marine,2,5,2,0,7,100,0
2563_marine,2,5,2,0,7,100,0
2564_marine,2,5,2,0,7,100,0
2565_marine,2,5,2,0,7,100,0
2566_marine,2,5,2,0,7,100,0
2567_marine,2,3,2,0,5,100,0
2568_marine,2,3,2,0,5,100,0
2569_marine,2,3,2,0,5,100,0
2570_marine,2,3,2,0,5,100,0
2571_marine,2,3,2,0,5,100,0
2572_marine,2,3,2,0,5,100,0
2573_marine,2,3,2,0,5,100,0
2574_marine,2,3,2,0,5,100,0
2575_marine,2,3,2,0,5,100,0
2576_marine,2,3,2,0,5,100,0
2577_marine,2,3,2,0,5,100,0
2578_marine,2,3,2,0,5,100,0
2579_marine,2,3,2,0,5,100,0
2580_marine,2,3,2,0,5,100,0
2581_marine,2,3,2,0,5,100,0
2582_marine,2,3,2,0,5,100,0
2583_marine,2,3,2,0,5,100,0
2584_marine,2,3,2,0,5,100,0
2585_marine,2,3,2,0,5,100,0
2586_marine,2,3,2,0,5,100,0
2587_marine,2,3,2,0,5,100,0
2588_marine,2,3,2,0,5,100,0
2589_marine,2,3,2,0,5,100,0
2590_marine,2,3,2,0,5,100,0
2591_marine,2,3,2,0,5,100,0
2592_marine,2,3,2,0,5,100,0
2593_marine,2,3,2,0,5,100,0
2594_marine,2,3,2,0,5,100,0
2595_marine,2,3,2,0,5,100,0
2596_marine,2,3,2,0,5,100,0
2597_marine,2,3,2,0,5,100,0
2598_marine,2,3,2,0,5,100,0
2599_marine,2,3,2,0,5,100,0
2600_marine,2,3,2,0,5,100,0
2601_marine,2,3,2,0,5,100,0
2602_marine,2,3,2,0,5,100,0
2603_marine,2,3,2,0,5,100,0
2604_marine,2,3,2,0,5,100,0
2605_marine,2,3,2,0,5,100,0
2606_marine,2,3,2,0,5,100,0
2607_marine,2,3,2,0,5,100,0
2630_marine,2,4,2,0,6,100,0
2783_marine,6,3,6,0,9,100,0
2784_marine,6,3,6,0,9,100,0
2785_marine,6,3,6,0,9,100,0
2786_marine,6,3,6,0,9,100,0
2787_marine,6,3,6,0,9,100,0
2788_marine,6,3,6,0,9,100,0
2789_marine,6,3,6,0,9,100,0
2790_marine,8,3,8,0,11,100,0
2791_marine,8,4,8,0,12,100,0
2792_marine,8,4,8,0,12,100,0
2793_marine,8,3,8,0,11,100,0
2794_marine,8,4,8,0,12,100,0
2795_marine,6,4,6,0,10,100,0
2796_marine,6,4,6,0,10,100,0
2797_marine,6,3,6,0,9,100,0
2798_marine,6,3,6,0,9,100,0
2799_marine,6,3,6,0,9,100,0
2800_marine,6,3,6,0,9,100,0
2801_marine,4,3,4,0,7,100,0
2802_marine,4,3,4,0,7,100,0
2803_marine,4,3,4,0,7,100,0
2804_marine,4,3,4,0,7,100,0
2805_marine,4,3,4,0,7,100,0
2806_marine,4,3,4,0,7,100,0
2807_marine,4,3,4,0,7,100,0
2808_marine,4,3,4,0,7,100,0
2809_marine,4,3,4,0,7,100,0
2810_marine,4,3,4,0,7,100,0
2811_marine,4,3,4,0,7,100,0
2812_marine,4,3,4,0,7,100,0
2813_marine,4,3,4,0,7,100,0
2814_marine,4,3,4,0,7,100,0
2815_marine,4,3,4,0,7,100,0
2816_marine,4,3,4,0,7,100,0
2817_marine,4,3,4,0,7,100,0
2818_marine,4,3,4,0,7,100,0
2819_marine,4,3,4,0,7,100,0
2820_marine,4,3,4,0,7,100,0
2821_marine,2,3,2,0,5,100,0
2822_marine,2,3,2,0,5,100,0
2823_marine,2,3,2,0,5,100,0
2824_marine,2,3,2,0,5,100,0
2825_marine,2,3,2,0,5,100,0
2826_marine,2,3,2,0,5,100,0
2827_marine,2,3,2,0,5,100,0
2828_marine,2,3,2,0,5,100,0
2829_marine,2,3,2,0,5,100,0
2830_marine,2,3,2,0,5,100,0
2831_marine,2,3,2,0,5,100,0
2832_marine,2,3,2,0,5,100,0
2833_marine,2,3,2,0,5,100,0
2834_marine,2,3,2,0,5,100,0
2835_marine,2,3,2,0,5,100,0
2836_marine,2,3,2,0,5,100,0
2837_marine,2,3,2,0,5,100,0
2838_marine,2,3,2,0,5,100,0
2839_marine,2,3,2,0,5,100,0
2911_marine,2,5,2,0,7,100,0
2912_marine,2,5,2,0,7,100,0
2913_marine,2,5,2,0,7,100,0
2914_marine,2,5,2,0,7,100,0
2915_marine,2,5,2,0,7,100,0
2916_marine,2,5,2,0,7,100,0
2917_marine,2,5,2,0,7,100,0
2918_marine,2,5,2,0,7,100,0
2919_marine,2,5,2,0,7,100,0
2920_marine,2,5,2,0,7,100,0
2921_marine,2,5,2,0,7,100,0
2922_marine,2,5,2,0,7,100,0
2923_marine,2,5,2,0,7,100,0
2924_marine,2,5,2,0,7,100,0
2925_marine,2,5,2,0,7,100,0
2926_marine,2,5,2,0,7,100,0
2927_marine,2,5,2,0,7,100,0
2928_marine,2,5,2,0,7,100,0
2929_marine,2,3,2,0,5,100,0
2930_marine,2,3,2,0,5,100,0
2931_marine,2,3,2,0,5,100,0
2932_marine,2,3,2,0,5,100,0
2933_marine,2,3,2,0,5,100,0
2934_marine,2,3,2,0,5,100,0
2935_marine,2,3,2,0,5,100,0
2936_marine,2,3,2,0,5,100,0
2937_marine,2,3,2,0,5,100,0
2938_marine,2,3,2,0,5,100,0
2939_marine,2,3,2,0,5,100,0
2940_marine,2,3,2,0,5,100,0
2941_marine,2,3,2,0,5,100,0
2942_marine,2,3,2,0,5,100,0
2943_marine,2,3,2,0,5,100,0
2944_marine,2,3,2,0,5,100,0
2945_marine,2,3,2,0,5,100,0
2946_marine,2,3,2,0,5,100,0
2947_marine,2,3,2,0,5,100,0
2948_marine,2,3,2,0,5,100,0
2949_marine,2,3,2,0,5,100,0
2950_marine,2,3,2,0,5,100,0
2951_marine,2,3,2,0,5,100,0
2952_marine,2,3,2,0,5,100,0
2953_marine,2,3,2,0,5,100,0
2954_marine,2,3,2,0,5,100,0
2955_marine,2,3,2,0,5,100,0
2956_marine,2,3,2,0,5,100,0
2957_marine,2,3,2,0,5,100,0
2958_marine,2,3,2,0,5,100,0
2959_marine,2,3,2,0,5,100,0
2960_marine,2,3,2,0,5,100,0
2961_marine,4,3,4,0,7,100,0
2962_marine,4,3,4,0,7,100,0
2963_marine,4,3,4,0,7,100,0
3162_marine,6,3,6,0,9,100,0
3163_marine,4,3,4,0,7,100,0
3164_marine,4,3,4,0,7,100,0
3165_marine,4,3,4,0,7,100,0
3166_marine,4,3,4,0,7,100,0
3167_marine,4,3,4,0,7,100,0
3168_marine,4,3,4,0,7,100,0
3169_marine,4,3,4,0,7,100,0
3170_marine,4,3,4,0,7,100,0
3171_marine,4,3,4,0,7,100,0
3172_marine,4,3,4,0,7,100,0
3173_marine,4,3,4,0,7,100,0
3174_marine,4,3,4,0,7,100,0
3175_marine,4,3,4,0,7,100,0
3176_marine,4,3,4,0,7,100,0
3177_marine,4,3,4,0,7,100,0
3178_marine,4,3,4,0,7,100,0
3179_marine,4,3,4,0,7,100,0
3180_marine,4,3,4,0,7,100,0
3181_marine,4,3,4,0,7,100,0
3182_marine,4,3,4,0,7,100,0
3183_marine,4,3,4,0,7,100,0
3184_marine,4,3,4,0,7,100,0
3185_marine,4,3,4,0,7,100,0
3186_marine,4,3,4,0,7,100,0
3187_marine,4,3,4,0,7,100,0
3188_marine,4,3,4,0,7,100,0
3189_marine,4,3,4,0,7,100,0
3190_marine,4,3,4,0,7,100,0
3191_marine,2,3,2,0,5,100,0
3192_marine,2,3,2,0,5,100,0
3193_marine,2,3,2,0,5,100,0
3194_marine,2,3,2,0,5,100,0
3195_marine,2,3,2,0,5,100,0
3196_marine,2,3,2,0,5,100,0
3197_marine,2,3,2,0,5,100,0
3198_marine,2,3,2,0,5,100,0
3274_marine,2,5,2,0,7,100,0
3275_marine,2,5,2,0,7,100,0
3276_marine,2,5,2,0,7,100,0
3277_marine,2,5,2,0,7,100,0
3278_marine,2,5,2,0,7,100,0
3279_marine,2,5,2,0,7,100,0
3280_marine,2,5,2,0,7,100,0
3281_marine,2,5,2,0,7,100,0
3282_marine,2,5,2,0,7,100,0
3283_marine,2,5,2,0,7,100,0
3284_marine,2,5,2,0,7,100,0
3285_marine,2,5,2,0,7,100,0
3286_marine,2,5,2,0,7,100,0
3287_marine,2,5,2,0,7,100,0
3288_marine,2,5,2,0,7,100,0
3289_marine,2,5,2,0,7,100,0
3290_marine,2,5,2,0,7,100,0
3291_marine,2,3,2,0,5,100,0
3292_marine,2,3,2,0,5,100,0
3293_marine,2,3,2,0,5,100,0
3294_marine,2,3,2,0,5,100,0
3295_marine,2,3,2,0,5,100,0
3296_marine,2,3,2,0,5,100,0
3297_marine,2,3,2,0,5,100,0
3298_marine,2,3,2,0,5,100,0
3299_marine,2,3,2,0,5,100,0
3300_marine,2,3,2,0,5,100,0
3301_marine,2,3,2,0,5,100,0
3302_marine,2,3,2,0,5,100,0
3303_marine,2,3,2,0,5,100,0
3304_marine,2,3,2,0,5,100,0
3305_marine,2,3,2,0,5,100,0
3306_marine,2,3,2,0,5,100,0
3307_marine,2,3,2,0,5,100,0
3308_marine,2,3,2,0,5,100,0
3309_marine,2,3,2,0,5,100,0
3310_marine,2,3,2,0,5,100,0
3311_marine,2,3,2,0,5,100,0
3312_marine,2,3,2,0,5,100,0
3313_marine,4,3,4,0,7,100,0
3314_marine,4,3,4,0,7,100,0
3315_marine,4,3,4,0,7,100,0
3316_marine,4,3,4,0,7,100,0
3317_marine,4,3,4,0,7,100,0
3318_marine,4,3,4,0,7,100,0
3319_marine,4,3,4,0,7,100,0
3525_marine,8,3,8,0,11,100,0
3526_marine,6,3,6,0,9,100,0
3527_marine,6,3,6,0,9,100,0
3528_marine,6,3,6,0,9,100,0
3529_marine,6,3,6,0,9,100,0
3530_marine,6,3,6,0,9,100,0
3531_marine,6,3,6,0,9,100,0
3532_marine,6,3,6,0,9,100,0
3533_marine,4,3,4,0,7,100,0
3534_marine,4,3,4,0,7,100,0
3535_marine,4,3,4,0,7,100,0
3536_marine,4,3,4,0,7,100,0
3537_marine,4,3,4,0,7,100,0
3538_marine,4,3,4,0,7,100,0
3539_marine,4,3,4,0,7,100,0
3540_marine,4,3,4,0,7,100,0
3541_marine,4,3,4,0,7,100,0
3542_marine,4,3,4,0,7,100,0
3543_marine,4,3,4,0,7,100,0
3544_marine,4,3,4,0,7,100,0
3545_marine,4,3,4,0,7,100,0
3546_marine,4,3,4,0,7,100,0
3547_marine,4,3,4,0,7,100,0
3548_marine,4,3,4,0,7,100,0
3549_marine,4,3,4,0,7,100,0
3550_marine,4,3,4,0,7,100,0
3551_marine,4,3,4,0,7,100,0
3552_marine,4,3,4,0,7,100,0
3553_marine,2,3,2,0,5,100,0
3554_marine,2,3,2,0,5,100,0
3555_marine,2,3,2,0,5,100,0
3556_marine,2,3,2,0,5,100,0
3557_marine,2,3,2,0,5,100,0
3638_marine,2,5,2,0,7,100,0
3639_marine,2,5,2,0,7,100,0
3640_marine,2,5,2,0,7,100,0
3641_marine,2,5,2,0,7,100,0
3642_marine,2,5,2,0,7,100,0
3643_marine,2,5,2,0,7,100,0
3644_marine,2,5,2,0,7,100,0
3645_marine,2,5,2,0,7,100,0
3646_marine,2,5,2,0,7,100,0
3647_marine,2,5,2,0,7,100,0
3648_marine,2,5,2,0,7,100,0
3649_marine,2,5,2,0,7,100,0
3650_marine,2,5,2,0,7,100,0
3651_marine,2,5,2,0,7,100,0
3652_marine,2,5,2,0,7,100,0
3653_marine,2,3,2,0,5,100,0
3654_marine,2,3,2,0,5,100,0
3655_marine,2,3,2,0,5,100,0
3656_marine,2,3,2,0,5,100,0
3657_marine,2,3,2,0,5,100,0
3658_marine,2,3,2,0,5,100,0
3659_marine,2,3,2,0,5,100,0
3660_marine,2,3,2,0,5,100,0
3661_marine,2,3,2,0,5,100,0
3662_marine,2,3,2,0,5,100,0
3663_marine,2,3,2,0,5,100,0
3664_marine,2,3,2,0,5,100,0
3665_marine,2,4,2,0,6,100,0
3666_marine,4,4,4,0,8,100,0
3667_marine,4,4,4,0,8,100,0
3668_marine,4,4,4,0,8,100,0
3669_marine,4,4,4,0,8,100,0
3670_marine,4,4,4,0,8,100,0
3671_marine,4,4,4,0,8,100,0
3672_marine,4,4,4,0,8,100,0
3673_marine,4,4,4,0,8,100,0
3674_marine,4,4,4,0,8,100,0
3888_marine,8,3,8,0,11,100,0
3889_marine,8,3,8,0,11,100,0
3890_marine,8,3,8,0,11,100,0
3891_marine,8,3,8,0,11,100,0
3892_marine,6,3,6,0,9,100,0
3893_marine,6,3,6,0,9,100,0
3894_marine,6,3,6,0,9,100,0
3895_marine,6,3,6,0,9,100,0
3896_marine,6,3,6,0,9,100,0
3897_marine,6,3,6,0,9,100,0
3898_marine,6,3,6,0,9,100,0
3899_marine,6,3,6,0,9,100,0
3900_marine,6,3,6,0,9,100,0
3901_marine,6,3,6,0,9,100,0
3902_marine,6,3,6,0,9,100,0
3903_marine,6,3,6,0,9,100,0
3904_marine,6,3,6,0,9,100,0
3905_marine,4,3,4,0,7,100,0
3906_marine,4,3,4,0,7,100,0
3907_marine,4,3,4,0,7,100,0
3908_marine,4,3,4,0,7,100,0
3909_marine,4,3,4,0,7,100,0
3910_marine,4,3,4,0,7,100,0
3911_marine,4,3,4,0,7,100,0
3912_marine,4,3,4,0,7,100,0
3913_marine,2,3,2,0,5,100,0
3914_marine,2,3,2,0,5,100,0
3915_marine,2,3,2,0,5,100,0
3916_marine,2,3,2,0,5,100,0
4001_marine,2,5,2,0,7,100,0
4002_marine,2,5,2,0,7,100,0
4003_marine,2,5,2,0,7,100,0
4004_marine,2,5,2,0,7,100,0
4005_marine,2,5,2,0,7,100,0
4006_marine,2,5,2,0,7,100,0
4007_marine,2,5,2,0,7,100,0
4008_marine,2,5,2,0,7,100,0
4009_marine,2,5,2,0,7,100,0
4010_marine,2,5,2,0,7,100,0
4011_marine,2,5,2,0,7,100,0
4012_marine,2,5,2,0,7,100,0
4013_marine,2,5,2,0,7,100,0
4014_marine,2,5,2,0,7,100,0
4015_marine,2,5,2,0,7,100,0
4016_marine,2,3,2,0,5,100,0
4017_marine,2,3,2,0,5,100,0
4018_marine,2,3,2,0,5,100,0
4019_marine,2,3,2,0,5,100,0
4020_marine,2,3,2,0,5,100,0
4021_marine,2,4,2,0,6,100,0
4022_marine,2,4,2,0,6,100,0
4023_marine,2,4,2,0,6,100,0
4024_marine,4,4,4,0,8,100,0
4025_marine,4,4,4,0,8,100,0
4032_marine,4,4,4,0,8,100,0
4033_marine,4,4,4,0,8,100,0
4034_marine,4,4,4,0,8,100,0
4254_marine,6,3,6,0,9,100,0
4255_marine,6,3,6,0,9,100,0
4256_marine,6,3,6,0,9,100,0
4257_marine,6,3,6,0,9,100,0
4258_marine,6,3,6,0,9,100,0
4259_marine,6,3,6,0,9,100,0
4260_marine,6,3,6,0,9,100,0
4261_marine,6,3,6,0,9,100,0
4262_marine,6,3,6,0,9,100,0
4263_marine,6,3,6,0,9,100,0
4264_marine,6,3,6,0,9,100,0
4265_marine,6,3,6,0,9,100,0
4266_marine,6,3,6,0,9,100,0
4267_marine,6,3,6,0,9,100,0
4268_marine,6,3,6,0,9,100,0
4269_marine,6,3,6,0,9,100,0
4270_marine,6,3,6,0,9,100,0
4271_marine,6,3,6,0,9,100,0
4272_marine,6,5,6,0,11,100,0
4273_marine,4,5,4,0,9,100,0
4274_marine,2,5,2,0,7,100,0
4275_marine,2,5,2,0,7,100,0
4364_marine,2,5,2,0,7,100,0
4365_marine,2,5,2,0,7,100,0
4366_marine,2,5,2,0,7,100,0
4367_marine,2,5,2,0,7,100,0
4368_marine,2,5,2,0,7,100,0
4369_marine,2,5,2,0,7,100,0
4370_marine,2,5,2,0,7,100,0
4371_marine,2,5,2,0,7,100,0
4372_marine,2,5,2,0,7,100,0
4373_marine,2,5,2,0,7,100,0
4374_marine,2,5,2,0,7,100,0
4375_marine,2,5,2,0,7,100,0
4376_marine,2,5,2,0,7,100,0
4377_marine,2,5,2,0,7,100,0
4378_marine,2,6,2,0,8,100,0
4379_marine,4,6,4,0,10,100,0
4392_marine,4,4,4,0,8,100,0
4393_marine,4,4,4,0,8,100,0
4618_marine,8,3,8,0,11,100,0
4619_marine,8,3,8,0,11,100,0
4620_marine,8,3,8,0,11,100,0
4621_marine,8,3,8,0,11,100,0
4622_marine,8,3,8,0,11,100,0
4623_marine,8,3,8,0,11,100,0
4624_marine,8,3,8,0,11,100,0
4625_marine,8,3,8,0,11,100,0
4626_marine,8,3,8,0,11,100,0
4627_marine,8,3,8,0,11,100,0
4628_marine,8,3,8,0,11,100,0
4629_marine,8,5,8,0,13,100,0
4630_marine,8,5,8,0,13,100,0
4631_marine,8,5,8,0,13,100,0
4632_marine,6,5,6,0,11,100,0
4633_marine,6,5,6,0,11,100,0
4634_marine,6,5,6,0,11,100,0
4727_marine,2,5,2,0,7,100,0
4728_marine,2,5,2,0,7,100,0
4729_marine,2,5,2,0,7,100,0
4730_marine,2,5,2,0,7,100,0
4731_marine,2,5,2,0,7,100,0
4732_marine,2,5,2,0,7,100,0
4733_marine,2,5,2,0,7,100,0
4734_marine,2,5,2,0,7,100,0
4735_marine,4,5,4,0,9,100,0
4736_marine,4,5,4,0,9,100,0
4983_marine,8,3,8,0,11,100,0
4984_marine,8,3,8,0,11,100,0
4985_marine,8,3,8,0,11,100,0
4986_marine,6,3,6,0,9,100,0
4987_marine,6,5,6,0,11,100,0
4988_marine,6,5,6,0,11,100,0
4989_marine,6,5,6,0,11,100,0
4990_marine,6,5,6,0,11,100,0
5089_marine,2,5,2,0,7,100,0
5090_marine,2,5,2,0,7,100,0
5091_marine,2,5,2,0,7,100,0
5092_marine,2,5,2,0,7,100,0
5093_marine,2,5,2,0,7,100,0
5094_marine,4,5,4,0,9,100,0
5095_marine,4,5,4,0,9,100,0
5096_marine,4,6,4,0,10,100,0
5450_marine,2,7,2,0,9,100,0
5451_marine,2,7,2,0,9,100,0
5452_marine,2,7,2,0,9,100,0
5453_marine,4,7,4,0,11,100,0
5811_marine,2,7,2,0,9,100,0
5812_marine,2,7,2,0,9,100,0
57488_marine,2,0,2,0,2,100,0
57848_marine,2,0,2,0,2,100,0
58078_marine,2,0,2,0,2,100,0
58208_marine,2,0,2,0,2,100,0
58209_marine,2,0,2,0,2,100,0
58438_marine,2,0,2,0,2,100,0
58568_marine,2,0,2,0,2,100,0
58569_marine,2,0,2,0,2,100,0
58570_marine,2,0,2,0,2,100,0
58571_marine,2,0,2,0,2,100,0
59121_marine,2,0,2,0,2,100,0
59157_marine,2,0,2,0,2,100,0
59470_marine,2,0,2,0,2,100,0
59471_marine,2,0,2,0,2,100,0
59472_marine,2,0,2,0,2,100,0
59473_marine,2,0,2,0,2,100,0
59476_marine,2,0,2,0,2,100,0
59477_marine,2,0,2,0,2,100,0
59481_marine,2,0,2,0,2,100,0
59558_marine,2,0,2,0,2,100,0
59559_marine,2,0,2,0,2,100,0
59560_marine,2,0,2,0,2,100,0
59561_marine,2,0,2,0,2,100,0
59562_marine,2,0,2,0,2,100,0
59866_marine,2,0,2,0,2,100,0
59867_marine,2,0,2,0,2,100,0
59868_marine,2,0,2,0,2,100,0
59869_marine,2,0,2,0,2,100,0
59870_marine,2,0,2,0,2,100,0
60221_marine,2,4,2,0,6,100,0
60222_marine,2,2,2,0,4,100,0
60223_marine,2,2,2,0,4,100,0
60229_marine,2,0,2,0,2,100,0
60230_marine,2,0,2,0,2,100,0
60231_marine,2,0,2,0,2,100,0
60577_marine,2,0,2,0,2,100,0
60578_marine,2,0,2,0,2,100,0
60938_marine,2,0,2,0,2,100,0
60968_marine,2,0,2,0,2,100,0
60969_marine,2,0,2,0,2,100,0
60970_marine,2,0,2,0,2,100,0
60991_marine,2,0,2,0,2,100,0
60992_marine,2,0,2,0,2,100,0
61351_marine,2,0,2,0,2,100,0
61352_marine,2,0,2,0,2,100,0
61671_marine,2,0,2,0,2,100,0
61672_marine,2,0,2,0,2,100,0
61703_marine,2,0,2,0,2,100,0
62049_marine,2,0,2,0,2,100,0
62403_marine,2,0,2,0,2,100,0
56798_terrestrial,0,1,0,0,1,0,0
56808_terrestrial,0,1,0,0,1,0,0
56809_terrestrial,0,1,0,0,1,0,0
56840_terrestrial,0,1,0,0,1,0,0
57786_terrestrial,0,1,0,0,1,0,0
57788_terrestrial,0,1,0,0,1,0,0
58143_terrestrial,0,1,0,0,1,0,0
58144_terrestrial,0,1,0,0,1,0,0
58145_terrestrial,0,1,0,0,1,0,0
58146_terrestrial,0,1,0,0,1,0,0
58214_terrestrial,0,1,0,0,1,0,0
58215_terrestrial,0,1,0,0,1,0,0
61470_terrestrial,0,2,0,0,2,0,0
61471_terrestrial,0,2,0,0,2,0,0
61830_terrestrial,0,2,0,0,2,0,0
61831_terrestrial,0,2,0,0,2,0,0
58441_terrestrial,0,2,0,0,2,0,0
58798_terrestrial,0,2,0,0,2,0,0
58801_terrestrial,0,2,0,0,2,0,0
59475_terrestrial,0,2,0,0,2,0,0
61650_terrestrial,0,2,0,0,2,0,0
61651_terrestrial,0,2,0,0,2,0,0
63001_terrestrial,0,2,0,0,2,0,0
63561_terrestrial,0,8,0,0,8,0,0
63562_terrestrial,0,16,0,0,16,0,0
63919_terrestrial,0,16,0,0,16,0,0
63920_terrestrial,0,8,0,0,8,0,0
63921_terrestrial,0,4,0,0,4,0,0
63922_terrestrial,0,8,0,0,8,0,0
64278_terrestrial,0,4,0,0,4,0,0
64279_terrestrial,0,4,0,0,4,0,0
64282_terrestrial,0,8,0,0,8,0,0
64642_terrestrial,0,12,0,0,12,0,0
